Away,AQ1,AQ2,AQ3,AQ4,AOT1,AOT2,AOT3,AOT4,Home,HQ1,HQ2,HQ3,HQ4,HOT1,HOT2,HOT3,HOT4,Date,Away_Final,Home_Final,Q1M,Q2M,Q3M,Q4M,FinalMargin,FinalTotal,HomeMargin,Season,OTs,Weekday,TravelDist,Playoffs
Miami,9,21,27,23,0,0,0,0,Boston,16,29,18,25,0,0,0,0,20101026,80,88,7,15,6,8,8,168,8,2010,0,1,1257,0
Houston,33,29,20,28,0,0,0,0,LA Lakers,26,25,26,35,0,0,0,0,20101026,110,112,-7,-11,-5,2,2,222,2,2010,0,1,1371,0
Phoenix,26,20,35,11,0,0,0,0,Portland,28,22,25,31,0,0,0,0,20101026,92,106,2,4,-6,14,14,198,14,2010,0,1,1005,0
New York,29,22,23,24,0,0,0,0,Toronto,22,25,25,21,0,0,0,0,20101027,98,93,7,4,2,5,5,191,-5,2010,0,2,341,0
Indiana,31,34,24,20,0,0,0,0,San Antonio,37,29,26,30,0,0,0,0,20101027,109,122,6,1,3,13,13,231,13,2010,0,2,999,0
Miami,18,31,31,17,0,0,0,0,Philadelphia,15,26,13,33,0,0,0,0,20101027,97,87,3,8,26,10,10,184,-10,2010,0,2,1021,0
Chicago,25,29,28,13,0,0,0,0,Oklahoma City,30,29,23,24,0,0,0,0,20101027,95,106,5,5,0,11,11,201,11,2010,0,2,690,0
Detroit,20,27,20,31,0,0,0,0,Brooklyn,20,19,31,31,0,0,0,0,20101027,98,101,0,-8,3,3,3,199,3,2010,0,2,480,0
Sacramento,27,26,34,30,0,0,0,0,Minnesota,23,35,25,33,0,0,0,0,20101027,117,116,4,-5,4,1,1,233,-1,2010,0,2,1511,0
Milwaukee,30,17,25,19,0,0,0,0,New Orleans,29,18,31,17,0,0,0,0,20101027,91,95,-1,0,6,4,4,186,4,2010,0,2,911,0
Portland,31,23,16,28,0,0,0,0,LA Clippers,23,26,22,17,0,0,0,0,20101027,98,88,8,5,-1,10,10,186,-10,2010,0,2,826,0
Houston,31,37,28,32,0,0,0,0,Golden State,34,33,37,28,0,0,0,0,20101027,128,132,3,-1,8,4,4,260,4,2010,0,2,1642,0
Utah,20,20,25,23,0,0,0,0,Denver,29,31,26,24,0,0,0,0,20101027,88,110,9,20,21,22,22,198,22,2010,0,2,370,0
Charlotte,21,24,22,19,0,0,0,0,Dallas,25,24,31,21,0,0,0,0,20101027,86,101,4,4,13,15,15,187,15,2010,0,2,928,0
Boston,23,24,26,14,0,0,0,0,Cleveland,21,25,22,27,0,0,0,0,20101027,87,95,-2,-1,-5,8,8,182,8,2010,0,2,549,0
Atlanta,30,32,29,28,0,0,0,0,Memphis,22,28,25,29,0,0,0,0,20101027,119,104,8,12,16,15,15,223,-15,2010,0,2,336,0
Washington,15,19,25,24,0,0,0,0,Orlando,29,29,32,22,0,0,0,0,20101028,83,112,14,24,31,29,29,195,29,2010,0,3,757,0
Phoenix,27,31,26,26,0,0,0,0,Utah,22,20,30,22,0,0,0,0,20101028,110,94,5,16,12,16,16,204,-16,2010,0,3,505,0
Sacramento,21,32,24,23,0,0,0,0,Brooklyn,29,32,15,30,0,0,0,0,20101029,100,106,8,8,-1,6,6,206,6,2010,0,4,2499,0
Cleveland,20,18,17,26,0,0,0,0,Toronto,24,22,31,24,0,0,0,0,20101029,81,101,4,8,22,20,20,182,20,2010,0,4,187,0
LA Lakers,28,29,30,27,0,0,0,0,Phoenix,27,23,29,27,0,0,0,0,20101029,114,106,1,7,8,8,8,220,-8,2010,0,4,356,0
Atlanta,33,29,22,20,0,0,0,0,Philadelphia,30,22,22,27,0,0,0,0,20101029,104,101,3,10,10,3,3,205,-3,2010,0,4,665,0
Denver,25,25,21,24,0,0,0,0,New Orleans,27,32,13,29,0,0,0,0,20101029,95,101,2,9,1,6,6,196,6,2010,0,4,1079,0
Milwaukee,28,18,18,21,0,0,0,0,Minnesota,27,28,19,22,0,0,0,0,20101029,85,96,-1,9,10,11,11,181,11,2010,0,4,298,0
Orlando,24,21,10,15,0,0,0,0,Miami,24,27,28,17,0,0,0,0,20101029,70,96,0,6,24,26,26,166,26,2010,0,4,204,0
LA Clippers,28,26,13,24,0,0,0,0,Golden State,27,31,32,19,0,0,0,0,20101029,91,109,-1,4,23,18,18,200,18,2010,0,4,347,0
Oklahoma City,26,30,27,22,0,0,0,0,Detroit,21,30,28,25,0,0,0,0,20101029,105,104,5,5,4,1,1,209,-1,2010,0,4,909,0
Memphis,24,17,28,22,0,0,0,0,Dallas,29,21,25,15,0,0,0,0,20101029,91,90,-5,-9,-6,1,1,181,-1,2010,0,4,419,0
Indiana,27,23,23,31,0,0,0,0,Charlotte,31,27,22,21,0,0,0,0,20101029,104,101,-4,-8,-7,3,3,205,-3,2010,0,4,428,0
New York,20,26,26,29,0,0,0,0,Boston,27,23,29,26,0,0,0,0,20101029,101,105,7,4,7,4,4,206,4,2010,0,4,190,0
New Orleans,17,26,33,23,0,0,0,0,San Antonio,24,18,18,30,0,0,0,0,20101030,99,90,-7,1,16,9,9,189,-9,2010,0,5,506,0
Portland,26,18,30,26,0,0,0,0,New York,19,25,30,21,0,0,0,0,20101030,100,95,7,0,0,5,5,195,-5,2010,0,5,2439,0
Minnesota,19,27,29,14,0,0,0,0,Memphis,34,25,28,22,0,0,0,0,20101030,89,109,15,13,12,20,20,198,20,2010,0,5,700,0
Philadelphia,26,25,15,20,0,0,0,0,Indiana,21,30,27,21,0,0,0,0,20101030,86,99,-5,0,12,13,13,185,13,2010,0,5,582,0
Charlotte,18,22,22,26,0,0,0,0,Milwaukee,27,21,25,25,0,0,0,0,20101030,88,98,9,8,11,10,10,186,10,2010,0,5,658,0
Sacramento,34,19,31,23,0,0,0,0,Cleveland,34,33,15,22,0,0,0,0,20101030,107,104,0,-14,2,3,3,211,-3,2010,0,5,2096,0
Detroit,24,39,19,9,0,0,0,0,Chicago,21,23,23,34,0,0,0,0,20101030,91,101,-3,-19,-15,10,10,192,10,2010,0,5,238,0
Washington,27,13,30,25,0,0,0,0,Atlanta,18,26,26,29,0,0,0,0,20101030,95,99,-9,4,0,4,4,194,4,2010,0,5,541,0
Denver,24,24,24,35,0,0,0,0,Houston,27,24,18,25,0,0,0,0,20101030,107,94,-3,-3,3,13,13,201,-13,2010,0,5,878,0
Dallas,27,22,29,21,0,0,0,0,LA Clippers,23,24,19,17,0,0,0,0,20101031,99,83,4,2,12,16,16,182,-16,2010,0,6,1237,0
Golden State,14,24,26,19,0,0,0,0,LA Lakers,34,22,25,26,0,0,0,0,20101031,83,107,20,18,17,24,24,190,24,2010,0,6,347,0
Miami,29,29,27,16,0,0,0,0,Brooklyn,18,24,19,17,0,0,0,0,20101031,101,78,11,16,24,23,23,179,-23,2010,0,6,1091,0
Utah,27,29,35,29,0,0,0,0,Oklahoma City,23,17,34,25,0,0,0,0,20101031,120,99,4,16,17,21,21,219,-21,2010,0,6,861,0
Portland,21,26,26,25,0,0,0,0,Chicago,32,24,32,22,0,0,0,0,20101101,98,110,11,9,15,12,12,208,12,2010,0,0,1754,0
San Antonio,26,24,25,22,0,0,0,0,LA Clippers,26,18,21,23,0,0,0,0,20101101,97,88,0,6,10,9,9,185,-9,2010,0,0,1201,0
Toronto,33,29,24,22,0,0,0,0,Sacramento,16,35,27,33,0,0,0,0,20101101,108,111,-17,-11,-8,3,3,219,3,2010,0,0,2195,0
Philadelphia,28,20,18,40,9,0,0,0,Washington,27,23,22,34,10,0,0,0,20101102,115,116,-1,2,6,0,1,231,1,2010,1,1,123,0
Minnesota,27,26,17,27,0,0,0,0,Miami,33,36,29,31,0,0,0,0,20101102,97,129,6,16,28,32,32,226,32,2010,0,1,1513,0
Portland,21,26,26,17,0,0,0,0,Milwaukee,27,18,17,14,0,0,0,0,20101102,90,76,-6,2,11,14,14,166,-14,2010,0,1,1714,0
Boston,31,26,31,21,0,0,0,0,Detroit,26,18,24,18,0,0,0,0,20101102,109,86,5,13,20,23,23,195,-23,2010,0,1,611,0
Memphis,23,23,30,29,0,0,0,0,LA Lakers,34,39,24,27,0,0,0,0,20101102,105,124,11,27,21,19,19,229,19,2010,0,1,1599,0
Atlanta,40,19,15,26,0,0,0,0,Cleveland,27,20,26,15,0,0,0,0,20101102,100,88,13,12,1,12,12,188,-12,2010,0,1,555,0
Toronto,22,25,37,24,0,0,0,0,Utah,41,25,25,34,0,0,0,0,20101103,108,125,19,19,7,17,17,233,17,2010,0,2,1664,0
LA Lakers,35,27,30,20,0,0,0,0,Sacramento,33,20,25,22,0,0,0,0,20101103,112,100,2,9,14,12,12,212,-12,2010,0,2,361,0
San Antonio,23,27,31,31,0,0,0,0,Phoenix,22,28,29,31,0,0,0,0,20101103,112,110,1,0,2,2,2,222,-2,2010,0,2,846,0
Indiana,16,15,27,17,0,0,0,0,Philadelphia,31,26,21,23,0,0,0,0,20101103,75,101,15,26,20,26,26,176,26,2010,0,2,582,0
Charlotte,23,18,21,23,0,0,0,0,Brooklyn,19,21,21,22,0,0,0,0,20101103,85,83,4,1,1,2,2,168,-2,2010,0,2,531,0
Minnesota,18,27,18,23,0,0,0,0,Orlando,37,41,24,26,0,0,0,0,20101103,86,128,19,33,39,42,42,214,42,2010,0,2,1309,0
New Orleans,28,15,30,34,0,0,0,0,Houston,28,21,22,28,0,0,0,0,20101103,107,99,0,-6,2,8,8,206,-8,2010,0,2,317,0
Memphis,26,26,31,26,0,0,0,0,Golden State,27,37,24,27,0,0,0,0,20101103,109,115,1,12,5,6,6,224,6,2010,0,2,1798,0
Dallas,23,27,34,18,0,0,0,0,Denver,27,25,28,21,0,0,0,0,20101103,102,101,-4,-2,4,1,1,203,-1,2010,0,2,661,0
Milwaukee,16,31,16,28,11,0,0,0,Boston,25,22,15,29,14,0,0,0,20101103,102,105,9,0,-1,0,3,207,3,2010,1,2,855,0
Detroit,22,26,18,19,0,0,0,0,Atlanta,24,20,26,24,0,0,0,0,20101103,85,94,2,-4,4,9,9,179,9,2010,0,2,597,0
Oklahoma City,21,22,23,26,0,0,0,0,LA Clippers,27,26,27,27,0,0,0,0,20101103,92,107,6,10,14,15,15,199,15,2010,0,2,1178,0
New York,34,36,23,27,0,0,0,0,Chicago,30,22,31,29,0,0,0,0,20101104,120,112,4,18,10,8,8,232,-8,2010,0,3,711,0
Oklahoma City,29,22,24,25,7,0,0,0,Portland,23,35,23,19,6,0,0,0,20101104,107,106,6,-7,-6,0,1,213,-1,2010,1,3,1484,0
Miami,17,24,23,29,0,0,0,0,New Orleans,29,21,22,24,0,0,0,0,20101105,93,96,12,9,8,3,3,189,3,2010,0,4,668,0
Cleveland,34,27,18,44,0,0,0,0,Philadelphia,20,33,31,32,0,0,0,0,20101105,123,116,14,8,-5,7,7,239,-7,2010,0,4,358,0
Memphis,35,20,21,23,10,9,0,0,Phoenix,20,25,25,29,10,14,0,0,20101105,118,123,-15,-10,-6,0,5,241,5,2010,2,4,1260,0
Washington,27,22,24,18,0,0,0,0,New York,26,32,23,31,0,0,0,0,20101105,91,112,-1,9,8,21,21,203,21,2010,0,4,204,0
Atlanta,26,30,27,30,0,0,0,0,Minnesota,25,26,20,32,0,0,0,0,20101105,113,103,1,5,12,10,10,216,-10,2010,0,4,908,0
Brooklyn,18,33,16,23,0,0,0,0,Orlando,20,28,32,25,0,0,0,0,20101105,90,105,2,-3,13,15,15,195,15,2010,0,4,939,0
Milwaukee,18,34,18,24,0,0,0,0,Indiana,20,40,16,14,0,0,0,0,20101105,94,90,-2,-8,-6,4,4,184,-4,2010,0,4,243,0
Utah,16,23,17,22,0,0,0,0,Golden State,17,23,20,25,0,0,0,0,20101105,78,85,1,1,4,7,7,163,7,2010,0,4,599,0
Charlotte,15,24,25,26,0,0,0,0,Detroit,32,23,17,25,0,0,0,0,20101105,90,97,17,16,8,7,7,187,7,2010,0,4,504,0
LA Clippers,28,26,17,33,0,0,0,0,Denver,24,29,29,29,0,0,0,0,20101105,104,111,-4,-1,11,7,7,215,7,2010,0,4,830,0
Chicago,23,15,26,32,9,0,0,0,Boston,19,30,23,24,14,0,0,0,20101105,105,110,-4,11,8,0,5,215,5,2010,1,4,849,0
Toronto,20,38,20,25,0,0,0,0,LA Lakers,33,22,27,26,0,0,0,0,20101105,103,108,13,-3,4,5,5,211,5,2010,0,4,2170,0
LA Clippers,35,20,18,18,6,10,0,0,Utah,22,17,31,21,6,12,0,0,20101106,107,109,-13,-16,-3,0,2,216,2,2010,2,5,579,0
Houston,34,18,32,29,8,0,0,0,San Antonio,34,23,34,22,11,0,0,0,20101106,121,124,0,5,7,0,3,245,3,2010,1,5,189,0
Memphis,30,23,27,20,0,0,0,0,Sacramento,24,25,18,24,0,0,0,0,20101106,100,91,6,4,13,9,9,191,-9,2010,0,5,1745,0
Toronto,17,17,25,25,0,0,0,0,Portland,18,27,28,24,0,0,0,0,20101106,84,97,1,11,14,13,13,181,13,2010,0,5,2108,0
Cleveland,27,32,17,31,0,0,0,0,Washington,28,23,25,26,0,0,0,0,20101106,107,102,-1,8,0,5,5,209,-5,2010,0,5,304,0
Brooklyn,25,26,17,21,0,0,0,0,Miami,24,31,32,14,0,0,0,0,20101106,89,101,-1,4,19,12,12,190,12,2010,0,5,1091,0
Denver,26,27,26,24,0,0,0,0,Dallas,24,28,27,13,0,0,0,0,20101106,103,92,2,1,0,11,11,195,-11,2010,0,5,661,0
Orlando,23,20,30,18,0,0,0,0,Charlotte,15,21,26,26,0,0,0,0,20101106,91,88,8,7,11,3,3,179,-3,2010,0,5,463,0
New Orleans,23,18,24,22,0,0,0,0,Milwaukee,18,17,19,27,0,0,0,0,20101106,87,81,5,6,11,6,6,168,-6,2010,0,5,911,0
Philadelphia,33,21,26,26,0,0,0,0,New York,25,31,25,15,0,0,0,0,20101107,106,96,8,-2,-1,10,10,202,-10,2010,0,6,80,0
Portland,14,22,28,32,0,0,0,0,LA Lakers,27,31,31,32,0,0,0,0,20101107,96,121,13,22,25,25,25,217,25,2010,0,6,826,0
Boston,28,30,15,19,0,0,0,0,Oklahoma City,21,16,27,19,0,0,0,0,20101107,92,83,7,21,9,9,9,175,-9,2010,0,6,1492,0
Golden State,18,27,31,21,0,0,0,0,Detroit,23,26,24,29,0,0,0,0,20101107,97,102,5,4,-3,5,5,199,5,2010,0,6,2087,0
Phoenix,30,31,29,28,0,0,0,0,Atlanta,28,22,38,26,0,0,0,0,20101107,118,114,2,11,2,4,4,232,-4,2010,0,6,1588,0
Minnesota,14,23,30,27,0,0,0,0,Houston,26,34,37,23,0,0,0,0,20101107,94,120,12,23,30,26,26,214,26,2010,0,6,1057,0
San Antonio,19,25,27,24,0,0,0,0,Charlotte,26,22,21,22,0,0,0,0,20101108,95,91,-7,-4,2,4,4,186,-4,2010,0,0,1103,0
Denver,28,15,27,22,0,0,0,0,Chicago,23,27,18,26,0,0,0,0,20101108,92,94,-5,7,-2,2,2,186,2,2010,0,0,916,0
Boston,19,21,29,18,0,0,0,0,Dallas,23,27,20,19,0,0,0,0,20101108,87,89,4,10,1,2,2,176,2,2010,0,0,1548,0
Phoenix,26,26,23,24,0,0,0,0,Memphis,28,27,33,21,0,0,0,0,20101108,99,109,2,3,13,10,10,208,10,2010,0,0,1260,0
Atlanta,23,24,23,19,0,0,0,0,Orlando,21,30,21,21,0,0,0,0,20101108,89,93,-2,4,2,4,4,182,4,2010,0,0,401,0
Golden State,26,29,29,25,0,0,0,0,Toronto,19,22,31,30,0,0,0,0,20101108,109,102,7,14,12,7,7,211,-7,2010,0,0,2263,0
Cleveland,23,22,18,30,0,0,0,0,Brooklyn,23,19,23,26,0,0,0,0,20101109,93,91,0,3,-2,2,2,184,-2,2010,0,1,403,0
LA Clippers,18,23,19,22,0,0,0,0,New Orleans,27,21,22,31,0,0,0,0,20101109,82,101,9,7,10,19,19,183,19,2010,0,1,1669,0
New York,19,24,24,13,0,0,0,0,Milwaukee,41,23,26,17,0,0,0,0,20101109,80,107,22,21,23,27,27,187,27,2010,0,1,732,0
Detroit,25,20,18,15,0,0,0,0,Portland,36,17,21,26,0,0,0,0,20101109,78,100,11,8,11,22,22,178,22,2010,0,1,1964,0
Minnesota,28,24,22,20,0,0,0,0,LA Lakers,26,32,24,17,0,0,0,0,20101109,94,99,-2,6,8,5,5,193,5,2010,0,1,1521,0
Denver,25,24,27,37,0,0,0,0,Indiana,27,32,54,31,0,0,0,0,20101109,113,144,2,10,37,31,31,257,31,2010,0,1,998,0
Utah,13,19,30,42,12,0,0,0,Miami,25,26,24,29,10,0,0,0,20101109,116,114,-12,-19,-13,0,2,230,-2,2010,1,1,2086,0
Milwaukee,21,33,34,20,0,0,0,0,Atlanta,26,14,19,32,0,0,0,0,20101110,108,91,-5,14,29,17,17,199,-17,2010,0,2,669,0
Brooklyn,18,24,25,28,0,0,0,0,Cleveland,25,27,17,18,0,0,0,0,20101110,95,87,-7,-10,-2,8,8,182,-8,2010,0,2,403,0
Dallas,27,28,31,20,0,0,0,0,Memphis,21,29,19,22,0,0,0,0,20101110,106,91,6,5,17,15,15,197,-15,2010,0,2,419,0
Golden State,34,26,29,33,0,0,0,0,New York,32,24,25,36,0,0,0,0,20101110,122,117,2,4,8,5,5,239,-5,2010,0,2,2565,0
Philadelphia,28,23,23,29,0,0,0,0,Oklahoma City,32,27,26,24,0,0,0,0,20101110,103,109,4,8,11,6,6,212,6,2010,0,2,1256,0
Utah,22,13,30,39,0,0,0,0,Orlando,23,22,29,20,0,0,0,0,20101110,104,94,-1,-10,-9,10,10,198,-10,2010,0,2,1915,0
Minnesota,27,24,23,24,0,0,0,0,Sacramento,22,23,27,17,0,0,0,0,20101110,98,89,5,6,2,9,9,187,-9,2010,0,2,1511,0
LA Clippers,20,24,21,30,0,0,0,0,San Antonio,24,27,28,28,0,0,0,0,20101110,95,107,4,7,14,12,12,202,12,2010,0,2,1201,0
Charlotte,26,22,21,32,0,0,0,0,Toronto,24,24,26,22,0,0,0,0,20101110,101,96,2,0,-5,5,5,197,-5,2010,0,2,585,0
Houston,21,25,26,19,0,0,0,0,Washington,30,23,20,25,0,0,0,0,20101110,91,98,9,7,1,7,7,189,7,2010,0,2,1217,0
Boston,27,34,27,24,0,0,0,0,Miami,20,26,32,29,0,0,0,0,20101111,112,107,7,15,10,5,5,219,-5,2010,0,3,1257,0
LA Lakers,26,38,29,19,0,0,0,0,Denver,24,35,26,33,0,0,0,0,20101111,112,118,-2,-5,-8,6,6,230,6,2010,0,3,830,0
Golden State,20,18,25,27,0,0,0,0,Chicago,34,32,28,26,0,0,0,0,20101111,90,120,14,28,31,30,30,210,30,2010,0,3,1853,0
Utah,25,17,21,27,0,0,0,0,Atlanta,26,19,24,17,0,0,0,0,20101112,90,86,-1,-3,-6,4,4,176,-4,2010,0,4,1580,0
Philadelphia,22,26,27,15,0,0,0,0,Dallas,31,24,23,21,0,0,0,0,20101112,90,99,9,7,3,9,9,189,9,2010,0,4,1297,0
Houston,26,22,30,24,0,0,0,0,Indiana,23,27,28,21,0,0,0,0,20101112,102,99,3,-2,0,3,3,201,-3,2010,0,4,865,0
Detroit,26,31,17,29,10,0,0,0,LA Clippers,19,28,27,29,4,0,0,0,20101112,113,107,7,10,0,0,6,220,-6,2010,1,4,1979,0
New York,30,35,22,16,0,0,0,0,Minnesota,27,24,29,32,0,0,0,0,20101112,103,112,-3,-14,-7,9,9,215,9,2010,0,4,1016,0
Portland,35,30,22,21,0,0,0,0,Oklahoma City,29,32,23,26,0,0,0,0,20101112,108,110,-6,-4,-3,2,2,218,2,2010,0,4,1484,0
Toronto,30,29,30,21,0,0,0,0,Orlando,31,28,23,24,0,0,0,0,20101112,110,106,-1,0,7,4,4,216,-4,2010,0,4,1048,0
Sacramento,24,19,25,21,0,0,0,0,Phoenix,30,22,25,26,0,0,0,0,20101112,89,103,6,9,9,14,14,192,14,2010,0,4,634,0
Charlotte,19,23,26,25,0,0,0,0,Washington,22,21,22,20,0,0,0,0,20101112,93,85,-3,-1,3,8,8,178,-8,2010,0,4,329,0
Philadelphia,28,24,12,29,0,0,0,0,San Antonio,39,22,35,20,0,0,0,0,20101113,93,116,11,9,32,23,23,209,23,2010,0,5,1505,0
Portland,19,16,31,21,0,0,0,0,New Orleans,26,22,27,32,0,0,0,0,20101113,87,107,7,13,9,20,20,194,20,2010,0,5,2059,0
Orlando,31,21,16,23,0,0,0,0,Brooklyn,25,26,18,21,0,0,0,0,20101113,91,90,6,1,-1,1,1,181,-1,2010,0,5,939,0
Golden State,16,14,21,21,0,0,0,0,Milwaukee,24,19,23,13,0,0,0,0,20101113,72,79,8,13,15,7,7,151,7,2010,0,5,1838,0
Boston,27,27,19,26,17,0,0,0,Memphis,27,22,24,26,11,0,0,0,20101113,116,110,0,5,0,0,6,226,-6,2010,1,5,1134,0
Indiana,26,28,19,26,0,0,0,0,Cleveland,30,24,14,17,0,0,0,0,20101113,99,85,-4,0,5,14,14,184,-14,2010,0,5,262,0
Washington,25,17,16,38,0,0,0,0,Chicago,24,26,22,31,0,0,0,0,20101113,96,103,-1,8,14,7,7,199,7,2010,0,5,594,0
Utah,13,20,30,33,0,0,0,0,Charlotte,28,21,24,22,0,0,0,0,20101113,96,95,-15,-16,-10,1,1,191,-1,2010,0,5,1723,0
Toronto,25,25,23,27,0,0,0,0,Miami,34,29,20,26,0,0,0,0,20101113,100,109,9,13,10,9,9,209,9,2010,0,5,1234,0
Minnesota,27,25,20,33,0,0,0,0,Atlanta,30,30,23,28,0,0,0,0,20101114,105,111,3,8,11,6,6,216,6,2010,0,6,908,0
Phoenix,23,33,36,29,0,0,0,0,LA Lakers,25,28,31,32,0,0,0,0,20101114,121,116,-2,3,8,5,5,237,-5,2010,0,6,356,0
Houston,26,32,26,20,0,0,0,0,New York,27,25,23,21,0,0,0,0,20101114,104,96,-1,6,9,8,8,200,-8,2010,0,6,1417,0
San Antonio,30,31,21,35,0,0,0,0,Oklahoma City,35,31,14,24,0,0,0,0,20101114,117,104,-5,-5,2,13,13,221,-13,2010,0,6,421,0
Detroit,22,28,25,25,0,0,0,0,Sacramento,19,26,27,22,0,0,0,0,20101114,100,94,3,5,3,6,6,194,-6,2010,0,6,2020,0
Memphis,12,22,22,16,0,0,0,0,Orlando,20,27,22,20,0,0,0,0,20101115,72,89,8,13,13,17,17,161,17,2010,0,0,683,0
Oklahoma City,27,31,35,22,0,0,0,0,Utah,33,23,29,23,0,0,0,0,20101115,115,108,-6,2,8,7,7,223,-7,2010,0,0,861,0
Denver,22,36,18,18,0,0,0,0,Phoenix,20,26,23,31,0,0,0,0,20101115,94,100,-2,-12,-7,6,6,194,6,2010,0,0,585,0
Detroit,21,21,27,28,0,0,0,0,Golden State,34,31,22,14,0,0,0,0,20101115,97,101,13,23,18,4,4,198,4,2010,0,0,2087,0
New Orleans,24,28,24,19,0,0,0,0,Dallas,27,20,22,29,0,0,0,0,20101115,95,98,3,-5,-7,3,3,193,3,2010,0,0,442,0
Minnesota,27,33,21,29,0,0,0,0,Charlotte,22,38,24,29,0,0,0,0,20101115,110,113,-5,0,3,3,3,223,3,2010,0,0,938,0
Brooklyn,24,31,21,34,0,0,0,0,LA Clippers,23,21,26,26,0,0,0,0,20101115,110,96,1,11,6,14,14,206,-14,2010,0,0,2445,0
Toronto,23,24,21,26,0,0,0,0,Washington,27,27,36,19,0,0,0,0,20101116,94,109,4,7,22,15,15,203,15,2010,0,1,349,0
Philadelphia,23,31,16,23,0,0,0,0,Cleveland,19,35,26,21,0,0,0,0,20101116,93,101,-4,0,10,8,8,194,8,2010,0,1,358,0
New York,26,28,28,36,0,0,0,0,Denver,26,35,33,26,0,0,0,0,20101116,118,120,0,7,12,2,2,238,2,2010,0,1,1627,0
Chicago,19,30,14,32,0,0,0,0,Houston,26,15,30,21,0,0,0,0,20101116,95,92,-7,8,-8,3,3,187,-3,2010,0,1,939,0
Atlanta,21,29,27,25,0,0,0,0,Indiana,24,25,16,27,0,0,0,0,20101116,102,92,-3,1,12,10,10,194,-10,2010,0,1,427,0
Portland,22,29,20,29,0,0,0,0,Memphis,17,28,25,29,0,0,0,0,20101116,100,99,5,6,1,1,1,199,-1,2010,0,1,1845,0
LA Lakers,32,25,33,28,0,0,0,0,Milwaukee,29,30,22,26,0,0,0,0,20101116,118,107,3,-2,9,11,11,225,-11,2010,0,1,1741,0
New York,14,40,29,30,0,0,0,0,Sacramento,27,22,25,32,0,0,0,0,20101117,113,106,-13,5,9,7,7,219,-7,2010,0,2,2499,0
Toronto,25,21,23,25,0,0,0,0,Philadelphia,26,21,24,15,0,0,0,0,20101117,94,86,-1,-1,-2,8,8,180,-8,2010,0,2,334,0
Chicago,25,22,12,35,0,0,0,0,San Antonio,18,19,37,29,0,0,0,0,20101117,94,103,-7,-10,15,9,9,197,9,2010,0,2,1050,0
Brooklyn,25,22,23,18,0,0,0,0,Utah,24,29,24,21,0,0,0,0,20101117,88,98,-1,6,7,10,10,186,10,2010,0,2,1967,0
Houston,23,30,26,20,0,0,0,0,Oklahoma City,28,36,30,22,0,0,0,0,20101117,99,116,5,11,15,17,17,215,17,2010,0,2,413,0
LA Lakers,34,25,25,19,0,0,0,0,Detroit,25,20,18,27,0,0,0,0,20101117,103,90,9,14,21,13,13,193,-13,2010,0,2,1979,0
LA Clippers,28,33,24,26,0,0,0,0,Minnesota,28,33,27,25,0,0,0,0,20101117,111,113,0,0,3,2,2,224,2,2010,0,2,1521,0
Phoenix,24,19,30,23,0,0,0,0,Miami,27,37,36,23,0,0,0,0,20101117,96,123,3,21,27,27,27,219,27,2010,0,2,1978,0
Washington,28,16,25,14,0,0,0,0,Boston,33,27,29,25,0,0,0,0,20101117,83,114,5,16,20,31,31,197,31,2010,0,2,394,0
Dallas,31,21,17,28,0,0,0,0,New Orleans,23,19,33,24,0,0,0,0,20101117,97,99,-8,-10,6,2,2,196,2,2010,0,2,442,0
LA Clippers,25,18,16,21,0,0,0,0,Indiana,22,31,27,27,0,0,0,0,20101118,80,107,-3,10,21,27,27,187,27,2010,0,3,1805,0
Phoenix,15,19,25,30,0,0,0,0,Orlando,31,31,29,14,0,0,0,0,20101118,89,105,16,28,32,16,16,194,16,2010,0,3,1842,0
Denver,28,17,26,12,0,0,0,0,Portland,16,27,26,17,0,0,0,0,20101118,83,86,-12,-2,-2,3,3,169,3,2010,0,3,981,0
Memphis,24,21,23,18,0,0,0,0,Washington,25,18,23,23,0,0,0,0,20101119,86,89,1,-2,-2,3,3,175,3,2010,0,4,762,0
San Antonio,24,20,26,24,0,0,0,0,Utah,14,26,28,14,0,0,0,0,20101119,94,82,10,4,2,12,12,176,-12,2010,0,4,1087,0
Houston,27,16,31,22,0,0,0,0,Toronto,28,23,24,31,0,0,0,0,20101119,96,106,1,8,1,10,10,202,10,2010,0,4,1299,0
Brooklyn,19,27,17,18,0,0,0,0,Sacramento,21,22,21,22,0,0,0,0,20101119,81,86,2,-3,1,5,5,167,5,2010,0,4,2499,0
Milwaukee,25,18,16,20,0,0,0,0,Philadelphia,20,29,23,18,0,0,0,0,20101119,79,90,-5,6,13,11,11,169,11,2010,0,4,692,0
Charlotte,23,14,31,19,0,0,0,0,Miami,31,25,19,20,0,0,0,0,20101119,87,95,8,19,7,8,8,182,8,2010,0,4,654,0
LA Lakers,20,31,33,28,0,0,0,0,Minnesota,21,20,30,24,0,0,0,0,20101119,112,95,-1,10,13,17,17,207,-17,2010,0,4,1521,0
New York,31,41,26,27,0,0,0,0,Golden State,31,28,25,35,0,0,0,0,20101119,125,119,0,13,14,6,6,244,-6,2010,0,4,2565,0
Chicago,19,20,17,32,0,0,0,0,Dallas,13,22,24,24,0,0,0,0,20101119,88,83,6,4,-3,5,5,171,-5,2010,0,4,802,0
Oklahoma City,25,24,28,12,0,0,0,0,Boston,23,23,23,15,0,0,0,0,20101119,89,84,2,3,8,5,5,173,-5,2010,0,4,1492,0
Cleveland,28,15,25,33,0,0,0,0,New Orleans,26,36,19,27,0,0,0,0,20101119,101,108,-2,19,13,7,7,209,7,2010,0,4,924,0
Miami,17,22,29,27,0,0,0,0,Memphis,26,17,25,29,0,0,0,0,20101120,95,97,9,4,0,2,2,192,2,2010,0,5,873,0
Utah,19,26,20,38,0,0,0,0,Portland,24,24,26,20,0,0,0,0,20101120,103,94,-5,-3,-9,9,9,197,-9,2010,0,5,634,0
Cleveland,29,28,18,17,0,0,0,0,San Antonio,28,36,25,27,0,0,0,0,20101120,92,116,-1,7,14,24,24,208,24,2010,0,5,1256,0
New York,28,30,35,31,0,0,0,0,LA Clippers,29,24,32,30,0,0,0,0,20101120,124,115,-1,5,8,9,9,239,-9,2010,0,5,2445,0
Oklahoma City,26,21,15,20,0,0,0,0,Milwaukee,19,18,19,25,0,0,0,0,20101120,82,81,7,10,6,1,1,163,-1,2010,0,5,732,0
Brooklyn,25,29,21,28,0,0,0,0,Denver,28,31,24,24,0,0,0,0,20101120,103,107,3,5,8,4,4,210,4,2010,0,5,1627,0
Phoenix,25,26,23,31,0,0,0,0,Charlotte,30,25,34,34,0,0,0,0,20101120,105,123,5,4,15,18,18,228,18,2010,0,5,1778,0
Dallas,28,27,22,21,0,0,0,0,Atlanta,25,18,25,25,0,0,0,0,20101120,98,93,3,12,9,5,5,191,-5,2010,0,5,719,0
Orlando,29,20,22,19,0,0,0,0,Indiana,26,26,14,20,0,0,0,0,20101120,90,86,3,-3,5,4,4,176,-4,2010,0,5,822,0
Washington,17,38,23,24,8,0,0,0,Detroit,24,28,25,25,13,0,0,0,20101121,110,115,7,-3,-1,0,5,225,5,2010,1,6,394,0
Golden State,21,20,19,29,0,0,0,0,LA Lakers,37,32,26,22,0,0,0,0,20101121,89,117,16,28,35,28,28,206,28,2010,0,6,347,0
New Orleans,14,25,20,16,0,0,0,0,Sacramento,16,23,17,15,0,0,0,0,20101121,75,71,-2,0,3,4,4,146,-4,2010,0,6,1879,0
Boston,31,27,17,26,0,0,0,0,Toronto,23,38,21,20,0,0,0,0,20101121,101,102,-8,3,7,1,1,203,1,2010,0,6,430,0
Sacramento,22,15,19,27,0,0,0,0,Utah,20,29,29,16,0,0,0,0,20101122,83,94,-2,12,22,11,11,177,11,2010,0,0,532,0
Orlando,30,22,25,20,0,0,0,0,San Antonio,28,25,21,32,0,0,0,0,20101122,97,106,-2,1,-3,9,9,203,9,2010,0,0,1035,0
Indiana,19,35,20,19,0,0,0,0,Miami,22,19,23,13,0,0,0,0,20101122,93,77,-3,13,10,16,16,170,-16,2010,0,0,1026,0
Minnesota,27,27,27,26,0,0,0,0,Oklahoma City,28,37,25,27,0,0,0,0,20101122,107,117,1,11,9,10,10,224,10,2010,0,0,694,0
Phoenix,26,33,31,33,0,0,0,0,Houston,25,20,31,40,0,0,0,0,20101122,123,116,1,14,14,7,7,239,-7,2010,0,0,1014,0
Denver,21,30,28,27,0,0,0,0,Golden State,24,28,19,18,0,0,0,0,20101122,106,89,-3,-1,8,17,17,195,-17,2010,0,0,947,0
Boston,39,25,21,14,0,0,0,0,Atlanta,13,29,14,20,0,0,0,0,20101122,99,76,26,22,29,23,23,175,-23,2010,0,0,935,0
New Orleans,37,20,16,22,0,0,0,0,LA Clippers,33,22,22,22,0,0,0,0,20101122,95,99,-4,-2,4,4,4,194,4,2010,0,0,1669,0
Detroit,17,25,19,23,0,0,0,0,Dallas,24,14,18,32,0,0,0,0,20101123,84,88,7,-4,-5,4,4,172,4,2010,0,1,999,0
Cleveland,16,21,19,33,0,0,0,0,Indiana,24,38,21,17,0,0,0,0,20101123,89,100,8,25,27,11,11,189,11,2010,0,1,262,0
Chicago,26,23,24,18,0,0,0,0,LA Lakers,26,25,23,24,0,0,0,0,20101123,91,98,0,2,1,7,7,189,7,2010,0,1,1741,0
Atlanta,21,22,24,26,8,0,0,0,Brooklyn,31,20,19,23,14,0,0,0,20101123,101,107,10,8,3,0,6,208,6,2010,1,1,745,0
Charlotte,26,23,26,32,0,0,0,0,New York,32,28,29,21,0,0,0,0,20101123,107,110,6,11,14,3,3,217,3,2010,0,1,531,0
Philadelphia,30,22,25,29,8,0,0,0,Washington,20,18,35,33,10,0,0,0,20101123,114,116,-10,-14,-4,0,2,230,2,2010,1,1,123,0
Dallas,24,31,20,36,0,0,0,0,Oklahoma City,27,29,25,22,0,0,0,0,20101124,111,103,-3,-1,-6,8,8,214,-8,2010,0,2,189,0
New Orleans,30,21,21,15,0,0,0,0,Utah,31,30,19,25,0,0,0,0,20101124,87,105,1,10,8,18,18,192,18,2010,0,2,1432,0
Chicago,17,33,22,29,10,12,0,0,Phoenix,36,26,22,17,10,4,0,0,20101124,123,115,-19,-12,-12,0,8,238,-8,2010,2,2,1450,0
Miami,18,25,28,24,0,0,0,0,Orlando,26,25,23,30,0,0,0,0,20101124,95,104,8,8,3,9,9,199,9,2010,0,2,204,0
San Antonio,18,23,30,35,7,0,0,0,Minnesota,33,22,27,24,3,0,0,0,20101124,113,109,-15,-14,-11,0,4,222,-4,2010,1,2,1112,0
Philadelphia,18,25,28,19,0,0,0,0,Toronto,33,29,25,19,0,0,0,0,20101124,90,106,15,19,16,16,16,196,16,2010,0,2,334,0
Golden State,23,28,27,23,0,0,0,0,Houston,36,23,23,29,0,0,0,0,20101124,101,111,13,8,4,10,10,212,10,2010,0,2,1642,0
Milwaukee,22,22,24,13,0,0,0,0,Cleveland,19,15,31,18,0,0,0,0,20101124,81,83,-3,-10,-3,2,2,164,2,2010,0,2,334,0
New York,24,27,30,18,0,0,0,0,Charlotte,25,23,23,24,0,0,0,0,20101124,99,95,-1,3,10,4,4,194,-4,2010,0,2,531,0
Detroit,21,29,18,16,0,0,0,0,Memphis,24,23,33,25,0,0,0,0,20101124,84,105,3,-3,12,21,21,189,21,2010,0,2,622,0
Brooklyn,17,29,17,20,0,0,0,0,Boston,18,20,23,28,0,0,0,0,20101124,83,89,1,-8,-2,6,6,172,6,2010,0,2,190,0
Washington,18,18,27,33,0,0,0,0,Atlanta,28,25,36,27,0,0,0,0,20101125,96,116,10,17,26,20,20,212,20,2010,0,3,541,0
Sacramento,25,25,19,13,0,0,0,0,LA Clippers,30,24,30,16,0,0,0,0,20101125,82,100,5,4,15,18,18,182,18,2010,0,3,361,0
LA Lakers,33,17,22,24,0,0,0,0,Utah,17,29,29,27,0,0,0,0,20101126,96,102,-16,-4,3,6,6,198,6,2010,0,4,579,0
Dallas,27,22,22,32,0,0,0,0,San Antonio,29,22,22,21,0,0,0,0,20101126,103,94,-2,-2,-2,9,9,197,-9,2010,0,4,252,0
New Orleans,26,28,21,22,0,0,0,0,Portland,33,15,17,13,0,0,0,0,20101126,97,78,-7,6,10,19,19,175,-19,2010,0,4,2059,0
LA Clippers,21,30,30,27,0,0,0,0,Phoenix,44,23,31,18,0,0,0,0,20101126,108,116,23,16,17,8,8,224,8,2010,0,4,356,0
Cleveland,22,27,25,26,0,0,0,0,Orlando,32,30,23,26,0,0,0,0,20101126,100,111,10,13,11,11,11,211,11,2010,0,4,895,0
Philadelphia,17,30,24,19,0,0,0,0,Miami,25,26,22,26,0,0,0,0,20101126,90,99,8,4,2,9,9,189,9,2010,0,4,1021,0
Milwaukee,18,25,21,25,0,0,0,0,Detroit,29,26,20,28,0,0,0,0,20101126,89,103,11,12,11,14,14,192,14,2010,0,4,251,0
Oklahoma City,23,21,27,25,14,0,0,0,Indiana,20,32,24,20,10,0,0,0,20101126,110,106,3,-8,-5,0,4,216,-4,2010,1,4,688,0
Chicago,20,18,35,24,0,0,0,0,Denver,25,23,28,22,0,0,0,0,20101126,97,98,5,10,3,1,1,195,1,2010,0,4,916,0
Houston,26,26,16,21,0,0,0,0,Charlotte,22,23,27,27,0,0,0,0,20101126,89,99,-4,-7,4,10,10,188,10,2010,0,4,925,0
Toronto,20,32,15,34,0,0,0,0,Boston,31,27,28,24,0,0,0,0,20101126,101,110,11,6,19,9,9,211,9,2010,0,4,430,0
Golden State,24,29,29,29,0,0,0,0,Memphis,30,33,24,29,0,0,0,0,20101126,111,116,6,10,5,5,5,227,5,2010,0,4,1798,0
Brooklyn,24,24,18,20,0,0,0,0,Philadelphia,27,19,20,36,0,0,0,0,20101127,86,102,3,-2,0,16,16,188,16,2010,0,5,80,0
Orlando,30,25,19,26,0,0,0,0,Washington,20,23,29,27,0,0,0,0,20101127,100,99,10,12,2,1,1,199,-1,2010,0,5,757,0
Atlanta,32,24,19,24,0,0,0,0,New York,22,16,28,24,0,0,0,0,20101127,99,90,10,18,9,9,9,189,-9,2010,0,5,745,0
Chicago,21,23,25,27,0,0,0,0,Sacramento,28,29,19,9,0,0,0,0,20101127,96,85,-7,-13,-7,11,11,181,-11,2010,0,5,1788,0
Charlotte,16,37,19,29,0,0,0,0,Milwaukee,29,31,22,22,0,0,0,0,20101127,101,104,13,7,10,3,3,205,3,2010,0,5,658,0
Miami,26,23,17,29,0,0,0,0,Dallas,26,25,31,24,0,0,0,0,20101127,95,106,0,2,16,11,11,201,11,2010,0,5,1110,0
Memphis,32,19,16,19,0,0,0,0,Cleveland,22,23,30,17,0,0,0,0,20101127,86,92,-10,-6,8,6,6,178,6,2010,0,5,629,0
Golden State,28,20,36,20,0,0,0,0,Minnesota,26,25,17,26,0,0,0,0,20101127,104,94,2,-3,16,10,10,198,-10,2010,0,5,1581,0
Phoenix,18,39,32,44,0,0,0,0,Denver,31,37,37,33,0,0,0,0,20101128,133,138,13,11,16,5,5,271,5,2010,0,6,585,0
New York,28,25,22,24,10,16,0,0,Detroit,25,30,23,21,10,7,0,0,20101128,125,116,3,-2,-3,0,9,241,-9,2010,2,6,480,0
Oklahoma City,25,17,29,27,0,0,0,0,Houston,33,17,27,22,0,0,0,0,20101128,98,99,8,8,6,1,1,197,1,2010,0,6,413,0
Utah,30,22,27,30,0,0,0,0,LA Clippers,32,28,14,23,0,0,0,0,20101128,109,97,-2,-8,5,12,12,206,-12,2010,0,6,579,0
Indiana,23,28,26,18,0,0,0,0,LA Lakers,26,19,24,23,0,0,0,0,20101128,95,92,-3,6,8,3,3,187,-3,2010,0,6,1805,0
Portland,26,26,26,18,0,0,0,0,Brooklyn,23,21,29,25,0,0,0,0,20101128,96,98,-3,-8,-5,2,2,194,2,2010,0,6,2439,0
San Antonio,26,18,28,37,0,0,0,0,New Orleans,34,27,16,18,0,0,0,0,20101128,109,95,-8,-17,-5,14,14,204,-14,2010,0,6,506,0
Atlanta,27,25,25,19,0,0,0,0,Toronto,23,23,11,21,0,0,0,0,20101128,96,78,4,6,20,18,18,174,-18,2010,0,6,733,0
Milwaukee,26,26,21,15,0,0,0,0,Utah,30,30,20,29,0,0,0,0,20101129,88,109,4,8,7,21,21,197,21,2010,0,0,1239,0
New Orleans,19,29,22,19,0,0,0,0,Oklahoma City,23,27,18,27,0,0,0,0,20101129,89,95,4,2,-2,6,6,184,6,2010,0,0,576,0
Washington,21,23,25,25,0,0,0,0,Miami,24,28,28,25,0,0,0,0,20101129,94,105,3,8,11,11,11,199,11,2010,0,0,924,0
Houston,26,19,26,20,0,0,0,0,Dallas,25,27,31,18,0,0,0,0,20101129,91,101,-1,7,12,10,10,192,10,2010,0,0,225,0
Boston,21,35,24,26,0,0,0,0,Cleveland,23,22,20,22,0,0,0,0,20101130,106,87,-2,11,15,19,19,193,-19,2010,0,1,549,0
San Antonio,30,28,33,27,0,0,0,0,Golden State,26,22,25,25,0,0,0,0,20101130,118,98,4,10,18,20,20,216,-20,2010,0,1,1487,0
LA Lakers,27,22,16,31,0,0,0,0,Memphis,27,24,19,28,0,0,0,0,20101130,96,98,0,2,5,2,2,194,2,2010,0,1,1599,0
Brooklyn,28,30,15,27,0,0,0,0,New York,30,25,33,23,0,0,0,0,20101130,100,111,2,-3,15,11,11,211,11,2010,0,1,0,0
Detroit,23,22,16,18,0,0,0,0,Orlando,18,25,21,26,0,0,0,0,20101130,79,90,-5,-2,3,11,11,169,11,2010,0,1,957,0
Portland,29,17,22,11,0,0,0,0,Philadelphia,29,18,19,22,0,0,0,0,20101130,79,88,0,1,-2,9,9,167,9,2010,0,1,2405,0
Indiana,22,30,28,27,0,0,0,0,Sacramento,23,29,17,29,0,0,0,0,20101130,107,98,-1,0,11,9,9,205,-9,2010,0,1,1882,0
Oklahoma City,16,28,27,22,7,10,13,0,Brooklyn,22,27,13,31,7,10,10,0,20101201,123,120,-6,-5,9,0,3,243,-3,2010,3,2,1324,0
Indiana,17,29,22,20,0,0,0,0,Utah,35,19,31,25,0,0,0,0,20101201,88,110,18,8,17,22,22,198,22,2010,0,2,1353,0
Washington,25,27,29,27,0,0,0,0,Toronto,34,38,29,26,0,0,0,0,20101201,108,127,9,20,20,19,19,235,19,2010,0,2,349,0
Charlotte,24,18,20,11,0,0,0,0,New Orleans,28,15,22,24,0,0,0,0,20101201,73,89,4,1,3,16,16,162,16,2010,0,2,648,0
Detroit,18,24,9,21,0,0,0,0,Miami,29,25,19,24,0,0,0,0,20101201,72,97,11,12,22,25,25,169,25,2010,0,2,1155,0
San Antonio,24,16,28,17,0,0,0,0,LA Clippers,25,23,25,17,0,0,0,0,20101201,85,90,1,8,5,5,5,175,5,2010,0,2,1201,0
Milwaukee,22,28,21,23,0,0,0,0,Denver,19,26,31,29,0,0,0,0,20101201,94,105,-3,-5,5,11,11,199,11,2010,0,2,912,0
Minnesota,20,23,21,22,0,0,0,0,Dallas,29,26,28,17,0,0,0,0,20101201,86,100,9,12,19,14,14,186,14,2010,0,2,863,0
Orlando,28,33,24,22,0,0,0,0,Chicago,22,15,25,16,0,0,0,0,20101201,107,78,6,24,23,29,29,185,-29,2010,0,2,984,0
Portland,26,23,23,23,0,0,0,0,Boston,20,28,31,20,0,0,0,0,20101201,95,99,-6,-1,7,4,4,194,4,2010,0,2,2532,0
Memphis,29,28,19,33,0,0,0,0,Atlanta,27,36,23,26,0,0,0,0,20101201,109,112,-2,6,10,3,3,221,3,2010,0,2,336,0
LA Lakers,26,30,22,21,0,0,0,0,Houston,23,30,23,33,0,0,0,0,20101201,99,109,-3,-3,-2,10,10,208,10,2010,0,2,1371,0
Miami,31,28,36,23,0,0,0,0,Cleveland,23,17,25,25,0,0,0,0,20101202,118,90,8,19,30,28,28,208,-28,2010,0,3,1089,0
Phoenix,31,21,23,32,0,0,0,0,Golden State,20,29,23,29,0,0,0,0,20101202,107,101,11,3,3,6,6,208,-6,2010,0,3,652,0
LA Clippers,29,19,29,27,0,0,0,0,Denver,25,24,32,28,0,0,0,0,20101203,104,109,-4,1,4,5,5,213,5,2010,0,4,830,0
Oklahoma City,25,34,18,22,0,0,0,0,Toronto,28,24,34,25,0,0,0,0,20101203,99,111,3,-7,9,12,12,210,12,2010,0,4,1114,0
Minnesota,25,29,32,15,0,0,0,0,San Antonio,25,28,18,36,0,0,0,0,20101203,101,107,0,-1,-15,6,6,208,6,2010,0,4,1112,0
Indiana,28,31,17,21,0,0,0,0,Phoenix,20,32,22,31,0,0,0,0,20101203,97,105,-8,-7,-2,8,8,202,8,2010,0,4,1496,0
New York,21,34,24,21,0,0,0,0,New Orleans,26,27,20,19,0,0,0,0,20101203,100,92,-5,2,6,8,8,192,-8,2010,0,4,1168,0
Houston,38,31,29,29,0,0,0,0,Memphis,31,29,30,21,0,0,0,0,20101203,127,111,7,9,8,16,16,238,-16,2010,0,4,484,0
Brooklyn,16,16,16,31,5,0,0,0,Charlotte,18,15,27,19,12,0,0,0,20101203,84,91,2,1,12,0,7,175,7,2010,1,4,531,0
Orlando,24,30,24,26,0,0,0,0,Detroit,26,29,18,18,0,0,0,0,20101203,104,91,-2,-1,5,13,13,195,-13,2010,0,4,957,0
Dallas,23,16,27,27,0,0,0,0,Utah,20,23,19,19,0,0,0,0,20101203,93,81,3,-4,4,12,12,174,-12,2010,0,4,998,0
Chicago,19,29,19,25,0,0,0,0,Boston,31,22,29,22,0,0,0,0,20101203,92,104,12,5,15,12,12,196,12,2010,0,4,849,0
Philadelphia,26,28,20,14,0,0,0,0,Atlanta,18,28,23,24,0,0,0,0,20101203,88,93,-8,-8,-5,5,5,181,5,2010,0,4,665,0
Sacramento,16,19,17,28,0,0,0,0,LA Lakers,21,31,30,31,0,0,0,0,20101203,80,113,5,17,30,33,33,193,33,2010,0,4,361,0
Portland,24,22,10,23,0,0,0,0,Washington,18,16,23,26,0,0,0,0,20101203,79,83,-6,-12,1,4,4,162,4,2010,0,4,2347,0
Dallas,28,26,26,25,0,0,0,0,Sacramento,37,18,25,23,0,0,0,0,20101204,105,103,-9,-1,0,2,2,208,-2,2010,0,5,1437,0
Charlotte,16,29,22,24,0,0,0,0,Philadelphia,32,24,29,24,0,0,0,0,20101204,91,109,16,11,18,18,18,200,18,2010,0,5,450,0
Cleveland,24,30,17,24,0,0,0,0,Minnesota,37,36,29,27,0,0,0,0,20101204,95,129,13,19,31,34,34,224,34,2010,0,5,629,0
Atlanta,15,21,25,16,0,0,0,0,Miami,26,24,13,26,0,0,0,0,20101204,77,89,11,14,2,12,12,166,12,2010,0,5,605,0
Houston,23,21,35,30,7,0,0,0,Chicago,25,31,25,28,10,0,0,0,20101204,116,119,2,12,2,0,3,235,3,2010,1,5,939,0
Orlando,16,26,20,23,0,0,0,0,Milwaukee,24,25,20,27,0,0,0,0,20101204,85,96,8,7,7,11,11,181,11,2010,0,5,1065,0
New York,33,27,22,34,0,0,0,0,Toronto,18,32,25,24,0,0,0,0,20101205,116,99,15,10,7,17,17,215,-17,2010,0,6,341,0
Memphis,16,31,30,30,0,0,0,0,Denver,33,29,14,32,0,0,0,0,20101205,107,108,17,15,-1,1,1,215,1,2010,0,6,877,0
Cleveland,24,22,21,25,0,0,0,0,Detroit,19,32,27,24,0,0,0,0,20101205,92,102,-5,5,11,10,10,194,10,2010,0,6,90,0
Boston,27,30,23,20,0,0,0,0,Brooklyn,25,12,16,22,0,0,0,0,20101205,100,75,2,20,27,25,25,175,-25,2010,0,6,190,0
Golden State,17,25,28,39,0,0,0,0,Oklahoma City,32,22,36,24,0,0,0,0,20101205,109,114,15,12,20,5,5,223,5,2010,0,6,1386,0
Washington,31,30,17,30,0,0,0,0,Phoenix,28,36,31,30,0,0,0,0,20101205,108,125,-3,3,17,17,17,233,17,2010,0,6,1977,0
LA Clippers,15,22,27,27,0,0,0,0,Portland,30,29,17,24,0,0,0,0,20101205,91,100,15,22,12,9,9,191,9,2010,0,6,826,0
New Orleans,23,18,18,25,0,0,0,0,San Antonio,34,34,22,19,0,0,0,0,20101205,84,109,11,27,31,25,25,193,25,2010,0,6,506,0
Memphis,16,24,25,20,0,0,0,0,Utah,20,21,29,24,0,0,0,0,20101206,85,94,4,1,5,9,9,179,9,2010,0,0,1247,0
Atlanta,19,17,18,26,0,0,0,0,Orlando,19,15,19,21,0,0,0,0,20101206,80,74,0,2,1,6,6,154,-6,2010,0,0,401,0
Minnesota,36,32,18,28,0,0,0,0,New York,32,29,31,29,0,0,0,0,20101206,114,121,-4,-7,6,7,7,235,7,2010,0,0,1016,0
Toronto,18,26,23,33,0,0,0,0,Indiana,31,37,21,35,0,0,0,0,20101206,100,124,13,24,22,24,24,224,24,2010,0,0,438,0
Sacramento,20,24,19,28,0,0,0,0,LA Clippers,16,34,29,19,0,0,0,0,20101206,91,98,-4,6,16,7,7,189,7,2010,0,0,361,0
Oklahoma City,22,26,18,24,0,0,0,0,Chicago,24,29,29,17,0,0,0,0,20101206,90,99,2,5,16,9,9,189,9,2010,0,0,690,0
Miami,25,21,23,19,0,0,0,0,Milwaukee,21,14,24,19,0,0,0,0,20101206,88,78,4,11,10,10,10,166,-10,2010,0,0,1269,0
Washington,23,33,28,24,0,0,0,0,LA Lakers,36,33,18,28,0,0,0,0,20101207,108,115,13,13,3,7,7,223,7,2010,0,1,2294,0
Cleveland,26,28,20,23,0,0,0,0,Philadelphia,35,31,23,28,0,0,0,0,20101207,97,117,9,12,15,20,20,214,20,2010,0,1,358,0
Detroit,24,21,21,17,0,0,0,0,Houston,29,25,21,22,0,0,0,0,20101207,83,97,5,9,9,14,14,180,14,2010,0,1,1105,0
Phoenix,23,24,28,24,0,0,0,0,Portland,29,22,18,37,0,0,0,0,20101207,99,106,6,4,-6,7,7,205,7,2010,0,1,1005,0
Denver,16,31,29,22,0,0,0,0,Charlotte,21,31,24,24,0,0,0,0,20101207,98,100,5,5,0,2,2,198,2,2010,0,1,1355,0
Brooklyn,26,21,24,30,0,0,0,0,Atlanta,27,33,23,33,0,0,0,0,20101207,101,116,1,13,12,15,15,217,15,2010,0,1,745,0
Golden State,26,22,24,28,0,0,0,0,Dallas,27,23,21,34,0,0,0,0,20101207,100,105,1,2,-1,5,5,205,5,2010,0,1,1480,0
Memphis,25,28,25,14,12,0,0,0,Phoenix,22,19,23,28,6,0,0,0,20101208,104,98,3,12,14,0,6,202,-6,2010,1,2,1260,0
Toronto,32,25,27,26,0,0,0,0,New York,28,31,25,29,0,0,0,0,20101208,110,113,-4,2,0,3,3,223,3,2010,0,2,341,0
Golden State,19,28,27,20,0,0,0,0,San Antonio,29,28,29,25,0,0,0,0,20101208,94,111,10,10,12,17,17,205,17,2010,0,2,1487,0
Miami,28,28,21,34,0,0,0,0,Utah,27,23,28,20,0,0,0,0,20101208,111,98,1,6,-1,13,13,209,-13,2010,0,2,2086,0
Detroit,15,19,23,17,0,0,0,0,New Orleans,22,22,29,20,0,0,0,0,20101208,74,93,7,10,16,19,19,167,19,2010,0,2,939,0
Washington,27,18,25,21,0,0,0,0,Sacramento,26,33,33,24,0,0,0,0,20101208,91,116,-1,14,22,25,25,207,25,2010,0,2,2371,0
Indiana,27,21,31,16,0,0,0,0,Milwaukee,33,23,22,19,0,0,0,0,20101208,95,97,6,8,-1,2,2,192,2,2010,0,2,243,0
Denver,21,31,17,20,0,0,0,0,Boston,35,24,21,25,0,0,0,0,20101208,89,105,14,7,11,16,16,194,16,2010,0,2,1765,0
Oklahoma City,22,31,31,27,0,0,0,0,Minnesota,40,24,22,17,0,0,0,0,20101208,111,103,-18,-11,-2,8,8,214,-8,2010,0,2,694,0
LA Lakers,20,21,24,22,0,0,0,0,LA Clippers,18,25,28,15,0,0,0,0,20101208,87,86,2,-2,-6,1,1,173,-1,2010,0,2,0,0
Chicago,21,20,19,28,0,0,0,0,Cleveland,15,20,33,15,0,0,0,0,20101208,88,83,6,6,-8,5,5,171,-5,2010,0,2,308,0
Brooklyn,19,21,29,20,0,0,0,0,Dallas,30,25,24,23,0,0,0,0,20101209,89,102,11,15,10,13,13,191,13,2010,0,3,1370,0
Boston,29,27,25,21,0,0,0,0,Philadelphia,32,23,25,21,0,0,0,0,20101209,102,101,-3,1,1,1,1,203,-1,2010,0,3,270,0
Orlando,22,24,16,21,0,0,0,0,Portland,14,31,22,30,0,0,0,0,20101209,83,97,-8,-1,5,14,14,180,14,2010,0,3,2525,0
New York,19,30,27,25,0,0,0,0,Washington,23,31,19,22,0,0,0,0,20101210,101,95,-4,-5,3,6,6,196,-6,2010,0,4,204,0
Atlanta,21,27,21,23,0,0,0,0,San Antonio,26,27,18,37,0,0,0,0,20101210,92,108,5,5,2,16,16,200,16,2010,0,4,881,0
Portland,28,33,26,14,0,0,0,0,Phoenix,22,31,20,21,0,0,0,0,20101210,101,94,6,8,14,7,7,195,-7,2010,0,4,1005,0
Oklahoma City,31,21,22,23,0,0,0,0,New Orleans,32,27,12,21,0,0,0,0,20101210,97,92,-1,-7,3,5,5,189,-5,2010,0,4,576,0
Orlando,31,26,15,33,0,0,0,0,Utah,30,28,24,35,0,0,0,0,20101210,105,117,-1,1,10,12,12,222,12,2010,0,4,1915,0
Houston,24,19,28,20,0,0,0,0,Milwaukee,27,20,26,24,0,0,0,0,20101210,91,97,3,4,2,6,6,188,6,2010,0,4,1005,0
Detroit,23,24,23,29,0,0,0,0,Minnesota,19,31,26,33,0,0,0,0,20101210,99,109,-4,3,6,10,10,208,10,2010,0,4,542,0
LA Lakers,22,10,26,26,0,0,0,0,Chicago,12,24,30,22,0,0,0,0,20101210,84,88,-10,4,8,4,4,172,4,2010,0,4,1741,0
Denver,39,35,24,25,0,0,0,0,Toronto,33,32,21,30,0,0,0,0,20101210,123,116,6,9,12,7,7,239,-7,2010,0,4,1341,0
Miami,26,22,36,22,0,0,0,0,Golden State,20,25,20,19,0,0,0,0,20101210,106,84,6,3,19,22,22,190,-22,2010,0,4,2590,0
Charlotte,22,28,19,23,0,0,0,0,Indiana,30,27,22,21,0,0,0,0,20101210,92,100,8,7,10,8,8,192,8,2010,0,4,428,0
Indiana,14,21,25,23,0,0,0,0,Atlanta,16,32,27,22,0,0,0,0,20101211,83,97,2,13,15,14,14,180,14,2010,0,5,427,0
Boston,20,22,22,29,0,0,0,0,Charlotte,16,16,15,15,0,0,0,0,20101211,93,62,4,10,17,31,31,155,-31,2010,0,5,720,0
Utah,19,23,28,27,0,0,0,0,Dallas,34,20,27,22,0,0,0,0,20101211,97,103,15,12,11,6,6,200,6,2010,0,5,998,0
Toronto,28,25,30,37,0,0,0,0,Detroit,29,43,27,17,0,0,0,0,20101211,120,116,-1,-19,-16,4,4,236,-4,2010,0,5,205,0
Cleveland,29,29,17,20,0,0,0,0,Houston,37,29,26,18,0,0,0,0,20101211,95,110,8,8,17,15,15,205,15,2010,0,5,1113,0
Memphis,19,22,22,21,0,0,0,0,LA Clippers,27,20,19,17,0,0,0,0,20101211,84,83,-8,-6,-3,1,1,167,-1,2010,0,5,1599,0
Miami,17,30,31,26,0,0,0,0,Sacramento,24,18,20,21,0,0,0,0,20101211,104,83,-7,5,16,21,21,187,-21,2010,0,5,2547,0
Minnesota,18,19,28,17,0,0,0,0,Chicago,27,31,29,26,0,0,0,0,20101211,82,113,9,21,22,31,31,195,31,2010,0,5,355,0
Portland,17,23,21,17,0,0,0,0,San Antonio,26,24,23,22,0,0,0,0,20101212,78,95,9,10,12,17,17,173,17,2010,0,6,1718,0
New Orleans,13,10,23,24,0,0,0,0,Philadelphia,20,25,22,21,0,0,0,0,20101212,70,88,7,22,21,18,18,158,18,2010,0,6,1088,0
Cleveland,17,28,13,19,0,0,0,0,Oklahoma City,31,25,30,20,0,0,0,0,20101212,77,106,14,11,28,29,29,183,29,2010,0,6,949,0
Denver,24,41,24,36,0,0,0,0,New York,35,31,31,32,0,0,0,0,20101212,125,129,11,1,8,4,4,254,4,2010,0,6,1627,0
Orlando,35,24,10,25,0,0,0,0,LA Clippers,14,26,19,26,0,0,0,0,20101212,94,85,21,19,10,9,9,179,-9,2010,0,6,2197,0
LA Lakers,30,22,17,30,0,0,0,0,Brooklyn,24,18,25,25,0,0,0,0,20101212,99,92,6,10,2,7,7,191,-7,2010,0,6,2445,0
Indiana,18,23,17,15,0,0,0,0,Chicago,27,16,22,27,0,0,0,0,20101213,73,92,9,2,7,19,19,165,19,2010,0,0,163,0
Milwaukee,15,28,32,28,0,0,0,0,Dallas,25,27,22,25,0,0,0,0,20101213,103,99,-10,-9,1,4,4,202,-4,2010,0,0,857,0
Portland,18,24,22,9,0,0,0,0,Memphis,23,26,12,25,0,0,0,0,20101213,73,86,5,7,-3,13,13,159,13,2010,0,0,1845,0
New Orleans,23,31,21,9,0,0,0,0,Miami,25,28,29,14,0,0,0,0,20101213,84,96,2,-1,7,12,12,180,12,2010,0,0,668,0
Golden State,23,23,24,25,0,0,0,0,Utah,20,23,31,34,0,0,0,0,20101213,95,108,-3,-3,4,13,13,203,13,2010,0,0,599,0
Sacramento,30,18,24,33,0,0,0,0,Houston,27,31,33,27,0,0,0,0,20101214,105,118,-3,10,19,13,13,223,13,2010,0,1,1606,0
Minnesota,25,26,25,23,0,0,0,0,Golden State,17,37,25,29,0,0,0,0,20101214,99,108,-8,3,3,9,9,207,9,2010,0,1,1581,0
LA Lakers,22,35,35,11,0,0,0,0,Washington,24,22,24,19,0,0,0,0,20101214,103,89,-2,11,22,14,14,192,-14,2010,0,1,2294,0
Orlando,31,24,23,16,0,0,0,0,Denver,29,32,18,32,0,0,0,0,20101214,94,111,-2,6,1,17,17,205,17,2010,0,1,1548,0
Toronto,29,24,19,19,0,0,0,0,Charlotte,20,27,25,25,0,0,0,0,20101214,91,97,-9,-6,0,6,6,188,6,2010,0,1,585,0
Atlanta,19,18,24,19,0,0,0,0,Detroit,28,21,15,39,0,0,0,0,20101214,80,103,9,12,3,23,23,183,23,2010,0,1,597,0
Philadelphia,26,14,19,23,0,0,0,0,Brooklyn,20,14,21,22,0,0,0,0,20101214,82,77,6,6,4,5,5,159,-5,2010,0,1,80,0
Chicago,23,40,28,19,0,0,0,0,Toronto,18,26,20,29,0,0,0,0,20101215,110,93,5,19,27,17,17,203,-17,2010,0,2,436,0
Portland,14,25,29,30,0,0,0,0,Dallas,17,34,27,25,0,0,0,0,20101215,98,103,3,12,10,5,5,201,5,2010,0,2,1630,0
LA Lakers,36,23,28,22,0,0,0,0,Indiana,22,15,32,25,0,0,0,0,20101215,109,94,14,22,18,15,15,203,-15,2010,0,2,1805,0
Charlotte,20,16,19,25,0,0,0,0,Memphis,24,35,25,29,0,0,0,0,20101215,80,113,4,23,29,33,33,193,33,2010,0,2,519,0
Cleveland,26,23,22,24,0,0,0,0,Miami,24,22,27,28,0,0,0,0,20101215,95,101,-2,-3,2,6,6,196,6,2010,0,2,1089,0
Sacramento,29,28,20,14,0,0,0,0,New Orleans,23,18,28,25,0,0,0,0,20101215,91,94,-6,-16,-8,3,3,185,3,2010,0,2,1879,0
Boston,24,27,32,35,0,0,0,0,New York,32,26,32,26,0,0,0,0,20101215,118,116,-8,-7,-7,2,2,234,-2,2010,0,2,190,0
Houston,31,25,20,29,0,0,0,0,Oklahoma City,31,31,25,30,0,0,0,0,20101215,105,117,0,6,11,12,12,222,12,2010,0,2,413,0
LA Clippers,29,27,18,17,0,0,0,0,Philadelphia,28,25,34,18,0,0,0,0,20101215,91,105,-1,-3,13,14,14,196,14,2010,0,2,2388,0
Minnesota,30,26,30,36,0,0,0,0,Phoenix,31,25,35,37,0,0,0,0,20101215,122,128,1,0,5,6,6,250,6,2010,0,2,1278,0
Milwaukee,20,15,28,27,0,0,0,0,San Antonio,25,26,20,21,0,0,0,0,20101215,90,92,5,16,8,2,2,182,2,2010,0,2,1108,0
Washington,17,21,29,22,0,0,0,0,Brooklyn,32,23,19,23,0,0,0,0,20101216,89,97,15,17,7,8,8,186,8,2010,0,3,204,0
Atlanta,20,23,26,21,0,0,0,0,Boston,22,22,31,27,0,0,0,0,20101216,90,102,2,1,6,12,12,192,12,2010,0,3,935,0
San Antonio,28,29,28,28,0,0,0,0,Denver,37,23,24,28,0,0,0,0,20101216,113,112,-9,-3,1,1,1,225,-1,2010,0,3,802,0
Charlotte,20,19,19,27,0,0,0,0,Atlanta,25,21,22,22,0,0,0,0,20101217,85,90,5,7,10,5,5,175,5,2010,0,4,226,0
Phoenix,25,17,17,32,0,0,0,0,Dallas,22,32,26,26,0,0,0,0,20101217,91,106,-3,12,21,15,15,197,15,2010,0,4,884,0
LA Clippers,25,26,29,29,0,0,0,0,Detroit,19,27,16,26,0,0,0,0,20101217,109,88,6,5,18,21,21,197,-21,2010,0,4,1979,0
Memphis,13,20,27,27,0,0,0,0,Houston,34,27,28,14,0,0,0,0,20101217,87,103,21,28,29,16,16,190,16,2010,0,4,484,0
Cleveland,23,25,26,25,0,0,0,0,Indiana,19,34,31,24,0,0,0,0,20101217,99,108,-4,5,10,9,9,207,9,2010,0,4,262,0
Utah,14,19,21,17,0,0,0,0,New Orleans,21,29,31,19,0,0,0,0,20101217,71,100,7,17,27,29,29,171,29,2010,0,4,1432,0
Miami,34,23,33,23,0,0,0,0,New York,25,32,17,17,0,0,0,0,20101217,113,91,9,0,16,22,22,204,-22,2010,0,4,1091,0
Sacramento,22,24,21,20,0,0,0,0,Oklahoma City,21,32,19,30,0,0,0,0,20101217,87,102,-1,7,5,15,15,189,15,2010,0,4,1336,0
LA Lakers,18,26,14,35,0,0,0,0,Philadelphia,21,18,23,19,0,0,0,0,20101217,93,81,-3,5,-4,12,12,174,-12,2010,0,4,2388,0
Minnesota,24,30,24,24,0,0,0,0,Portland,25,36,21,25,0,0,0,0,20101217,102,107,1,7,4,5,5,209,5,2010,0,4,1423,0
Brooklyn,23,25,23,21,0,0,0,0,Toronto,21,21,27,29,0,0,0,0,20101217,92,98,-2,-6,-2,6,6,190,6,2010,0,4,341,0
Miami,19,27,26,23,0,0,0,0,Washington,25,22,27,20,0,0,0,0,20101218,95,94,-6,-1,-2,1,1,189,-1,2010,0,5,924,0
Memphis,31,18,22,29,6,0,0,0,San Antonio,28,25,27,20,12,0,0,0,20101218,106,112,-3,4,9,0,6,218,6,2010,1,5,631,0
Golden State,18,24,23,30,0,0,0,0,Portland,21,30,23,22,0,0,0,0,20101218,95,96,3,9,9,1,1,191,1,2010,0,5,535,0
Philadelphia,20,20,31,26,0,0,0,0,Orlando,21,18,25,25,0,0,0,0,20101218,97,89,-1,1,7,8,8,186,-8,2010,0,5,864,0
Utah,19,24,28,24,0,0,0,0,Milwaukee,25,21,22,18,0,0,0,0,20101218,95,86,-6,-3,3,9,9,181,-9,2010,0,5,1239,0
Minnesota,27,23,25,38,0,0,0,0,Denver,35,27,26,27,0,0,0,0,20101218,113,115,8,12,13,2,2,228,2,2010,0,5,698,0
LA Clippers,28,33,22,17,0,0,0,0,Chicago,31,22,23,23,0,0,0,0,20101218,100,99,-3,8,7,1,1,199,-1,2010,0,5,1741,0
New York,27,25,22,19,9,0,0,0,Cleveland,21,28,25,19,16,0,0,0,20101218,102,109,-6,-3,0,0,7,211,7,2010,1,5,403,0
LA Lakers,28,29,29,34,0,0,0,0,Toronto,34,15,30,31,0,0,0,0,20101219,120,110,-6,8,7,10,10,230,-10,2010,0,6,2170,0
Indiana,23,25,17,23,0,0,0,0,Boston,30,21,18,30,0,0,0,0,20101219,88,99,7,3,4,11,11,187,11,2010,0,6,805,0
New Orleans,20,31,27,22,8,0,0,0,Detroit,20,21,31,28,11,0,0,0,20101219,108,111,0,-10,-6,0,3,219,3,2010,1,6,939,0
Atlanta,30,13,19,20,0,0,0,0,Brooklyn,23,20,19,27,0,0,0,0,20101219,82,89,-7,0,0,7,7,171,7,2010,0,6,745,0
Phoenix,25,29,28,31,0,0,0,0,Oklahoma City,23,22,40,25,0,0,0,0,20101219,113,110,2,9,-3,3,3,223,-3,2010,0,6,840,0
Houston,26,26,27,23,0,0,0,0,Sacramento,31,26,24,12,0,0,0,0,20101219,102,93,-5,-5,-2,9,9,195,-9,2010,0,6,1606,0
Phoenix,26,28,24,32,0,0,0,0,San Antonio,27,26,40,25,0,0,0,0,20101220,110,118,1,-1,15,8,8,228,8,2010,0,0,846,0
Utah,24,25,27,25,0,0,0,0,Cleveland,20,24,20,26,0,0,0,0,20101220,101,90,4,5,12,11,11,191,-11,2010,0,0,1564,0
Milwaukee,18,17,25,20,0,0,0,0,Portland,25,34,19,28,0,0,0,0,20101220,80,106,7,24,18,26,26,186,26,2010,0,0,1714,0
Charlotte,25,20,11,19,0,0,0,0,Washington,32,18,31,27,0,0,0,0,20101220,75,108,7,5,25,33,33,183,33,2010,0,0,329,0
Dallas,23,20,22,33,0,0,0,0,Miami,22,22,24,28,0,0,0,0,20101220,98,96,1,-1,-3,2,2,194,-2,2010,0,0,1110,0
Orlando,14,24,20,23,0,0,0,0,Atlanta,20,23,22,26,0,0,0,0,20101220,81,91,6,5,7,10,10,172,10,2010,0,0,401,0
New Orleans,16,27,26,24,0,0,0,0,Indiana,24,28,16,26,0,0,0,0,20101220,93,94,8,9,-1,1,1,187,1,2010,0,0,713,0
Houston,26,24,31,40,0,0,0,0,Golden State,26,20,29,37,0,0,0,0,20101220,121,112,0,4,6,9,9,233,-9,2010,0,0,1642,0
Minnesota,31,27,21,11,0,0,0,0,LA Clippers,34,34,26,19,0,0,0,0,20101220,90,113,3,10,15,23,23,203,23,2010,0,0,1521,0
Oklahoma City,21,24,23,31,0,0,0,0,Charlotte,23,17,29,12,0,0,0,0,20101221,99,81,-2,5,-1,18,18,180,-18,2010,0,1,938,0
Philadelphia,19,24,11,22,0,0,0,0,Chicago,33,28,31,29,0,0,0,0,20101221,76,121,14,18,38,45,45,197,45,2010,0,1,664,0
Milwaukee,25,25,22,26,0,0,0,0,LA Lakers,22,24,20,13,0,0,0,0,20101221,98,79,3,4,6,19,19,177,-19,2010,0,1,1741,0
Brooklyn,26,19,28,28,0,0,0,0,Memphis,18,25,24,27,0,0,0,0,20101221,101,94,8,2,6,7,7,195,-7,2010,0,1,953,0
Dallas,27,22,27,29,0,0,0,0,Orlando,21,24,27,27,0,0,0,0,20101221,105,99,6,4,4,6,6,204,-6,2010,0,1,961,0
Golden State,26,23,21,32,15,0,0,0,Sacramento,18,30,36,18,7,0,0,0,20101221,117,109,8,1,-14,0,8,226,-8,2010,1,1,75,0
Chicago,29,17,27,14,0,0,0,0,Washington,33,17,20,10,0,0,0,0,20101222,87,80,-4,-4,3,7,7,167,-7,2010,0,2,594,0
Detroit,24,38,24,29,0,0,0,0,Toronto,23,21,24,25,0,0,0,0,20101222,115,93,1,18,18,22,22,208,-22,2010,0,2,205,0
Denver,27,29,33,14,0,0,0,0,San Antonio,26,33,21,29,0,0,0,0,20101222,103,109,-1,3,-9,6,6,212,6,2010,0,2,802,0
Oklahoma City,28,27,23,20,0,0,0,0,New York,27,36,27,22,0,0,0,0,20101222,98,112,-1,8,12,14,14,210,14,2010,0,2,1324,0
Philadelphia,17,27,17,19,0,0,0,0,Boston,23,15,26,20,0,0,0,0,20101222,80,84,6,-6,3,4,4,164,4,2010,0,2,270,0
Utah,20,25,26,41,0,0,0,0,Minnesota,29,27,27,24,0,0,0,0,20101222,112,107,-9,-11,-12,5,5,219,-5,2010,0,2,984,0
Houston,32,24,18,23,0,0,0,0,LA Clippers,28,15,19,30,0,0,0,0,20101222,97,92,4,13,12,5,5,189,-5,2010,0,2,1371,0
Cleveland,22,24,23,15,0,0,0,0,Atlanta,17,32,28,21,0,0,0,0,20101222,84,98,-5,3,8,14,14,182,14,2010,0,2,555,0
Brooklyn,29,21,13,28,0,0,0,0,New Orleans,32,25,26,22,0,0,0,0,20101222,91,105,3,7,20,14,14,196,14,2010,0,2,1168,0
Miami,19,26,27,23,0,0,0,0,Phoenix,22,17,20,24,0,0,0,0,20101223,95,83,-3,6,13,12,12,178,-12,2010,0,3,1978,0
San Antonio,26,27,23,25,0,0,0,0,Orlando,28,34,35,26,0,0,0,0,20101223,101,123,2,9,21,22,22,224,22,2010,0,3,1035,0
Milwaukee,24,19,19,22,0,0,0,0,Sacramento,25,14,25,15,0,0,0,0,20101223,84,79,-1,4,-2,5,5,163,-5,2010,0,3,1771,0
Boston,20,26,17,15,0,0,0,0,Orlando,19,17,21,29,0,0,0,0,20101225,78,86,-1,-10,-6,8,8,164,8,2010,0,5,1115,0
Denver,34,24,27,21,0,0,0,0,Oklahoma City,26,30,32,26,0,0,0,0,20101225,106,114,-8,-2,3,8,8,220,8,2010,0,5,503,0
Portland,28,29,23,22,0,0,0,0,Golden State,25,31,22,31,0,0,0,0,20101225,102,109,-3,-1,-2,7,7,211,7,2010,0,5,535,0
Miami,20,27,28,21,0,0,0,0,LA Lakers,14,24,26,16,0,0,0,0,20101225,96,80,6,9,11,16,16,176,-16,2010,0,5,2335,0
Chicago,20,34,29,12,0,0,0,0,New York,21,31,33,18,0,0,0,0,20101225,95,103,1,-2,2,8,8,198,8,2010,0,5,711,0
Minnesota,17,34,19,28,0,0,0,0,Cleveland,28,21,24,24,0,0,0,0,20101226,98,97,-11,2,-3,1,1,195,-1,2010,0,6,629,0
Philadelphia,13,30,23,29,0,0,0,0,Denver,25,21,25,18,0,0,0,0,20101226,95,89,-12,-3,-5,6,6,184,-6,2010,0,6,1574,0
Chicago,23,17,28,17,10,0,0,0,Detroit,15,19,23,28,7,0,0,0,20101226,95,92,8,6,11,0,3,187,-3,2010,1,6,238,0
Memphis,32,19,26,27,0,0,0,0,Indiana,20,26,18,26,0,0,0,0,20101226,104,90,12,5,13,14,14,194,-14,2010,0,6,383,0
Phoenix,18,31,29,25,0,0,0,0,LA Clippers,33,28,18,29,0,0,0,0,20101226,103,108,15,12,1,5,5,211,5,2010,0,6,356,0
Atlanta,27,28,16,15,0,0,0,0,New Orleans,25,21,28,19,0,0,0,0,20101226,86,93,-2,-9,3,7,7,179,7,2010,0,6,424,0
Washington,23,19,23,15,0,0,0,0,San Antonio,27,21,33,13,0,0,0,0,20101226,80,94,4,6,16,14,14,174,14,2010,0,6,1385,0
Portland,20,25,21,30,0,0,0,0,Utah,27,20,19,25,0,0,0,0,20101227,96,91,-7,-2,0,5,5,187,-5,2010,0,0,634,0
LA Clippers,28,30,18,24,0,0,0,0,Sacramento,21,28,27,23,0,0,0,0,20101227,100,99,7,9,0,1,1,199,-1,2010,0,0,361,0
Dallas,34,22,23,24,0,0,0,0,Oklahoma City,29,27,25,12,0,0,0,0,20101227,103,93,5,0,-2,10,10,196,-10,2010,0,0,189,0
Orlando,24,27,30,23,0,0,0,0,Brooklyn,25,19,25,19,0,0,0,0,20101227,104,88,-1,7,12,16,16,192,-16,2010,0,0,939,0
New Orleans,35,22,20,21,0,0,0,0,Minnesota,27,27,28,31,0,0,0,0,20101227,98,113,-8,-3,5,15,15,211,15,2010,0,0,1052,0
Philadelphia,30,19,22,24,0,0,0,0,Golden State,25,30,21,34,0,0,0,0,20101227,95,110,-5,6,5,15,15,205,15,2010,0,0,2516,0
Toronto,24,20,19,22,0,0,0,0,Memphis,16,32,29,19,0,0,0,0,20101227,85,96,-8,4,14,11,11,181,11,2010,0,0,815,0
Washington,27,21,25,20,0,0,0,0,Houston,28,19,21,32,0,0,0,0,20101227,93,100,1,-1,-5,7,7,193,7,2010,0,0,1217,0
Detroit,26,14,29,31,0,0,0,0,Charlotte,26,30,29,20,0,0,0,0,20101227,100,105,0,16,16,5,5,205,5,2010,0,0,504,0
Atlanta,29,28,20,18,0,0,0,0,Milwaukee,18,24,25,13,0,0,0,0,20101227,95,80,11,15,10,15,15,175,-15,2010,0,0,669,0
Boston,19,26,21,29,0,0,0,0,Indiana,26,21,20,16,0,0,0,0,20101228,95,83,-7,-2,-1,12,12,178,-12,2010,0,1,805,0
New York,18,22,25,33,0,0,0,0,Miami,34,19,27,26,0,0,0,0,20101228,98,106,16,13,15,8,8,204,8,2010,0,1,1091,0
Portland,21,20,17,19,0,0,0,0,Denver,25,23,30,17,0,0,0,0,20101228,77,95,4,7,20,18,18,172,18,2010,0,1,981,0
LA Lakers,18,26,18,20,0,0,0,0,San Antonio,27,15,29,26,0,0,0,0,20101228,82,97,9,-2,9,15,15,179,15,2010,0,1,1201,0
Orlando,30,30,15,35,0,0,0,0,Cleveland,33,24,17,21,0,0,0,0,20101228,110,95,-3,3,1,15,15,205,-15,2010,0,1,895,0
Milwaukee,15,30,17,15,0,0,0,0,Chicago,27,17,23,23,0,0,0,0,20101228,77,90,12,-1,5,13,13,167,13,2010,0,1,83,0
Toronto,23,23,18,20,0,0,0,0,Dallas,13,27,19,17,0,0,0,0,20101228,84,76,10,6,5,8,8,160,-8,2010,0,1,1201,0
Golden State,27,20,22,24,0,0,0,0,Atlanta,29,23,26,25,0,0,0,0,20101229,93,103,2,5,9,10,10,196,10,2010,0,2,2135,0
Cleveland,20,24,23,25,0,0,0,0,Charlotte,33,24,24,20,0,0,0,0,20101229,92,101,13,13,14,9,9,193,9,2010,0,2,435,0
Boston,21,16,25,30,0,0,0,0,Detroit,27,18,29,30,0,0,0,0,20101229,92,104,6,8,12,12,12,196,12,2010,0,2,611,0
Miami,35,24,29,37,0,0,0,0,Houston,28,34,22,35,0,0,0,0,20101229,125,119,7,-3,4,6,6,244,-6,2010,0,2,966,0
Utah,23,28,30,22,0,0,0,0,LA Clippers,31,26,13,25,0,0,0,0,20101229,103,95,-8,-6,11,8,8,198,-8,2010,0,2,579,0
Denver,23,30,29,37,0,0,0,0,Minnesota,30,29,24,30,0,0,0,0,20101229,119,113,-7,-6,-1,6,6,232,-6,2010,0,2,698,0
LA Lakers,26,33,24,20,0,0,0,0,New Orleans,23,18,19,28,0,0,0,0,20101229,103,88,3,18,23,15,15,191,-15,2010,0,2,1669,0
Brooklyn,24,22,24,23,0,0,0,0,Oklahoma City,24,33,31,26,0,0,0,0,20101229,93,114,0,11,18,21,21,207,21,2010,0,2,1324,0
Philadelphia,33,33,26,31,0,0,0,0,Phoenix,35,30,21,24,0,0,0,0,20101229,123,110,-2,1,6,13,13,233,-13,2010,0,2,2078,0
Memphis,27,24,23,24,0,0,0,0,Sacramento,24,26,20,30,0,0,0,0,20101229,98,100,-3,-1,-4,2,2,198,2,2010,0,2,1745,0
Indiana,19,25,23,23,0,0,0,0,Washington,19,25,28,32,0,0,0,0,20101229,90,104,0,0,5,14,14,194,14,2010,0,2,490,0
Utah,25,16,27,21,0,0,0,0,Portland,29,17,33,21,0,0,0,0,20101230,89,100,4,5,11,11,11,189,11,2010,0,3,634,0
San Antonio,29,24,18,28,0,0,0,0,Dallas,27,19,18,29,0,0,0,0,20101230,99,93,2,7,7,6,6,192,-6,2010,0,3,252,0
New York,23,21,27,32,0,0,0,0,Orlando,22,40,20,30,0,0,0,0,20101230,103,112,-1,18,11,9,9,215,9,2010,0,3,939,0
New Orleans,23,14,29,17,0,0,0,0,Boston,19,20,18,24,0,0,0,0,20101231,83,81,4,-2,9,2,2,164,-2,2010,0,4,1358,0
Golden State,30,22,25,19,0,0,0,0,Charlotte,28,18,24,25,0,0,0,0,20101231,96,95,2,6,7,1,1,191,-1,2010,0,4,2296,0
Brooklyn,21,23,19,18,0,0,0,0,Chicago,23,23,24,20,0,0,0,0,20101231,81,90,2,2,7,9,9,171,9,2010,0,4,711,0
Toronto,34,21,20,30,0,0,0,0,Houston,20,42,22,30,0,0,0,0,20101231,105,114,-14,7,9,9,9,219,9,2010,0,4,1299,0
Washington,22,12,28,24,0,0,0,0,Indiana,25,24,27,19,0,0,0,0,20101231,86,95,3,15,14,9,9,181,9,2010,0,4,490,0
Philadelphia,19,25,29,25,0,0,0,0,LA Lakers,29,23,30,20,0,0,0,0,20101231,98,102,10,8,9,4,4,200,4,2010,0,4,2388,0
Atlanta,24,29,26,15,0,0,0,0,Oklahoma City,33,27,23,20,0,0,0,0,20101231,94,103,9,7,4,9,9,197,9,2010,0,4,755,0
Detroit,14,18,26,17,0,0,0,0,Phoenix,24,26,18,24,0,0,0,0,20101231,75,92,10,18,10,17,17,167,17,2010,0,4,1687,0
Oklahoma City,17,19,17,21,0,0,0,0,San Antonio,31,18,28,24,0,0,0,0,20110101,74,101,14,13,24,27,27,175,27,2010,0,5,421,0
New Orleans,24,18,26,24,0,0,0,0,Washington,23,24,15,19,0,0,0,0,20110101,92,81,1,-5,6,11,11,173,-11,2010,0,5,964,0
Memphis,21,17,31,23,0,0,0,0,Utah,21,27,23,27,0,0,0,0,20110101,92,98,0,10,2,6,6,190,6,2010,0,5,1247,0
Brooklyn,29,26,9,24,0,0,0,0,Minnesota,36,18,23,26,0,0,0,0,20110101,88,103,7,-1,13,15,15,191,15,2010,0,5,1016,0
Dallas,18,32,21,16,0,0,0,0,Milwaukee,25,27,21,26,0,0,0,0,20110101,87,99,7,2,2,12,12,186,12,2010,0,5,857,0
Golden State,36,36,12,23,0,0,0,0,Miami,28,30,25,31,0,0,0,0,20110101,107,114,-8,-14,-1,7,7,221,7,2010,0,5,2590,0
Sacramento,23,16,21,26,0,0,0,0,Denver,23,28,18,35,0,0,0,0,20110101,86,104,0,12,9,18,18,190,18,2010,0,5,886,0
Cleveland,28,33,9,21,0,0,0,0,Chicago,24,29,32,15,0,0,0,0,20110101,91,100,-4,-8,15,9,9,191,9,2010,0,5,308,0
Dallas,27,28,24,25,0,0,0,0,Cleveland,25,22,22,26,0,0,0,0,20110102,104,95,2,8,10,9,9,199,-9,2010,0,6,1024,0
Atlanta,18,24,28,37,0,0,0,0,LA Clippers,31,22,21,24,0,0,0,0,20110102,107,98,-13,-11,-4,9,9,205,-9,2010,0,6,1932,0
Memphis,23,25,31,25,0,0,0,0,LA Lakers,18,21,23,23,0,0,0,0,20110102,104,85,5,9,17,19,19,189,-19,2010,0,6,1599,0
Indiana,32,23,22,15,0,0,0,0,New York,30,25,24,19,0,0,0,0,20110102,92,98,-2,0,2,6,6,190,6,2010,0,6,643,0
Houston,25,23,14,23,0,0,0,0,Portland,27,27,25,21,0,0,0,0,20110102,85,100,2,6,17,15,15,185,15,2010,0,6,1833,0
Phoenix,27,21,25,16,0,0,0,0,Sacramento,17,22,26,29,0,0,0,0,20110102,89,94,-10,-9,-8,5,5,183,5,2010,0,6,634,0
Boston,24,19,28,22,0,0,0,0,Toronto,23,19,20,17,0,0,0,0,20110102,93,79,1,1,9,14,14,172,-14,2010,0,6,430,0
Detroit,28,23,28,18,0,0,0,0,Utah,25,28,25,24,0,0,0,0,20110103,97,102,-3,2,-1,5,5,199,5,2010,0,0,1488,0
Golden State,28,25,18,19,0,0,0,0,Orlando,24,20,35,31,0,0,0,0,20110103,90,110,-4,-9,8,20,20,200,20,2010,0,0,2437,0
Philadelphia,26,14,18,19,0,0,0,0,New Orleans,23,20,25,16,0,0,0,0,20110103,77,84,-3,3,10,7,7,161,7,2010,0,0,1088,0
Miami,23,24,31,18,0,0,0,0,Charlotte,28,15,16,23,0,0,0,0,20110103,96,82,-5,4,19,14,14,178,-14,2010,0,0,654,0
Minnesota,25,22,26,20,0,0,0,0,Boston,17,26,27,26,0,0,0,0,20110103,93,96,-8,-4,-3,3,3,189,3,2010,0,0,1120,0
Houston,21,31,29,25,0,0,0,0,Denver,25,27,29,32,0,0,0,0,20110103,106,113,4,0,0,7,7,219,7,2010,0,0,878,0
Toronto,27,14,28,22,0,0,0,0,Chicago,29,30,22,30,0,0,0,0,20110104,91,111,2,18,12,20,20,202,20,2010,0,1,436,0
Portland,24,16,20,21,0,0,0,0,Dallas,24,19,19,22,0,0,0,0,20110104,81,84,0,3,2,3,3,165,3,2010,0,1,1630,0
Detroit,19,23,17,24,0,0,0,0,LA Lakers,24,21,31,32,0,0,0,0,20110104,83,108,5,3,17,25,25,191,25,2010,0,1,1979,0
Oklahoma City,27,28,22,28,0,0,0,0,Memphis,31,24,24,31,0,0,0,0,20110104,105,110,4,0,2,5,5,215,5,2010,0,1,421,0
Milwaukee,20,31,19,19,0,0,0,0,Miami,26,21,26,28,0,0,0,0,20110104,89,101,6,-4,3,12,12,190,12,2010,0,1,1269,0
San Antonio,35,34,26,20,0,0,0,0,New York,36,36,29,27,0,0,0,0,20110104,115,128,1,3,6,13,13,243,13,2010,0,1,1581,0
Atlanta,27,27,23,31,0,0,0,0,Sacramento,23,17,23,39,0,0,0,0,20110104,108,102,4,14,14,6,6,210,-6,2010,0,1,2082,0
Milwaukee,17,16,24,30,0,0,0,0,Orlando,25,24,22,26,0,0,0,0,20110105,87,97,8,16,14,10,10,184,10,2010,0,2,1065,0
Atlanta,30,25,31,24,0,0,0,0,Utah,17,24,28,18,0,0,0,0,20110105,110,87,13,14,17,23,23,197,-23,2010,0,2,1580,0
LA Lakers,31,18,31,19,0,0,0,0,Phoenix,24,26,23,22,0,0,0,0,20110105,99,95,7,-1,7,4,4,194,-4,2010,0,2,356,0
Washington,26,26,23,22,0,0,0,0,Philadelphia,29,21,26,33,0,0,0,0,20110105,97,109,3,-2,1,12,12,206,12,2010,0,2,123,0
Golden State,29,18,25,38,0,0,0,0,New Orleans,34,24,24,21,0,0,0,0,20110105,110,103,-5,-11,-10,7,7,213,-7,2010,0,2,1921,0
Portland,31,24,19,29,0,0,0,0,Houston,25,22,33,20,0,0,0,0,20110105,103,100,6,8,-6,3,3,203,-3,2010,0,2,1833,0
Charlotte,24,33,14,24,13,0,0,0,Minnesota,23,20,30,22,10,0,0,0,20110105,108,105,1,14,-2,0,3,213,-3,2010,1,2,938,0
Denver,23,20,31,19,0,0,0,0,LA Clippers,30,21,31,24,0,0,0,0,20110105,93,106,7,8,8,13,13,199,13,2010,0,2,830,0
Toronto,26,40,24,30,0,0,0,0,Cleveland,38,25,21,21,0,0,0,0,20110105,120,105,-12,3,6,15,15,225,-15,2010,0,2,187,0
San Antonio,25,26,21,31,0,0,0,0,Boston,27,22,28,28,0,0,0,0,20110105,103,105,2,-2,5,2,2,208,2,2010,0,2,1765,0
Chicago,24,23,18,29,0,0,0,0,Brooklyn,25,21,32,18,0,0,0,0,20110105,94,96,1,-1,13,2,2,190,2,2010,0,2,711,0
Oklahoma City,23,28,22,26,0,0,0,0,Dallas,30,25,15,25,0,0,0,0,20110106,99,95,-7,-4,3,4,4,194,-4,2010,0,3,189,0
Denver,27,28,26,21,0,0,0,0,Sacramento,29,40,22,31,0,0,0,0,20110106,102,122,2,14,10,20,20,224,20,2010,0,3,886,0
Brooklyn,13,24,20,20,0,0,0,0,Washington,30,26,15,26,0,0,0,0,20110107,77,97,17,19,14,20,20,174,20,2010,0,4,204,0
New York,30,25,38,28,0,0,0,0,Phoenix,22,23,26,25,0,0,0,0,20110107,121,96,8,10,22,25,25,217,-25,2010,0,4,2139,0
Chicago,30,26,18,25,0,0,0,0,Philadelphia,28,26,32,19,0,0,0,0,20110107,99,105,-2,-2,12,6,6,204,6,2010,0,4,664,0
Houston,28,22,21,24,0,0,0,0,Orlando,27,26,39,18,0,0,0,0,20110107,95,110,-1,3,21,15,15,205,15,2010,0,4,847,0
Portland,37,26,25,20,0,0,0,0,Minnesota,27,16,29,26,0,0,0,0,20110107,108,98,10,20,16,10,10,206,-10,2010,0,4,1423,0
New Orleans,24,22,25,26,0,0,0,0,LA Lakers,27,24,29,21,0,0,0,0,20110107,97,101,3,5,9,4,4,198,4,2010,0,4,1669,0
Utah,23,21,21,34,0,0,0,0,Memphis,27,22,27,34,0,0,0,0,20110107,99,110,4,5,11,11,11,209,11,2010,0,4,1247,0
San Antonio,19,29,16,26,0,0,0,0,Indiana,20,27,28,12,0,0,0,0,20110107,90,87,-1,1,-11,3,3,177,-3,2010,0,4,999,0
Cleveland,24,25,28,21,0,0,0,0,Golden State,33,32,23,28,0,0,0,0,20110107,98,116,9,16,11,18,18,214,18,2010,0,4,2161,0
Toronto,22,23,32,25,0,0,0,0,Boston,34,33,27,28,0,0,0,0,20110107,102,122,12,22,17,20,20,224,20,2010,0,4,430,0
Miami,30,25,20,16,10,0,0,0,Milwaukee,18,30,24,19,4,0,0,0,20110107,101,95,12,7,3,0,6,196,-6,2010,1,4,1269,0
Utah,19,19,26,25,14,0,0,0,Houston,27,25,15,22,10,0,0,0,20110108,103,99,-8,-14,-3,0,4,202,-4,2010,1,5,1199,0
Memphis,20,27,30,23,0,0,0,0,Oklahoma City,27,22,34,26,0,0,0,0,20110108,100,109,7,2,6,9,9,209,9,2010,0,5,421,0
Milwaukee,28,27,33,27,0,0,0,0,Brooklyn,15,30,20,27,0,0,0,0,20110108,115,92,13,10,23,23,23,207,-23,2010,0,5,732,0
Philadelphia,34,22,18,25,10,0,0,0,Detroit,30,22,19,28,13,0,0,0,20110108,109,112,-4,-4,-3,0,3,221,3,2010,1,5,441,0
Orlando,19,32,29,37,0,0,0,0,Dallas,28,29,24,26,0,0,0,0,20110108,117,107,-9,-6,-1,10,10,224,-10,2010,0,5,961,0
Boston,21,21,22,15,0,0,0,0,Chicago,22,24,21,23,0,0,0,0,20110108,79,90,1,4,3,11,11,169,11,2010,0,5,849,0
Washington,20,26,25,18,0,0,0,0,Charlotte,26,23,28,27,0,0,0,0,20110108,89,104,6,3,6,15,15,193,15,2010,0,5,329,0
Indiana,24,26,18,25,0,0,0,0,Atlanta,29,26,29,24,0,0,0,0,20110108,93,108,5,5,16,15,15,201,15,2010,0,5,427,0
New Orleans,23,31,24,18,0,0,0,0,Denver,22,21,23,21,0,0,0,0,20110109,96,87,1,11,12,9,9,183,-9,2010,0,6,1079,0
Golden State,28,20,25,18,0,0,0,0,LA Clippers,32,30,29,14,0,0,0,0,20110109,91,105,4,14,18,14,14,196,14,2010,0,6,347,0
New York,21,26,23,17,0,0,0,0,LA Lakers,25,27,29,28,0,0,0,0,20110109,87,109,4,5,11,22,22,196,22,2010,0,6,2445,0
Cleveland,26,26,29,19,0,0,0,0,Phoenix,26,25,30,27,0,0,0,0,20110109,100,108,0,-1,0,8,8,208,8,2010,0,6,1745,0
Miami,27,19,19,28,14,0,0,0,Portland,26,18,23,26,7,0,0,0,20110109,107,100,1,2,-2,0,7,207,-7,2010,1,6,2704,0
Minnesota,21,23,23,24,0,0,0,0,San Antonio,18,32,24,20,0,0,0,0,20110109,91,94,-3,6,7,3,3,185,3,2010,0,6,1112,0
Sacramento,31,19,35,27,0,0,0,0,Toronto,34,23,28,33,0,0,0,0,20110109,112,118,3,7,0,6,6,230,6,2010,0,6,2195,0
Memphis,15,16,26,25,0,0,0,0,Charlotte,22,22,24,28,0,0,0,0,20110110,82,96,7,13,11,14,14,178,14,2010,0,0,519,0
Detroit,25,30,15,12,0,0,0,0,Chicago,20,23,33,19,0,0,0,0,20110110,82,95,-5,-12,6,13,13,177,13,2010,0,0,238,0
Houston,27,23,30,28,0,0,0,0,Boston,22,27,25,28,0,0,0,0,20110110,108,102,5,1,6,6,6,210,-6,2010,0,0,1603,0
Phoenix,32,23,17,26,0,0,0,0,Denver,20,44,38,30,0,0,0,0,20110111,98,132,-12,9,30,34,34,230,34,2010,0,1,585,0
Cleveland,12,13,16,16,0,0,0,0,LA Lakers,27,30,35,20,0,0,0,0,20110111,57,112,15,32,51,55,55,169,55,2010,0,1,2044,0
San Antonio,36,27,25,19,0,0,0,0,Minnesota,25,28,23,20,0,0,0,0,20110111,107,96,11,10,12,11,11,203,-11,2010,0,1,1112,0
Indiana,27,30,27,27,0,0,0,0,Philadelphia,23,26,32,22,0,0,0,0,20110111,111,103,4,8,3,8,8,214,-8,2010,0,1,582,0
New York,29,27,19,25,0,0,0,0,Portland,23,27,16,20,0,0,0,0,20110111,100,86,6,6,9,14,14,186,-14,2010,0,1,2439,0
Sacramento,19,37,27,43,7,0,0,0,Washington,38,16,40,32,10,0,0,0,20110111,133,136,19,-2,11,0,3,269,3,2010,1,1,2371,0
San Antonio,21,22,22,26,0,0,0,0,Milwaukee,26,25,15,18,0,0,0,0,20110112,91,84,-5,-8,-1,7,7,175,-7,2010,0,2,1108,0
New York,32,25,37,31,0,0,0,0,Utah,31,34,35,31,0,0,0,0,20110112,125,131,-1,8,6,6,6,256,6,2010,0,2,1967,0
Atlanta,27,33,15,29,0,0,0,0,Toronto,21,34,22,24,0,0,0,0,20110112,104,101,6,5,-2,3,3,205,-3,2010,0,2,733,0
Brooklyn,28,29,27,19,6,0,0,0,Phoenix,28,27,18,30,15,0,0,0,20110112,109,118,0,-2,-11,0,9,227,9,2010,1,2,2139,0
Orlando,21,18,22,20,8,0,0,0,New Orleans,17,23,27,14,11,0,0,0,20110112,89,92,-4,1,6,0,3,181,3,2010,1,2,533,0
Miami,26,32,20,27,0,0,0,0,LA Clippers,44,24,18,25,0,0,0,0,20110112,105,111,18,10,8,6,6,216,6,2010,0,2,2335,0
Dallas,26,26,17,20,0,0,0,0,Indiana,25,27,25,25,0,0,0,0,20110112,89,102,-1,0,8,13,13,191,13,2010,0,2,763,0
Oklahoma City,31,21,30,36,0,0,0,0,Houston,31,23,25,33,0,0,0,0,20110112,118,112,0,-2,3,6,6,230,-6,2010,0,2,413,0
LA Lakers,21,24,24,46,0,0,0,0,Golden State,26,27,22,35,0,0,0,0,20110112,115,110,-5,-8,-6,5,5,225,-5,2010,0,2,347,0
Memphis,21,22,30,34,0,0,0,0,Detroit,26,20,18,35,0,0,0,0,20110112,107,99,-5,-3,9,8,8,206,-8,2010,0,2,622,0
Chicago,22,20,28,21,0,0,0,0,Charlotte,36,19,14,27,0,0,0,0,20110112,91,96,14,13,-1,5,5,187,5,2010,0,2,586,0
Sacramento,22,27,18,28,0,0,0,0,Boston,28,29,33,29,0,0,0,0,20110112,95,119,6,8,23,24,24,214,24,2010,0,2,2624,0
Miami,23,20,25,34,0,0,0,0,Denver,26,34,38,32,0,0,0,0,20110113,102,130,3,17,30,28,28,232,28,2010,0,3,1724,0
Washington,18,30,30,19,0,0,0,0,Minnesota,28,27,27,27,0,0,0,0,20110113,97,109,10,7,4,12,12,206,12,2010,0,3,931,0
Orlando,27,33,26,38,0,0,0,0,Oklahoma City,35,29,32,29,0,0,0,0,20110113,124,125,8,4,10,1,1,249,1,2010,0,3,1057,0
Cleveland,25,25,33,16,0,0,0,0,Utah,31,39,23,28,0,0,0,0,20110114,99,121,6,20,10,22,22,220,22,2010,0,4,1564,0
Detroit,31,30,22,18,0,0,0,0,Toronto,26,28,20,21,0,0,0,0,20110114,101,95,5,7,9,6,6,196,-6,2010,0,4,205,0
Dallas,19,23,19,28,0,0,0,0,San Antonio,27,30,28,16,0,0,0,0,20110114,89,101,8,15,24,12,12,190,12,2010,0,4,252,0
Portland,36,23,27,25,0,0,0,0,Phoenix,28,28,29,30,0,0,0,0,20110114,111,115,-8,-3,-1,4,4,226,4,2010,0,4,1005,0
Milwaukee,23,26,23,22,0,0,0,0,Philadelphia,28,27,22,18,0,0,0,0,20110114,94,95,5,6,5,1,1,189,1,2010,0,4,692,0
Chicago,28,25,26,20,0,0,0,0,Indiana,24,17,22,23,0,0,0,0,20110114,99,86,4,12,16,13,13,185,-13,2010,0,4,163,0
Brooklyn,24,16,23,25,0,0,0,0,LA Lakers,22,23,25,30,0,0,0,0,20110114,88,100,-2,5,7,12,12,188,12,2010,0,4,2445,0
New Orleans,21,29,14,31,15,0,0,0,Houston,28,19,29,19,10,0,0,0,20110114,110,105,-7,3,-12,0,5,215,-5,2010,1,4,317,0
LA Clippers,39,23,24,26,0,0,0,0,Golden State,35,34,25,28,0,0,0,0,20110114,112,122,-4,7,8,10,10,234,10,2010,0,4,347,0
Charlotte,24,18,24,28,0,0,0,0,Boston,24,18,27,30,0,0,0,0,20110114,94,99,0,0,3,5,5,193,5,2010,0,4,720,0
Sacramento,24,22,23,24,0,0,0,0,New York,15,27,16,25,0,0,0,0,20110114,93,83,9,4,11,10,10,176,-10,2010,0,4,2499,0
Dallas,19,17,12,22,0,0,0,0,Memphis,31,15,21,22,0,0,0,0,20110115,70,89,12,10,19,19,19,159,19,2010,0,5,419,0
Toronto,25,17,25,28,0,0,0,0,Washington,19,28,28,23,0,0,0,0,20110115,95,98,-6,5,8,3,3,193,3,2010,0,5,349,0
Brooklyn,26,27,23,13,0,0,0,0,Portland,18,28,28,22,0,0,0,0,20110115,89,96,-8,-7,-2,7,7,185,7,2010,0,5,2439,0
Sacramento,36,34,10,26,0,0,0,0,Detroit,27,32,23,28,0,0,0,0,20110115,106,110,-9,-11,2,4,4,216,4,2010,0,5,2020,0
Orlando,20,28,33,27,0,0,0,0,Minnesota,29,26,18,26,0,0,0,0,20110115,108,99,-9,-7,8,9,9,207,-9,2010,0,5,1309,0
Miami,19,34,17,26,0,0,0,0,Chicago,28,20,25,26,0,0,0,0,20110115,96,99,9,-5,3,3,3,195,3,2010,0,5,1189,0
Houston,29,27,27,29,0,0,0,0,Atlanta,31,27,24,24,0,0,0,0,20110115,112,106,-2,-2,1,6,6,218,-6,2010,0,5,700,0
Cleveland,22,27,21,29,0,0,0,0,Denver,34,46,25,22,0,0,0,0,20110115,99,127,12,31,35,28,28,226,28,2010,0,5,1223,0
New Orleans,25,23,21,19,0,0,0,0,Charlotte,21,21,25,14,0,0,0,0,20110115,88,81,4,6,2,7,7,169,-7,2010,0,5,648,0
LA Lakers,22,23,26,21,0,0,0,0,LA Clippers,27,17,24,31,0,0,0,0,20110116,92,99,5,-1,-3,7,7,191,7,2010,0,6,0,0
Denver,24,21,22,30,0,0,0,0,San Antonio,20,37,25,28,0,0,0,0,20110116,97,110,-4,12,15,13,13,207,13,2010,0,6,802,0
Toronto,16,28,21,16,0,0,0,0,New Orleans,20,17,25,23,0,0,0,0,20110117,81,85,4,-7,-3,4,4,166,4,2010,0,0,1112,0
Utah,18,21,29,33,0,0,0,0,Washington,21,21,36,30,0,0,0,0,20110117,101,108,3,3,10,7,7,209,7,2010,0,0,1841,0
Minnesota,29,17,27,29,0,0,0,0,Portland,30,20,38,25,0,0,0,0,20110117,102,113,1,4,15,11,11,215,11,2010,0,0,1423,0
Charlotte,23,16,20,27,6,0,0,0,Philadelphia,22,18,25,21,10,0,0,0,20110117,92,96,-1,1,6,0,4,188,4,2010,1,0,450,0
Phoenix,39,22,36,32,0,0,0,0,New York,30,34,27,30,0,0,0,0,20110117,129,121,9,-3,6,8,8,250,-8,2010,0,0,2139,0
Oklahoma City,28,27,20,19,0,0,0,0,LA Lakers,28,30,23,20,0,0,0,0,20110117,94,101,0,3,6,7,7,195,7,2010,0,0,1178,0
Chicago,26,27,26,17,0,0,0,0,Memphis,17,25,18,24,0,0,0,0,20110117,96,84,9,11,19,12,12,180,-12,2010,0,0,480,0
Milwaukee,15,24,27,18,0,0,0,0,Houston,18,21,35,19,0,0,0,0,20110117,84,93,3,0,8,9,9,177,9,2010,0,0,1005,0
Brooklyn,28,18,27,27,0,0,0,0,Golden State,28,26,25,30,0,0,0,0,20110117,100,109,0,8,6,9,9,209,9,2010,0,0,2565,0
Dallas,18,19,25,27,0,0,0,0,Detroit,21,20,34,28,0,0,0,0,20110117,89,103,3,4,13,14,14,192,14,2010,0,0,999,0
Orlando,22,32,27,25,0,0,0,0,Boston,27,28,26,28,0,0,0,0,20110117,106,109,5,1,0,3,3,215,3,2010,0,0,1115,0
Sacramento,32,30,20,16,0,0,0,0,Atlanta,27,26,20,27,0,0,0,0,20110117,98,100,-5,-9,-9,2,2,198,2,2010,0,0,2082,0
Indiana,31,27,22,27,0,0,0,0,LA Clippers,26,29,26,33,0,0,0,0,20110117,107,114,-5,-3,1,7,7,221,7,2010,0,0,1805,0
Charlotte,27,20,17,19,0,0,0,0,Chicago,24,20,22,16,0,0,0,0,20110118,83,82,3,3,-2,1,1,165,-1,2010,0,1,586,0
Atlanta,19,15,24,19,16,0,0,0,Miami,11,24,20,22,12,0,0,0,20110118,93,89,8,-1,3,0,4,182,-4,2010,1,1,605,0
Washington,27,22,17,21,0,0,0,0,Milwaukee,19,28,28,25,0,0,0,0,20110119,87,100,-8,-2,9,13,13,187,13,2010,0,2,634,0
Portland,21,25,19,20,9,0,0,0,Sacramento,26,22,17,20,5,0,0,0,20110119,94,90,-5,-2,0,0,4,184,-4,2010,1,2,483,0
Philadelphia,21,27,22,20,8,0,0,0,Orlando,17,27,19,27,9,0,0,0,20110119,98,99,-4,-4,-7,0,1,197,1,2010,1,2,864,0
Memphis,26,25,16,25,10,0,0,0,New Orleans,18,24,25,25,11,0,0,0,20110119,102,103,-8,-9,0,0,1,205,1,2010,1,2,358,0
Utah,19,29,16,31,0,0,0,0,Brooklyn,27,21,29,26,0,0,0,0,20110119,95,103,8,0,13,8,8,198,8,2010,0,2,1967,0
Toronto,23,30,16,26,0,0,0,0,San Antonio,22,20,33,29,0,0,0,0,20110119,95,104,-1,-11,6,9,9,199,9,2010,0,2,1438,0
New York,27,23,21,18,0,0,0,0,Houston,36,24,22,22,0,0,0,0,20110119,89,104,9,10,11,15,15,193,15,2010,0,2,1417,0
Indiana,29,29,25,25,0,0,0,0,Golden State,28,25,28,29,0,0,0,0,20110119,108,110,-1,-5,-2,2,2,218,2,2010,0,2,1944,0
Oklahoma City,24,31,31,21,0,0,0,0,Denver,27,28,30,27,0,0,0,0,20110119,107,112,3,0,-1,5,5,219,5,2010,0,2,503,0
LA Lakers,31,25,17,27,0,0,0,0,Dallas,23,29,30,27,0,0,0,0,20110119,100,109,-8,-4,9,9,9,209,9,2010,0,2,1237,0
Phoenix,36,26,28,16,0,0,0,0,Cleveland,28,21,28,21,0,0,0,0,20110119,106,98,8,13,13,8,8,204,-8,2010,0,2,1745,0
Detroit,22,23,16,21,0,0,0,0,Boston,22,20,16,28,0,0,0,0,20110119,82,86,0,-3,-3,4,4,168,4,2010,0,2,611,0
Minnesota,19,29,31,32,0,0,0,0,LA Clippers,29,31,32,34,0,0,0,0,20110119,111,126,10,12,13,15,15,237,15,2010,0,2,1521,0
Philadelphia,27,23,18,29,0,0,0,0,Charlotte,30,26,18,26,0,0,0,0,20110120,97,100,3,6,6,3,3,197,3,2010,0,3,450,0
Dallas,20,15,25,17,0,0,0,0,Chicago,19,25,12,26,0,0,0,0,20110120,77,82,-1,9,-4,5,5,159,5,2010,0,3,802,0
LA Clippers,27,23,21,22,0,0,0,0,Portland,23,32,29,24,0,0,0,0,20110120,93,108,-4,5,13,15,15,201,15,2010,0,3,826,0
Phoenix,22,30,31,26,0,0,0,0,Washington,33,20,18,20,0,0,0,0,20110121,109,91,-11,-1,12,18,18,200,-18,2010,0,4,1977,0
New York,27,23,21,21,0,0,0,0,San Antonio,29,32,16,24,0,0,0,0,20110121,92,101,2,11,6,9,9,193,9,2010,0,4,1581,0
Toronto,18,23,16,15,0,0,0,0,Orlando,26,21,26,39,0,0,0,0,20110121,72,112,8,6,16,40,40,184,40,2010,0,4,1048,0
Detroit,18,23,19,14,0,0,0,0,Brooklyn,21,25,21,22,0,0,0,0,20110121,74,89,3,5,7,15,15,163,15,2010,0,4,480,0
Houston,37,30,21,22,0,0,0,0,Memphis,32,26,29,28,0,0,0,0,20110121,110,115,-5,-9,-1,5,5,225,5,2010,0,4,484,0
LA Lakers,22,27,33,25,0,0,0,0,Denver,25,27,20,25,0,0,0,0,20110121,107,97,-3,-3,10,10,10,204,-10,2010,0,4,830,0
Milwaukee,27,26,26,23,0,0,0,0,Cleveland,25,16,29,18,0,0,0,0,20110121,102,88,2,12,9,14,14,190,-14,2010,0,4,334,0
Utah,19,22,22,23,0,0,0,0,Boston,30,29,26,25,0,0,0,0,20110121,86,110,11,18,22,24,24,196,24,2010,0,4,2093,0
New Orleans,19,30,21,30,0,0,0,0,Atlanta,17,17,11,14,0,0,0,0,20110121,100,59,2,15,25,41,41,159,-41,2010,0,4,424,0
Sacramento,28,23,23,30,8,0,0,0,Golden State,27,24,31,22,15,0,0,0,20110121,112,119,-1,0,8,0,7,231,7,2010,1,4,75,0
Dallas,22,26,20,19,0,0,0,0,Brooklyn,26,19,23,18,0,0,0,0,20110122,87,86,-4,3,0,1,1,173,-1,2010,0,5,1370,0
Indiana,28,25,17,22,0,0,0,0,Portland,19,27,21,30,0,0,0,0,20110122,92,97,-9,-7,-3,5,5,189,5,2010,0,5,1880,0
Utah,22,19,22,22,0,0,0,0,Philadelphia,26,21,23,26,0,0,0,0,20110122,85,96,4,6,7,11,11,181,11,2010,0,5,1920,0
New York,30,30,17,21,0,0,0,0,Oklahoma City,31,22,22,26,0,0,0,0,20110122,98,101,1,-7,-2,3,3,199,3,2010,0,5,1324,0
San Antonio,12,26,10,24,0,0,0,0,New Orleans,13,28,31,24,0,0,0,0,20110122,72,96,1,3,24,24,24,168,24,2010,0,5,506,0
Memphis,21,22,29,22,0,0,0,0,Milwaukee,19,21,19,22,0,0,0,0,20110122,94,81,2,3,13,13,13,175,-13,2010,0,5,557,0
Boston,35,21,16,11,0,0,0,0,Washington,20,26,24,15,0,0,0,0,20110122,83,85,-15,-10,-2,2,2,168,2,2010,0,5,394,0
Golden State,22,34,26,27,0,0,0,0,LA Clippers,34,31,21,27,0,0,0,0,20110122,109,113,12,9,4,4,4,222,4,2010,0,5,347,0
Atlanta,24,20,32,27,0,0,0,0,Charlotte,29,20,18,20,0,0,0,0,20110122,103,87,-5,-5,9,16,16,190,-16,2010,0,5,226,0
Cleveland,17,21,24,17,0,0,0,0,Chicago,22,26,24,20,0,0,0,0,20110122,79,92,5,10,10,13,13,171,13,2010,0,5,308,0
Toronto,17,23,37,26,0,0,0,0,Miami,32,34,26,28,0,0,0,0,20110122,103,120,15,26,15,17,17,223,17,2010,0,5,1234,0
Orlando,34,34,32,18,0,0,0,0,Houston,26,25,25,28,0,0,0,0,20110122,118,104,8,17,24,14,14,222,-14,2010,0,5,847,0
Phoenix,17,21,23,13,0,0,0,0,Detroit,21,15,11,28,0,0,0,0,20110122,74,75,4,-2,-14,1,1,149,1,2010,0,5,1687,0
Indiana,30,21,27,29,0,0,0,0,Denver,27,32,34,28,0,0,0,0,20110123,107,121,-3,8,15,14,14,228,14,2010,0,6,998,0
Memphis,25,26,29,20,0,0,0,0,Toronto,24,25,25,24,0,0,0,0,20110124,100,98,1,2,6,2,2,198,-2,2010,0,0,815,0
Phoenix,25,22,23,25,0,0,0,0,Philadelphia,26,35,26,18,0,0,0,0,20110124,95,105,1,14,17,10,10,200,10,2010,0,0,2078,0
Detroit,27,29,19,28,0,0,0,0,Orlando,26,20,19,31,0,0,0,0,20110124,103,96,1,10,10,7,7,199,-7,2010,0,0,957,0
Washington,26,36,29,15,0,0,0,0,New York,33,29,31,22,0,0,0,0,20110124,106,115,7,0,2,9,9,221,9,2010,0,0,204,0
Sacramento,25,20,25,26,0,0,0,0,Portland,20,23,22,16,0,0,0,0,20110124,96,81,5,2,5,15,15,177,-15,2010,0,0,483,0
Cleveland,29,25,23,24,0,0,0,0,Brooklyn,26,22,25,30,0,0,0,0,20110124,101,103,-3,-6,-4,2,2,204,2,2010,0,0,403,0
Houston,39,26,35,29,0,0,0,0,Minnesota,31,32,25,37,0,0,0,0,20110124,129,125,8,2,12,4,4,254,-4,2010,0,0,1057,0
San Antonio,34,28,28,23,0,0,0,0,Golden State,34,21,23,24,0,0,0,0,20110124,113,102,0,7,12,11,11,215,-11,2010,0,0,1487,0
Milwaukee,18,14,26,25,0,0,0,0,Chicago,19,29,20,24,0,0,0,0,20110124,83,92,1,16,10,9,9,175,9,2010,0,0,83,0
Oklahoma City,33,12,26,18,0,0,0,0,New Orleans,19,31,21,20,0,0,0,0,20110124,89,91,-14,5,0,2,2,180,2,2010,0,0,576,0
Cleveland,26,19,24,26,0,0,0,0,Boston,34,33,24,21,0,0,0,0,20110125,95,112,8,22,22,17,17,207,17,2010,0,1,549,0
LA Clippers,33,29,16,27,0,0,0,0,Dallas,25,29,27,31,0,0,0,0,20110125,105,112,-8,-8,3,7,7,217,7,2010,0,1,1237,0
Utah,22,16,27,26,0,0,0,0,LA Lakers,37,29,27,27,0,0,0,0,20110125,91,120,15,28,28,29,29,211,29,2010,0,1,579,0
Charlotte,21,31,24,18,0,0,0,0,Sacramento,19,23,25,22,0,0,0,0,20110125,94,89,2,10,9,5,5,183,-5,2010,0,1,2239,0
Denver,33,35,28,24,0,0,0,0,Washington,26,31,22,30,0,0,0,0,20110125,120,109,7,11,17,11,11,229,-11,2010,0,1,1489,0
Memphis,32,21,13,22,0,0,0,0,Brooklyn,16,26,18,33,0,0,0,0,20110126,88,93,-16,-11,-6,5,5,181,5,2010,0,2,953,0
San Antonio,29,29,30,24,0,0,0,0,Utah,25,24,29,27,0,0,0,0,20110126,112,105,4,9,10,7,7,217,-7,2010,0,2,1087,0
Philadelphia,20,30,34,23,0,0,0,0,Toronto,29,21,27,17,0,0,0,0,20110126,107,94,-9,0,7,13,13,201,-13,2010,0,2,334,0
Charlotte,31,28,33,22,0,0,0,0,Phoenix,26,31,30,20,0,0,0,0,20110126,114,107,5,2,5,7,7,221,-7,2010,0,2,1778,0
Oklahoma City,25,29,29,27,8,0,0,0,Minnesota,28,28,23,31,7,0,0,0,20110126,118,117,-3,-2,4,0,1,235,-1,2010,1,2,694,0
Atlanta,23,24,28,15,0,0,0,0,Milwaukee,22,22,20,34,0,0,0,0,20110126,90,98,-1,-3,-11,8,8,188,8,2010,0,2,669,0
Orlando,24,38,24,25,0,0,0,0,Indiana,21,27,24,24,0,0,0,0,20110126,111,96,3,14,14,15,15,207,-15,2010,0,2,822,0
LA Clippers,22,30,21,10,0,0,0,0,Houston,27,28,15,26,0,0,0,0,20110126,83,96,5,3,-3,13,13,179,13,2010,0,2,1371,0
New Orleans,34,27,32,19,0,0,0,0,Golden State,21,28,27,27,0,0,0,0,20110126,112,103,13,12,17,9,9,215,-9,2010,0,2,1921,0
Denver,29,27,24,29,0,0,0,0,Detroit,24,26,24,26,0,0,0,0,20110126,109,100,5,6,6,9,9,209,-9,2010,0,2,1154,0
Houston,15,32,34,25,0,0,0,0,Dallas,33,31,24,23,0,0,0,0,20110127,106,111,18,17,7,5,5,217,5,2010,0,3,225,0
Miami,24,24,25,15,0,0,0,0,New York,23,23,18,29,0,0,0,0,20110127,88,93,-1,-2,-9,5,5,181,5,2010,0,3,1091,0
Boston,21,20,23,24,0,0,0,0,Portland,18,19,21,20,0,0,0,0,20110127,88,78,3,4,6,10,10,166,-10,2010,0,3,2532,0
Minnesota,25,30,22,23,0,0,0,0,Utah,32,26,27,23,0,0,0,0,20110128,100,108,7,3,8,8,8,208,8,2010,0,4,984,0
Milwaukee,32,23,26,23,12,0,0,0,Toronto,22,35,21,26,6,0,0,0,20110128,116,110,10,-2,3,0,6,226,-6,2010,1,4,429,0
Boston,16,19,23,13,0,0,0,0,Phoenix,30,19,26,13,0,0,0,0,20110128,71,88,14,14,17,17,17,159,17,2010,0,4,2295,0
Memphis,21,19,17,42,0,0,0,0,Philadelphia,18,26,29,21,0,0,0,0,20110128,99,94,3,-4,-16,5,5,193,-5,2010,0,4,878,0
Washington,29,23,28,23,7,7,0,0,Oklahoma City,21,35,19,28,7,14,0,0,20110128,117,124,-8,4,-5,0,7,241,7,2010,2,4,1149,0
Detroit,22,20,26,19,0,0,0,0,Miami,19,20,25,24,0,0,0,0,20110128,87,88,-3,-3,-4,1,1,175,1,2010,0,4,1155,0
Charlotte,22,22,27,30,20,0,0,0,Golden State,28,22,26,25,12,0,0,0,20110128,121,113,-6,-6,-5,0,8,234,-8,2010,1,4,2296,0
Brooklyn,27,27,24,14,0,0,0,0,Indiana,33,35,36,20,0,0,0,0,20110128,92,124,6,14,26,32,32,216,32,2010,0,4,643,0
Denver,31,39,23,24,0,0,0,0,Cleveland,24,26,33,20,0,0,0,0,20110128,117,103,7,20,10,14,14,220,-14,2010,0,4,1223,0
Orlando,23,28,17,22,0,0,0,0,Chicago,24,22,34,19,0,0,0,0,20110128,90,99,1,-5,12,9,9,189,9,2010,0,4,984,0
New York,21,22,33,26,0,0,0,0,Atlanta,30,30,31,20,0,0,0,0,20110128,102,111,9,17,15,9,9,213,9,2010,0,4,745,0
Sacramento,30,29,26,15,0,0,0,0,LA Lakers,33,22,16,24,0,0,0,0,20110128,100,95,-3,4,14,5,5,195,-5,2010,0,4,361,0
Toronto,20,19,20,28,0,0,0,0,Minnesota,21,28,31,23,0,0,0,0,20110129,87,103,1,10,21,16,16,190,16,2010,0,5,691,0
New Orleans,22,24,21,29,0,0,0,0,Sacramento,24,32,20,26,0,0,0,0,20110129,96,102,2,10,9,6,6,198,6,2010,0,5,1879,0
Brooklyn,25,12,24,20,0,0,0,0,Milwaukee,22,23,23,23,0,0,0,0,20110129,81,91,-3,8,7,10,10,172,10,2010,0,5,732,0
Houston,26,25,20,24,0,0,0,0,San Antonio,25,28,23,32,0,0,0,0,20110129,95,108,-1,2,5,13,13,203,13,2010,0,5,189,0
Charlotte,23,19,18,28,0,0,0,0,LA Clippers,24,33,26,20,0,0,0,0,20110129,88,103,1,15,23,15,15,191,15,2010,0,5,2115,0
Atlanta,24,25,29,13,0,0,0,0,Dallas,28,24,25,25,0,0,0,0,20110129,91,102,4,3,-1,11,11,193,11,2010,0,5,719,0
Indiana,27,24,21,17,0,0,0,0,Chicago,25,30,22,33,0,0,0,0,20110129,89,110,-2,4,5,21,21,199,21,2010,0,5,163,0
Washington,28,22,17,26,0,0,0,0,Memphis,33,26,27,21,0,0,0,0,20110129,93,107,5,9,19,14,14,200,14,2010,0,5,762,0
New Orleans,25,28,27,22,0,0,0,0,Phoenix,27,26,35,16,0,0,0,0,20110130,102,104,2,0,8,2,2,206,2,2010,0,6,1312,0
Denver,34,17,21,27,0,0,0,0,Philadelphia,32,22,28,28,0,0,0,0,20110130,99,110,-2,3,10,11,11,209,11,2010,0,6,1574,0
Cleveland,17,26,20,24,0,0,0,0,Orlando,33,23,23,24,0,0,0,0,20110130,87,103,16,13,16,16,16,190,16,2010,0,6,895,0
Boston,22,28,27,32,0,0,0,0,LA Lakers,21,33,18,24,0,0,0,0,20110130,109,96,1,-4,5,13,13,205,-13,2010,0,6,2590,0
Detroit,31,31,29,15,0,0,0,0,New York,30,30,31,33,0,0,0,0,20110130,106,124,-1,-2,0,18,18,230,18,2010,0,6,480,0
Miami,35,29,21,23,0,0,0,0,Oklahoma City,38,23,24,18,0,0,0,0,20110130,108,103,-3,3,0,5,5,211,-5,2010,0,6,1225,0
Utah,25,20,16,20,0,0,0,0,Golden State,31,18,22,25,0,0,0,0,20110130,81,96,6,4,10,15,15,177,15,2010,0,6,599,0
Denver,21,29,28,21,0,0,0,0,Brooklyn,31,32,22,30,0,0,0,0,20110131,99,115,10,13,7,16,16,214,16,2010,0,0,1627,0
Cleveland,20,37,15,18,0,0,0,0,Miami,35,31,23,28,0,0,0,0,20110131,90,117,15,9,17,27,27,207,27,2010,0,0,1089,0
Orlando,28,30,16,23,0,0,0,0,Memphis,21,33,32,14,0,0,0,0,20110131,97,100,-7,-4,12,3,3,197,3,2010,0,0,683,0
Charlotte,18,23,21,16,0,0,0,0,Utah,24,19,19,21,0,0,0,0,20110131,78,83,6,2,0,5,5,161,5,2010,0,0,1723,0
Toronto,21,24,25,23,0,0,0,0,Indiana,32,19,24,29,0,0,0,0,20110131,93,104,11,6,5,11,11,197,11,2010,0,0,438,0
Washington,25,24,19,24,0,0,0,0,Dallas,21,29,24,28,0,0,0,0,20110131,92,102,-4,1,6,10,10,194,10,2010,0,0,1181,0
Milwaukee,16,31,26,25,0,0,0,0,LA Clippers,26,23,28,28,0,0,0,0,20110131,98,105,10,2,4,7,7,203,7,2010,0,0,1741,0
Houston,23,25,26,24,8,0,0,0,LA Lakers,31,23,20,24,16,0,0,0,20110201,106,114,8,6,0,0,8,220,8,2010,1,1,1371,0
Washington,26,18,21,24,0,0,0,0,New Orleans,29,26,25,17,0,0,0,0,20110201,89,97,3,11,15,8,8,186,8,2010,0,1,964,0
San Antonio,22,30,19,15,0,0,0,0,Portland,24,23,24,28,0,0,0,0,20110201,86,99,2,-5,0,13,13,185,13,2010,0,1,1718,0
Boston,27,18,29,21,0,0,0,0,Sacramento,20,34,17,19,0,0,0,0,20110201,95,90,7,-9,3,5,5,185,-5,2010,0,1,2624,0
Philadelphia,28,25,25,28,0,0,0,0,Brooklyn,26,18,22,26,0,0,0,0,20110202,106,92,2,9,12,14,14,198,-14,2010,0,2,80,0
Houston,30,24,25,18,0,0,0,0,Utah,26,29,27,14,0,0,0,0,20110202,97,96,4,-1,-3,1,1,193,-1,2010,0,2,1199,0
Milwaukee,17,14,22,24,0,0,0,0,Phoenix,25,27,19,21,0,0,0,0,20110202,77,92,8,21,18,15,15,169,15,2010,0,2,1462,0
New Orleans,25,30,17,21,0,0,0,0,Oklahoma City,29,20,32,23,0,0,0,0,20110202,93,104,4,-6,9,11,11,197,11,2010,0,2,576,0
Memphis,26,23,30,23,0,0,0,0,Minnesota,20,21,16,27,0,0,0,0,20110202,102,84,6,8,22,18,18,186,-18,2010,0,2,700,0
Dallas,27,29,30,27,0,0,0,0,New York,34,18,21,24,0,0,0,0,20110202,113,97,-7,4,13,16,16,210,-16,2010,0,2,1370,0
Charlotte,25,19,24,29,0,0,0,0,Detroit,21,20,24,22,0,0,0,0,20110202,97,87,4,3,3,10,10,184,-10,2010,0,2,504,0
Chicago,28,27,27,24,0,0,0,0,LA Clippers,23,26,22,17,0,0,0,0,20110202,106,88,5,6,11,18,18,194,-18,2010,0,2,1741,0
Portland,23,23,24,20,0,0,0,0,Denver,22,23,32,32,0,0,0,0,20110202,90,109,-1,-1,7,19,19,199,19,2010,0,2,981,0
Indiana,35,24,30,28,0,0,0,0,Cleveland,25,29,33,25,0,0,0,0,20110202,117,112,10,5,2,5,5,229,-5,2010,0,2,262,0
Toronto,24,21,24,18,0,0,0,0,Atlanta,28,26,21,25,0,0,0,0,20110202,87,100,4,9,6,13,13,187,13,2010,0,2,733,0
Miami,30,25,24,25,0,0,0,0,Orlando,26,19,18,37,0,0,0,0,20110203,104,100,4,10,16,4,4,204,-4,2010,0,3,204,0
Milwaukee,22,25,26,21,0,0,0,0,Golden State,18,28,26,28,0,0,0,0,20110203,94,100,-4,-1,-1,6,6,194,6,2010,0,3,1838,0
San Antonio,22,20,24,23,0,0,0,0,LA Lakers,18,24,21,25,0,0,0,0,20110203,89,88,4,0,3,1,1,177,-1,2010,0,3,1201,0
Minnesota,31,24,25,20,0,0,0,0,Toronto,33,26,27,25,0,0,0,0,20110204,100,111,2,4,6,11,11,211,11,2010,0,4,691,0
Orlando,29,22,23,36,0,0,0,0,Washington,21,28,15,28,0,0,0,0,20110204,110,92,8,2,10,18,18,202,-18,2010,0,4,757,0
San Antonio,34,27,30,22,0,0,0,0,Sacramento,19,24,32,25,0,0,0,0,20110204,113,100,15,18,16,13,13,213,-13,2010,0,4,1456,0
Oklahoma City,31,32,17,31,0,0,0,0,Phoenix,36,24,27,20,0,0,0,0,20110204,111,107,-5,3,-7,4,4,218,-4,2010,0,4,840,0
Cleveland,32,27,25,21,0,0,0,0,Memphis,26,26,31,29,0,0,0,0,20110204,105,112,-6,-7,-1,7,7,217,7,2010,0,4,629,0
New York,21,31,30,16,0,0,0,0,Philadelphia,35,16,22,27,0,0,0,0,20110204,98,100,14,-1,-9,2,2,198,2,2010,0,4,80,0
Brooklyn,22,22,19,19,0,0,0,0,Detroit,28,20,24,20,0,0,0,0,20110204,82,92,6,4,9,10,10,174,10,2010,0,4,480,0
Utah,23,27,32,31,0,0,0,0,Denver,24,23,30,29,0,0,0,0,20110204,113,106,-1,3,5,7,7,219,-7,2010,0,4,370,0
Miami,29,30,24,26,0,0,0,0,Charlotte,26,29,22,20,0,0,0,0,20110204,109,97,3,4,6,12,12,206,-12,2010,0,4,654,0
Dallas,34,20,23,24,0,0,0,0,Boston,27,24,26,20,0,0,0,0,20110204,101,97,7,3,0,4,4,198,-4,2010,0,4,1548,0
LA Clippers,19,31,17,33,0,0,0,0,Atlanta,22,25,32,22,0,0,0,0,20110204,100,101,3,-3,12,1,1,201,1,2010,0,4,1932,0
Portland,25,29,18,15,0,0,0,0,Indiana,32,28,26,14,0,0,0,0,20110204,87,100,7,6,14,13,13,187,13,2010,0,4,1880,0
Atlanta,28,24,24,23,0,0,0,0,Washington,19,27,25,21,0,0,0,0,20110205,99,92,9,6,5,7,7,191,-7,2010,0,5,541,0
Oklahoma City,27,35,30,29,0,0,0,0,Utah,37,20,24,24,0,0,0,0,20110205,121,105,-10,5,11,16,16,226,-16,2010,0,5,861,0
LA Lakers,27,29,25,20,0,0,0,0,New Orleans,19,31,32,13,0,0,0,0,20110205,101,95,8,6,-1,6,6,196,-6,2010,0,5,1669,0
Denver,25,34,28,26,0,0,0,0,Minnesota,23,23,38,16,0,0,0,0,20110205,113,100,2,13,3,13,13,213,-13,2010,0,5,698,0
Chicago,25,22,25,18,0,0,0,0,Golden State,23,25,25,28,0,0,0,0,20110205,90,101,-2,1,1,11,11,191,11,2010,0,5,1853,0
Memphis,26,25,20,16,6,0,0,0,Houston,20,23,24,20,8,0,0,0,20110205,93,95,-6,-8,-4,0,2,188,2,2010,1,5,484,0
Portland,23,32,31,25,0,0,0,0,Cleveland,20,37,26,22,0,0,0,0,20110205,111,105,3,-2,3,6,6,216,-6,2010,0,5,2049,0
Dallas,31,24,27,19,0,0,0,0,Charlotte,22,23,21,26,0,0,0,0,20110205,101,92,9,10,16,9,9,193,-9,2010,0,5,928,0
Detroit,26,26,14,23,0,0,0,0,Milwaukee,22,25,13,18,0,0,0,0,20110205,89,78,4,5,6,11,11,167,-11,2010,0,5,251,0
Indiana,33,23,25,24,0,0,0,0,Brooklyn,24,19,24,19,0,0,0,0,20110206,105,86,9,13,14,19,19,191,-19,2010,0,6,643,0
Philadelphia,24,27,29,23,0,0,0,0,New York,31,24,31,31,0,0,0,0,20110206,103,117,7,4,6,14,14,220,14,2010,0,6,80,0
LA Clippers,19,17,25,18,0,0,0,0,Miami,20,27,23,27,0,0,0,0,20110206,79,97,1,11,9,18,18,176,18,2010,0,6,2335,0
Orlando,22,21,18,19,0,0,0,0,Boston,17,29,24,21,0,0,0,0,20110206,80,91,-5,3,9,11,11,171,11,2010,0,6,1115,0
Boston,29,21,19,20,0,0,0,0,Charlotte,25,26,14,29,0,0,0,0,20110207,89,94,-4,1,-4,5,5,183,5,2010,0,0,720,0
Cleveland,28,21,24,23,0,0,0,0,Dallas,29,30,18,22,0,0,0,0,20110207,96,99,1,10,4,3,3,195,3,2010,0,0,1024,0
Houston,25,27,29,27,0,0,0,0,Denver,26,24,16,37,0,0,0,0,20110207,108,103,-1,2,15,5,5,211,-5,2010,0,0,878,0
Phoenix,33,29,27,15,0,0,0,0,Golden State,17,28,30,17,0,0,0,0,20110207,104,92,16,17,14,12,12,196,-12,2010,0,0,652,0
LA Lakers,26,24,23,20,0,0,0,0,Memphis,29,16,23,16,0,0,0,0,20110207,93,84,-3,5,5,9,9,177,-9,2010,0,0,1599,0
Minnesota,23,37,22,22,0,0,0,0,New Orleans,23,23,24,22,0,0,0,0,20110207,104,92,0,14,12,12,12,196,-12,2010,0,0,1052,0
Chicago,26,24,22,31,0,0,0,0,Portland,28,22,25,34,0,0,0,0,20110207,103,109,2,0,3,6,6,212,6,2010,0,0,1754,0
Utah,30,25,25,27,0,0,0,0,Sacramento,30,26,31,17,0,0,0,0,20110207,107,104,0,-1,-7,3,3,211,-3,2010,0,0,532,0
Philadelphia,33,32,23,29,0,0,0,0,Atlanta,15,18,25,25,0,0,0,0,20110208,117,83,18,32,30,34,34,200,-34,2010,0,1,665,0
San Antonio,26,26,19,29,0,0,0,0,Detroit,25,26,15,23,0,0,0,0,20110208,100,89,1,1,5,11,11,189,-11,2010,0,1,1238,0
Minnesota,27,29,27,29,0,0,0,0,Houston,29,24,32,23,0,0,0,0,20110208,112,108,-2,3,-2,4,4,220,-4,2010,0,1,1057,0
Indiana,29,37,31,15,0,0,0,0,Miami,33,30,27,27,0,0,0,0,20110208,112,117,4,-3,-7,5,5,229,5,2010,0,1,1026,0
Toronto,17,21,20,16,0,0,0,0,Milwaukee,24,16,26,26,0,0,0,0,20110208,74,92,7,2,8,18,18,166,18,2010,0,1,429,0
Memphis,24,20,30,21,10,0,0,0,Oklahoma City,27,27,17,24,6,0,0,0,20110208,105,101,-3,-10,3,0,4,206,-4,2010,1,1,421,0
LA Clippers,23,23,19,20,0,0,0,0,Orlando,21,21,24,35,0,0,0,0,20110208,85,101,-2,-4,1,16,16,186,16,2010,0,1,2197,0
Chicago,21,23,22,25,0,0,0,0,Utah,23,18,19,26,0,0,0,0,20110209,91,86,-2,3,6,5,5,177,-5,2010,0,2,1256,0
Dallas,20,36,18,28,0,0,0,0,Sacramento,28,19,26,27,0,0,0,0,20110209,102,100,-8,9,1,2,2,202,-2,2010,0,2,1437,0
Milwaukee,19,18,23,25,0,0,0,0,Washington,22,25,30,23,0,0,0,0,20110209,85,100,3,10,17,15,15,185,15,2010,0,2,634,0
Orlando,18,31,25,25,0,0,0,0,Philadelphia,27,20,22,26,0,0,0,0,20110209,99,95,-9,2,5,4,4,194,-4,2010,0,2,864,0
San Antonio,31,29,21,30,0,0,0,0,Toronto,29,27,28,16,0,0,0,0,20110209,111,100,2,4,-3,11,11,211,-11,2010,0,2,1438,0
New Orleans,27,15,29,20,10,0,0,0,Brooklyn,23,23,23,22,12,0,0,0,20110209,101,103,-4,4,-2,0,2,204,2,2010,1,2,1168,0
Charlotte,28,20,22,33,0,0,0,0,Indiana,29,29,23,23,0,0,0,0,20110209,103,104,1,10,11,1,1,207,1,2010,0,2,428,0
Denver,35,33,24,22,0,0,0,0,Golden State,34,36,30,16,0,0,0,0,20110209,114,116,-1,2,8,2,2,230,2,2010,0,2,947,0
Detroit,25,30,26,22,0,0,0,0,Cleveland,16,27,27,24,0,0,0,0,20110209,103,94,9,12,11,9,9,197,-9,2010,0,2,90,0
LA Clippers,28,30,30,28,0,0,0,0,New York,29,18,31,30,0,0,0,0,20110209,116,108,-1,11,10,8,8,224,-8,2010,0,2,2445,0
LA Lakers,20,25,27,20,0,0,0,0,Boston,27,26,15,18,0,0,0,0,20110210,92,86,-7,-8,4,6,6,178,-6,2010,0,3,2590,0
Dallas,19,39,34,28,0,0,0,0,Denver,33,26,29,33,0,0,0,0,20110210,120,121,14,1,-4,1,1,241,1,2010,0,3,661,0
Golden State,22,20,19,27,0,0,0,0,Phoenix,32,33,22,25,0,0,0,0,20110210,88,112,10,23,26,24,24,200,24,2010,0,3,652,0
Phoenix,19,25,27,24,0,0,0,0,Utah,31,25,13,14,0,0,0,0,20110211,95,83,-12,-12,2,12,12,178,-12,2010,0,4,505,0
Portland,23,32,17,30,0,0,0,0,Toronto,19,28,23,26,0,0,0,0,20110211,102,96,4,8,2,6,6,198,-6,2010,0,4,2108,0
San Antonio,22,24,12,13,0,0,0,0,Philadelphia,27,19,14,17,0,0,0,0,20110211,71,77,5,0,2,6,6,148,6,2010,0,4,1505,0
New Orleans,28,33,19,19,0,0,0,0,Orlando,24,28,28,13,0,0,0,0,20110211,99,93,4,9,0,6,6,192,-6,2010,0,4,533,0
LA Lakers,30,32,23,28,0,0,0,0,New York,28,20,20,28,0,0,0,0,20110211,113,96,2,14,17,17,17,209,-17,2010,0,4,2445,0
Milwaukee,17,23,28,18,0,0,0,0,Memphis,20,25,18,26,0,0,0,0,20110211,86,89,3,5,-5,3,3,175,3,2010,0,4,557,0
Miami,25,39,22,20,0,0,0,0,Detroit,21,22,22,27,0,0,0,0,20110211,106,92,4,21,21,14,14,198,-14,2010,0,4,1155,0
LA Clippers,33,20,28,29,9,0,0,0,Cleveland,29,23,31,27,16,0,0,0,20110211,119,126,-4,-1,2,0,7,245,7,2010,1,4,2044,0
Brooklyn,24,28,20,22,0,0,0,0,Charlotte,21,16,23,29,0,0,0,0,20110211,94,89,3,15,12,5,5,183,-5,2010,0,4,531,0
Minnesota,31,27,32,15,0,0,0,0,Indiana,31,25,27,33,0,0,0,0,20110211,105,116,0,-2,-7,11,11,221,11,2010,0,4,510,0
Oklahoma City,27,27,21,24,0,0,0,0,Sacramento,24,21,27,25,0,0,0,0,20110212,99,97,3,9,3,2,2,196,-2,2010,0,5,1336,0
Charlotte,27,12,29,20,0,0,0,0,Atlanta,27,25,20,14,0,0,0,0,20110212,88,86,0,-13,-4,2,2,174,-2,2010,0,5,226,0
Dallas,23,34,26,23,0,0,0,0,Houston,25,19,23,35,0,0,0,0,20110212,106,102,-2,13,16,4,4,208,-4,2010,0,5,225,0
Indiana,32,19,24,28,0,0,0,0,Milwaukee,29,20,23,25,0,0,0,0,20110212,103,97,3,2,3,6,6,200,-6,2010,0,5,243,0
Philadelphia,28,26,31,22,0,0,0,0,Minnesota,32,18,24,13,0,0,0,0,20110212,107,87,-4,4,11,20,20,194,-20,2010,0,5,983,0
New York,27,32,13,33,0,0,0,0,Brooklyn,21,33,14,27,0,0,0,0,20110212,105,95,6,5,4,10,10,200,-10,2010,0,5,0,0
Chicago,24,18,30,25,0,0,0,0,New Orleans,22,31,21,14,0,0,0,0,20110212,97,88,2,-11,-2,9,9,185,-9,2010,0,5,832,0
San Antonio,37,35,29,17,0,0,0,0,Washington,18,27,20,29,0,0,0,0,20110212,118,94,19,27,36,24,24,212,-24,2010,0,5,1385,0
LA Clippers,24,24,23,22,0,0,0,0,Toronto,24,24,30,20,0,0,0,0,20110213,93,98,0,0,7,5,5,191,5,2010,0,6,2170,0
Sacramento,30,20,28,35,0,0,0,0,Phoenix,32,25,24,27,0,0,0,0,20110213,113,108,-2,-7,-3,5,5,221,-5,2010,0,6,634,0
Denver,26,41,23,18,0,0,0,0,Memphis,31,24,27,34,0,0,0,0,20110213,108,116,5,-12,-8,8,8,224,8,2010,0,6,877,0
LA Lakers,21,20,19,15,0,0,0,0,Orlando,24,21,22,22,0,0,0,0,20110213,75,89,3,4,7,14,14,164,14,2010,0,6,2197,0
Portland,20,27,27,31,0,0,0,0,Detroit,21,28,21,30,0,0,0,0,20110213,105,100,-1,-2,4,5,5,205,-5,2010,0,6,1964,0
Oklahoma City,20,23,23,28,0,0,0,0,Golden State,23,24,27,26,0,0,0,0,20110213,94,100,3,4,8,6,6,194,6,2010,0,6,1386,0
Washington,35,33,27,20,0,0,0,0,Cleveland,23,23,33,21,0,0,0,0,20110213,115,100,12,22,16,15,15,215,-15,2010,0,6,304,0
Miami,20,23,18,21,0,0,0,0,Boston,15,24,35,11,0,0,0,0,20110213,82,85,-5,-4,13,3,3,167,3,2010,0,6,1257,0
LA Lakers,22,21,17,29,0,0,0,0,Charlotte,24,25,29,31,0,0,0,0,20110214,89,109,2,6,18,20,20,198,20,2010,0,0,2115,0
Atlanta,20,33,21,20,0,0,0,0,Detroit,27,24,17,11,0,0,0,0,20110214,94,79,-7,2,6,15,15,173,-15,2010,0,0,597,0
Denver,32,22,14,34,0,0,0,0,Houston,19,39,30,33,0,0,0,0,20110214,102,121,-13,4,20,19,19,223,19,2010,0,0,878,0
LA Clippers,17,28,20,13,0,0,0,0,Milwaukee,22,25,24,31,0,0,0,0,20110214,78,102,5,2,6,24,24,180,24,2010,0,0,1741,0
Portland,29,27,21,18,0,0,0,0,Minnesota,14,34,13,20,0,0,0,0,20110214,95,81,15,8,16,14,14,176,-14,2010,0,0,1423,0
San Antonio,27,32,21,22,0,0,0,0,Brooklyn,23,25,18,19,0,0,0,0,20110214,102,85,4,11,14,17,17,187,-17,2010,0,0,1581,0
Utah,27,26,20,28,0,0,0,0,Phoenix,29,21,26,26,0,0,0,0,20110215,101,102,2,-3,3,1,1,203,1,2010,0,1,505,0
Sacramento,24,26,25,21,0,0,0,0,Oklahoma City,37,31,32,26,0,0,0,0,20110215,96,126,13,18,25,30,30,222,30,2010,0,1,1336,0
Philadelphia,10,34,31,16,0,0,0,0,Memphis,26,29,22,25,0,0,0,0,20110215,91,102,16,11,2,11,11,193,11,2010,0,1,878,0
Charlotte,23,22,28,21,0,0,0,0,Chicago,29,23,26,28,0,0,0,0,20110215,94,106,6,7,5,12,12,200,12,2010,0,1,586,0
New Orleans,32,21,18,18,0,0,0,0,Golden State,22,36,25,19,0,0,0,0,20110215,89,102,-10,5,12,13,13,191,13,2010,0,1,1921,0
Miami,41,17,24,28,0,0,0,0,Indiana,19,35,29,20,0,0,0,0,20110215,110,103,22,4,-1,7,7,213,-7,2010,0,1,1026,0
Atlanta,19,26,20,25,0,0,0,0,New York,26,26,26,24,0,0,0,0,20110216,90,102,7,7,13,12,12,192,12,2010,0,2,745,0
Golden State,20,28,28,31,0,0,0,0,Utah,23,25,28,24,0,0,0,0,20110216,107,100,-3,0,0,7,7,207,-7,2010,0,2,599,0
New Orleans,26,23,27,20,0,0,0,0,Portland,35,13,22,33,0,0,0,0,20110216,96,103,9,-1,-6,7,7,199,7,2010,0,2,2059,0
Washington,18,21,16,21,0,0,0,0,Orlando,17,31,32,21,0,0,0,0,20110216,76,101,-1,9,25,25,25,177,25,2010,0,2,757,0
LA Clippers,23,20,29,26,0,0,0,0,Minnesota,20,22,20,28,0,0,0,0,20110216,98,90,3,1,10,8,8,188,-8,2010,0,2,1521,0
Miami,29,21,30,23,0,0,0,0,Toronto,27,19,26,23,0,0,0,0,20110216,103,95,2,4,8,8,8,198,-8,2010,0,2,1234,0
Philadelphia,23,32,31,28,0,0,0,0,Houston,23,29,26,27,0,0,0,0,20110216,114,105,0,3,8,9,9,219,-9,2010,0,2,1339,0
Indiana,22,33,23,26,5,0,0,0,Detroit,33,27,24,20,11,0,0,0,20110216,109,115,11,5,6,0,6,224,6,2010,1,2,240,0
Sacramento,25,23,28,24,0,0,0,0,Dallas,25,36,35,20,0,0,0,0,20110216,100,116,0,13,20,16,16,216,16,2010,0,2,1437,0
LA Lakers,21,25,25,28,0,0,0,0,Cleveland,29,22,23,30,0,0,0,0,20110216,99,104,8,5,3,5,5,203,5,2010,0,2,2044,0
Brooklyn,22,24,24,10,0,0,0,0,Boston,27,19,24,24,0,0,0,0,20110216,80,94,5,0,0,14,14,174,14,2010,0,2,190,0
Denver,27,19,25,23,0,0,0,0,Milwaukee,16,27,28,16,0,0,0,0,20110216,94,87,11,3,0,7,7,181,-7,2010,0,2,912,0
San Antonio,25,26,24,24,0,0,0,0,Chicago,30,28,25,26,0,0,0,0,20110217,99,109,5,7,8,10,10,208,10,2010,0,3,1050,0
Dallas,28,26,31,27,0,0,0,0,Phoenix,25,26,29,26,0,0,0,0,20110217,112,106,3,3,5,6,6,218,-6,2010,0,3,884,0
Indiana,25,33,32,23,0,0,0,0,Washington,30,19,19,28,0,0,0,0,20110222,113,96,-5,9,22,17,17,209,-17,2010,0,1,490,0
Minnesota,23,21,23,21,0,0,0,0,Milwaukee,26,18,23,27,0,0,0,0,20110222,88,94,3,0,0,6,6,182,6,2010,0,1,298,0
Sacramento,16,28,26,27,0,0,0,0,Miami,35,28,30,24,0,0,0,0,20110222,97,117,19,19,23,20,20,214,20,2010,0,1,2547,0
Atlanta,15,18,21,26,0,0,0,0,LA Lakers,28,26,26,24,0,0,0,0,20110222,80,104,13,21,26,24,24,184,24,2010,0,1,1932,0
LA Clippers,23,23,21,21,0,0,0,0,Oklahoma City,23,39,16,33,0,0,0,0,20110222,88,111,0,16,11,23,23,199,23,2010,0,1,1178,0
Houston,20,31,27,30,0,0,0,0,Detroit,28,23,24,25,0,0,0,0,20110222,108,100,-8,0,3,8,8,208,-8,2010,0,1,1105,0
Memphis,23,19,34,31,0,0,0,0,Denver,32,29,41,18,0,0,0,0,20110222,107,120,9,19,26,13,13,227,13,2010,0,1,877,0
Toronto,27,17,25,32,0,0,0,0,Charlotte,33,28,28,25,0,0,0,0,20110222,101,114,6,17,20,13,13,215,13,2010,0,1,585,0
Boston,31,29,28,27,0,0,0,0,Golden State,30,30,18,15,0,0,0,0,20110222,115,93,1,0,10,22,22,208,-22,2010,0,1,2692,0
Chicago,29,29,23,32,0,0,0,0,Toronto,25,30,30,33,0,0,0,0,20110223,113,118,-4,-3,4,5,5,231,5,2010,0,2,436,0
Oklahoma City,37,16,27,25,0,0,0,0,San Antonio,31,33,24,21,0,0,0,0,20110223,105,109,-6,11,8,4,4,214,4,2010,0,2,421,0
LA Lakers,23,18,26,20,19,0,0,0,Portland,29,18,22,18,14,0,0,0,20110223,106,101,-6,-6,-2,0,5,207,-5,2010,1,2,826,0
Atlanta,31,16,24,26,0,0,0,0,Phoenix,33,28,19,25,0,0,0,0,20110223,97,105,2,14,9,8,8,202,8,2010,0,2,1588,0
Washington,31,18,15,30,0,0,0,0,Philadelphia,24,30,34,29,0,0,0,0,20110223,94,117,-7,5,24,23,23,211,23,2010,0,2,123,0
Sacramento,31,27,21,32,0,0,0,0,Orlando,25,36,23,21,0,0,0,0,20110223,111,105,6,-3,-5,6,6,216,-6,2010,0,2,2390,0
Milwaukee,24,33,22,29,0,0,0,0,New York,33,26,27,28,0,0,0,0,20110223,108,114,9,2,7,6,6,222,6,2010,0,2,732,0
Memphis,26,28,22,28,0,0,0,0,Minnesota,18,24,26,27,0,0,0,0,20110223,104,95,8,12,8,9,9,199,-9,2010,0,2,700,0
Detroit,19,24,30,28,0,0,0,0,Indiana,26,25,27,24,0,0,0,0,20110223,101,102,7,8,5,1,1,203,1,2010,0,2,240,0
Utah,26,29,22,22,0,0,0,0,Dallas,23,36,29,30,0,0,0,0,20110223,99,118,-3,4,11,19,19,217,19,2010,0,2,998,0
Houston,28,33,30,33,0,0,0,0,Cleveland,27,38,23,31,0,0,0,0,20110223,124,119,1,-4,3,5,5,243,-5,2010,0,2,1113,0
LA Clippers,16,22,24,25,0,0,0,0,New Orleans,23,22,28,25,0,0,0,0,20110223,87,98,7,7,11,11,11,185,11,2010,0,2,1669,0
Boston,23,13,24,15,0,0,0,0,Denver,18,19,24,28,0,0,0,0,20110224,75,89,-5,1,1,14,14,164,14,2010,0,3,1765,0
Miami,31,22,14,22,0,0,0,0,Chicago,23,21,27,22,0,0,0,0,20110224,89,93,-8,-9,4,4,4,182,4,2010,0,3,1189,0
Denver,19,20,33,25,9,0,0,0,Portland,25,24,16,32,10,0,0,0,20110225,106,107,6,10,-7,0,1,213,1,2010,1,4,981,0
Oklahoma City,22,26,22,18,0,0,0,0,Orlando,28,31,21,31,0,0,0,0,20110225,88,111,6,11,10,23,23,199,23,2010,0,4,1057,0
Phoenix,35,25,26,24,0,0,0,0,Toronto,14,28,20,30,0,0,0,0,20110225,110,92,21,18,24,18,18,202,-18,2010,0,4,1885,0
Brooklyn,25,29,18,24,0,0,0,0,San Antonio,29,24,35,18,0,0,0,0,20110225,96,106,4,-1,16,10,10,202,10,2010,0,4,1581,0
New Orleans,35,20,24,16,0,0,0,0,Minnesota,26,17,18,20,0,0,0,0,20110225,95,81,9,12,18,14,14,176,-14,2010,0,4,1052,0
Detroit,22,27,26,19,0,0,0,0,Philadelphia,29,30,27,24,0,0,0,0,20110225,94,110,7,10,11,16,16,204,16,2010,0,4,441,0
LA Clippers,31,19,17,28,0,0,0,0,LA Lakers,30,22,33,23,0,0,0,0,20110225,95,108,-1,2,18,13,13,203,13,2010,0,4,0,0
Utah,24,19,22,30,0,0,0,0,Indiana,13,25,25,21,0,0,0,0,20110225,95,84,11,5,2,11,11,179,-11,2010,0,4,1353,0
Washington,25,36,23,29,0,0,0,0,Miami,20,43,25,33,0,0,0,0,20110225,113,121,-5,2,4,8,8,234,8,2010,0,4,924,0
Atlanta,29,26,26,14,0,0,0,0,Golden State,17,18,20,24,0,0,0,0,20110225,95,79,12,20,26,16,16,174,-16,2010,0,4,2135,0
New York,30,23,22,34,0,0,0,0,Cleveland,28,25,30,32,0,0,0,0,20110225,109,115,-2,0,8,6,6,224,6,2010,0,4,403,0
Sacramento,30,14,29,25,0,0,0,0,Charlotte,28,24,26,32,0,0,0,0,20110225,98,110,-2,8,5,12,12,208,12,2010,0,4,2239,0
Chicago,21,18,31,13,0,0,0,0,Milwaukee,25,14,20,16,0,0,0,0,20110226,83,75,-4,0,11,8,8,158,-8,2010,0,5,83,0
Sacramento,28,21,17,26,0,0,0,0,Memphis,23,33,33,31,0,0,0,0,20110226,92,120,-5,7,23,28,28,212,28,2010,0,5,1745,0
Dallas,23,36,19,27,0,0,0,0,Washington,22,27,23,27,0,0,0,0,20110226,105,99,1,10,6,6,6,204,-6,2010,0,5,1181,0
Brooklyn,33,25,24,26,0,0,0,0,Houston,37,34,28,24,0,0,0,0,20110226,108,123,4,13,17,15,15,231,15,2010,0,5,1417,0
Utah,28,25,31,32,0,0,0,0,Detroit,27,31,25,37,0,0,0,0,20110226,116,120,-1,5,-1,4,4,236,4,2010,0,5,1488,0
Boston,18,22,34,25,0,0,0,0,LA Clippers,26,21,21,24,0,0,0,0,20110226,99,92,-8,-7,6,7,7,191,-7,2010,0,5,2590,0
Philadelphia,22,27,26,20,0,0,0,0,Cleveland,23,20,21,27,0,0,0,0,20110227,95,91,-1,6,11,4,4,186,-4,2010,0,6,358,0
Phoenix,33,27,22,17,11,0,0,0,Indiana,29,22,21,27,9,0,0,0,20110227,110,108,4,9,10,0,2,218,-2,2010,1,6,1496,0
New York,23,29,13,26,0,0,0,0,Miami,34,17,15,20,0,0,0,0,20110227,91,86,-11,1,-1,5,5,177,-5,2010,0,6,1091,0
Golden State,41,32,16,34,0,0,0,0,Minnesota,32,37,35,22,0,0,0,0,20110227,123,126,-9,-4,15,3,3,249,3,2010,0,6,1581,0
Houston,21,19,22,29,0,0,0,0,New Orleans,27,28,17,17,0,0,0,0,20110227,91,89,-6,-15,-10,2,2,180,-2,2010,0,6,317,0
LA Lakers,22,29,21,18,0,0,0,0,Oklahoma City,28,28,13,18,0,0,0,0,20110227,90,87,-6,-5,3,3,3,177,-3,2010,0,6,1178,0
Charlotte,28,23,18,17,0,0,0,0,Orlando,30,29,21,20,0,0,0,0,20110227,86,100,2,8,11,14,14,186,14,2010,0,6,463,0
Atlanta,19,29,20,22,0,0,0,0,Portland,18,18,13,34,0,0,0,0,20110227,90,83,1,12,19,7,7,173,-7,2010,0,6,2168,0
Memphis,16,19,28,25,0,0,0,0,San Antonio,26,17,16,36,0,0,0,0,20110227,88,95,10,8,-4,7,7,183,7,2010,0,6,631,0
Dallas,24,26,25,39,0,0,0,0,Toronto,30,27,15,24,0,0,0,0,20110227,114,96,-6,-7,3,18,18,210,-18,2010,0,6,1201,0
Chicago,25,25,28,27,0,0,0,0,Washington,20,17,20,20,0,0,0,0,20110228,105,77,5,13,21,28,28,182,-28,2010,0,0,594,0
LA Clippers,29,23,31,16,0,0,0,0,Sacramento,29,22,27,27,0,0,0,0,20110228,99,105,0,-1,-5,6,6,204,6,2010,0,0,361,0
Boston,30,26,23,28,0,0,0,0,Utah,21,32,22,27,0,0,0,0,20110228,107,102,9,3,4,5,5,209,-5,2010,0,0,2093,0
Atlanta,25,22,23,20,0,0,0,0,Denver,21,25,25,29,0,0,0,0,20110228,90,100,-4,-1,1,10,10,190,10,2010,0,0,1209,0
Phoenix,26,26,17,27,8,0,0,0,Brooklyn,23,28,15,30,7,0,0,0,20110228,104,103,3,1,3,0,1,207,-1,2010,1,0,2139,0
Golden State,19,27,25,29,0,0,0,0,Indiana,29,14,37,29,0,0,0,0,20110301,100,109,10,-3,9,9,9,209,9,2010,0,1,1944,0
San Antonio,30,22,15,26,0,0,0,0,Memphis,32,29,22,26,0,0,0,0,20110301,93,109,2,9,16,16,16,202,16,2010,0,1,631,0
Detroit,22,28,25,15,0,0,0,0,Milwaukee,28,23,21,20,0,0,0,0,20110301,90,92,6,1,-3,2,2,182,2,2010,0,1,251,0
LA Lakers,18,22,25,25,0,0,0,0,Minnesota,21,24,16,18,0,0,0,0,20110301,90,79,-3,-5,4,11,11,169,-11,2010,0,1,1521,0
New York,21,37,26,26,0,0,0,0,Orlando,32,15,32,37,0,0,0,0,20110301,110,116,11,-11,-5,6,6,226,6,2010,0,1,939,0
Dallas,23,28,28,22,0,0,0,0,Philadelphia,22,22,33,16,0,0,0,0,20110301,101,93,1,7,2,8,8,194,-8,2010,0,1,1297,0
Houston,30,23,30,20,0,0,0,0,Portland,26,16,26,19,0,0,0,0,20110301,103,87,4,11,15,16,16,190,-16,2010,0,1,1833,0
New Orleans,20,22,20,28,0,0,0,0,Toronto,27,30,15,24,0,0,0,0,20110301,90,96,7,15,10,6,6,186,6,2010,0,1,1112,0
Charlotte,23,23,21,13,0,0,0,0,Denver,31,31,29,29,0,0,0,0,20110302,80,120,8,16,24,40,40,200,40,2010,0,2,1355,0
Golden State,32,30,29,15,0,0,0,0,Washington,33,20,21,28,0,0,0,0,20110302,106,102,-1,9,17,4,4,208,-4,2010,0,2,2435,0
Portland,30,31,18,28,0,0,0,0,Sacramento,29,24,20,29,0,0,0,0,20110302,107,102,1,8,6,5,5,209,-5,2010,0,2,483,0
Indiana,18,24,20,27,0,0,0,0,Oklahoma City,27,36,26,24,0,0,0,0,20110302,89,113,9,21,27,24,24,202,24,2010,0,2,688,0
New Orleans,25,17,20,26,0,0,0,0,New York,27,25,30,25,0,0,0,0,20110302,88,107,2,10,20,19,19,195,19,2010,0,2,1168,0
Phoenix,21,21,30,31,0,0,0,0,Boston,32,30,29,24,0,0,0,0,20110302,103,115,11,20,19,12,12,218,12,2010,0,2,2295,0
Minnesota,30,33,26,27,0,0,0,0,Detroit,32,29,24,20,0,0,0,0,20110302,116,105,-2,2,4,11,11,221,-11,2010,0,2,542,0
San Antonio,24,33,32,20,0,0,0,0,Cleveland,25,27,20,27,0,0,0,0,20110302,109,99,-1,5,17,10,10,208,-10,2010,0,2,1256,0
Chicago,28,22,13,17,0,0,0,0,Atlanta,19,14,25,25,0,0,0,0,20110302,80,83,-9,-17,-5,3,3,163,3,2010,0,2,587,0
Houston,21,33,15,34,0,0,0,0,LA Clippers,23,26,26,31,0,0,0,0,20110302,103,106,2,-5,6,3,3,209,3,2010,0,2,1371,0
Denver,30,28,16,29,0,0,0,0,Utah,23,28,25,25,0,0,0,0,20110303,103,101,7,7,-2,2,2,204,-2,2010,0,3,370,0
Orlando,22,23,26,28,0,0,0,0,Miami,30,33,17,16,0,0,0,0,20110303,99,96,-8,-18,-9,3,3,195,-3,2010,0,3,204,0
Chicago,21,28,16,24,0,0,0,0,Orlando,21,14,22,24,0,0,0,0,20110304,89,81,0,14,8,8,8,170,-8,2010,0,4,984,0
Cleveland,32,26,27,34,0,0,0,0,New York,32,32,24,27,0,0,0,0,20110304,119,115,0,-6,-3,4,4,234,-4,2010,0,4,403,0
Miami,12,38,22,23,0,0,0,0,San Antonio,36,26,32,31,0,0,0,0,20110304,95,125,24,12,22,30,30,220,30,2010,0,4,1147,0
Minnesota,31,18,29,22,0,0,0,0,Philadelphia,22,34,29,26,0,0,0,0,20110304,100,111,-9,7,7,11,11,211,11,2010,0,4,983,0
Toronto,23,28,30,22,0,0,0,0,Brooklyn,27,20,31,38,0,0,0,0,20110304,103,116,4,-4,-3,13,13,219,13,2010,0,4,341,0
New Orleans,20,25,27,26,0,0,0,0,Memphis,20,25,27,19,0,0,0,0,20110304,98,91,0,0,0,7,7,189,-7,2010,0,4,358,0
Charlotte,19,16,22,27,0,0,0,0,LA Lakers,29,16,24,23,0,0,0,0,20110304,84,92,10,10,12,8,8,176,8,2010,0,4,2115,0
Indiana,33,24,24,27,0,0,0,0,Dallas,35,33,22,26,0,0,0,0,20110304,108,116,2,11,9,8,8,224,8,2010,0,4,763,0
Golden State,27,26,28,22,0,0,0,0,Boston,32,32,24,19,0,0,0,0,20110304,103,107,5,11,7,4,4,210,4,2010,0,4,2692,0
Oklahoma City,31,25,27,28,0,0,0,0,Atlanta,26,25,22,31,0,0,0,0,20110304,111,104,5,5,10,7,7,215,-7,2010,0,4,755,0
Phoenix,22,23,31,26,0,0,0,0,Milwaukee,26,22,15,25,0,0,0,0,20110304,102,88,-4,-3,13,14,14,190,-14,2010,0,4,1462,0
Sacramento,29,20,23,23,7,0,0,0,Utah,30,27,15,23,14,0,0,0,20110305,102,109,1,8,0,0,7,211,7,2010,1,5,532,0
Indiana,18,31,19,27,0,0,0,0,Houston,29,36,29,18,0,0,0,0,20110305,95,112,11,16,26,17,17,207,17,2010,0,5,865,0
Denver,23,15,27,29,0,0,0,0,LA Clippers,30,18,23,29,0,0,0,0,20110305,94,100,7,10,6,6,6,194,6,2010,0,5,830,0
Toronto,30,32,26,22,9,7,10,0,Brooklyn,23,42,23,22,9,7,11,0,20110305,136,137,-7,3,0,0,1,273,1,2010,3,5,341,0
Charlotte,16,19,17,17,0,0,0,0,Portland,15,25,25,28,0,0,0,0,20110305,69,93,-1,5,13,24,24,162,24,2010,0,5,2284,0
Minnesota,29,20,23,24,0,0,0,0,Washington,25,26,17,35,0,0,0,0,20110305,96,103,-4,2,-4,7,7,199,7,2010,0,5,931,0
Phoenix,28,33,30,18,9,0,0,0,Oklahoma City,25,32,29,23,13,0,0,0,20110306,118,122,-3,-4,-5,0,4,240,4,2010,1,6,840,0
Boston,27,16,26,20,0,0,0,0,Milwaukee,26,23,16,18,0,0,0,0,20110306,89,83,1,-6,4,6,6,172,-6,2010,0,6,855,0
Chicago,18,22,23,24,0,0,0,0,Miami,22,27,16,21,0,0,0,0,20110306,87,86,-4,-9,-2,1,1,173,-1,2010,0,6,1189,0
New York,24,20,18,30,0,0,0,0,Atlanta,19,23,14,23,0,0,0,0,20110306,92,79,5,2,6,13,13,171,-13,2010,0,6,745,0
Memphis,21,17,41,25,0,0,0,0,Dallas,27,28,23,25,0,0,0,0,20110306,104,103,-6,-17,1,1,1,207,-1,2010,0,6,419,0
New Orleans,27,24,22,23,0,0,0,0,Cleveland,24,24,18,15,0,0,0,0,20110306,96,81,3,3,7,15,15,177,-15,2010,0,6,924,0
Golden State,25,31,24,26,11,0,0,0,Philadelphia,31,33,16,26,19,0,0,0,20110306,117,125,6,8,0,0,8,242,8,2010,1,6,2516,0
Washington,22,29,22,29,0,0,0,0,Detroit,29,31,22,31,0,0,0,0,20110306,102,113,7,9,9,11,11,215,11,2010,0,6,394,0
LA Lakers,34,31,16,18,0,0,0,0,San Antonio,13,24,15,31,0,0,0,0,20110306,99,83,21,28,29,16,16,182,-16,2010,0,6,1201,0
Portland,24,23,23,19,0,0,0,0,Orlando,19,24,23,19,0,0,0,0,20110307,89,85,5,4,4,4,4,174,-4,2010,0,0,2525,0
Houston,29,36,30,28,0,0,0,0,Sacramento,30,28,16,27,0,0,0,0,20110307,123,101,-1,7,21,22,22,224,-22,2010,0,0,1606,0
Utah,24,24,26,35,0,0,0,0,New York,40,26,36,29,0,0,0,0,20110307,109,131,16,18,28,22,22,240,22,2010,0,0,1967,0
Dallas,22,26,25,35,0,0,0,0,Minnesota,30,20,30,25,0,0,0,0,20110307,108,105,-8,-2,-7,3,3,213,-3,2010,0,0,863,0
Oklahoma City,24,22,27,28,0,0,0,0,Memphis,25,33,21,28,0,0,0,0,20110307,101,107,1,12,6,6,6,208,6,2010,0,0,421,0
New Orleans,23,20,17,17,0,0,0,0,Chicago,26,17,23,19,0,0,0,0,20110307,77,85,3,0,6,8,8,162,8,2010,0,0,832,0
LA Clippers,27,22,22,21,0,0,0,0,Charlotte,26,21,20,20,0,0,0,0,20110307,92,87,1,2,4,5,5,179,-5,2010,0,0,2115,0
LA Lakers,27,30,24,20,0,0,0,0,Atlanta,25,24,16,22,0,0,0,0,20110308,101,87,2,8,16,14,14,188,-14,2010,0,1,1932,0
Golden State,18,29,29,19,0,0,0,0,Cleveland,30,16,19,20,0,0,0,0,20110308,95,85,-12,1,11,10,10,180,-10,2010,0,1,2161,0
Philadelphia,34,31,19,26,0,0,0,0,Indiana,23,30,17,30,0,0,0,0,20110308,110,100,11,12,14,10,10,210,-10,2010,0,1,582,0
Portland,25,32,20,28,0,0,0,0,Miami,25,26,24,21,0,0,0,0,20110308,105,96,0,6,2,9,9,201,-9,2010,0,1,2704,0
Houston,26,24,32,28,0,0,0,0,Phoenix,24,24,31,34,0,0,0,0,20110308,110,113,-2,-2,-3,3,3,223,3,2010,0,1,1014,0
Milwaukee,22,29,24,20,0,0,0,0,Washington,21,15,16,24,0,0,0,0,20110308,95,76,1,15,23,19,19,171,-19,2010,0,1,634,0
Utah,31,21,18,26,0,0,0,0,Toronto,26,24,26,18,0,0,0,0,20110309,96,94,5,2,-6,2,2,190,-2,2010,0,2,1664,0
Detroit,26,26,23,29,0,0,0,0,San Antonio,40,27,21,23,0,0,0,0,20110309,104,111,14,15,13,7,7,215,7,2010,0,2,1238,0
Orlando,29,27,20,30,0,0,0,0,Sacramento,33,26,20,23,0,0,0,0,20110309,106,102,-4,-3,-3,4,4,208,-4,2010,0,2,2390,0
Oklahoma City,28,27,27,19,9,0,0,0,Philadelphia,34,21,25,21,4,0,0,0,20110309,110,105,-6,0,2,0,5,215,-5,2010,1,2,1256,0
Dallas,16,30,24,22,0,0,0,0,New Orleans,16,27,17,33,0,0,0,0,20110309,92,93,0,-3,-10,1,1,185,1,2010,0,2,442,0
New York,30,31,35,14,0,0,0,0,Memphis,27,26,29,26,0,0,0,0,20110309,110,108,3,8,14,2,2,218,-2,2010,0,2,953,0
Indiana,19,21,16,19,0,0,0,0,Minnesota,27,23,29,22,0,0,0,0,20110309,75,101,8,10,23,26,26,176,26,2010,0,2,510,0
Cleveland,27,22,18,23,0,0,0,0,Milwaukee,23,39,26,22,0,0,0,0,20110309,90,110,-4,13,21,20,20,200,20,2010,0,2,334,0
Chicago,27,25,23,26,0,0,0,0,Charlotte,24,25,20,15,0,0,0,0,20110309,101,84,3,3,6,17,17,185,-17,2010,0,2,586,0
LA Clippers,30,30,16,32,0,0,0,0,Boston,17,25,24,37,0,0,0,0,20110309,108,103,13,18,10,5,5,211,-5,2010,0,2,2590,0
Golden State,22,27,28,13,0,0,0,0,Brooklyn,29,22,23,20,0,0,0,0,20110309,90,94,7,2,-3,4,4,184,4,2010,0,2,2565,0
Denver,30,29,31,26,0,0,0,0,Phoenix,25,24,17,31,0,0,0,0,20110310,116,97,5,10,24,19,19,213,-19,2010,0,3,585,0
New York,21,30,34,24,0,0,0,0,Dallas,31,41,27,28,0,0,0,0,20110310,109,127,10,21,14,18,18,236,18,2010,0,3,1370,0
LA Lakers,26,27,17,18,0,0,0,0,Miami,29,26,13,26,0,0,0,0,20110310,88,94,3,2,-2,6,6,182,6,2010,0,3,2335,0
Boston,22,23,23,18,0,0,0,0,Philadelphia,25,24,23,17,0,0,0,0,20110311,86,89,3,4,4,3,3,175,3,2010,0,4,270,0
Detroit,26,24,25,19,0,0,0,0,Oklahoma City,22,33,31,18,0,0,0,0,20110311,94,104,-4,5,11,10,10,198,10,2010,0,4,909,0
Sacramento,20,26,25,32,0,0,0,0,San Antonio,22,30,23,33,0,0,0,0,20110311,103,108,2,6,4,5,5,211,5,2010,0,4,1456,0
LA Clippers,26,25,16,27,4,0,0,0,Brooklyn,14,23,31,26,8,0,0,0,20110311,98,102,-12,-14,1,0,4,200,4,2010,1,4,2445,0
Indiana,27,21,25,25,0,0,0,0,Toronto,32,30,21,25,0,0,0,0,20110311,98,108,5,14,10,10,10,206,10,2010,0,4,438,0
Orlando,27,29,25,20,19,0,0,0,Golden State,20,22,30,29,22,0,0,0,20110311,120,123,-7,-14,-9,0,3,243,3,2010,1,4,2437,0
Atlanta,20,30,10,16,0,0,0,0,Chicago,22,26,24,22,0,0,0,0,20110311,76,94,2,-2,12,18,18,170,18,2010,0,4,587,0
Portland,25,20,25,22,0,0,0,0,Charlotte,22,23,19,33,0,0,0,0,20110311,92,97,-3,0,-6,5,5,189,5,2010,0,4,2284,0
Utah,28,29,15,29,0,0,0,0,Minnesota,39,27,31,25,0,0,0,0,20110311,101,122,11,9,25,21,21,223,21,2010,0,4,984,0
LA Clippers,38,26,27,31,0,0,0,0,Washington,27,28,18,28,0,0,0,0,20110312,122,101,11,9,18,21,21,223,-21,2010,0,5,2294,0
Philadelphia,25,16,16,17,0,0,0,0,Milwaukee,26,33,21,22,0,0,0,0,20110312,74,102,1,18,23,28,28,176,28,2010,0,5,692,0
Memphis,22,15,23,25,0,0,0,0,Miami,28,27,29,34,0,0,0,0,20110312,85,118,6,18,24,33,33,203,33,2010,0,5,873,0
San Antonio,36,23,22,34,0,0,0,0,Houston,25,24,33,25,0,0,0,0,20110312,115,107,11,10,-1,8,8,222,-8,2010,0,5,189,0
Sacramento,24,33,28,18,0,0,0,0,New Orleans,31,26,27,31,0,0,0,0,20110312,103,115,7,0,-1,12,12,218,12,2010,0,5,1879,0
LA Lakers,22,28,23,23,0,0,0,0,Dallas,21,23,21,26,0,0,0,0,20110312,96,91,1,6,8,5,5,187,-5,2010,0,5,1237,0
Utah,17,24,30,29,0,0,0,0,Chicago,37,31,20,30,0,0,0,0,20110312,100,118,20,27,17,18,18,218,18,2010,0,5,1256,0
Portland,18,20,16,28,0,0,0,0,Atlanta,19,16,27,29,0,0,0,0,20110312,82,91,1,-3,8,9,9,173,9,2010,0,5,2168,0
Detroit,28,32,14,27,0,0,0,0,Denver,33,33,27,38,0,0,0,0,20110312,101,131,5,6,19,30,30,232,30,2010,0,5,1154,0
Milwaukee,9,13,16,18,0,0,0,0,Boston,20,19,21,27,0,0,0,0,20110313,56,87,11,17,22,31,31,143,31,2010,0,6,855,0
Oklahoma City,29,21,25,20,0,0,0,0,Cleveland,14,24,18,19,0,0,0,0,20110313,95,75,15,12,19,20,20,170,-20,2010,0,6,949,0
Minnesota,23,21,15,18,0,0,0,0,Golden State,26,23,26,25,0,0,0,0,20110313,77,100,3,5,16,23,23,177,23,2010,0,6,1581,0
Indiana,29,25,31,21,0,0,0,0,New York,21,25,26,21,0,0,0,0,20110313,106,93,8,8,13,13,13,199,-13,2010,0,6,643,0
Orlando,32,29,26,24,0,0,0,0,Phoenix,26,26,13,23,0,0,0,0,20110313,111,88,6,9,22,23,23,199,-23,2010,0,6,1842,0
Charlotte,24,26,26,19,0,0,0,0,Toronto,22,25,24,19,0,0,0,0,20110313,95,90,2,3,5,5,5,185,-5,2010,0,6,585,0
Denver,23,35,36,20,0,0,0,0,New Orleans,21,24,30,28,0,0,0,0,20110314,114,103,2,13,19,11,11,217,-11,2010,0,0,1079,0
Oklahoma City,33,35,27,21,0,0,0,0,Washington,24,23,23,19,0,0,0,0,20110314,116,89,9,21,25,27,27,205,-27,2010,0,0,1149,0
Philadelphia,23,19,27,34,4,0,0,0,Utah,28,32,22,21,9,0,0,0,20110314,107,112,5,18,13,0,5,219,5,2010,1,0,1920,0
Boston,23,15,23,18,0,0,0,0,Brooklyn,14,22,31,21,0,0,0,0,20110314,79,88,-9,-2,6,9,9,167,9,2010,0,0,190,0
Golden State,20,39,25,35,0,0,0,0,Sacramento,35,36,36,22,0,0,0,0,20110314,119,129,15,12,23,10,10,248,10,2010,0,0,75,0
LA Clippers,20,16,20,26,0,0,0,0,Memphis,21,29,28,27,0,0,0,0,20110314,82,105,1,14,22,23,23,187,23,2010,0,0,1599,0
Orlando,25,21,20,18,0,0,0,0,LA Lakers,19,22,30,26,0,0,0,0,20110314,84,97,-6,-5,5,13,13,181,13,2010,0,0,2197,0
Phoenix,16,26,22,29,0,0,0,0,Houston,27,23,24,21,0,0,0,0,20110314,93,95,11,8,10,2,2,188,2,2010,0,0,1014,0
San Antonio,19,20,24,17,0,0,0,0,Miami,22,27,28,33,0,0,0,0,20110314,80,110,3,10,14,30,30,190,30,2010,0,0,1147,0
Milwaukee,17,22,16,30,0,0,0,0,Atlanta,28,27,29,26,0,0,0,0,20110315,85,110,11,16,29,25,25,195,25,2010,0,1,669,0
Washington,19,27,14,19,0,0,0,0,Chicago,31,19,25,23,0,0,0,0,20110315,79,98,12,4,15,19,19,177,19,2010,0,1,594,0
New York,27,27,28,35,0,0,0,0,Indiana,29,28,30,32,0,0,0,0,20110315,117,119,2,3,5,2,2,236,2,2010,0,1,643,0
Dallas,32,24,24,21,0,0,0,0,Portland,29,24,29,22,0,0,0,0,20110315,101,104,-3,-3,2,3,3,205,3,2010,0,1,1630,0
Minnesota,32,18,30,24,0,0,0,0,Utah,35,36,21,27,0,0,0,0,20110316,104,119,3,21,12,15,15,223,15,2010,0,2,984,0
Cleveland,18,27,28,24,0,0,0,0,Sacramento,28,23,23,19,0,0,0,0,20110316,97,93,-10,-6,-1,4,4,190,-4,2010,0,2,2096,0
Phoenix,29,17,19,30,0,0,0,0,New Orleans,31,25,21,23,0,0,0,0,20110316,95,100,2,10,12,5,5,195,5,2010,0,2,1312,0
Orlando,23,23,15,18,14,0,0,0,Milwaukee,14,23,27,15,10,0,0,0,20110316,93,89,9,9,-3,0,4,182,-4,2010,1,2,1065,0
Oklahoma City,24,22,21,29,0,0,0,0,Miami,18,27,17,23,0,0,0,0,20110316,96,85,6,1,5,11,11,181,-11,2010,0,2,1225,0
Philadelphia,24,25,30,25,0,0,0,0,LA Clippers,24,22,19,29,0,0,0,0,20110316,104,94,0,3,14,10,10,198,-10,2010,0,2,2388,0
Dallas,25,28,28,31,0,0,0,0,Golden State,34,25,22,25,0,0,0,0,20110316,112,106,-9,-6,0,6,6,218,-6,2010,0,2,1480,0
Toronto,24,28,24,17,0,0,0,0,Detroit,38,25,24,20,0,0,0,0,20110316,93,107,14,11,11,14,14,200,14,2010,0,2,205,0
Indiana,20,20,20,20,0,0,0,0,Boston,15,32,27,18,0,0,0,0,20110316,80,92,-5,7,14,12,12,172,12,2010,0,2,805,0
Denver,17,29,26,30,0,0,0,0,Atlanta,20,22,21,24,0,0,0,0,20110316,102,87,-3,4,9,15,15,189,-15,2010,0,2,1209,0
Charlotte,22,17,18,21,0,0,0,0,Houston,29,20,19,26,0,0,0,0,20110316,78,94,7,10,11,16,16,172,16,2010,0,2,925,0
Chicago,24,19,17,24,0,0,0,0,Brooklyn,20,16,14,23,0,0,0,0,20110317,84,73,4,7,10,11,11,157,-11,2010,0,3,711,0
Memphis,29,22,23,25,0,0,0,0,New York,29,30,33,28,0,0,0,0,20110317,99,120,0,8,18,21,21,219,21,2010,0,3,953,0
Cleveland,12,22,11,25,0,0,0,0,Portland,37,27,25,22,0,0,0,0,20110317,70,111,25,30,44,41,41,181,41,2010,0,3,2049,0
Charlotte,18,25,22,17,0,0,0,0,Oklahoma City,26,19,29,25,0,0,0,0,20110318,82,99,8,2,9,17,17,181,17,2010,0,4,938,0
Washington,27,26,24,30,0,0,0,0,Toronto,33,29,26,28,0,0,0,0,20110318,107,116,6,9,11,9,9,223,9,2010,0,4,349,0
Golden State,20,18,27,32,0,0,0,0,Phoenix,27,23,34,24,0,0,0,0,20110318,97,108,7,12,19,11,11,205,11,2010,0,4,652,0
Denver,21,21,18,22,0,0,0,0,Orlando,18,29,17,21,0,0,0,0,20110318,82,85,-3,5,4,3,3,167,3,2010,0,4,1548,0
Brooklyn,26,28,19,22,0,0,0,0,Milwaukee,29,23,28,30,0,0,0,0,20110318,95,110,3,-2,7,15,15,205,15,2010,0,4,732,0
Philadelphia,32,23,25,22,0,0,0,0,Sacramento,23,15,16,26,0,0,0,0,20110318,102,80,9,17,26,22,22,182,-22,2010,0,4,2451,0
Chicago,21,27,25,29,6,0,0,0,Indiana,31,31,27,13,13,0,0,0,20110318,108,115,10,14,16,0,7,223,7,2010,1,4,163,0
Boston,22,18,16,21,0,0,0,0,Houston,28,34,19,12,0,0,0,0,20110318,77,93,6,22,25,16,16,170,16,2010,0,4,1603,0
New York,25,28,25,17,0,0,0,0,Detroit,26,29,15,29,0,0,0,0,20110318,95,99,1,2,-8,4,4,194,4,2010,0,4,480,0
San Antonio,30,20,23,24,0,0,0,0,Dallas,20,25,21,25,0,0,0,0,20110318,97,91,10,5,7,6,6,188,-6,2010,0,4,252,0
Miami,25,25,36,20,0,0,0,0,Atlanta,21,16,20,28,0,0,0,0,20110318,106,85,4,13,29,21,21,191,-21,2010,0,4,605,0
Minnesota,27,24,23,24,0,0,0,0,LA Lakers,21,28,29,28,0,0,0,0,20110318,98,106,-6,-2,4,8,8,204,8,2010,0,4,1521,0
Cleveland,28,22,28,14,0,0,0,0,LA Clippers,25,29,28,18,0,0,0,0,20110319,92,100,-3,4,4,8,8,192,8,2010,0,5,2044,0
Indiana,20,21,19,18,0,0,0,0,Memphis,27,31,18,23,0,0,0,0,20110319,78,99,7,17,16,21,21,177,21,2010,0,5,383,0
Denver,21,26,24,27,0,0,0,0,Miami,29,27,23,24,0,0,0,0,20110319,98,103,8,9,8,5,5,201,5,2010,0,5,1724,0
Boston,14,26,27,22,0,0,0,0,New Orleans,28,23,13,21,0,0,0,0,20110319,89,85,-14,-11,3,4,4,174,-4,2010,0,5,1358,0
Philadelphia,27,27,29,18,0,0,0,0,Portland,36,26,25,23,0,0,0,0,20110319,101,110,9,8,4,9,9,211,9,2010,0,5,2405,0
Charlotte,13,28,27,30,0,0,0,0,San Antonio,24,34,32,19,0,0,0,0,20110319,98,109,11,17,22,11,11,207,11,2010,0,5,1103,0
Brooklyn,35,21,12,24,0,0,0,0,Washington,23,20,28,27,0,0,0,0,20110320,92,98,-12,-13,3,6,6,190,6,2010,0,6,204,0
Toronto,25,23,28,19,0,0,0,0,Oklahoma City,22,22,22,27,0,0,0,0,20110320,95,93,3,4,10,2,2,188,-2,2010,0,6,1114,0
Sacramento,28,29,28,42,0,0,0,0,Minnesota,23,25,27,20,0,0,0,0,20110320,127,95,5,9,10,32,32,222,-32,2010,0,6,1511,0
New York,9,32,31,23,0,0,0,0,Milwaukee,32,15,28,25,0,0,0,0,20110320,95,100,23,6,3,5,5,195,5,2010,0,6,732,0
Utah,19,28,28,33,0,0,0,0,Houston,30,25,22,33,0,0,0,0,20110320,108,110,11,8,2,2,2,218,2,2010,0,6,1199,0
Phoenix,27,27,27,27,0,0,0,0,LA Clippers,23,26,29,21,0,0,0,0,20110320,108,99,4,5,3,9,9,207,-9,2010,0,6,356,0
Golden State,23,20,20,10,0,0,0,0,Dallas,31,20,25,25,0,0,0,0,20110320,73,101,8,8,13,28,28,174,28,2010,0,6,1480,0
Detroit,17,33,24,22,0,0,0,0,Atlanta,21,34,24,25,0,0,0,0,20110320,96,104,4,5,5,8,8,200,8,2010,0,6,597,0
Portland,20,28,18,14,0,0,0,0,LA Lakers,27,17,18,22,0,0,0,0,20110320,80,84,7,-4,-4,4,4,164,4,2010,0,6,826,0
Golden State,21,24,24,27,0,0,0,0,San Antonio,32,22,32,25,0,0,0,0,20110321,96,111,11,9,17,15,15,207,15,2010,0,0,1487,0
Sacramento,28,19,25,20,0,0,0,0,Chicago,34,30,34,34,0,0,0,0,20110321,92,132,6,17,26,40,40,224,40,2010,0,0,1788,0
Orlando,30,26,24,17,0,0,0,0,Cleveland,15,23,20,28,0,0,0,0,20110321,97,86,15,18,22,11,11,183,-11,2010,0,0,895,0
Toronto,23,21,28,18,0,0,0,0,Denver,36,36,29,22,0,0,0,0,20110321,90,123,13,28,29,33,33,213,33,2010,0,0,1341,0
Utah,21,21,23,20,0,0,0,0,Memphis,29,25,26,23,0,0,0,0,20110321,85,103,8,12,15,18,18,188,18,2010,0,0,1247,0
Indiana,15,25,29,33,0,0,0,0,Brooklyn,19,25,17,37,0,0,0,0,20110321,102,98,-4,-4,8,4,4,200,-4,2010,0,0,643,0
Boston,22,15,26,33,0,0,0,0,New York,25,26,18,17,0,0,0,0,20110321,96,86,-3,-14,-6,10,10,182,-10,2010,0,0,190,0
Phoenix,31,29,26,26,9,9,7,0,LA Lakers,27,39,29,17,9,9,9,0,20110322,137,139,-4,6,9,0,2,276,2,2010,3,1,356,0
Washington,29,16,14,17,0,0,0,0,Portland,35,27,29,20,0,0,0,0,20110322,76,111,6,17,32,35,35,187,35,2010,0,1,2347,0
Chicago,31,41,26,16,0,0,0,0,Atlanta,21,22,17,21,0,0,0,0,20110322,114,81,10,29,38,33,33,195,-33,2010,0,1,587,0
Orlando,28,27,24,32,0,0,0,0,New York,25,34,19,21,0,0,0,0,20110323,111,99,3,-4,1,12,12,210,-12,2010,0,2,939,0
Memphis,20,24,23,23,0,0,0,0,Boston,15,30,25,17,0,0,0,0,20110323,90,87,5,-1,-3,3,3,177,-3,2010,0,2,1134,0
Indiana,23,31,33,24,0,0,0,0,Charlotte,28,25,19,16,0,0,0,0,20110323,111,88,-5,1,15,23,23,199,-23,2010,0,2,428,0
Brooklyn,17,22,23,20,16,0,0,0,Cleveland,22,20,20,20,12,0,0,0,20110323,98,94,-5,-3,0,0,4,192,-4,2010,1,2,403,0
San Antonio,34,35,24,19,0,0,0,0,Denver,24,40,26,25,0,0,0,0,20110323,112,115,-10,-5,-3,3,3,227,3,2010,0,2,802,0
Miami,21,32,20,27,0,0,0,0,Detroit,27,28,26,13,0,0,0,0,20110323,100,94,-6,-2,-8,6,6,194,-6,2010,0,2,1155,0
Golden State,33,24,28,27,0,0,0,0,Houston,36,30,34,31,0,0,0,0,20110323,112,131,3,9,15,19,19,243,19,2010,0,2,1642,0
Washington,21,28,28,25,11,6,0,0,LA Clippers,33,25,17,27,11,14,0,0,20110323,119,127,12,9,-2,0,8,246,8,2010,2,2,2294,0
Sacramento,25,28,22,22,0,0,0,0,Milwaukee,32,24,18,16,0,0,0,0,20110323,97,90,-7,-3,1,7,7,187,-7,2010,0,2,1771,0
Utah,25,20,24,25,0,0,0,0,Oklahoma City,32,18,28,28,0,0,0,0,20110323,94,106,7,5,9,12,12,200,12,2010,0,2,861,0
Atlanta,28,31,21,20,0,0,0,0,Philadelphia,30,23,21,31,0,0,0,0,20110323,100,105,2,-6,-6,5,5,205,5,2010,0,2,665,0
Toronto,32,29,25,20,0,0,0,0,Phoenix,26,29,31,28,0,0,0,0,20110323,106,114,-6,-6,0,8,8,220,8,2010,0,2,1885,0
New Orleans,27,29,22,27,16,0,0,0,Utah,32,22,24,27,12,0,0,0,20110324,121,117,-5,2,0,0,4,238,-4,2010,1,3,1432,0
Minnesota,23,24,25,24,0,0,0,0,Dallas,17,32,27,28,0,0,0,0,20110324,96,104,-6,2,4,8,8,200,8,2010,0,3,863,0
Philadelphia,27,23,32,17,0,0,0,0,Miami,20,31,26,34,0,0,0,0,20110325,99,111,-7,1,-5,12,12,210,12,2010,0,4,1021,0
Minnesota,27,26,29,21,0,0,0,0,Oklahoma City,30,34,24,23,0,0,0,0,20110325,103,111,3,11,6,8,8,214,8,2010,0,4,694,0
Milwaukee,35,23,24,20,0,0,0,0,New York,24,27,26,19,0,0,0,0,20110325,102,96,11,7,5,6,6,198,-6,2010,0,4,732,0
Brooklyn,20,18,25,22,0,0,0,0,Orlando,25,23,18,29,0,0,0,0,20110325,85,95,5,10,3,10,10,180,10,2010,0,4,939,0
LA Clippers,23,25,32,24,0,0,0,0,LA Lakers,33,24,28,27,0,0,0,0,20110325,104,112,10,9,5,8,8,216,8,2010,0,4,0,0
Charlotte,19,18,16,30,0,0,0,0,Boston,25,17,24,15,0,0,0,0,20110325,83,81,-6,-5,-13,2,2,164,-2,2010,0,4,720,0
Toronto,36,22,16,26,0,0,0,0,Golden State,45,39,32,22,0,0,0,0,20110325,100,138,9,26,42,38,38,238,38,2010,0,4,2263,0
Washington,16,29,22,27,0,0,0,0,Denver,30,34,18,32,0,0,0,0,20110325,94,114,14,19,15,20,20,208,20,2010,0,4,1489,0
Detroit,24,27,17,23,0,0,0,0,Cleveland,26,26,23,22,0,0,0,0,20110325,91,97,2,1,7,6,6,188,6,2010,0,4,90,0
Memphis,22,24,27,23,0,0,0,0,Chicago,21,28,25,25,0,0,0,0,20110325,96,99,-1,3,1,3,3,195,3,2010,0,4,480,0
New Orleans,21,29,23,33,0,0,0,0,Phoenix,27,29,22,22,0,0,0,0,20110325,106,100,-6,-6,-5,6,6,206,-6,2010,0,4,1312,0
Sacramento,22,33,30,25,0,0,0,0,Indiana,18,19,31,25,0,0,0,0,20110325,110,93,4,18,17,17,17,203,-17,2010,0,4,1882,0
San Antonio,28,21,21,26,0,0,0,0,Portland,24,23,26,25,0,0,0,0,20110325,96,98,-4,-2,3,2,2,194,2,2010,0,4,1718,0
Chicago,21,23,25,26,0,0,0,0,Milwaukee,25,23,26,13,0,0,0,0,20110326,95,87,-4,-4,-5,8,8,182,-8,2010,0,5,83,0
Dallas,20,23,15,36,0,0,0,0,Utah,22,25,13,17,0,0,0,0,20110326,94,77,-2,-4,-2,17,17,171,-17,2010,0,5,998,0
Toronto,21,23,29,17,0,0,0,0,LA Clippers,18,25,23,28,0,0,0,0,20110326,90,94,-3,-1,-7,4,4,184,4,2010,0,5,2170,0
New York,31,20,28,27,0,0,0,0,Charlotte,30,34,28,22,0,0,0,0,20110326,106,114,-1,13,13,8,8,220,8,2010,0,5,531,0
Indiana,25,22,18,23,0,0,0,0,Detroit,26,22,29,23,0,0,0,0,20110326,88,100,1,1,12,12,12,188,12,2010,0,5,240,0
Brooklyn,15,16,30,26,0,0,0,0,Atlanta,32,25,25,16,0,0,0,0,20110326,87,98,17,26,21,11,11,185,11,2010,0,5,745,0
Atlanta,21,31,22,25,0,0,0,0,Cleveland,18,21,27,17,0,0,0,0,20110327,99,83,3,13,8,16,16,182,-16,2010,0,6,555,0
Washington,36,31,17,20,0,0,0,0,Golden State,35,29,26,24,0,0,0,0,20110327,104,114,-1,-3,6,10,10,218,10,2010,0,6,2435,0
New Orleans,19,22,22,21,0,0,0,0,LA Lakers,30,27,17,28,0,0,0,0,20110327,84,102,11,16,11,18,18,186,18,2010,0,6,1669,0
San Antonio,23,27,27,27,0,0,0,0,Memphis,24,31,26,30,0,0,0,0,20110327,104,111,1,5,4,7,7,215,7,2010,0,6,631,0
Houston,37,31,25,26,0,0,0,0,Miami,38,33,22,32,0,0,0,0,20110327,119,125,1,3,0,6,6,244,6,2010,0,6,966,0
Boston,32,15,17,21,0,0,0,0,Minnesota,13,21,28,20,0,0,0,0,20110327,85,82,19,13,2,3,3,167,-3,2010,0,6,1120,0
Portland,20,21,31,18,0,0,0,0,Oklahoma City,21,34,23,21,0,0,0,0,20110327,90,99,1,14,6,9,9,189,9,2010,0,6,1484,0
Sacramento,18,26,30,26,14,0,0,0,Philadelphia,27,22,22,29,11,0,0,0,20110327,114,111,-9,-5,3,0,3,225,-3,2010,1,6,2451,0
Dallas,17,27,21,26,0,0,0,0,Phoenix,26,23,18,16,0,0,0,0,20110327,91,83,-9,-5,-2,8,8,174,-8,2010,0,6,884,0
Washington,16,35,22,12,15,0,0,0,Utah,21,22,20,22,10,0,0,0,20110328,100,95,-5,8,10,0,5,195,-5,2010,1,0,1841,0
Portland,28,30,9,33,0,0,0,0,San Antonio,22,29,21,20,0,0,0,0,20110328,100,92,6,7,-5,8,8,192,-8,2010,0,0,1718,0
Orlando,18,26,29,27,6,0,0,0,New York,18,30,27,25,13,0,0,0,20110328,106,113,0,4,2,0,7,219,7,2010,1,0,939,0
Boston,33,16,36,15,0,0,0,0,Indiana,27,30,24,26,0,0,0,0,20110328,100,107,-6,8,-4,7,7,207,7,2010,0,0,805,0
Philadelphia,27,26,16,28,0,0,0,0,Chicago,13,24,27,21,0,0,0,0,20110328,97,85,14,16,5,12,12,182,-12,2010,0,0,664,0
Milwaukee,26,20,26,14,0,0,0,0,Charlotte,27,18,20,22,0,0,0,0,20110328,86,87,1,-1,-7,1,1,173,1,2010,0,0,658,0
Miami,24,18,28,20,0,0,0,0,Cleveland,24,29,22,27,0,0,0,0,20110329,90,102,0,11,5,12,12,192,12,2010,0,1,1089,0
Houston,34,27,22,29,0,0,0,0,Brooklyn,21,22,20,24,0,0,0,0,20110329,112,87,13,18,20,25,25,199,-25,2010,0,1,1417,0
Golden State,29,21,27,29,8,0,0,0,Oklahoma City,25,33,20,28,9,0,0,0,20110329,114,115,-4,8,1,0,1,229,1,2010,1,1,1386,0
Phoenix,34,27,32,20,0,0,0,0,Sacramento,30,29,26,31,0,0,0,0,20110329,113,116,-4,-2,-8,3,3,229,3,2010,0,1,634,0
Miami,32,31,25,35,0,0,0,0,Washington,29,23,29,26,0,0,0,0,20110330,123,107,3,11,7,16,16,230,-16,2010,0,2,924,0
Milwaukee,22,30,24,28,0,0,0,0,Toronto,28,21,27,22,0,0,0,0,20110330,104,98,-6,3,0,6,6,202,-6,2010,0,2,429,0
Oklahoma City,33,22,24,37,0,0,0,0,Phoenix,28,23,22,25,0,0,0,0,20110330,116,98,5,4,6,18,18,214,-18,2010,0,2,840,0
Houston,33,22,27,15,0,0,0,0,Philadelphia,31,21,32,24,0,0,0,0,20110330,97,108,-2,-3,2,11,11,205,11,2010,0,2,1339,0
Brooklyn,36,32,24,24,0,0,0,0,New York,30,28,33,29,0,0,0,0,20110330,116,120,-6,-10,-1,4,4,236,4,2010,0,2,0,0
Portland,31,19,20,21,0,0,0,0,New Orleans,25,23,20,27,0,0,0,0,20110330,91,95,-6,-2,-2,4,4,186,4,2010,0,2,2059,0
Dallas,23,25,27,31,0,0,0,0,LA Clippers,28,18,24,30,0,0,0,0,20110330,106,100,-5,2,5,6,6,206,-6,2010,0,2,1237,0
Golden State,24,29,19,19,0,0,0,0,Memphis,29,19,31,31,0,0,0,0,20110330,91,110,5,-5,7,19,19,201,19,2010,0,2,1798,0
Detroit,27,20,23,31,0,0,0,0,Indiana,24,35,32,20,0,0,0,0,20110330,101,111,-3,12,21,10,10,212,10,2010,0,2,240,0
Sacramento,28,23,20,19,0,0,0,0,Denver,20,21,33,30,0,0,0,0,20110330,90,104,-8,-10,3,14,14,194,14,2010,0,2,886,0
Cleveland,26,24,26,21,0,0,0,0,Charlotte,28,19,29,22,0,0,0,0,20110330,97,98,2,-3,0,1,1,195,1,2010,0,2,435,0
Orlando,25,18,18,21,0,0,0,0,Atlanta,27,19,23,16,0,0,0,0,20110330,82,85,2,3,8,3,3,167,3,2010,0,2,401,0
Chicago,30,27,29,22,0,0,0,0,Minnesota,19,25,22,25,0,0,0,0,20110330,108,91,11,13,20,17,17,199,-17,2010,0,2,355,0
Dallas,26,25,19,12,0,0,0,0,LA Lakers,28,26,28,28,0,0,0,0,20110331,82,110,2,3,12,28,28,192,28,2010,0,3,1237,0
Boston,31,18,28,30,0,0,0,0,San Antonio,33,16,21,27,0,0,0,0,20110331,107,97,-2,0,7,10,10,204,-10,2010,0,3,1765,0
Cleveland,26,31,25,25,0,0,0,0,Washington,29,23,31,32,0,0,0,0,20110401,107,115,3,-5,1,8,8,222,8,2010,0,4,304,0
LA Lakers,22,20,29,25,0,0,0,0,Utah,28,20,16,21,0,0,0,0,20110401,96,85,-6,-6,7,11,11,181,-11,2010,0,4,579,0
Denver,21,27,31,20,0,0,0,0,Sacramento,28,23,16,23,0,0,0,0,20110401,99,90,-7,-3,12,9,9,189,-9,2010,0,4,886,0
Oklahoma City,30,29,11,21,0,0,0,0,Portland,20,33,25,20,0,0,0,0,20110401,91,98,-10,-6,8,7,7,189,7,2010,0,4,1484,0
LA Clippers,23,21,26,28,0,0,0,0,Phoenix,25,32,31,23,0,0,0,0,20110401,98,111,2,13,18,13,13,209,13,2010,0,4,356,0
Brooklyn,21,22,22,25,0,0,0,0,Philadelphia,29,31,34,21,0,0,0,0,20110401,90,115,8,17,29,25,25,205,25,2010,0,4,80,0
Milwaukee,22,17,21,28,0,0,0,0,Indiana,14,32,23,20,0,0,0,0,20110401,88,89,-8,7,9,1,1,177,1,2010,0,4,243,0
Memphis,23,28,20,22,0,0,0,0,New Orleans,12,26,23,20,0,0,0,0,20110401,93,81,11,13,10,12,12,174,-12,2010,0,4,358,0
Miami,30,21,34,26,0,0,0,0,Minnesota,20,32,20,20,0,0,0,0,20110401,111,92,10,-1,13,19,19,203,-19,2010,0,4,1513,0
San Antonio,27,29,29,23,6,0,0,0,Houston,31,33,23,21,11,0,0,0,20110401,114,119,4,8,2,0,5,233,5,2010,1,4,189,0
Chicago,31,27,22,21,0,0,0,0,Detroit,21,26,25,24,0,0,0,0,20110401,101,96,10,11,8,5,5,197,-5,2010,0,4,238,0
Boston,21,31,16,15,0,0,0,0,Atlanta,23,21,18,26,0,0,0,0,20110401,83,88,2,-8,-6,5,5,171,5,2010,0,4,935,0
Charlotte,17,22,21,17,0,0,0,0,Orlando,23,26,21,19,0,0,0,0,20110401,77,89,6,10,10,12,12,166,12,2010,0,4,463,0
Philadelphia,30,18,13,18,8,0,0,0,Milwaukee,20,19,22,18,14,0,0,0,20110402,87,93,-10,-9,0,0,6,180,6,2010,1,5,692,0
Oklahoma City,22,27,22,21,0,0,0,0,LA Clippers,15,22,31,30,0,0,0,0,20110402,92,98,-7,-12,-3,6,6,190,6,2010,0,5,1178,0
Minnesota,20,24,20,25,0,0,0,0,Memphis,29,27,17,33,0,0,0,0,20110402,89,106,9,12,9,17,17,195,17,2010,0,5,700,0
Toronto,19,24,32,31,0,0,0,0,Chicago,25,28,30,30,0,0,0,0,20110402,106,113,6,10,8,7,7,219,7,2010,0,5,436,0
Dallas,29,21,17,25,0,0,0,0,Golden State,28,20,24,27,0,0,0,0,20110402,92,99,-1,-2,5,7,7,191,7,2010,0,5,1480,0
Dallas,17,29,21,29,0,0,0,0,Portland,23,38,24,19,0,0,0,0,20110403,96,104,6,15,18,8,8,200,8,2010,0,6,1630,0
Detroit,29,19,18,24,0,0,0,0,Boston,26,23,33,19,0,0,0,0,20110403,90,101,-3,1,16,11,11,191,11,2010,0,6,611,0
Washington,22,26,28,21,0,0,0,0,Charlotte,19,24,22,26,0,0,0,0,20110403,97,91,3,5,11,6,6,188,-6,2010,0,6,329,0
Atlanta,23,40,18,28,0,0,0,0,Houston,21,33,32,28,0,0,0,0,20110403,109,114,-2,-9,5,5,5,223,5,2010,0,6,700,0
Denver,21,19,29,26,0,0,0,0,LA Lakers,20,27,22,21,0,0,0,0,20110403,95,90,1,-7,0,5,5,185,-5,2010,0,6,830,0
Miami,32,26,19,31,0,0,0,0,Brooklyn,18,26,25,25,0,0,0,0,20110403,108,94,14,14,8,14,14,202,-14,2010,0,6,1091,0
Indiana,21,23,21,31,0,0,0,0,New Orleans,29,28,32,19,0,0,0,0,20110403,96,108,8,13,24,12,12,204,12,2010,0,6,713,0
Cleveland,25,32,31,19,0,0,0,0,New York,36,31,26,30,0,0,0,0,20110403,107,123,11,10,5,16,16,230,16,2010,0,6,403,0
Utah,19,21,32,25,0,0,0,0,Sacramento,26,24,31,25,0,0,0,0,20110403,97,106,7,10,9,9,9,203,9,2010,0,6,532,0
Phoenix,20,26,25,26,0,0,0,0,San Antonio,35,35,21,23,0,0,0,0,20110403,97,114,15,24,20,17,17,211,17,2010,0,6,846,0
Orlando,19,30,30,19,0,0,0,0,Toronto,23,23,27,29,0,0,0,0,20110403,98,102,4,-3,-6,4,4,200,4,2010,0,6,1048,0
Toronto,26,28,28,36,0,0,0,0,New York,39,39,21,32,0,0,0,0,20110405,118,131,13,24,17,13,13,249,13,2010,0,1,341,0
Milwaukee,14,19,22,17,0,0,0,0,Orlando,26,16,15,21,0,0,0,0,20110405,72,78,12,9,2,6,6,150,6,2010,0,1,1065,0
Detroit,22,32,27,24,0,0,0,0,Washington,31,21,26,29,0,0,0,0,20110405,105,107,9,-2,-3,2,2,212,2,2010,0,1,394,0
Minnesota,23,27,25,30,0,0,0,0,Brooklyn,29,32,24,22,0,0,0,0,20110405,105,107,6,11,10,2,2,212,2,2010,0,1,1016,0
Golden State,19,28,37,24,0,0,0,0,Portland,19,28,21,19,0,0,0,0,20110405,108,87,0,0,16,21,21,195,-21,2010,0,1,535,0
LA Clippers,18,21,20,23,0,0,0,0,Memphis,23,20,25,13,0,0,0,0,20110405,82,81,-5,-4,-9,1,1,163,-1,2010,0,1,1599,0
Phoenix,24,16,30,24,0,0,0,0,Chicago,25,28,28,16,0,0,0,0,20110405,94,97,1,13,11,3,3,191,3,2010,0,1,1450,0
Sacramento,24,28,24,28,0,0,0,0,Houston,28,18,28,27,0,0,0,0,20110405,104,101,-4,6,2,3,3,205,-3,2010,0,1,1606,0
Oklahoma City,27,21,21,32,0,0,0,0,Denver,16,31,20,27,0,0,0,0,20110405,101,94,11,1,2,7,7,195,-7,2010,0,1,503,0
Charlotte,16,22,28,23,0,0,0,0,Cleveland,34,21,19,25,0,0,0,0,20110405,89,99,18,17,8,10,10,188,10,2010,0,1,435,0
Philadelphia,26,24,15,17,0,0,0,0,Boston,24,30,21,24,0,0,0,0,20110405,82,99,-2,4,10,17,17,181,17,2010,0,1,270,0
San Antonio,16,27,23,31,0,0,0,0,Atlanta,21,25,19,25,0,0,0,0,20110405,97,90,-5,-3,1,7,7,187,-7,2010,0,1,881,0
Utah,20,14,23,29,0,0,0,0,LA Lakers,24,16,17,28,0,0,0,0,20110405,86,85,-4,-6,0,1,1,171,-1,2010,0,1,579,0
Houston,38,17,16,22,0,0,0,0,New Orleans,21,30,23,27,0,0,0,0,20110406,93,101,-17,-4,3,8,8,194,8,2010,0,2,317,0
Cleveland,28,32,17,27,0,0,0,0,Toronto,17,23,24,32,0,0,0,0,20110406,104,96,11,20,13,8,8,200,-8,2010,0,2,187,0
Sacramento,22,27,21,22,0,0,0,0,San Antonio,23,28,41,32,0,0,0,0,20110406,92,124,1,2,22,32,32,216,32,2010,0,2,1456,0
New York,26,23,29,19,0,0,0,0,Philadelphia,19,22,24,27,0,0,0,0,20110406,97,92,7,8,13,5,5,189,-5,2010,0,2,80,0
LA Clippers,31,22,24,31,0,0,0,0,Oklahoma City,26,32,29,25,0,0,0,0,20110406,108,112,-5,5,10,4,4,220,4,2010,0,2,1178,0
Phoenix,26,30,26,26,0,0,0,0,Minnesota,23,30,24,21,0,0,0,0,20110406,108,98,3,3,5,10,10,206,-10,2010,0,2,1278,0
Orlando,26,21,24,25,15,0,0,0,Charlotte,28,25,24,19,6,0,0,0,20110406,111,102,-2,-6,-6,0,9,213,-9,2010,1,2,463,0
Washington,29,27,31,25,0,0,0,0,Indiana,43,32,33,28,0,0,0,0,20110406,112,136,14,19,21,24,24,248,24,2010,0,2,490,0
LA Lakers,23,15,17,32,0,0,0,0,Golden State,14,29,29,23,0,0,0,0,20110406,87,95,-9,5,17,8,8,182,8,2010,0,2,347,0
Brooklyn,28,31,29,21,0,0,0,0,Detroit,32,22,35,27,0,0,0,0,20110406,109,116,4,-5,1,7,7,225,7,2010,0,2,480,0
Denver,23,30,19,32,0,0,0,0,Dallas,17,26,26,27,0,0,0,0,20110406,104,96,6,10,3,8,8,200,-8,2010,0,2,661,0
Milwaukee,25,20,18,27,0,0,0,0,Miami,15,25,23,22,0,0,0,0,20110406,90,85,10,5,0,5,5,175,-5,2010,0,2,1269,0
Boston,18,25,17,21,0,0,0,0,Chicago,26,22,23,26,0,0,0,0,20110407,81,97,8,5,11,16,16,178,16,2010,0,3,849,0
Portland,27,22,30,19,0,0,0,0,Utah,18,24,25,20,0,0,0,0,20110407,98,87,9,7,12,11,11,185,-11,2010,0,3,634,0
Denver,17,25,22,25,0,0,0,0,Oklahoma City,17,31,27,29,0,0,0,0,20110408,89,104,0,6,11,15,15,193,15,2010,0,4,503,0
Phoenix,30,23,26,18,0,0,0,0,New Orleans,31,28,26,24,0,0,0,0,20110408,97,109,1,6,6,12,12,206,12,2010,0,4,1312,0
New York,36,32,28,20,0,0,0,0,Brooklyn,31,20,21,21,0,0,0,0,20110408,116,93,5,17,24,23,23,209,-23,2010,0,4,0,0
Charlotte,25,19,25,34,0,0,0,0,Miami,31,24,28,29,0,0,0,0,20110408,103,112,6,11,14,9,9,215,9,2010,0,4,654,0
Sacramento,21,22,24,29,0,0,0,0,Memphis,28,18,31,24,0,0,0,0,20110408,96,101,7,3,10,5,5,197,5,2010,0,4,1745,0
LA Clippers,35,19,21,21,0,0,0,0,Dallas,19,28,30,30,0,0,0,0,20110408,96,107,-16,-7,2,11,11,203,11,2010,0,4,1237,0
Milwaukee,21,30,23,26,0,0,0,0,Detroit,26,29,29,26,0,0,0,0,20110408,100,110,5,4,10,10,10,210,10,2010,0,4,251,0
Chicago,29,25,24,15,0,0,0,0,Cleveland,26,20,17,19,0,0,0,0,20110408,93,82,3,8,15,11,11,175,-11,2010,0,4,308,0
Washington,23,33,19,13,0,0,0,0,Boston,28,31,24,21,0,0,0,0,20110408,88,104,5,3,8,16,16,192,16,2010,0,4,394,0
Toronto,18,24,30,21,0,0,0,0,Philadelphia,28,26,19,25,0,0,0,0,20110408,93,98,10,12,1,5,5,191,5,2010,0,4,334,0
Atlanta,26,24,21,31,0,0,0,0,Indiana,33,23,26,32,0,0,0,0,20110408,102,114,7,6,11,12,12,216,12,2010,0,4,427,0
LA Lakers,21,26,15,24,0,0,0,0,Portland,21,32,21,19,0,0,0,0,20110408,86,93,0,6,12,7,7,179,7,2010,0,4,826,0
Atlanta,18,28,26,11,0,0,0,0,Washington,29,32,27,27,0,0,0,0,20110409,83,115,11,15,16,32,32,198,32,2010,0,5,541,0
Utah,22,24,30,26,0,0,0,0,San Antonio,25,32,32,22,0,0,0,0,20110409,102,111,3,11,13,9,9,213,9,2010,0,5,1087,0
Cleveland,18,26,34,23,0,0,0,0,Milwaukee,30,30,25,23,0,0,0,0,20110409,101,108,12,16,7,7,7,209,7,2010,0,5,334,0
LA Clippers,18,19,18,23,0,0,0,0,Houston,25,28,21,25,0,0,0,0,20110409,78,99,7,16,19,21,21,177,21,2010,0,5,1371,0
Minnesota,23,28,18,37,0,0,0,0,Denver,25,40,36,29,0,0,0,0,20110409,106,130,2,14,32,24,24,236,24,2010,0,5,698,0
Detroit,25,25,34,28,0,0,0,0,Charlotte,40,19,19,23,0,0,0,0,20110410,112,101,-15,-9,6,11,11,213,-11,2010,0,6,504,0
Phoenix,17,22,21,30,0,0,0,0,Dallas,36,29,15,35,0,0,0,0,20110410,90,115,19,26,20,25,25,205,25,2010,0,6,884,0
Sacramento,30,30,17,27,0,0,0,0,Golden State,26,33,24,20,0,0,0,0,20110410,104,103,4,1,-6,1,1,207,-1,2010,0,6,75,0
New York,33,34,20,23,0,0,0,0,Indiana,33,28,35,13,0,0,0,0,20110410,110,109,0,6,-9,1,1,219,-1,2010,0,6,643,0
Oklahoma City,36,30,22,32,0,0,0,0,LA Lakers,31,33,26,16,0,0,0,0,20110410,120,106,5,2,-2,14,14,226,-14,2010,0,6,1178,0
New Orleans,30,18,19,22,0,0,0,0,Memphis,30,22,30,29,0,0,0,0,20110410,89,111,0,4,15,22,22,200,22,2010,0,6,358,0
Boston,22,18,19,18,0,0,0,0,Miami,21,26,27,26,0,0,0,0,20110410,77,100,-1,7,15,23,23,177,23,2010,0,6,1257,0
Chicago,32,18,30,22,0,0,0,0,Orlando,24,25,28,22,0,0,0,0,20110410,102,99,8,1,3,3,3,201,-3,2010,0,6,984,0
Brooklyn,22,20,20,30,0,0,0,0,Toronto,31,30,21,17,0,0,0,0,20110410,92,99,9,19,20,7,7,191,7,2010,0,6,341,0
Boston,23,21,16,24,10,0,0,0,Washington,19,18,23,24,11,0,0,0,20110411,94,95,-4,-7,0,0,1,189,1,2010,1,0,394,0
Oklahoma City,24,27,36,33,0,0,0,0,Sacramento,20,37,26,29,0,0,0,0,20110411,120,112,4,-6,4,8,8,232,-8,2010,0,0,1336,0
Minnesota,33,32,27,29,6,0,0,0,Phoenix,24,34,34,29,14,0,0,0,20110411,127,135,-9,-7,0,0,8,262,8,2010,1,0,1278,0
Orlando,34,16,26,19,0,0,0,0,Philadelphia,25,22,15,23,0,0,0,0,20110411,95,85,9,3,14,10,10,180,-10,2010,0,0,864,0
Utah,29,18,23,20,0,0,0,0,New Orleans,21,16,20,21,0,0,0,0,20110411,90,78,8,10,13,12,12,168,-12,2010,0,0,1432,0
Toronto,33,18,20,15,0,0,0,0,Milwaukee,25,21,23,24,0,0,0,0,20110411,86,93,-8,-5,-2,7,7,179,7,2010,0,0,429,0
Dallas,20,23,24,19,12,0,0,0,Houston,23,24,24,15,5,0,0,0,20110411,98,91,-3,-4,-4,0,7,189,-7,2010,1,0,225,0
Cleveland,23,33,30,24,0,0,0,0,Detroit,33,24,18,26,0,0,0,0,20110411,110,101,-10,-1,11,9,9,211,-9,2010,0,0,90,0
Golden State,32,22,37,20,0,0,0,0,Denver,31,23,44,36,0,0,0,0,20110411,111,134,-1,0,7,23,23,245,23,2010,0,0,947,0
Miami,28,34,17,19,0,0,0,0,Atlanta,23,23,21,23,0,0,0,0,20110411,98,90,5,16,12,8,8,188,-8,2010,0,0,605,0
Charlotte,25,24,30,26,0,0,0,0,Brooklyn,29,24,20,30,0,0,0,0,20110411,105,103,-4,-4,6,2,2,208,-2,2010,0,0,531,0
San Antonio,15,30,19,29,0,0,0,0,LA Lakers,24,21,25,32,0,0,0,0,20110412,93,102,9,0,6,9,9,195,9,2010,0,1,1201,0
Chicago,24,28,32,19,0,0,0,0,New York,27,28,18,17,0,0,0,0,20110412,103,90,-3,-3,11,13,13,193,-13,2010,0,1,711,0
Memphis,25,20,21,23,0,0,0,0,Portland,27,18,29,28,0,0,0,0,20110412,89,102,2,0,8,13,13,191,13,2010,0,1,1845,0
Indiana,14,15,26,19,0,0,0,0,Orlando,28,25,18,21,0,0,0,0,20110413,74,92,14,24,16,18,18,166,18,2010,0,2,822,0
Denver,31,27,20,25,0,0,0,0,Utah,29,32,21,25,0,0,0,0,20110413,103,107,-2,3,4,4,4,210,4,2010,0,2,370,0
Miami,29,21,20,27,0,0,0,0,Toronto,20,31,18,10,0,0,0,0,20110413,97,79,9,-1,1,18,18,176,-18,2010,0,2,1234,0
LA Lakers,31,25,32,11,17,0,0,0,Sacramento,26,22,22,29,9,0,0,0,20110413,116,108,5,8,18,0,8,224,-8,2010,1,2,361,0
San Antonio,27,26,21,29,0,0,0,0,Phoenix,43,18,24,21,0,0,0,0,20110413,103,106,16,8,11,3,3,209,3,2010,0,2,846,0
Detroit,29,23,31,21,0,0,0,0,Philadelphia,24,32,21,23,0,0,0,0,20110413,104,100,5,-4,6,4,4,204,-4,2010,0,2,441,0
Milwaukee,16,30,18,32,14,0,0,0,Oklahoma City,21,22,31,22,10,0,0,0,20110413,110,106,-5,3,-10,0,4,216,-4,2010,1,2,732,0
New York,28,29,27,18,0,0,0,0,Boston,27,34,25,26,0,0,0,0,20110413,102,112,-1,4,2,10,10,214,10,2010,0,2,190,0
Memphis,20,17,37,29,0,0,0,0,LA Clippers,34,32,26,18,0,0,0,0,20110413,103,110,14,29,18,7,7,213,7,2010,0,2,1599,0
Portland,28,17,24,17,0,0,0,0,Golden State,30,21,34,25,0,0,0,0,20110413,86,110,2,6,16,24,24,196,24,2010,0,2,535,0
New Orleans,27,34,13,15,0,0,0,0,Dallas,28,30,28,35,0,0,0,0,20110413,89,121,1,-3,12,32,32,210,32,2010,0,2,442,0
Washington,35,15,24,19,0,0,0,0,Cleveland,23,24,24,29,0,0,0,0,20110413,93,100,-12,-3,-3,7,7,193,7,2010,0,2,304,0
Brooklyn,20,23,25,24,0,0,0,0,Chicago,26,24,18,29,0,0,0,0,20110413,92,97,6,7,0,5,5,189,5,2010,0,2,711,0
Atlanta,18,25,23,19,0,0,0,0,Charlotte,29,32,13,22,0,0,0,0,20110413,85,96,11,18,8,11,11,181,11,2010,0,2,226,0
Houston,32,37,21,31,0,0,0,0,Minnesota,30,22,37,13,0,0,0,0,20110413,121,102,2,17,1,19,19,223,-19,2010,0,2,1057,0
Atlanta,17,38,30,18,0,0,0,0,Orlando,19,29,23,22,0,0,0,0,20110416,103,93,-2,7,14,10,10,196,-10,2010,0,5,401,1
Philadelphia,31,18,20,20,0,0,0,0,Miami,19,35,26,17,0,0,0,0,20110416,89,97,-12,5,11,8,8,186,8,2010,0,5,1021,1
Portland,22,15,20,24,0,0,0,0,Dallas,21,26,14,28,0,0,0,0,20110416,81,89,-1,10,4,8,8,170,8,2010,0,5,1630,1
Indiana,27,28,24,20,0,0,0,0,Chicago,23,28,20,33,0,0,0,0,20110416,99,104,-4,-4,-8,5,5,203,5,2010,0,5,163,1
New York,23,28,13,21,0,0,0,0,Boston,24,15,20,28,0,0,0,0,20110417,85,87,1,-12,-5,2,2,172,2,2010,0,6,190,1
New Orleans,26,29,18,36,0,0,0,0,LA Lakers,24,23,25,28,0,0,0,0,20110417,109,100,2,8,1,9,9,209,-9,2010,0,6,1669,1
Denver,33,27,22,21,0,0,0,0,Oklahoma City,24,35,27,21,0,0,0,0,20110417,103,107,-9,-1,4,4,4,210,4,2010,0,6,503,1
Memphis,27,18,25,31,0,0,0,0,San Antonio,22,21,31,24,0,0,0,0,20110417,101,98,5,2,-4,3,3,199,-3,2010,0,6,631,1
Philadelphia,13,18,21,21,0,0,0,0,Miami,19,30,26,19,0,0,0,0,20110418,73,94,6,18,23,21,21,167,21,2010,0,0,1021,1
Indiana,18,29,20,23,0,0,0,0,Chicago,17,27,23,29,0,0,0,0,20110418,90,96,-1,-3,0,6,6,186,6,2010,0,0,163,1
Portland,24,28,20,17,0,0,0,0,Dallas,22,28,23,28,0,0,0,0,20110419,89,101,-2,-2,1,12,12,190,12,2010,0,1,1630,1
Atlanta,22,20,12,28,0,0,0,0,Orlando,16,32,17,23,0,0,0,0,20110419,82,88,-6,6,11,6,6,170,6,2010,0,1,401,1
New York,21,24,22,26,0,0,0,0,Boston,23,21,30,22,0,0,0,0,20110419,93,96,2,-1,7,3,3,189,3,2010,0,1,190,1
New Orleans,23,18,15,22,0,0,0,0,LA Lakers,23,24,16,24,0,0,0,0,20110420,78,87,0,6,7,9,9,165,9,2010,0,2,1669,1
Denver,15,29,22,23,0,0,0,0,Oklahoma City,31,28,22,25,0,0,0,0,20110420,89,106,16,15,15,17,17,195,17,2010,0,2,503,1
Memphis,17,27,21,22,0,0,0,0,San Antonio,17,24,25,27,0,0,0,0,20110420,87,93,0,-3,1,6,6,180,6,2010,0,2,631,1
Chicago,21,21,23,23,0,0,0,0,Indiana,17,25,22,20,0,0,0,0,20110421,88,84,4,0,1,4,4,172,-4,2010,0,3,163,1
Miami,21,29,23,27,0,0,0,0,Philadelphia,29,23,23,19,0,0,0,0,20110421,100,94,-8,-2,-2,6,6,194,-6,2010,0,3,1021,1
Dallas,23,29,20,20,0,0,0,0,Portland,28,26,21,22,0,0,0,0,20110421,92,97,5,2,3,5,5,189,5,2010,0,3,1630,1
Orlando,25,17,20,22,0,0,0,0,Atlanta,25,26,15,22,0,0,0,0,20110422,84,88,0,9,4,4,4,172,4,2010,0,4,401,1
LA Lakers,30,21,24,25,0,0,0,0,New Orleans,23,19,26,18,0,0,0,0,20110422,100,86,7,9,7,14,14,186,-14,2010,0,4,1669,1
Boston,27,25,34,27,0,0,0,0,New York,20,24,19,33,0,0,0,0,20110422,113,96,7,8,23,17,17,209,-17,2010,0,4,190,1
Dallas,16,21,30,15,0,0,0,0,Portland,11,24,14,35,0,0,0,0,20110423,82,84,-5,-2,-18,2,2,166,2,2010,0,5,1630,1
San Antonio,20,22,24,22,0,0,0,0,Memphis,29,23,19,20,0,0,0,0,20110423,88,91,9,10,5,3,3,179,3,2010,0,5,631,1
Oklahoma City,26,30,15,26,0,0,0,0,Denver,31,18,24,21,0,0,0,0,20110423,97,94,-5,7,-2,3,3,191,-3,2010,0,5,503,1
Chicago,19,14,23,28,0,0,0,0,Indiana,23,26,18,22,0,0,0,0,20110423,84,89,4,16,11,5,5,173,5,2010,0,5,163,1
Orlando,17,20,24,24,0,0,0,0,Atlanta,25,21,20,22,0,0,0,0,20110424,85,88,8,9,5,3,3,173,3,2010,0,6,401,1
LA Lakers,25,20,22,21,0,0,0,0,New Orleans,22,27,20,24,0,0,0,0,20110424,88,93,-3,4,2,5,5,181,5,2010,0,6,1669,1
Boston,29,26,27,19,0,0,0,0,New York,23,15,34,17,0,0,0,0,20110424,101,89,6,17,10,12,12,190,-12,2010,0,6,190,1
Miami,16,31,19,16,0,0,0,0,Philadelphia,28,18,18,22,0,0,0,0,20110424,82,86,12,-1,-2,4,4,168,4,2010,0,6,1021,1
Portland,20,23,20,19,0,0,0,0,Dallas,15,29,31,18,0,0,0,0,20110425,82,93,-5,1,12,11,11,175,11,2010,0,0,1630,1
Oklahoma City,20,25,24,32,0,0,0,0,Denver,26,19,26,33,0,0,0,0,20110425,101,104,6,0,2,3,3,205,3,2010,0,0,503,1
San Antonio,26,24,15,21,0,0,0,0,Memphis,21,27,30,26,0,0,0,0,20110425,86,104,-5,-2,13,18,18,190,18,2010,0,0,631,1
Atlanta,13,22,18,23,0,0,0,0,Orlando,26,32,21,22,0,0,0,0,20110426,76,101,13,23,26,25,25,177,25,2010,0,1,401,1
Indiana,25,21,19,24,0,0,0,0,Chicago,36,18,30,32,0,0,0,0,20110426,89,116,11,8,19,27,27,205,27,2010,0,1,163,1
New Orleans,32,19,21,18,0,0,0,0,LA Lakers,23,31,25,27,0,0,0,0,20110426,90,106,-9,3,7,16,16,196,16,2010,0,1,1669,1
Memphis,14,28,26,29,6,0,0,0,San Antonio,20,30,15,32,13,0,0,0,20110427,103,110,6,8,-3,0,7,213,7,2010,1,2,631,1
Denver,28,22,26,21,0,0,0,0,Oklahoma City,25,25,22,28,0,0,0,0,20110427,97,100,-3,0,-4,3,3,197,3,2010,0,2,503,1
Philadelphia,23,19,25,24,0,0,0,0,Miami,27,18,27,25,0,0,0,0,20110427,91,97,4,3,5,6,6,188,6,2010,0,2,1021,1
Orlando,18,18,19,26,0,0,0,0,Atlanta,23,19,20,22,0,0,0,0,20110428,81,84,5,6,7,3,3,165,3,2010,0,3,401,1
LA Lakers,18,22,29,29,0,0,0,0,New Orleans,16,18,23,23,0,0,0,0,20110428,98,80,2,6,12,18,18,178,-18,2010,0,3,1669,1
Dallas,19,33,23,28,0,0,0,0,Portland,27,16,19,34,0,0,0,0,20110428,103,96,-8,9,13,7,7,199,-7,2010,0,3,1630,1
San Antonio,16,27,23,25,0,0,0,0,Memphis,24,22,24,29,0,0,0,0,20110429,91,99,8,3,4,8,8,190,8,2010,0,4,631,1
Boston,14,22,26,28,0,0,0,0,Miami,20,31,25,23,0,0,0,0,20110501,90,99,6,15,14,9,9,189,9,2010,0,6,1257,1
Memphis,28,29,27,30,0,0,0,0,Oklahoma City,24,23,24,30,0,0,0,0,20110501,114,101,4,10,13,13,13,215,-13,2010,0,6,421,1
Atlanta,28,23,21,31,0,0,0,0,Chicago,18,32,21,24,0,0,0,0,20110502,103,95,10,1,1,8,8,198,-8,2010,0,0,587,1
Dallas,25,19,27,25,0,0,0,0,LA Lakers,23,30,25,16,0,0,0,0,20110502,96,94,2,-9,-7,2,2,190,-2,2010,0,0,1237,1
Boston,26,16,25,24,0,0,0,0,Miami,27,20,25,30,0,0,0,0,20110503,91,102,1,5,5,11,11,193,11,2010,0,1,1257,1
Memphis,17,27,24,34,0,0,0,0,Oklahoma City,28,26,22,35,0,0,0,0,20110503,102,111,11,10,8,9,9,213,9,2010,0,1,421,1
Dallas,26,25,17,25,0,0,0,0,LA Lakers,20,29,13,19,0,0,0,0,20110504,93,81,6,2,6,12,12,174,-12,2010,0,2,1237,1
Atlanta,19,18,21,15,0,0,0,0,Chicago,25,23,17,21,0,0,0,0,20110504,73,86,6,11,7,13,13,159,13,2010,0,2,587,1
Chicago,29,27,24,19,0,0,0,0,Atlanta,23,20,20,19,0,0,0,0,20110506,99,82,6,13,17,17,17,181,-17,2010,0,4,587,1
LA Lakers,27,24,21,20,0,0,0,0,Dallas,29,18,19,32,0,0,0,0,20110506,92,98,2,-4,-6,6,6,190,6,2010,0,4,1237,1
Miami,21,25,15,20,0,0,0,0,Boston,27,17,28,25,0,0,0,0,20110507,81,97,6,-2,11,16,16,178,16,2010,0,5,1257,1
Oklahoma City,20,31,25,10,7,0,0,0,Memphis,22,21,20,23,15,0,0,0,20110507,93,101,2,-8,-13,0,8,194,8,2010,1,5,421,1
Chicago,26,20,23,19,0,0,0,0,Atlanta,28,19,20,33,0,0,0,0,20110508,88,100,2,1,-2,12,12,188,12,2010,0,6,587,1
LA Lakers,23,16,23,24,0,0,0,0,Dallas,27,36,23,36,0,0,0,0,20110508,86,122,4,24,24,36,36,208,36,2010,0,6,1237,1
Miami,28,22,19,17,12,0,0,0,Boston,31,22,20,13,4,0,0,0,20110509,98,90,-3,-3,-4,0,8,188,-8,2010,1,0,1257,1
Oklahoma City,16,33,22,25,13,10,14,0,Memphis,28,25,19,24,13,10,4,0,20110509,133,123,-12,-4,-1,0,10,256,-10,2010,3,0,421,1
Atlanta,21,21,26,15,0,0,0,0,Chicago,32,16,21,26,0,0,0,0,20110510,83,95,11,6,1,12,12,178,12,2010,0,1,587,1
Boston,24,25,24,14,0,0,0,0,Miami,16,31,24,26,0,0,0,0,20110511,87,97,-8,-2,-2,10,10,184,10,2010,0,2,1257,1
Memphis,17,18,17,20,0,0,0,0,Oklahoma City,17,29,25,28,0,0,0,0,20110511,72,99,0,11,19,27,27,171,27,2010,0,2,421,1
Chicago,27,18,25,23,0,0,0,0,Atlanta,17,18,18,20,0,0,0,0,20110512,93,73,10,10,17,20,20,166,-20,2010,0,3,587,1
Oklahoma City,21,33,14,15,0,0,0,0,Memphis,23,21,28,23,0,0,0,0,20110513,83,95,2,-10,4,12,12,178,12,2010,0,4,421,1
Miami,23,25,15,19,0,0,0,0,Chicago,20,28,24,31,0,0,0,0,20110515,82,103,-3,0,9,21,21,185,21,2010,0,6,1189,1
Memphis,17,17,24,32,0,0,0,0,Oklahoma City,21,21,30,33,0,0,0,0,20110515,90,105,4,8,14,15,15,195,15,2010,0,6,421,1
Oklahoma City,27,21,31,33,0,0,0,0,Dallas,20,35,35,31,0,0,0,0,20110517,112,121,-7,7,11,9,9,233,9,2010,0,1,189,1
Miami,19,29,23,14,0,0,0,0,Chicago,26,20,19,10,0,0,0,0,20110518,85,75,-7,2,6,10,10,160,-10,2010,0,2,1189,1
Oklahoma City,26,33,18,29,0,0,0,0,Dallas,31,26,19,24,0,0,0,0,20110519,106,100,-5,2,1,6,6,206,-6,2010,0,3,189,1
Dallas,27,25,18,23,0,0,0,0,Oklahoma City,12,24,20,31,0,0,0,0,20110521,93,87,15,16,14,6,6,180,-6,2010,0,5,189,1
Chicago,15,25,25,20,0,0,0,0,Miami,18,25,25,28,0,0,0,0,20110522,85,96,3,3,3,11,11,181,11,2010,0,6,1189,1
Dallas,22,32,23,24,11,0,0,0,Oklahoma City,31,28,22,20,4,0,0,0,20110523,112,105,-9,-5,-4,0,7,217,-7,2010,1,0,189,1
Chicago,19,27,22,17,8,0,0,0,Miami,16,28,19,22,16,0,0,0,20110524,93,101,-3,-2,-5,0,8,194,8,2010,1,1,1189,1
Oklahoma City,27,28,21,20,0,0,0,0,Dallas,26,26,20,28,0,0,0,0,20110525,96,100,-1,-3,-4,4,4,196,4,2010,0,2,189,1
Miami,21,17,19,26,0,0,0,0,Chicago,25,20,17,18,0,0,0,0,20110526,83,80,-4,-7,-5,3,3,163,-3,2010,0,3,1189,1
Dallas,17,27,17,23,0,0,0,0,Miami,16,27,22,27,0,0,0,0,20110531,84,92,-1,-1,4,8,8,176,8,2010,0,1,1110,1
Dallas,28,23,20,24,0,0,0,0,Miami,28,23,24,18,0,0,0,0,20110602,95,93,0,0,-4,2,2,188,-2,2010,0,3,1110,1
Miami,29,18,20,21,0,0,0,0,Dallas,22,20,22,22,0,0,0,0,20110605,88,86,7,5,3,2,2,174,-2,2010,0,6,1110,1
Miami,21,26,22,14,0,0,0,0,Dallas,21,24,20,21,0,0,0,0,20110607,83,86,0,-2,-4,3,3,169,3,2010,0,1,1110,1
Miami,31,26,22,24,0,0,0,0,Dallas,30,30,24,28,0,0,0,0,20110609,103,112,-1,3,5,9,9,215,9,2010,0,3,1110,1
Dallas,32,21,28,24,0,0,0,0,Miami,27,24,21,23,0,0,0,0,20110612,105,95,5,2,9,10,10,200,-10,2010,0,6,1110,1
Miami,32,30,35,8,0,0,0,0,Dallas,17,24,24,29,0,0,0,0,20111225,105,94,15,21,32,11,11,199,-11,2011,0,6,1110,0
LA Clippers,24,17,34,30,0,0,0,0,Golden State,20,23,25,18,0,0,0,0,20111225,105,86,4,-2,7,19,19,191,-19,2011,0,6,347,0
Chicago,22,34,12,20,0,0,0,0,LA Lakers,20,29,20,18,0,0,0,0,20111225,88,87,2,7,-1,1,1,175,-1,2011,0,6,1741,0
Boston,23,29,35,17,0,0,0,0,New York,34,28,17,27,0,0,0,0,20111225,104,106,11,10,-8,2,2,210,2,2011,0,6,190,0
Orlando,22,19,22,26,0,0,0,0,Oklahoma City,27,28,26,16,0,0,0,0,20111225,89,97,5,14,18,8,8,186,8,2011,0,6,1057,0
Brooklyn,13,24,29,24,0,0,0,0,Washington,26,19,22,17,0,0,0,0,20111226,90,84,-13,-8,-1,6,6,174,-6,2011,0,0,204,0
LA Lakers,20,20,24,27,0,0,0,0,Sacramento,21,28,29,22,0,0,0,0,20111226,91,100,1,9,14,9,9,191,9,2011,0,0,361,0
Philadelphia,15,29,28,31,0,0,0,0,Portland,26,22,29,30,0,0,0,0,20111226,103,107,11,4,5,4,4,210,4,2011,0,0,2405,0
New Orleans,23,24,15,23,0,0,0,0,Phoenix,20,21,24,19,0,0,0,0,20111226,85,84,3,6,-3,1,1,169,-1,2011,0,0,1312,0
Houston,23,27,23,22,0,0,0,0,Orlando,27,26,24,27,0,0,0,0,20111226,95,104,4,3,4,9,9,199,9,2011,0,0,847,0
Memphis,22,22,14,24,0,0,0,0,San Antonio,14,29,29,23,0,0,0,0,20111226,82,95,-8,-1,14,13,13,177,13,2011,0,0,631,0
Detroit,17,21,20,21,0,0,0,0,Indiana,26,26,24,15,0,0,0,0,20111226,79,91,9,14,18,12,12,170,12,2011,0,0,240,0
Chicago,22,19,20,30,0,0,0,0,Golden State,30,27,21,21,0,0,0,0,20111226,91,99,8,16,17,8,8,190,8,2011,0,0,1853,0
Denver,32,37,28,18,0,0,0,0,Dallas,23,19,26,25,0,0,0,0,20111226,115,93,9,27,29,22,22,208,-22,2011,0,0,661,0
Toronto,23,29,26,26,0,0,0,0,Cleveland,23,19,28,26,0,0,0,0,20111226,104,96,0,10,8,8,8,200,-8,2011,0,0,187,0
Milwaukee,27,25,14,29,0,0,0,0,Charlotte,19,22,30,25,0,0,0,0,20111226,95,96,-8,-11,5,1,1,191,1,2011,0,0,658,0
Oklahoma City,23,29,26,26,0,0,0,0,Minnesota,24,22,26,28,0,0,0,0,20111226,104,100,-1,6,6,4,4,204,-4,2011,0,0,694,0
Utah,17,14,15,25,0,0,0,0,LA Lakers,18,23,30,25,0,0,0,0,20111227,71,96,1,10,25,25,25,167,25,2011,0,1,579,0
Boston,27,27,29,24,0,0,0,0,Miami,30,39,22,24,0,0,0,0,20111227,107,115,3,15,8,8,8,222,8,2011,0,1,1257,0
Minnesota,30,18,20,27,0,0,0,0,Milwaukee,32,28,19,19,0,0,0,0,20111227,95,98,2,12,11,3,3,193,3,2011,0,1,298,0
Atlanta,28,24,25,29,0,0,0,0,Brooklyn,11,19,25,15,0,0,0,0,20111227,106,70,17,22,22,36,36,176,-36,2011,0,1,745,0
Sacramento,25,21,19,14,0,0,0,0,Portland,23,23,28,27,0,0,0,0,20111227,79,101,-2,0,9,22,22,180,22,2011,0,1,483,0
Indiana,18,20,25,27,0,0,0,0,Toronto,11,23,21,30,0,0,0,0,20111228,90,85,7,4,8,5,5,175,-5,2011,0,2,438,0
LA Clippers,19,35,17,19,0,0,0,0,San Antonio,26,32,38,19,0,0,0,0,20111228,90,115,7,4,25,25,25,205,25,2011,0,2,1201,0
Philadelphia,25,23,32,23,0,0,0,0,Phoenix,18,16,20,29,0,0,0,0,20111228,103,83,7,14,26,20,20,186,-20,2011,0,2,2078,0
Boston,18,21,24,15,0,0,0,0,New Orleans,24,24,24,25,0,0,0,0,20111228,78,97,6,9,9,19,19,175,19,2011,0,2,1358,0
Oklahoma City,23,31,18,26,0,0,0,0,Memphis,20,29,21,25,0,0,0,0,20111228,98,95,3,5,2,3,3,193,-3,2011,0,2,421,0
New York,23,20,21,14,0,0,0,0,Golden State,21,16,27,28,0,0,0,0,20111228,78,92,-2,-6,0,14,14,170,14,2011,0,2,2565,0
Utah,23,23,20,34,0,0,0,0,Denver,28,35,25,29,0,0,0,0,20111228,100,117,5,17,22,17,17,217,17,2011,0,2,370,0
Miami,20,25,24,27,0,0,0,0,Charlotte,32,28,10,25,0,0,0,0,20111228,96,95,-12,-15,-1,1,1,191,-1,2011,0,2,654,0
Washington,17,25,22,19,0,0,0,0,Atlanta,26,29,30,16,0,0,0,0,20111228,83,101,9,13,21,18,18,184,18,2011,0,2,541,0
Cleveland,25,25,29,26,0,0,0,0,Detroit,23,16,30,20,0,0,0,0,20111228,105,89,2,11,10,16,16,194,-16,2011,0,2,90,0
San Antonio,18,17,24,26,0,0,0,0,Houston,23,30,25,27,0,0,0,0,20111229,85,105,5,18,19,20,20,190,20,2011,0,3,189,0
New York,24,27,21,10,0,0,0,0,LA Lakers,31,32,17,19,0,0,0,0,20111229,82,99,7,12,8,17,17,181,17,2011,0,3,2445,0
Dallas,29,23,24,26,0,0,0,0,Oklahoma City,28,28,22,26,0,0,0,0,20111229,102,104,-1,4,2,2,2,206,2,2011,0,3,189,0
Brooklyn,16,28,18,16,0,0,0,0,Orlando,28,22,25,19,0,0,0,0,20111229,78,94,12,6,13,16,16,172,16,2011,0,3,939,0
Denver,17,36,26,23,0,0,0,0,Portland,30,23,30,28,0,0,0,0,20111229,102,111,13,0,4,9,9,213,9,2011,0,3,981,0
Chicago,30,30,25,23,0,0,0,0,Sacramento,24,29,22,23,0,0,0,0,20111229,108,98,6,7,10,10,10,206,-10,2011,0,3,1788,0
Washington,24,17,26,14,0,0,0,0,Milwaukee,36,29,13,24,0,0,0,0,20111230,81,102,12,24,11,21,21,183,21,2011,0,4,634,0
Philadelphia,29,22,22,26,0,0,0,0,Utah,22,31,18,31,0,0,0,0,20111230,99,102,-7,2,-2,3,3,201,3,2011,0,4,1920,0
Phoenix,22,30,23,18,0,0,0,0,New Orleans,22,23,16,17,0,0,0,0,20111230,93,78,0,7,14,15,15,171,-15,2011,0,4,1312,0
Miami,31,20,31,21,0,0,0,0,Minnesota,20,33,22,26,0,0,0,0,20111230,103,101,11,-2,7,2,2,204,-2,2011,0,4,1513,0
Houston,28,23,16,26,0,0,0,0,Memphis,30,27,31,25,0,0,0,0,20111230,93,113,2,6,21,20,20,206,20,2011,0,4,484,0
Orlando,29,27,19,25,0,0,0,0,Charlotte,23,20,19,17,0,0,0,0,20111230,100,79,6,13,13,21,21,179,-21,2011,0,4,463,0
Cleveland,24,23,14,23,7,0,0,0,Indiana,22,23,25,14,14,0,0,0,20111230,91,98,-2,-2,9,0,7,189,7,2011,1,4,262,0
Toronto,23,23,24,16,0,0,0,0,Dallas,29,21,27,22,0,0,0,0,20111230,86,99,6,4,7,13,13,185,13,2011,0,4,1201,0
Detroit,22,21,21,21,0,0,0,0,Boston,24,26,36,10,0,0,0,0,20111230,85,96,2,7,22,11,11,181,11,2011,0,4,611,0
Brooklyn,19,18,35,26,0,0,0,0,Atlanta,20,23,33,29,0,0,0,0,20111230,98,105,1,6,4,7,7,203,7,2011,0,4,745,0
Chicago,29,28,26,31,0,0,0,0,LA Clippers,28,24,25,24,0,0,0,0,20111230,114,101,1,5,6,13,13,215,-13,2011,0,4,1741,0
Indiana,18,26,20,24,0,0,0,0,Detroit,21,31,30,14,0,0,0,0,20111231,88,96,3,8,18,8,8,184,8,2011,0,5,240,0
Philadelphia,19,31,22,35,0,0,0,0,Golden State,25,17,12,25,0,0,0,0,20111231,107,79,-6,8,18,28,28,186,-28,2011,0,5,2516,0
Atlanta,22,22,16,24,0,0,0,0,Houston,31,20,21,23,0,0,0,0,20111231,84,95,9,7,12,11,11,179,11,2011,0,5,700,0
Denver,23,22,26,18,0,0,0,0,LA Lakers,22,24,23,23,0,0,0,0,20111231,89,92,-1,1,-2,3,3,181,3,2011,0,5,830,0
Phoenix,22,24,21,30,0,0,0,0,Oklahoma City,27,33,29,18,0,0,0,0,20111231,97,107,5,14,22,10,10,204,10,2011,0,5,840,0
New York,35,21,22,36,0,0,0,0,Sacramento,20,22,23,27,0,0,0,0,20111231,114,92,15,14,13,22,22,206,-22,2011,0,5,2499,0
Utah,18,21,21,29,0,0,0,0,San Antonio,23,31,29,21,0,0,0,0,20111231,89,104,5,15,23,15,15,193,15,2011,0,5,1087,0
Boston,28,23,22,21,0,0,0,0,Washington,17,17,26,26,0,0,0,0,20120101,94,86,11,17,13,8,8,180,-8,2011,0,6,394,0
New Orleans,22,18,18,22,0,0,0,0,Sacramento,21,17,30,28,0,0,0,0,20120101,80,96,-1,-2,10,16,16,176,16,2011,0,6,1879,0
Toronto,27,25,29,15,0,0,0,0,Orlando,18,29,23,32,0,0,0,0,20120101,96,102,-9,-5,-11,6,6,198,6,2011,0,6,1048,0
Dallas,25,16,28,13,0,0,0,0,Minnesota,25,25,24,25,0,0,0,0,20120101,82,99,0,9,5,17,17,181,17,2011,0,6,863,0
Memphis,12,16,16,20,0,0,0,0,Chicago,25,29,30,20,0,0,0,0,20120101,64,104,13,26,40,40,40,168,40,2011,0,6,480,0
Portland,17,19,16,36,0,0,0,0,LA Clippers,21,23,25,24,0,0,0,0,20120101,88,93,4,8,17,5,5,181,5,2011,0,6,826,0
LA Lakers,21,15,35,19,0,0,0,0,Denver,26,21,25,27,0,0,0,0,20120101,90,99,5,11,1,9,9,189,9,2011,0,6,830,0
Brooklyn,27,22,18,15,0,0,0,0,Cleveland,24,19,30,25,0,0,0,0,20120101,82,98,-3,-6,6,16,16,180,16,2011,0,6,403,0
Charlotte,15,22,27,26,0,0,0,0,Miami,33,32,27,37,0,0,0,0,20120101,90,129,18,28,28,39,39,219,39,2011,0,6,654,0
New Orleans,22,25,27,16,0,0,0,0,Utah,18,32,20,24,0,0,0,0,20120102,90,94,-4,3,-4,4,4,184,4,2011,0,0,1432,0
Golden State,26,21,22,22,0,0,0,0,Phoenix,25,26,21,30,0,0,0,0,20120102,91,102,-1,4,3,11,11,193,11,2011,0,0,652,0
Toronto,22,29,16,23,0,0,0,0,New York,23,11,24,27,0,0,0,0,20120102,90,85,-1,17,9,5,5,175,-5,2011,0,0,341,0
Indiana,29,19,29,31,0,0,0,0,Brooklyn,21,21,22,30,0,0,0,0,20120102,108,94,8,6,13,14,14,202,-14,2011,0,0,643,0
San Antonio,25,34,21,16,0,0,0,0,Minnesota,35,31,28,12,0,0,0,0,20120102,96,106,10,7,14,10,10,202,10,2011,0,0,1112,0
Orlando,19,27,17,15,0,0,0,0,Detroit,21,23,24,21,0,0,0,0,20120102,78,89,2,-2,5,11,11,167,11,2011,0,0,957,0
Milwaukee,30,18,26,12,0,0,0,0,Denver,24,24,20,23,0,0,0,0,20120102,86,91,-6,0,-6,5,5,177,5,2011,0,0,912,0
Oklahoma City,20,27,18,22,0,0,0,0,Dallas,20,34,24,22,0,0,0,0,20120102,87,100,0,7,13,13,13,187,13,2011,0,0,189,0
Washington,24,24,22,22,0,0,0,0,Boston,23,24,22,31,0,0,0,0,20120102,92,100,-1,-1,-1,8,8,192,8,2011,0,0,394,0
Atlanta,19,28,20,33,0,0,0,0,Miami,23,27,21,21,0,0,0,0,20120102,100,92,-4,-3,-4,8,8,192,-8,2011,0,0,605,0
Atlanta,23,15,18,18,0,0,0,0,Chicago,15,11,16,34,0,0,0,0,20120103,74,76,-8,-12,-14,2,2,150,2,2011,0,1,587,0
Charlotte,34,17,29,21,0,0,0,0,Cleveland,27,30,30,28,0,0,0,0,20120103,101,115,-7,6,7,14,14,216,14,2011,0,1,435,0
Houston,25,21,29,24,0,0,0,0,LA Lakers,31,19,26,32,0,0,0,0,20120103,99,108,6,4,1,9,9,207,9,2011,0,1,1371,0
Sacramento,17,33,18,28,0,0,0,0,Memphis,31,21,35,26,0,0,0,0,20120103,96,113,14,2,19,17,17,209,17,2011,0,1,1745,0
Portland,21,30,27,25,0,0,0,0,Oklahoma City,26,27,21,19,0,0,0,0,20120103,103,93,-5,-2,4,10,10,196,-10,2011,0,1,1484,0
Milwaukee,16,18,21,18,0,0,0,0,Utah,22,21,19,23,0,0,0,0,20120103,73,85,6,9,7,12,12,158,12,2011,0,1,1239,0
Golden State,26,27,22,20,0,0,0,0,San Antonio,20,25,25,31,0,0,0,0,20120104,95,101,-6,-8,-5,6,6,196,6,2011,0,2,1487,0
Washington,14,24,22,25,0,0,0,0,Orlando,31,25,27,20,0,0,0,0,20120104,85,103,17,18,23,18,18,188,18,2011,0,2,757,0
Charlotte,30,32,26,30,0,0,0,0,New York,26,26,26,32,0,0,0,0,20120104,118,110,4,10,10,8,8,228,-8,2011,0,2,531,0
Philadelphia,16,24,27,34,0,0,0,0,New Orleans,27,20,26,20,0,0,0,0,20120104,101,93,-11,-7,-6,8,8,194,-8,2011,0,2,1088,0
Memphis,20,23,14,33,0,0,0,0,Minnesota,14,23,22,27,0,0,0,0,20120104,90,86,6,6,-2,4,4,176,-4,2011,0,2,700,0
Phoenix,25,16,25,23,0,0,0,0,Dallas,25,24,28,21,0,0,0,0,20120104,89,98,0,8,11,9,9,187,9,2011,0,2,884,0
Houston,26,29,20,14,0,0,0,0,LA Clippers,41,26,23,27,0,0,0,0,20120104,89,117,15,12,15,28,28,206,28,2011,0,2,1371,0
Chicago,22,29,20,28,0,0,0,0,Detroit,14,21,23,25,0,0,0,0,20120104,99,83,8,16,13,16,16,182,-16,2011,0,2,238,0
Sacramento,17,22,25,19,0,0,0,0,Denver,27,29,29,25,0,0,0,0,20120104,83,110,10,17,21,27,27,193,27,2011,0,2,886,0
Brooklyn,17,18,12,23,0,0,0,0,Boston,18,16,29,26,0,0,0,0,20120104,70,89,1,-1,16,19,19,159,19,2011,0,2,190,0
Cleveland,18,21,12,26,0,0,0,0,Toronto,21,25,20,26,0,0,0,0,20120104,77,92,3,7,15,15,15,169,15,2011,0,2,187,0
Indiana,27,12,27,17,0,0,0,0,Miami,29,33,26,30,0,0,0,0,20120104,83,118,2,23,22,35,35,201,35,2011,0,2,1026,0
Milwaukee,30,28,24,18,0,0,0,0,Sacramento,25,12,31,35,0,0,0,0,20120105,100,103,-5,-21,-14,3,3,203,3,2011,0,3,1771,0
Dallas,17,12,13,29,0,0,0,0,San Antonio,31,24,11,27,0,0,0,0,20120105,71,93,14,26,24,22,22,164,22,2011,0,3,252,0
Miami,22,32,14,25,6,10,7,0,Atlanta,19,30,21,23,6,10,0,0,20120105,116,109,3,5,-2,0,7,225,-7,2011,3,3,605,0
LA Lakers,31,25,18,22,0,0,0,0,Portland,27,25,32,23,0,0,0,0,20120105,96,107,-4,-4,10,11,11,203,11,2011,0,3,826,0
Memphis,26,21,17,21,0,0,0,0,Utah,22,23,22,27,0,0,0,0,20120106,85,94,-4,-2,3,9,9,179,9,2011,0,4,1247,0
Brooklyn,22,26,27,22,0,0,0,0,Toronto,21,19,24,21,0,0,0,0,20120106,97,85,1,8,11,12,12,182,-12,2011,0,4,341,0
Portland,19,15,21,22,0,0,0,0,Phoenix,30,19,25,28,0,0,0,0,20120106,77,102,11,15,19,25,25,179,25,2011,0,4,1005,0
Detroit,19,15,22,17,0,0,0,0,Philadelphia,20,23,21,32,0,0,0,0,20120106,73,96,1,9,8,23,23,169,23,2011,0,4,441,0
Chicago,26,27,20,24,0,0,0,0,Orlando,27,16,19,21,0,0,0,0,20120106,97,83,-1,10,11,14,14,180,-14,2011,0,4,984,0
New York,18,28,26,27,0,0,0,0,Washington,32,15,22,27,0,0,0,0,20120106,99,96,-14,-1,3,3,3,195,-3,2011,0,4,204,0
Denver,24,17,21,34,0,0,0,0,New Orleans,32,15,16,25,0,0,0,0,20120106,96,88,-8,-6,-1,8,8,184,-8,2011,0,4,1079,0
Cleveland,28,24,24,22,0,0,0,0,Minnesota,24,21,19,23,0,0,0,0,20120106,98,87,4,7,12,11,11,185,-11,2011,0,4,629,0
Golden State,22,17,19,32,0,0,0,0,LA Lakers,20,15,32,30,0,0,0,0,20120106,90,97,-2,-4,9,7,7,187,7,2011,0,4,347,0
Atlanta,20,23,27,21,11,0,0,0,Charlotte,18,20,23,30,5,0,0,0,20120106,102,96,2,5,9,0,6,198,-6,2011,1,4,226,0
Indiana,14,19,30,24,0,0,0,0,Boston,14,11,30,19,0,0,0,0,20120106,87,74,0,8,8,13,13,161,-13,2011,0,4,805,0
Houston,20,21,24,29,0,0,0,0,Oklahoma City,30,28,28,23,0,0,0,0,20120106,94,109,10,17,21,15,15,203,15,2011,0,4,413,0
Denver,25,30,30,32,0,0,0,0,San Antonio,37,25,32,27,0,0,0,0,20120107,117,121,12,7,9,4,4,238,4,2011,0,5,802,0
Toronto,16,18,15,13,0,0,0,0,Philadelphia,19,22,32,24,0,0,0,0,20120107,62,97,3,7,24,35,35,159,35,2011,0,5,334,0
Miami,31,26,21,23,0,0,0,0,Brooklyn,18,17,29,26,0,0,0,0,20120107,101,90,13,22,14,11,11,191,-11,2011,0,5,1091,0
Milwaukee,15,25,25,21,0,0,0,0,LA Clippers,18,20,34,20,0,0,0,0,20120107,86,92,3,-2,7,6,6,178,6,2011,0,5,1741,0
Charlotte,30,19,14,14,0,0,0,0,Indiana,22,21,28,28,0,0,0,0,20120107,77,99,-8,-6,8,22,22,176,22,2011,0,5,428,0
Utah,27,18,18,25,0,0,0,0,Golden State,19,27,20,21,0,0,0,0,20120107,88,87,8,-1,-3,1,1,175,-1,2011,0,5,599,0
New York,25,39,22,17,0,0,0,0,Detroit,24,18,15,23,0,0,0,0,20120107,103,80,1,22,29,23,23,183,-23,2011,0,5,480,0
New Orleans,20,21,24,16,0,0,0,0,Dallas,26,26,23,21,0,0,0,0,20120107,81,96,6,11,10,15,15,177,15,2011,0,5,442,0
Chicago,18,27,17,32,0,0,0,0,Atlanta,33,30,22,24,0,0,0,0,20120107,94,109,15,18,23,15,15,203,15,2011,0,5,587,0
Oklahoma City,23,25,24,26,0,0,0,0,Houston,21,25,26,23,0,0,0,0,20120107,98,95,2,2,0,3,3,193,-3,2011,0,5,413,0
Orlando,19,30,32,23,0,0,0,0,Sacramento,21,26,32,18,0,0,0,0,20120108,104,97,-2,2,2,7,7,201,-7,2011,0,6,2390,0
Minnesota,20,28,27,18,0,0,0,0,Washington,17,17,26,12,0,0,0,0,20120108,93,72,3,14,15,21,21,165,-21,2011,0,6,931,0
Cleveland,17,18,22,21,0,0,0,0,Portland,18,24,27,29,0,0,0,0,20120108,78,98,1,7,12,20,20,176,20,2011,0,6,2049,0
San Antonio,22,26,21,27,0,0,0,0,Oklahoma City,24,30,37,17,0,0,0,0,20120108,96,108,2,6,22,12,12,204,12,2011,0,6,421,0
Memphis,22,24,22,14,0,0,0,0,LA Lakers,31,25,22,12,0,0,0,0,20120108,82,90,9,10,10,8,8,172,8,2011,0,6,1599,0
Milwaukee,25,22,19,27,0,0,0,0,Phoenix,30,27,34,18,0,0,0,0,20120108,93,109,5,10,25,16,16,202,16,2011,0,6,1462,0
Detroit,21,13,25,9,0,0,0,0,Chicago,21,22,25,24,0,0,0,0,20120109,68,92,0,9,9,24,24,160,24,2011,0,0,238,0
New Orleans,26,28,24,16,0,0,0,0,Denver,27,19,18,17,0,0,0,0,20120109,94,81,-1,8,14,13,13,175,-13,2011,0,0,1079,0
Atlanta,31,25,24,26,0,0,0,0,Brooklyn,18,27,26,30,0,0,0,0,20120109,106,101,13,11,9,5,5,207,-5,2011,0,0,745,0
Charlotte,21,24,20,22,0,0,0,0,New York,24,26,22,19,0,0,0,0,20120109,87,91,3,5,7,4,4,178,4,2011,0,0,531,0
Indiana,20,20,24,22,0,0,0,0,Philadelphia,25,20,28,23,0,0,0,0,20120109,86,96,5,5,9,10,10,182,10,2011,0,0,582,0
Minnesota,25,24,20,18,0,0,0,0,Toronto,27,28,18,24,0,0,0,0,20120109,87,97,2,6,4,10,10,184,10,2011,0,0,691,0
Phoenix,19,23,26,15,0,0,0,0,LA Lakers,25,21,27,26,0,0,0,0,20120110,83,99,6,4,5,16,16,182,16,2011,0,1,356,0
Cleveland,26,17,37,25,0,0,0,0,Utah,27,25,33,28,0,0,0,0,20120110,105,113,1,9,5,8,8,218,8,2011,0,1,1564,0
LA Clippers,26,21,24,26,0,0,0,0,Portland,24,30,24,27,0,0,0,0,20120110,97,105,-2,7,7,8,8,202,8,2011,0,1,826,0
Sacramento,22,20,18,25,0,0,0,0,Philadelphia,26,26,32,28,0,0,0,0,20120110,85,112,4,10,24,27,27,197,27,2011,0,1,2451,0
Chicago,33,20,26,32,0,0,0,0,Minnesota,17,30,27,26,0,0,0,0,20120110,111,100,16,6,5,11,11,211,-11,2011,0,1,355,0
Dallas,30,22,24,24,0,0,0,0,Detroit,20,18,17,31,0,0,0,0,20120110,100,86,10,14,21,14,14,186,-14,2011,0,1,999,0
Oklahoma City,26,28,21,25,0,0,0,0,Memphis,25,27,19,24,0,0,0,0,20120110,100,95,1,2,4,5,5,195,-5,2011,0,1,421,0
Miami,22,35,27,12,10,0,0,0,Golden State,27,26,19,24,15,0,0,0,20120110,106,111,5,-4,-12,0,5,217,5,2011,1,1,2590,0
Toronto,20,14,18,26,0,0,0,0,Washington,17,29,25,22,0,0,0,0,20120110,78,93,-3,12,19,15,15,171,15,2011,0,1,349,0
Houston,20,23,24,15,0,0,0,0,Charlotte,23,16,14,17,0,0,0,0,20120110,82,70,-3,4,14,12,12,152,-12,2011,0,1,925,0
San Antonio,33,26,22,22,0,0,0,0,Milwaukee,25,34,20,27,0,0,0,0,20120110,103,106,-8,0,-2,3,3,209,3,2011,0,1,1108,0
Orlando,36,26,23,22,0,0,0,0,Portland,22,28,18,36,0,0,0,0,20120111,107,104,14,12,17,3,3,211,-3,2011,0,2,2525,0
Philadelphia,15,20,21,23,0,0,0,0,New York,28,17,22,18,0,0,0,0,20120111,79,85,13,10,11,6,6,164,6,2011,0,2,80,0
Sacramento,23,18,22,35,0,0,0,0,Toronto,19,21,23,28,0,0,0,0,20120111,98,91,4,1,0,7,7,189,-7,2011,0,2,2195,0
LA Lakers,26,15,25,12,12,0,0,0,Utah,23,19,19,17,9,0,0,0,20120111,90,87,3,-1,5,0,3,177,-3,2011,1,2,579,0
Oklahoma City,22,27,24,22,0,0,0,0,New Orleans,27,21,22,15,0,0,0,0,20120111,95,85,-5,1,3,10,10,180,-10,2011,0,2,576,0
Houston,27,23,18,22,5,0,0,0,San Antonio,23,24,25,18,11,0,0,0,20120111,95,101,-4,-3,4,0,6,196,6,2011,1,2,189,0
Atlanta,20,30,9,25,0,0,0,0,Indiana,28,25,27,16,0,0,0,0,20120111,84,96,8,3,21,12,12,180,12,2011,0,2,427,0
Brooklyn,28,24,28,35,0,0,0,0,Denver,35,33,32,23,0,0,0,0,20120111,115,123,7,16,20,8,8,238,8,2011,0,2,1627,0
Washington,15,22,16,11,0,0,0,0,Chicago,17,28,12,21,0,0,0,0,20120111,64,78,2,8,4,14,14,142,14,2011,0,2,594,0
Dallas,23,19,26,22,0,0,0,0,Boston,15,26,18,26,0,0,0,0,20120111,90,85,8,1,9,5,5,175,-5,2011,0,2,1548,0
Miami,24,24,21,17,3,0,0,0,LA Clippers,21,22,27,16,9,0,0,0,20120111,89,95,-3,-5,1,0,6,184,6,2011,1,2,2335,0
Charlotte,21,26,19,15,0,0,0,0,Atlanta,25,32,28,26,0,0,0,0,20120112,81,111,4,10,19,30,30,192,30,2011,0,3,226,0
Orlando,22,31,27,37,0,0,0,0,Golden State,29,28,25,27,0,0,0,0,20120112,117,109,-7,-4,-2,8,8,226,-8,2011,0,3,2437,0
New York,19,19,14,31,0,0,0,0,Memphis,28,21,26,19,0,0,0,0,20120112,83,94,9,11,23,11,11,177,11,2011,0,3,953,0
Detroit,27,16,25,25,0,0,0,0,Milwaukee,31,21,27,23,0,0,0,0,20120112,93,102,4,9,11,9,9,195,9,2011,0,3,251,0
Cleveland,30,26,23,22,0,0,0,0,Phoenix,30,18,23,19,0,0,0,0,20120112,101,90,0,8,8,11,11,191,-11,2011,0,3,1745,0
Indiana,15,25,25,30,0,0,0,0,Toronto,27,18,20,25,0,0,0,0,20120113,95,90,-12,-5,0,5,5,185,-5,2011,0,4,438,0
Portland,31,16,18,18,0,0,0,0,San Antonio,27,23,15,34,0,0,0,0,20120113,83,99,-4,3,0,16,16,182,16,2011,0,4,1718,0
Brooklyn,22,32,34,22,0,0,0,0,Phoenix,25,26,31,21,0,0,0,0,20120113,110,103,-3,3,6,7,7,213,-7,2011,0,4,2139,0
Washington,23,17,18,31,0,0,0,0,Philadelphia,33,21,38,28,0,0,0,0,20120113,89,120,10,14,34,31,31,209,31,2011,0,4,123,0
Minnesota,16,21,26,24,0,0,0,0,New Orleans,21,17,13,29,0,0,0,0,20120113,87,80,-5,-1,12,7,7,167,-7,2011,0,4,1052,0
Milwaukee,23,22,18,13,0,0,0,0,Dallas,32,28,23,19,0,0,0,0,20120113,76,102,9,15,20,26,26,178,26,2011,0,4,857,0
Sacramento,28,24,20,17,0,0,0,0,Houston,26,24,31,22,0,0,0,0,20120113,89,103,-2,-2,9,14,14,192,14,2011,0,4,1606,0
Miami,21,32,28,23,0,0,0,0,Denver,30,25,31,31,0,0,0,0,20120113,104,117,9,2,5,13,13,221,13,2011,0,4,1724,0
Detroit,27,24,27,20,0,0,0,0,Charlotte,23,16,20,22,0,0,0,0,20120113,98,81,4,12,19,17,17,179,-17,2011,0,4,504,0
Chicago,26,26,15,21,0,0,0,0,Boston,13,20,26,20,0,0,0,0,20120113,88,79,13,19,8,9,9,167,-9,2011,0,4,849,0
Cleveland,28,13,29,22,0,0,0,0,LA Lakers,32,27,23,15,0,0,0,0,20120113,92,97,4,18,12,5,5,189,5,2011,0,4,2044,0
LA Lakers,24,18,30,22,0,0,0,0,LA Clippers,31,24,21,26,0,0,0,0,20120114,94,102,7,13,4,8,8,196,8,2011,0,5,0,0
Brooklyn,20,20,27,27,0,0,0,0,Utah,30,27,30,20,0,0,0,0,20120114,94,107,10,17,20,13,13,201,13,2011,0,5,1967,0
New York,22,25,18,27,0,0,0,0,Oklahoma City,32,38,22,12,0,0,0,0,20120114,92,104,10,23,27,12,12,196,12,2011,0,5,1324,0
Philadelphia,23,29,25,26,0,0,0,0,Washington,26,14,20,30,0,0,0,0,20120114,103,90,-3,12,17,13,13,193,-13,2011,0,5,123,0
Boston,24,24,19,16,0,0,0,0,Indiana,29,27,26,15,0,0,0,0,20120114,83,97,5,8,15,14,14,180,14,2011,0,5,805,0
New Orleans,24,23,28,24,0,0,0,0,Memphis,20,37,29,22,0,0,0,0,20120114,99,108,-4,10,11,9,9,207,9,2011,0,5,358,0
Sacramento,11,12,22,15,0,0,0,0,Dallas,27,25,20,27,0,0,0,0,20120114,60,99,16,29,27,39,39,159,39,2011,0,5,1437,0
Toronto,14,23,15,12,0,0,0,0,Chicago,23,14,19,21,0,0,0,0,20120114,64,77,9,0,4,13,13,141,13,2011,0,5,436,0
Golden State,25,21,27,27,0,0,0,0,Charlotte,38,28,27,19,0,0,0,0,20120114,100,112,13,20,20,12,12,212,12,2011,0,5,2296,0
Minnesota,24,29,18,20,0,0,0,0,Atlanta,18,24,21,30,0,0,0,0,20120114,91,93,-6,-11,-8,2,2,184,2,2011,0,5,908,0
Portland,21,32,23,21,8,0,0,0,Houston,27,31,26,13,10,0,0,0,20120114,105,107,6,5,8,0,2,212,2,2011,1,5,1833,0
Utah,25,23,29,29,0,0,0,0,Denver,26,22,25,23,0,0,0,0,20120115,106,96,-1,0,4,10,10,202,-10,2011,0,6,370,0
Golden State,24,20,30,25,0,0,0,0,Detroit,19,29,21,22,0,0,0,0,20120115,99,91,5,-4,5,8,8,190,-8,2011,0,6,2087,0
Phoenix,26,16,26,23,0,0,0,0,San Antonio,30,26,22,24,0,0,0,0,20120115,91,102,4,14,10,11,11,193,11,2011,0,6,846,0
Houston,27,31,33,23,0,0,0,0,Washington,28,26,21,31,0,0,0,0,20120116,114,106,-1,4,16,8,8,220,-8,2011,0,0,1217,0
Milwaukee,25,18,19,20,0,0,0,0,Philadelphia,31,16,29,18,0,0,0,0,20120116,82,94,6,4,14,12,12,176,12,2011,0,0,692,0
Orlando,17,28,28,29,0,0,0,0,New York,23,28,24,18,0,0,0,0,20120116,102,93,-6,-6,-2,9,9,195,-9,2011,0,0,939,0
Sacramento,22,24,16,24,0,0,0,0,Minnesota,28,14,25,32,0,0,0,0,20120116,86,99,6,-4,5,13,13,185,13,2011,0,0,1511,0
Chicago,21,17,28,20,0,0,0,0,Memphis,28,30,19,25,0,0,0,0,20120116,86,102,7,20,11,16,16,188,16,2011,0,0,480,0
Portland,20,17,27,20,0,0,0,0,New Orleans,15,20,16,26,0,0,0,0,20120116,84,77,5,2,13,7,7,161,-7,2011,0,0,2059,0
Brooklyn,17,23,23,28,0,0,0,0,LA Clippers,32,21,21,27,0,0,0,0,20120116,91,101,15,13,11,10,10,192,10,2011,0,0,2445,0
Cleveland,30,16,33,23,0,0,0,0,Charlotte,23,34,20,17,0,0,0,0,20120116,102,94,7,-11,2,8,8,196,-8,2011,0,0,435,0
Oklahoma City,25,21,26,25,0,0,0,0,Boston,17,22,23,26,0,0,0,0,20120116,97,88,8,7,10,9,9,185,-9,2011,0,0,1492,0
Toronto,18,27,26,13,0,0,0,0,Atlanta,26,24,23,20,0,0,0,0,20120116,84,93,8,5,2,9,9,177,9,2011,0,0,733,0
Dallas,18,17,16,19,0,0,0,0,LA Lakers,15,24,7,27,0,0,0,0,20120116,70,73,-3,4,-5,3,3,143,3,2011,0,0,1237,0
LA Clippers,17,24,18,20,0,0,0,0,Utah,29,23,26,30,0,0,0,0,20120117,79,108,12,11,19,29,29,187,29,2011,0,1,579,0
Charlotte,24,26,17,22,0,0,0,0,Orlando,17,30,20,29,0,0,0,0,20120117,89,96,-7,-3,0,7,7,185,7,2011,0,1,463,0
Denver,26,37,22,20,0,0,0,0,Milwaukee,21,23,23,28,0,0,0,0,20120117,105,95,5,19,18,10,10,200,-10,2011,0,1,912,0
San Antonio,35,28,12,23,0,0,0,0,Miami,26,23,39,32,0,0,0,0,20120117,98,120,-9,-14,13,22,22,218,22,2011,0,1,1147,0
Golden State,26,29,26,24,0,0,0,0,Cleveland,26,24,29,16,0,0,0,0,20120117,105,95,0,5,2,10,10,200,-10,2011,0,1,2161,0
Phoenix,31,16,21,29,0,0,0,0,Chicago,39,28,29,22,0,0,0,0,20120117,97,118,8,20,28,21,21,215,21,2011,0,1,1450,0
Detroit,20,20,19,21,0,0,0,0,Houston,28,19,22,28,0,0,0,0,20120117,80,97,8,7,10,17,17,177,17,2011,0,1,1105,0
San Antonio,13,24,20,18,10,0,0,0,Orlando,19,21,18,17,8,0,0,0,20120118,85,83,-6,-3,-1,0,2,168,-2,2011,1,2,1035,0
Oklahoma City,22,29,25,26,0,0,0,0,Washington,18,28,26,33,0,0,0,0,20120118,102,105,-4,-5,-4,3,3,207,3,2011,0,2,1149,0
Indiana,23,27,30,8,0,0,0,0,Sacramento,19,26,21,26,0,0,0,0,20120118,88,92,-4,-5,-14,4,4,180,4,2011,0,2,1882,0
Denver,19,32,27,18,12,0,0,0,Philadelphia,28,17,27,24,8,0,0,0,20120118,108,104,-9,6,6,0,4,212,-4,2011,1,2,1574,0
Phoenix,20,25,19,27,0,0,0,0,New York,19,23,19,27,0,0,0,0,20120118,91,88,1,3,3,3,3,179,-3,2011,0,2,2139,0
Golden State,31,25,27,17,0,0,0,0,Brooklyn,29,26,25,27,0,0,0,0,20120118,100,107,-2,-1,-3,7,7,207,7,2011,0,2,2565,0
Memphis,33,22,17,21,0,0,0,0,New Orleans,22,26,19,20,0,0,0,0,20120118,93,87,11,7,5,6,6,180,-6,2011,0,2,358,0
Detroit,20,22,29,14,0,0,0,0,Minnesota,17,19,28,29,0,0,0,0,20120118,85,93,-3,-6,-7,8,8,178,8,2011,0,2,542,0
Dallas,27,24,20,18,0,0,0,0,LA Clippers,31,21,19,20,0,0,0,0,20120118,89,91,4,1,0,2,2,180,2,2011,0,2,1237,0
Toronto,14,24,17,18,0,0,0,0,Boston,29,15,29,23,0,0,0,0,20120118,73,96,15,6,18,23,23,169,23,2011,0,2,430,0
Portland,17,25,20,27,0,0,0,0,Atlanta,21,30,24,17,0,0,0,0,20120118,89,92,4,9,13,3,3,181,3,2011,0,2,2168,0
New Orleans,27,22,14,19,6,0,0,0,Houston,32,26,17,7,8,0,0,0,20120119,88,90,5,9,12,0,2,178,2,2011,1,3,317,0
LA Lakers,20,17,19,31,0,0,0,0,Miami,25,27,25,21,0,0,0,0,20120119,87,98,5,15,21,11,11,185,11,2011,0,3,2335,0
Dallas,25,34,12,23,0,0,0,0,Utah,22,28,21,20,0,0,0,0,20120119,94,91,3,9,0,3,3,185,-3,2011,0,3,998,0
Denver,27,34,25,22,0,0,0,0,Washington,37,26,18,23,0,0,0,0,20120120,108,104,-10,-2,5,4,4,212,-4,2011,0,4,1489,0
Portland,27,20,24,23,0,0,0,0,Toronto,14,18,28,24,0,0,0,0,20120120,94,84,13,15,11,10,10,178,-10,2011,0,4,2108,0
Sacramento,32,18,23,15,0,0,0,0,San Antonio,20,27,20,19,0,0,0,0,20120120,88,86,12,3,6,2,2,174,-2,2011,0,4,1456,0
Atlanta,24,23,10,19,0,0,0,0,Philadelphia,18,21,25,26,0,0,0,0,20120120,76,90,-6,-8,7,14,14,166,14,2011,0,4,665,0
LA Lakers,10,21,21,28,0,0,0,0,Orlando,22,26,19,25,0,0,0,0,20120120,80,92,12,17,15,12,12,172,12,2011,0,4,2197,0
Indiana,27,16,24,27,0,0,0,0,Golden State,23,20,26,22,0,0,0,0,20120120,94,91,4,0,-2,3,3,185,-3,2011,0,4,1944,0
Minnesota,22,26,24,29,0,0,0,0,LA Clippers,31,28,20,19,0,0,0,0,20120120,101,98,-9,-11,-7,3,3,199,-3,2011,0,4,1521,0
Memphis,22,27,24,25,0,0,0,0,Detroit,12,18,35,16,0,0,0,0,20120120,98,81,10,19,8,17,17,179,-17,2011,0,4,622,0
Chicago,34,29,22,29,0,0,0,0,Cleveland,26,18,17,14,0,0,0,0,20120120,114,75,8,19,24,39,39,189,-39,2011,0,4,308,0
Phoenix,20,26,14,19,0,0,0,0,Boston,15,20,20,16,0,0,0,0,20120120,79,71,5,11,5,8,8,150,-8,2011,0,4,2295,0
Milwaukee,27,28,24,21,0,0,0,0,New York,23,28,16,19,0,0,0,0,20120120,100,86,4,4,12,14,14,186,-14,2011,0,4,732,0
Oklahoma City,28,20,15,21,0,0,0,0,Brooklyn,18,17,16,23,0,0,0,0,20120121,84,74,10,13,12,10,10,158,-10,2011,0,5,1324,0
Minnesota,26,26,29,17,0,0,0,0,Utah,22,32,30,24,0,0,0,0,20120121,98,108,-4,2,3,10,10,206,10,2011,0,5,984,0
Dallas,27,14,23,19,0,0,0,0,New Orleans,23,18,12,28,0,0,0,0,20120121,83,81,4,0,11,2,2,164,-2,2011,0,5,442,0
Philadelphia,28,21,20,23,0,0,0,0,Miami,29,27,25,32,0,0,0,0,20120121,92,113,1,7,12,21,21,205,21,2011,0,5,1021,0
Denver,25,21,26,26,7,14,0,0,New York,24,30,18,26,7,9,0,0,20120121,119,114,1,-8,0,0,5,233,-5,2011,2,5,1627,0
San Antonio,23,26,26,27,0,0,0,0,Houston,28,27,22,28,0,0,0,0,20120121,102,105,5,6,2,3,3,207,3,2011,0,5,189,0
Portland,27,16,25,23,0,0,0,0,Detroit,26,28,19,21,0,0,0,0,20120121,91,94,-1,11,5,3,3,185,3,2011,0,5,1964,0
Charlotte,23,20,26,20,0,0,0,0,Chicago,27,23,30,15,0,0,0,0,20120121,89,95,4,7,11,6,6,184,6,2011,0,5,586,0
Cleveland,19,23,21,31,0,0,0,0,Atlanta,27,34,28,32,0,0,0,0,20120121,94,121,8,19,26,27,27,215,27,2011,0,5,555,0
Sacramento,21,39,16,19,0,0,0,0,Memphis,34,34,34,26,0,0,0,0,20120121,95,128,13,8,26,33,33,223,33,2011,0,5,1745,0
Toronto,11,26,21,33,0,0,0,0,LA Clippers,27,22,27,27,0,0,0,0,20120122,91,103,16,12,18,12,12,194,12,2011,0,6,2170,0
Indiana,14,35,28,21,0,0,0,0,LA Lakers,27,25,26,18,0,0,0,0,20120122,98,96,-13,-3,-1,2,2,194,-2,2011,0,6,1805,0
Milwaukee,18,28,19,26,0,0,0,0,Miami,21,20,22,19,0,0,0,0,20120122,91,82,-3,5,2,9,9,173,-9,2011,0,6,1269,0
Charlotte,21,21,19,26,0,0,0,0,Brooklyn,28,30,17,22,0,0,0,0,20120122,87,97,7,16,14,10,10,184,10,2011,0,6,531,0
Boston,20,29,24,27,0,0,0,0,Washington,21,19,29,25,0,0,0,0,20120122,100,94,-1,9,4,6,6,194,-6,2011,0,6,394,0
Sacramento,21,17,18,33,0,0,0,0,Portland,21,32,21,27,0,0,0,0,20120123,89,101,0,15,18,12,12,190,12,2011,0,0,483,0
Washington,14,18,26,25,0,0,0,0,Philadelphia,33,29,23,18,0,0,0,0,20120123,83,103,19,30,27,20,20,186,20,2011,0,0,123,0
Detroit,12,21,25,21,0,0,0,0,Oklahoma City,29,31,25,14,0,0,0,0,20120123,79,99,17,27,27,20,20,178,20,2011,0,0,909,0
San Antonio,30,26,23,25,0,0,0,0,New Orleans,28,27,25,22,0,0,0,0,20120123,104,102,2,1,-1,2,2,206,-2,2011,0,0,506,0
Houston,28,26,22,31,0,0,0,0,Minnesota,19,28,24,21,0,0,0,0,20120123,107,92,9,7,5,15,15,199,-15,2011,0,0,1057,0
Memphis,13,22,17,39,0,0,0,0,Golden State,21,23,24,22,0,0,0,0,20120123,91,90,-8,-9,-16,1,1,181,-1,2011,0,0,1798,0
Phoenix,27,19,19,22,0,0,0,0,Dallas,32,17,25,19,0,0,0,0,20120123,87,93,5,3,9,6,6,180,6,2011,0,0,884,0
Brooklyn,18,25,25,27,0,0,0,0,Chicago,28,31,26,25,0,0,0,0,20120123,95,110,10,16,17,15,15,205,15,2011,0,0,711,0
Orlando,20,16,10,10,0,0,0,0,Boston,22,24,23,18,0,0,0,0,20120123,56,87,2,10,23,31,31,143,31,2011,0,0,1115,0
Atlanta,28,20,22,27,0,0,0,0,Milwaukee,23,25,16,28,0,0,0,0,20120123,97,92,5,0,6,5,5,189,-5,2011,0,0,669,0
Memphis,25,18,13,28,0,0,0,0,Portland,25,22,23,27,0,0,0,0,20120124,84,97,0,4,14,13,13,181,13,2011,0,1,1845,0
Cleveland,18,19,21,27,0,0,0,0,Miami,17,20,24,31,0,0,0,0,20120124,85,92,-1,0,3,7,7,177,7,2011,0,1,1089,0
Toronto,17,31,31,20,0,0,0,0,Phoenix,27,25,19,25,0,0,0,0,20120124,99,96,-10,-4,8,3,3,195,-3,2011,0,1,1885,0
New York,26,26,21,38,0,0,0,0,Charlotte,23,19,15,21,0,0,0,0,20120124,111,78,3,10,16,33,33,189,-33,2011,0,1,531,0
Orlando,22,23,29,28,0,0,0,0,Indiana,29,16,17,21,0,0,0,0,20120124,102,83,-7,0,12,19,19,185,-19,2011,0,1,822,0
New Orleans,22,29,20,20,0,0,0,0,Oklahoma City,30,30,18,23,0,0,0,0,20120125,91,101,8,9,7,10,10,192,10,2011,0,2,576,0
Charlotte,17,11,21,26,0,0,0,0,Washington,31,17,23,21,0,0,0,0,20120125,75,92,14,20,22,17,17,167,17,2011,0,2,329,0
Toronto,23,27,19,21,10,11,0,0,Utah,32,18,25,15,10,6,0,0,20120125,111,106,-9,0,-6,0,5,217,-5,2011,2,2,1664,0
Atlanta,18,26,17,22,0,0,0,0,San Antonio,24,24,28,29,0,0,0,0,20120125,83,105,6,4,15,22,22,188,22,2011,0,2,881,0
Denver,32,34,28,28,0,0,0,0,Sacramento,26,17,22,28,0,0,0,0,20120125,122,93,6,23,29,29,29,215,-29,2011,0,2,886,0
Brooklyn,22,21,23,16,15,0,0,0,Philadelphia,18,27,16,21,8,0,0,0,20120125,97,90,4,-2,5,0,7,187,-7,2011,1,2,80,0
LA Clippers,27,24,20,20,0,0,0,0,LA Lakers,25,24,19,28,0,0,0,0,20120125,91,96,-2,-2,-3,5,5,187,5,2011,0,2,0,0
Minnesota,26,26,26,27,0,0,0,0,Dallas,27,27,18,18,0,0,0,0,20120125,105,90,-1,-2,6,15,15,195,-15,2011,0,2,863,0
Portland,26,27,20,20,0,0,0,0,Golden State,24,24,31,22,0,0,0,0,20120125,93,101,-2,-5,6,8,8,194,8,2011,0,2,535,0
Indiana,24,20,31,20,0,0,0,0,Chicago,23,31,20,16,0,0,0,0,20120125,95,90,1,-10,1,5,5,185,-5,2011,0,2,163,0
New York,23,22,19,17,0,0,0,0,Cleveland,27,18,24,22,0,0,0,0,20120125,81,91,4,0,5,10,10,172,10,2011,0,2,403,0
Milwaukee,29,13,30,33,0,0,0,0,Houston,23,28,19,29,0,0,0,0,20120125,105,99,6,-9,2,6,6,204,-6,2011,0,2,1005,0
Miami,24,32,24,21,0,0,0,0,Detroit,17,33,24,24,0,0,0,0,20120125,101,98,7,6,6,3,3,199,-3,2011,0,2,1155,0
Memphis,17,27,28,19,0,0,0,0,LA Clippers,29,16,29,24,0,0,0,0,20120126,91,98,12,1,2,7,7,189,7,2011,0,3,1599,0
Boston,16,21,27,27,0,0,0,0,Orlando,32,26,17,8,0,0,0,0,20120126,91,83,-16,-21,-11,8,8,174,-8,2011,0,3,1115,0
Phoenix,24,9,12,26,0,0,0,0,Portland,21,26,31,31,0,0,0,0,20120127,71,109,-3,14,33,38,38,180,38,2011,0,4,1005,0
Charlotte,10,27,14,21,0,0,0,0,Philadelphia,23,36,18,12,0,0,0,0,20120127,72,89,13,22,26,17,17,161,17,2011,0,4,450,0
Orlando,19,15,18,15,0,0,0,0,New Orleans,23,24,22,24,0,0,0,0,20120127,67,93,4,13,17,26,26,160,26,2011,0,4,533,0
San Antonio,22,20,22,15,0,0,0,0,Minnesota,21,20,23,23,0,0,0,0,20120127,79,87,-1,-1,0,8,8,166,8,2011,0,4,1112,0
New York,22,26,23,18,0,0,0,0,Miami,22,30,22,25,0,0,0,0,20120127,89,99,0,4,3,10,10,188,10,2011,0,4,1091,0
Washington,21,20,21,14,0,0,0,0,Houston,17,27,34,25,0,0,0,0,20120127,76,103,-4,3,16,27,27,179,27,2011,0,4,1217,0
Oklahoma City,28,29,28,35,0,0,0,0,Golden State,23,29,25,32,0,0,0,0,20120127,120,109,5,5,8,11,11,229,-11,2011,0,4,1386,0
Atlanta,15,20,28,24,20,0,0,0,Detroit,17,29,22,19,14,0,0,0,20120127,107,101,-2,-11,-5,0,6,208,-6,2011,1,4,597,0
Utah,30,20,32,19,0,0,0,0,Dallas,30,28,30,28,0,0,0,0,20120127,101,116,0,8,6,15,15,217,15,2011,0,4,998,0
Brooklyn,30,17,25,27,0,0,0,0,Cleveland,20,17,24,35,0,0,0,0,20120127,99,96,10,10,11,3,3,195,-3,2011,0,4,403,0
Milwaukee,27,23,18,32,0,0,0,0,Chicago,30,21,28,28,0,0,0,0,20120127,100,107,3,1,11,7,7,207,7,2011,0,4,83,0
Indiana,17,17,27,26,0,0,0,0,Boston,23,19,29,23,0,0,0,0,20120127,87,94,6,8,10,7,7,181,7,2011,0,4,805,0
Toronto,12,20,32,17,0,0,0,0,Denver,28,26,24,18,0,0,0,0,20120127,81,96,16,22,14,15,15,177,15,2011,0,4,1341,0
Detroit,14,17,22,21,0,0,0,0,Philadelphia,24,18,27,26,0,0,0,0,20120128,74,95,10,11,16,21,21,169,21,2011,0,5,441,0
Memphis,16,16,24,28,0,0,0,0,Phoenix,24,24,15,23,0,0,0,0,20120128,84,86,8,16,7,2,2,170,2,2011,0,5,1260,0
Sacramento,26,21,20,26,0,0,0,0,Utah,27,22,29,18,0,0,0,0,20120128,93,96,1,2,11,3,3,189,3,2011,0,5,532,0
LA Lakers,23,20,30,16,0,0,0,0,Milwaukee,27,24,29,20,0,0,0,0,20120128,89,100,4,8,7,11,11,189,11,2011,0,5,1741,0
Washington,26,32,25,19,0,0,0,0,Charlotte,26,22,30,21,0,0,0,0,20120128,102,99,0,10,5,3,3,201,-3,2011,0,5,329,0
New York,21,25,14,24,0,0,0,0,Houston,20,33,22,22,0,0,0,0,20120128,84,97,-1,7,15,13,13,181,13,2011,0,5,1417,0
Cleveland,23,21,18,26,0,0,0,0,Boston,24,19,27,17,0,0,0,0,20120129,88,87,-1,1,-8,1,1,175,-1,2011,0,6,549,0
San Antonio,18,22,18,33,9,0,0,0,Dallas,24,27,18,22,10,0,0,0,20120129,100,101,6,11,11,0,1,201,1,2011,1,6,252,0
LA Clippers,23,25,29,32,0,0,0,0,Denver,26,27,30,22,0,0,0,0,20120129,109,105,-3,-5,-6,4,4,214,-4,2011,0,6,830,0
Chicago,22,29,20,22,0,0,0,0,Miami,24,32,20,21,0,0,0,0,20120129,93,97,2,5,5,4,4,190,4,2011,0,6,1189,0
LA Lakers,22,31,26,27,0,0,0,0,Minnesota,19,26,29,27,0,0,0,0,20120129,106,101,3,8,5,5,5,207,-5,2011,0,6,1521,0
Toronto,24,20,26,24,0,0,0,0,Brooklyn,24,15,14,20,0,0,0,0,20120129,94,73,0,5,17,21,21,167,-21,2011,0,6,341,0
Atlanta,27,19,30,18,0,0,0,0,New Orleans,11,24,17,20,0,0,0,0,20120129,94,72,16,11,24,22,22,166,-22,2011,0,6,424,0
Indiana,29,19,32,26,0,0,0,0,Orlando,22,29,17,17,0,0,0,0,20120129,106,85,7,-3,12,21,21,191,-21,2011,0,6,822,0
Chicago,26,25,25,22,0,0,0,0,Washington,16,24,19,29,0,0,0,0,20120130,98,88,10,11,17,10,10,186,-10,2011,0,0,594,0
Portland,26,19,25,19,0,0,0,0,Utah,20,19,30,24,0,0,0,0,20120130,89,93,-6,-6,-1,4,4,182,4,2011,0,0,634,0
Dallas,31,35,30,26,0,0,0,0,Phoenix,24,24,22,29,0,0,0,0,20120130,122,99,7,18,26,23,23,221,-23,2011,0,0,884,0
Orlando,18,15,9,27,0,0,0,0,Philadelphia,19,18,21,16,0,0,0,0,20120130,69,74,1,4,16,5,5,143,5,2011,0,0,864,0
Minnesota,26,28,42,24,0,0,0,0,Houston,24,32,25,27,0,0,0,0,20120130,120,108,2,-2,15,12,12,228,-12,2011,0,0,1057,0
New Orleans,29,20,19,27,0,0,0,0,Miami,27,24,36,22,0,0,0,0,20120130,95,109,-2,2,19,14,14,204,14,2011,0,0,668,0
San Antonio,24,21,25,13,0,0,0,0,Memphis,19,16,15,23,0,0,0,0,20120130,83,73,5,10,20,10,10,156,-10,2011,0,0,631,0
Oklahoma City,25,21,24,30,0,0,0,0,LA Clippers,36,28,26,22,0,0,0,0,20120130,100,112,11,18,20,12,12,212,12,2011,0,0,1178,0
Detroit,16,25,19,22,0,0,0,0,Milwaukee,30,17,28,28,0,0,0,0,20120130,82,103,14,6,15,21,21,185,21,2011,0,0,251,0
Denver,23,26,18,24,6,0,0,0,Memphis,19,18,23,31,9,0,0,0,20120131,97,100,-4,-12,-7,0,3,197,3,2011,1,1,877,0
Detroit,24,21,12,29,0,0,0,0,New York,33,24,24,32,0,0,0,0,20120131,86,113,9,12,24,27,27,199,27,2011,0,1,480,0
Charlotte,18,18,22,15,0,0,0,0,LA Lakers,30,30,13,33,0,0,0,0,20120131,73,106,12,24,15,33,33,179,33,2011,0,1,2115,0
Atlanta,23,33,21,23,0,0,0,0,Toronto,18,19,23,17,0,0,0,0,20120131,100,77,5,19,17,23,23,177,-23,2011,0,1,733,0
Sacramento,23,24,21,22,0,0,0,0,Golden State,24,21,22,26,0,0,0,0,20120131,90,93,1,-2,-1,3,3,183,3,2011,0,1,75,0
Boston,28,23,25,17,0,0,0,0,Cleveland,24,15,19,32,0,0,0,0,20120131,93,90,4,12,18,3,3,183,-3,2011,0,1,549,0
Brooklyn,24,29,19,27,0,0,0,0,Indiana,28,27,29,22,0,0,0,0,20120131,99,106,4,2,12,7,7,205,7,2011,0,1,643,0
LA Clippers,32,24,16,35,0,0,0,0,Utah,29,29,16,31,0,0,0,0,20120201,107,105,3,-2,-2,2,2,212,-2,2011,0,2,579,0
Chicago,21,23,11,27,0,0,0,0,Philadelphia,27,22,26,23,0,0,0,0,20120201,82,98,6,5,20,16,16,180,16,2011,0,2,664,0
Houston,27,25,19,20,0,0,0,0,San Antonio,16,23,28,32,0,0,0,0,20120201,91,99,-11,-13,-4,8,8,190,8,2011,0,2,189,0
Charlotte,18,17,13,20,0,0,0,0,Portland,35,26,31,20,0,0,0,0,20120201,68,112,17,26,44,44,44,180,44,2011,0,2,2284,0
Washington,20,23,25,35,0,0,0,0,Orlando,25,22,22,40,0,0,0,0,20120201,103,109,5,4,1,6,6,212,6,2011,0,2,757,0
Toronto,16,19,14,15,0,0,0,0,Boston,29,28,20,23,0,0,0,0,20120201,64,100,13,22,28,36,36,164,36,2011,0,2,430,0
Detroit,23,15,33,25,0,0,0,0,Brooklyn,23,26,23,27,0,0,0,0,20120201,96,99,0,11,1,3,3,195,3,2011,0,2,480,0
Oklahoma City,21,28,22,24,0,0,0,0,Dallas,29,23,14,20,0,0,0,0,20120201,95,86,-8,-3,5,9,9,181,-9,2011,0,2,189,0
Phoenix,25,31,32,32,0,0,0,0,New Orleans,27,32,28,16,0,0,0,0,20120201,120,103,-2,-3,1,17,17,223,-17,2011,0,2,1312,0
Indiana,20,25,31,33,0,0,0,0,Minnesota,25,16,29,29,0,0,0,0,20120201,109,99,-5,4,6,10,10,208,-10,2011,0,2,510,0
Miami,40,20,19,18,0,0,0,0,Milwaukee,23,24,29,29,0,0,0,0,20120201,97,105,-17,-13,-3,8,8,202,8,2011,0,2,1269,0
Memphis,21,32,26,17,0,0,0,0,Atlanta,19,24,12,22,0,0,0,0,20120202,96,77,2,10,24,19,19,173,-19,2011,0,3,336,0
Utah,22,24,31,24,0,0,0,0,Golden State,25,23,40,31,0,0,0,0,20120202,101,119,3,2,11,18,18,220,18,2011,0,3,599,0
Denver,19,35,32,26,0,0,0,0,LA Clippers,32,19,16,24,0,0,0,0,20120202,112,91,-13,3,19,21,21,203,-21,2011,0,3,830,0
Chicago,29,26,22,28,0,0,0,0,New York,25,19,31,27,0,0,0,0,20120202,105,102,4,11,2,3,3,207,-3,2011,0,3,711,0
Portland,30,26,13,23,0,0,0,0,Sacramento,27,20,24,24,0,0,0,0,20120202,92,95,-3,-9,2,3,3,187,3,2011,0,3,483,0
New Orleans,22,23,23,13,0,0,0,0,San Antonio,23,21,27,22,0,0,0,0,20120202,81,93,1,-1,3,12,12,174,12,2011,0,3,506,0
Washington,22,23,24,20,0,0,0,0,Toronto,22,33,25,26,0,0,0,0,20120203,89,106,0,10,11,17,17,195,17,2011,0,4,349,0
Miami,25,26,16,32,0,0,0,0,Philadelphia,24,23,16,16,0,0,0,0,20120203,99,79,1,4,4,20,20,178,-20,2011,0,4,1021,0
Cleveland,17,20,16,41,0,0,0,0,Orlando,18,30,24,30,0,0,0,0,20120203,94,102,1,11,19,8,8,196,8,2011,0,4,895,0
Memphis,30,20,27,17,0,0,0,0,Oklahoma City,25,19,25,32,0,0,0,0,20120203,94,101,-5,-6,-8,7,7,195,7,2011,0,4,421,0
Minnesota,23,26,31,28,0,0,0,0,Brooklyn,19,31,25,30,0,0,0,0,20120203,108,105,4,-1,5,3,3,213,-3,2011,0,4,1016,0
Milwaukee,26,15,20,19,0,0,0,0,Detroit,26,25,21,16,0,0,0,0,20120203,80,88,0,10,11,8,8,168,8,2011,0,4,251,0
LA Lakers,23,21,28,21,0,0,0,0,Denver,21,20,27,21,0,0,0,0,20120203,93,89,2,3,4,4,4,182,-4,2011,0,4,830,0
Indiana,29,23,24,22,0,0,0,0,Dallas,28,25,16,18,0,0,0,0,20120203,98,87,1,-1,7,11,11,185,-11,2011,0,4,763,0
New York,28,27,17,17,0,0,0,0,Boston,27,22,20,22,0,0,0,0,20120203,89,91,-1,-6,-3,2,2,180,2,2011,0,4,190,0
Phoenix,20,19,22,20,0,0,0,0,Houston,30,29,21,19,0,0,0,0,20120203,81,99,10,20,19,18,18,180,18,2011,0,4,1014,0
LA Clippers,28,30,29,20,0,0,0,0,Washington,17,17,19,28,0,0,0,0,20120204,107,81,11,24,34,26,26,188,-26,2011,0,5,2294,0
LA Lakers,25,24,18,20,0,0,0,0,Utah,22,25,20,29,0,0,0,0,20120204,87,96,-3,-2,0,9,9,183,9,2011,0,5,579,0
Oklahoma City,21,26,23,26,0,0,0,0,San Antonio,25,32,31,19,0,0,0,0,20120204,96,107,4,10,18,11,11,203,11,2011,0,5,421,0
Golden State,28,26,22,26,4,0,0,0,Sacramento,27,26,34,15,12,0,0,0,20120204,106,114,-1,-1,11,0,8,220,8,2011,1,5,75,0
Denver,26,27,18,26,0,0,0,0,Portland,33,26,26,32,0,0,0,0,20120204,97,117,7,6,14,20,20,214,20,2011,0,5,981,0
Charlotte,24,24,24,17,0,0,0,0,Phoenix,25,17,30,23,0,0,0,0,20120204,89,95,1,-6,0,6,6,184,6,2011,0,5,1778,0
Chicago,30,37,20,26,0,0,0,0,Milwaukee,16,27,21,26,0,0,0,0,20120204,113,90,14,24,23,23,23,203,-23,2011,0,5,83,0
Houston,25,17,30,19,0,0,0,0,Minnesota,33,22,26,19,0,0,0,0,20120204,91,100,8,13,9,9,9,191,9,2011,0,5,1057,0
Brooklyn,30,18,24,20,0,0,0,0,New York,20,26,24,29,0,0,0,0,20120204,92,99,-10,-2,-2,7,7,191,7,2011,0,5,0,0
Philadelphia,20,37,24,17,0,0,0,0,Atlanta,21,20,21,25,0,0,0,0,20120204,98,87,-1,16,19,11,11,185,-11,2011,0,5,665,0
New Orleans,23,21,17,26,0,0,0,0,Detroit,25,16,24,24,0,0,0,0,20120204,87,89,2,-3,4,2,2,176,2,2011,0,5,939,0
Orlando,23,16,23,23,0,0,0,0,Indiana,21,18,14,28,0,0,0,0,20120204,85,81,2,0,9,4,4,166,-4,2011,0,5,822,0
Dallas,24,27,13,24,0,0,0,0,Cleveland,15,28,27,21,0,0,0,0,20120204,88,91,-9,-8,6,3,3,179,3,2011,0,5,1024,0
Memphis,16,19,26,19,0,0,0,0,Boston,24,19,26,29,0,0,0,0,20120205,80,98,8,8,8,18,18,178,18,2011,0,6,1134,0
Toronto,27,21,14,27,0,0,0,0,Miami,31,22,22,20,0,0,0,0,20120205,89,95,4,5,13,6,6,184,6,2011,0,6,1234,0
Phoenix,27,28,29,15,0,0,0,0,Atlanta,23,25,16,26,0,0,0,0,20120206,99,90,4,7,20,9,9,189,-9,2011,0,0,1588,0
San Antonio,26,26,15,22,0,0,0,0,Memphis,18,28,27,11,0,0,0,0,20120206,89,84,8,6,-6,5,5,173,-5,2011,0,0,631,0
Chicago,35,27,21,25,0,0,0,0,Brooklyn,14,23,27,23,0,0,0,0,20120206,108,87,21,25,19,21,21,195,-21,2011,0,0,711,0
Sacramento,20,19,30,31,0,0,0,0,New Orleans,29,23,26,14,0,0,0,0,20120206,100,92,-9,-13,-9,8,8,192,-8,2011,0,0,1879,0
Utah,16,22,35,15,0,0,0,0,New York,19,32,24,24,0,0,0,0,20120206,88,99,3,13,2,11,11,187,11,2011,0,0,1967,0
LA Clippers,21,21,23,29,13,0,0,0,Orlando,30,17,15,32,8,0,0,0,20120206,107,102,-9,-5,3,0,5,209,-5,2011,1,0,2197,0
LA Lakers,24,26,19,21,0,0,0,0,Philadelphia,21,25,24,25,0,0,0,0,20120206,90,95,-3,-4,1,5,5,185,5,2011,0,0,2388,0
Oklahoma City,29,31,25,18,8,0,0,0,Portland,31,21,27,24,4,0,0,0,20120206,111,107,-2,8,6,0,4,218,-4,2011,1,0,1484,0
Toronto,19,23,30,33,3,0,0,0,Washington,29,28,25,23,6,0,0,0,20120206,108,111,10,15,10,0,3,219,3,2011,1,0,349,0
Houston,26,21,26,26,0,0,0,0,Denver,28,17,26,19,0,0,0,0,20120206,99,90,-2,2,2,9,9,189,-9,2011,0,0,878,0
Phoenix,34,33,21,19,0,0,0,0,Milwaukee,30,20,31,24,0,0,0,0,20120207,107,105,4,17,7,2,2,212,-2,2011,0,1,1462,0
Sacramento,16,20,24,24,0,0,0,0,Minnesota,31,17,21,17,0,0,0,0,20120207,84,86,15,12,9,2,2,170,2,2011,0,1,1511,0
Cleveland,25,23,24,19,0,0,0,0,Miami,28,26,24,29,0,0,0,0,20120207,91,107,3,6,6,16,16,198,16,2011,0,1,1089,0
Oklahoma City,29,30,32,28,0,0,0,0,Golden State,35,22,36,23,0,0,0,0,20120207,119,116,-6,2,-2,3,3,235,-3,2011,0,1,1386,0
Charlotte,22,16,24,22,0,0,0,0,Boston,27,18,24,25,0,0,0,0,20120207,84,94,5,7,7,10,10,178,10,2011,0,1,720,0
Utah,23,23,31,22,0,0,0,0,Indiana,27,30,27,20,0,0,0,0,20120207,99,104,4,11,7,5,5,203,5,2011,0,1,1353,0
New York,17,35,25,30,0,0,0,0,Washington,23,23,22,25,0,0,0,0,20120208,107,93,-6,6,9,14,14,200,-14,2011,0,2,204,0
Milwaukee,28,30,18,29,0,0,0,0,Toronto,29,22,22,26,0,0,0,0,20120208,105,99,-1,7,3,6,6,204,-6,2011,0,2,429,0
San Antonio,26,22,27,25,0,0,0,0,Philadelphia,24,21,22,23,0,0,0,0,20120208,100,90,2,3,8,10,10,190,-10,2011,0,2,1505,0
Miami,18,32,11,28,0,0,0,0,Orlando,26,27,24,25,0,0,0,0,20120208,89,102,8,3,16,13,13,191,13,2011,0,2,204,0
Chicago,23,21,26,20,0,0,0,0,New Orleans,14,17,15,21,0,0,0,0,20120208,90,67,9,13,24,23,23,157,-23,2011,0,2,832,0
Houston,30,30,17,26,0,0,0,0,Portland,28,18,24,26,0,0,0,0,20120208,103,96,2,14,7,7,7,199,-7,2011,0,2,1833,0
Minnesota,21,13,20,26,0,0,0,0,Memphis,26,18,22,19,0,0,0,0,20120208,80,85,5,10,12,5,5,165,5,2011,0,2,700,0
Dallas,33,31,23,18,0,0,0,0,Denver,25,28,25,17,0,0,0,0,20120208,105,95,8,11,9,10,10,200,-10,2011,0,2,661,0
LA Clippers,24,16,24,28,0,0,0,0,Cleveland,19,21,30,29,0,0,0,0,20120208,92,99,-5,0,6,7,7,191,7,2011,0,2,2044,0
Indiana,21,20,31,15,0,0,0,0,Atlanta,32,27,21,17,0,0,0,0,20120208,87,97,11,18,8,10,10,184,10,2011,0,2,427,0
Detroit,20,31,23,25,0,0,0,0,Brooklyn,20,19,28,25,0,0,0,0,20120208,99,92,0,12,7,7,7,191,-7,2011,0,2,480,0
LA Lakers,22,23,22,15,6,0,0,0,Boston,26,21,17,18,5,0,0,0,20120209,88,87,-4,-2,3,0,1,175,-1,2011,1,3,2590,0
Golden State,27,20,37,25,0,0,0,0,Denver,28,23,20,30,0,0,0,0,20120209,109,101,-1,-4,13,8,8,210,-8,2011,0,3,947,0
Houston,26,28,20,22,0,0,0,0,Phoenix,29,15,32,13,0,0,0,0,20120209,96,89,-3,10,-2,7,7,185,-7,2011,0,3,1014,0
Oklahoma City,19,36,23,23,0,0,0,0,Sacramento,23,34,19,30,0,0,0,0,20120209,101,106,4,2,-2,5,5,207,5,2011,0,3,1336,0
Miami,23,29,22,32,0,0,0,0,Washington,19,23,25,22,0,0,0,0,20120210,106,89,4,10,7,17,17,195,-17,2011,0,4,924,0
Oklahoma City,27,22,25,27,0,0,0,0,Utah,30,14,21,22,0,0,0,0,20120210,101,87,-3,5,9,14,14,188,-14,2011,0,4,861,0
Boston,14,20,17,23,0,0,0,0,Toronto,26,15,22,23,0,0,0,0,20120210,74,86,12,7,12,12,12,160,12,2011,0,4,430,0
LA Clippers,18,23,19,18,0,0,0,0,Philadelphia,27,16,18,16,0,0,0,0,20120210,78,77,-9,-2,-1,1,1,155,-1,2011,0,4,2388,0
LA Lakers,15,26,19,25,0,0,0,0,New York,22,27,17,26,0,0,0,0,20120210,85,92,7,8,6,7,7,177,7,2011,0,4,2445,0
Atlanta,20,21,20,17,11,0,0,0,Orlando,17,22,15,24,9,0,0,0,20120210,89,87,3,2,7,0,2,176,-2,2011,1,4,401,0
Dallas,29,27,22,26,0,0,0,0,Minnesota,16,29,28,24,0,0,0,0,20120210,104,97,13,11,5,7,7,201,-7,2011,0,4,863,0
Indiana,22,25,26,19,0,0,0,0,Memphis,22,25,26,25,0,0,0,0,20120210,92,98,0,0,0,6,6,190,6,2011,0,4,383,0
Brooklyn,15,18,31,28,0,0,0,0,Detroit,24,28,35,22,0,0,0,0,20120210,92,109,9,19,23,17,17,201,17,2011,0,4,480,0
Milwaukee,28,25,24,25,11,0,0,0,Cleveland,25,32,28,17,10,0,0,0,20120210,113,112,3,-4,-8,0,1,225,-1,2011,1,4,334,0
Chicago,30,26,23,16,0,0,0,0,Charlotte,16,18,17,13,0,0,0,0,20120210,95,64,14,22,28,31,31,159,-31,2011,0,4,586,0
Portland,21,21,28,24,0,0,0,0,New Orleans,19,27,21,19,0,0,0,0,20120210,94,86,2,-4,3,8,8,180,-8,2011,0,4,2059,0
San Antonio,24,31,22,26,0,0,0,0,Brooklyn,22,18,19,30,0,0,0,0,20120211,103,89,2,15,18,14,14,192,-14,2011,0,5,1581,0
New York,30,24,28,18,0,0,0,0,Minnesota,33,29,25,11,0,0,0,0,20120211,100,98,-3,-8,-5,2,2,198,-2,2011,0,5,1016,0
Orlando,16,27,29,27,0,0,0,0,Milwaukee,21,28,24,21,0,0,0,0,20120211,99,94,-5,-6,-1,5,5,193,-5,2011,0,5,1065,0
Phoenix,31,22,22,23,0,0,0,0,Sacramento,24,20,16,24,0,0,0,0,20120211,98,84,7,9,15,14,14,182,-14,2011,0,5,634,0
Portland,14,18,23,26,6,7,0,0,Dallas,25,18,18,20,6,10,0,0,20120211,94,97,11,11,6,0,3,191,3,2011,2,5,1630,0
Philadelphia,21,37,21,20,0,0,0,0,Cleveland,19,22,19,24,0,0,0,0,20120211,99,84,2,17,19,15,15,183,-15,2011,0,5,358,0
LA Clippers,24,31,29,27,0,0,0,0,Charlotte,16,21,15,34,0,0,0,0,20120211,111,86,8,18,32,25,25,197,-25,2011,0,5,2115,0
Denver,26,34,27,26,0,0,0,0,Indiana,35,25,24,25,0,0,0,0,20120211,113,109,-9,0,3,4,4,222,-4,2011,0,5,998,0
LA Lakers,34,20,19,21,0,0,0,0,Toronto,19,27,21,25,0,0,0,0,20120212,94,92,15,8,6,2,2,186,-2,2011,0,6,2170,0
Houston,29,15,30,23,0,0,0,0,Golden State,23,25,28,30,0,0,0,0,20120212,97,106,-6,4,2,9,9,203,9,2011,0,6,1642,0
Utah,22,24,23,29,0,0,0,0,Memphis,18,22,26,22,0,0,0,0,20120212,98,88,4,6,3,10,10,186,-10,2011,0,6,1247,0
Chicago,23,20,23,25,0,0,0,0,Boston,28,20,24,23,0,0,0,0,20120212,91,95,5,5,6,4,4,186,4,2011,0,6,849,0
Miami,30,33,25,19,0,0,0,0,Atlanta,18,23,20,26,0,0,0,0,20120212,107,87,12,22,27,20,20,194,-20,2011,0,6,605,0
Washington,26,19,29,24,0,0,0,0,Detroit,18,27,18,14,0,0,0,0,20120212,98,77,8,0,11,21,21,175,-21,2011,0,6,394,0
Minnesota,26,18,22,23,0,0,0,0,Orlando,29,26,24,23,0,0,0,0,20120213,89,102,3,11,13,13,13,191,13,2011,0,0,1309,0
Philadelphia,28,27,16,27,0,0,0,0,Charlotte,17,28,22,22,0,0,0,0,20120213,98,89,11,10,4,9,9,187,-9,2011,0,0,450,0
LA Clippers,19,28,29,16,0,0,0,0,Dallas,27,28,19,22,0,0,0,0,20120213,92,96,8,8,-2,4,4,188,4,2011,0,0,1237,0
Phoenix,27,19,27,23,0,0,0,0,Golden State,20,23,33,26,0,0,0,0,20120213,96,102,-7,-3,3,6,6,198,6,2011,0,0,652,0
Miami,27,28,35,24,0,0,0,0,Milwaukee,30,20,24,22,0,0,0,0,20120213,114,96,-3,5,16,18,18,210,-18,2011,0,0,1269,0
Utah,21,15,15,29,0,0,0,0,New Orleans,20,21,25,20,0,0,0,0,20120213,80,86,-1,5,15,6,6,166,6,2011,0,0,1432,0
Washington,28,30,33,33,0,0,0,0,Portland,26,20,36,27,0,0,0,0,20120214,124,109,2,12,9,15,15,233,-15,2011,0,1,2347,0
Houston,17,26,21,19,0,0,0,0,Memphis,21,31,20,21,0,0,0,0,20120214,83,93,4,9,8,10,10,176,10,2011,0,1,484,0
New York,21,15,30,24,0,0,0,0,Toronto,28,19,28,12,0,0,0,0,20120214,90,87,-7,-11,-9,3,3,177,-3,2011,0,1,341,0
Atlanta,24,17,10,27,0,0,0,0,LA Lakers,27,15,17,27,0,0,0,0,20120214,78,86,3,1,8,8,8,164,8,2011,0,1,1932,0
Utah,19,20,24,22,0,0,0,0,Oklahoma City,25,28,26,32,0,0,0,0,20120214,85,111,6,14,16,26,26,196,26,2011,0,1,861,0
San Antonio,32,23,19,25,0,0,0,0,Detroit,22,24,16,33,0,0,0,0,20120214,99,95,10,9,12,4,4,194,-4,2011,0,1,1238,0
Sacramento,24,28,25,38,0,0,0,0,Chicago,27,29,32,33,0,0,0,0,20120214,115,121,3,4,11,6,6,236,6,2011,0,1,1788,0
Miami,33,35,22,15,0,0,0,0,Indiana,16,23,19,32,0,0,0,0,20120214,105,90,17,29,32,15,15,195,-15,2011,0,1,1026,0
Phoenix,21,30,19,22,0,0,0,0,Denver,33,25,28,23,0,0,0,0,20120214,92,109,12,7,16,17,17,201,17,2011,0,1,585,0
San Antonio,25,30,28,30,0,0,0,0,Toronto,17,28,33,28,0,0,0,0,20120215,113,106,8,10,5,7,7,219,-7,2011,0,2,1438,0
Atlanta,21,26,26,28,0,0,0,0,Phoenix,31,25,21,22,0,0,0,0,20120215,101,99,-10,-9,-4,2,2,200,-2,2011,0,2,1588,0
Philadelphia,16,23,31,17,0,0,0,0,Orlando,29,26,24,24,0,0,0,0,20120215,87,103,13,16,9,16,16,190,16,2011,0,2,864,0
Memphis,23,30,24,28,0,0,0,0,Brooklyn,28,27,23,22,0,0,0,0,20120215,105,100,-5,-2,-1,5,5,205,-5,2011,0,2,953,0
Charlotte,30,18,18,24,0,0,0,0,Minnesota,25,21,30,26,0,0,0,0,20120215,90,102,-5,-2,10,12,12,192,12,2011,0,2,938,0
New Orleans,27,23,22,20,0,0,0,0,Milwaukee,28,17,20,24,0,0,0,0,20120215,92,89,-1,5,7,3,3,181,-3,2011,0,2,911,0
Sacramento,17,19,19,30,0,0,0,0,New York,25,29,23,23,0,0,0,0,20120215,85,100,8,18,22,15,15,185,15,2011,0,2,2499,0
Oklahoma City,13,31,29,22,0,0,0,0,Houston,29,16,30,21,0,0,0,0,20120215,95,96,16,1,2,1,1,191,1,2011,0,2,413,0
Portland,20,37,15,21,0,0,0,0,Golden State,27,27,16,21,0,0,0,0,20120215,93,91,-7,3,2,2,2,184,-2,2011,0,2,535,0
Denver,17,22,15,30,0,0,0,0,Dallas,27,24,32,19,0,0,0,0,20120215,84,102,10,12,29,18,18,186,18,2011,0,2,661,0
Indiana,20,18,23,26,0,0,0,0,Cleveland,32,24,23,19,0,0,0,0,20120215,87,98,12,18,18,11,11,185,11,2011,0,2,262,0
Detroit,26,21,26,25,0,0,0,0,Boston,28,21,23,16,0,0,0,0,20120215,98,88,-2,-2,1,10,10,186,-10,2011,0,2,611,0
Washington,20,27,19,18,0,0,0,0,LA Clippers,23,27,24,28,0,0,0,0,20120215,84,102,3,3,8,18,18,186,18,2011,0,2,2294,0
Boston,24,11,24,21,0,0,0,0,Chicago,18,26,16,29,0,0,0,0,20120216,80,89,-6,9,1,9,9,169,9,2011,0,3,849,0
Brooklyn,29,21,15,23,0,0,0,0,Indiana,21,29,14,29,0,0,0,0,20120216,88,93,-8,0,-1,5,5,181,5,2011,0,3,643,0
LA Clippers,20,12,20,22,0,0,0,0,Portland,27,16,17,11,0,0,0,0,20120216,74,71,-7,-11,-8,3,3,145,-3,2011,0,3,826,0
Milwaukee,27,19,28,11,0,0,0,0,Orlando,15,29,28,22,0,0,0,0,20120217,85,94,-12,-2,-2,9,9,179,9,2011,0,4,1065,0
Washington,20,30,28,22,0,0,0,0,Utah,32,30,38,14,0,0,0,0,20120217,100,114,12,12,22,14,14,214,14,2011,0,4,1841,0
Charlotte,22,25,21,30,0,0,0,0,Toronto,23,22,24,22,0,0,0,0,20120217,98,91,-1,2,-1,7,7,189,-7,2011,0,4,585,0
Dallas,21,16,24,21,0,0,0,0,Philadelphia,27,24,8,16,0,0,0,0,20120217,82,75,-6,-14,2,7,7,157,-7,2011,0,4,1297,0
New Orleans,27,16,25,21,0,0,0,0,New York,13,26,19,27,0,0,0,0,20120217,89,85,14,4,10,4,4,174,-4,2011,0,4,1168,0
Golden State,24,24,17,22,0,0,0,0,Oklahoma City,20,38,26,26,0,0,0,0,20120217,87,110,-4,10,19,23,23,197,23,2011,0,4,1386,0
Phoenix,25,23,25,26,0,0,0,0,LA Lakers,21,36,30,24,0,0,0,0,20120217,99,111,-4,9,14,12,12,210,12,2011,0,4,356,0
Minnesota,30,31,30,20,0,0,0,0,Houston,29,25,23,21,0,0,0,0,20120217,111,98,1,7,14,13,13,209,-13,2011,0,4,1057,0
Sacramento,31,29,28,20,0,0,0,0,Detroit,24,32,30,28,0,0,0,0,20120217,108,114,-7,-4,-2,6,6,222,6,2011,0,4,2020,0
Miami,35,28,27,21,0,0,0,0,Cleveland,14,24,29,20,0,0,0,0,20120217,111,87,21,25,23,24,24,198,-24,2011,0,4,1089,0
Denver,15,28,30,29,0,0,0,0,Memphis,34,26,23,20,0,0,0,0,20120217,102,103,19,17,10,1,1,205,1,2011,0,4,877,0
Brooklyn,34,25,14,24,0,0,0,0,Chicago,19,26,11,29,0,0,0,0,20120218,97,85,15,14,17,12,12,182,-12,2011,0,5,711,0
San Antonio,15,30,25,25,8,0,0,0,LA Clippers,26,17,24,28,5,0,0,0,20120218,103,100,-11,2,3,0,3,203,-3,2011,1,5,1201,0
Golden State,19,37,22,25,0,0,0,0,Memphis,34,20,22,28,0,0,0,0,20120218,103,104,15,-2,-2,1,1,207,1,2011,0,5,1798,0
Atlanta,25,12,19,21,0,0,0,0,Portland,33,19,20,25,0,0,0,0,20120218,77,97,8,15,16,20,20,174,20,2011,0,5,2168,0
Utah,22,24,18,21,0,0,0,0,Houston,23,22,27,29,0,0,0,0,20120219,85,101,1,-1,8,16,16,186,16,2011,0,6,1199,0
Denver,27,31,25,28,7,0,0,0,Oklahoma City,25,28,30,28,13,0,0,0,20120219,118,124,-2,-5,0,0,6,242,6,2011,1,6,503,0
Dallas,20,25,30,22,0,0,0,0,New York,32,16,24,32,0,0,0,0,20120219,97,104,12,3,-3,7,7,201,7,2011,0,6,1370,0
Milwaukee,23,20,27,22,0,0,0,0,Brooklyn,17,19,20,29,0,0,0,0,20120219,92,85,6,7,14,7,7,177,-7,2011,0,6,732,0
Philadelphia,24,25,25,17,0,0,0,0,Minnesota,22,22,28,20,0,0,0,0,20120219,91,92,-2,-5,-2,1,1,183,1,2011,0,6,983,0
Sacramento,31,18,19,24,0,0,0,0,Cleveland,27,23,25,18,0,0,0,0,20120219,92,93,-4,1,7,1,1,185,1,2011,0,6,2096,0
Charlotte,12,21,15,25,0,0,0,0,Indiana,24,29,35,20,0,0,0,0,20120219,73,108,12,20,40,35,35,181,35,2011,0,6,428,0
Boston,26,16,19,20,0,0,0,0,Detroit,26,29,20,21,0,0,0,0,20120219,81,96,0,13,14,15,15,177,15,2011,0,6,611,0
LA Lakers,19,21,27,23,0,0,0,0,Phoenix,35,28,19,20,0,0,0,0,20120219,90,102,16,23,15,12,12,192,12,2011,0,6,356,0
Orlando,19,12,23,24,0,0,0,0,Miami,22,21,27,20,0,0,0,0,20120219,78,90,3,12,16,12,12,168,12,2011,0,6,204,0
Brooklyn,18,32,32,18,0,0,0,0,New York,21,21,22,28,0,0,0,0,20120220,100,92,-3,8,18,8,8,192,-8,2011,0,0,0,0
Orlando,27,22,18,26,0,0,0,0,Milwaukee,29,19,22,20,0,0,0,0,20120220,93,90,-2,1,-3,3,3,183,-3,2011,0,0,1065,0
San Antonio,26,30,24,26,0,0,0,0,Utah,30,23,27,22,0,0,0,0,20120220,106,102,-4,3,0,4,4,208,-4,2011,0,0,1087,0
New Orleans,18,20,31,24,0,0,0,0,Oklahoma City,31,29,24,17,0,0,0,0,20120220,93,101,13,22,15,8,8,194,8,2011,0,0,576,0
Portland,7,23,36,26,0,0,0,0,LA Lakers,29,23,28,23,0,0,0,0,20120220,92,103,22,22,14,11,11,195,11,2011,0,0,826,0
Washington,25,23,13,27,0,0,0,0,Phoenix,31,22,32,19,0,0,0,0,20120220,88,104,6,5,24,16,16,192,16,2011,0,0,1977,0
LA Clippers,23,33,18,23,0,0,0,0,Golden State,29,27,21,27,0,0,0,0,20120220,97,104,6,0,3,7,7,201,7,2011,0,0,347,0
Minnesota,30,16,27,20,8,0,0,0,Denver,18,33,25,17,10,0,0,0,20120220,101,103,-12,5,3,0,2,204,2,2011,1,0,698,0
Boston,15,19,19,20,0,0,0,0,Dallas,20,24,26,19,0,0,0,0,20120220,73,89,5,10,17,16,16,162,16,2011,0,0,1548,0
Memphis,28,26,22,17,0,0,0,0,Houston,31,27,18,21,0,0,0,0,20120220,93,97,3,4,0,4,4,190,4,2011,0,0,484,0
Atlanta,17,20,27,15,0,0,0,0,Chicago,35,20,18,17,0,0,0,0,20120220,79,90,18,18,9,11,11,169,11,2011,0,0,587,0
Detroit,29,26,22,23,0,0,0,0,Cleveland,30,14,22,35,0,0,0,0,20120221,100,101,1,-11,-11,1,1,201,1,2011,0,1,90,0
New Orleans,31,25,20,24,8,0,0,0,Indiana,24,29,27,20,17,0,0,0,20120221,108,117,-7,-3,4,0,9,225,9,2011,1,1,713,0
Philadelphia,10,32,18,16,0,0,0,0,Memphis,30,17,22,20,0,0,0,0,20120221,76,89,20,5,9,13,13,165,13,2011,0,1,878,0
Sacramento,32,21,35,20,0,0,0,0,Miami,26,31,36,27,0,0,0,0,20120221,108,120,-6,4,5,12,12,228,12,2011,0,1,2547,0
San Antonio,23,20,22,32,0,0,0,0,Portland,41,25,37,34,0,0,0,0,20120221,97,137,18,23,38,40,40,234,40,2011,0,1,1718,0
Sacramento,29,31,28,27,0,0,0,0,Washington,34,34,21,18,0,0,0,0,20120222,115,107,-5,-8,-1,8,8,222,-8,2011,0,2,2371,0
Detroit,24,21,15,33,0,0,0,0,Toronto,28,25,21,29,0,0,0,0,20120222,93,103,4,8,14,10,10,196,10,2011,0,2,205,0
Golden State,39,20,24,23,0,0,0,0,Phoenix,22,23,34,25,0,0,0,0,20120222,106,104,17,14,4,2,2,210,-2,2011,0,2,652,0
Boston,25,24,31,24,0,0,0,0,Oklahoma City,35,37,22,25,0,0,0,0,20120222,104,119,10,23,14,15,15,223,15,2011,0,2,1492,0
Atlanta,16,19,21,26,0,0,0,0,New York,30,30,18,21,0,0,0,0,20120222,82,99,14,25,22,17,17,181,17,2011,0,2,745,0
Orlando,34,24,29,21,0,0,0,0,Brooklyn,17,24,29,21,0,0,0,0,20120222,108,91,17,17,17,17,17,199,-17,2011,0,2,939,0
Denver,27,27,25,16,0,0,0,0,LA Clippers,27,25,28,23,0,0,0,0,20120222,95,103,0,-2,1,8,8,198,8,2011,0,2,830,0
Philadelphia,16,25,24,22,0,0,0,0,Houston,19,26,16,32,0,0,0,0,20120222,87,93,3,4,-4,6,6,180,6,2011,0,2,1339,0
LA Lakers,25,23,24,24,0,0,0,0,Dallas,21,27,24,19,0,0,0,0,20120222,96,91,4,0,0,5,5,187,-5,2011,0,2,1237,0
New Orleans,29,21,19,20,0,0,0,0,Cleveland,20,23,16,25,0,0,0,0,20120222,89,84,9,7,10,5,5,173,-5,2011,0,2,924,0
Milwaukee,23,30,22,16,0,0,0,0,Chicago,30,34,29,17,0,0,0,0,20120222,91,110,7,11,18,19,19,201,19,2011,0,2,83,0
Indiana,23,27,28,24,0,0,0,0,Charlotte,28,14,26,20,0,0,0,0,20120222,102,88,-5,8,10,14,14,190,-14,2011,0,2,428,0
Utah,27,22,28,21,0,0,0,0,Minnesota,15,22,27,36,0,0,0,0,20120222,98,100,-12,-12,-13,2,2,198,2,2011,0,2,984,0
Orlando,20,10,25,23,0,0,0,0,Atlanta,29,18,11,25,0,0,0,0,20120223,78,83,9,17,3,5,5,161,5,2011,0,3,401,0
San Antonio,31,34,27,22,0,0,0,0,Denver,15,24,33,27,0,0,0,0,20120223,114,99,16,26,20,15,15,213,-15,2011,0,3,802,0
New York,20,27,19,22,0,0,0,0,Miami,24,27,29,22,0,0,0,0,20120223,88,102,4,4,14,14,14,190,14,2011,0,3,1091,0
LA Lakers,23,20,19,23,0,0,0,0,Oklahoma City,19,27,27,27,0,0,0,0,20120223,85,100,-4,3,11,15,15,185,15,2011,0,3,1178,0
Minnesota,22,29,22,36,0,0,0,0,LA Clippers,31,23,22,21,0,0,0,0,20120228,109,97,-9,-3,-3,12,12,206,-12,2011,0,1,1521,0
Utah,25,22,24,25,0,0,0,0,Sacramento,23,21,30,29,0,0,0,0,20120228,96,103,-2,-3,3,7,7,199,7,2011,0,1,532,0
Washington,24,29,36,29,0,0,0,0,Milwaukee,33,34,25,27,0,0,0,0,20120228,118,119,9,14,3,1,1,237,1,2011,0,1,634,0
Golden State,21,17,16,24,0,0,0,0,Indiana,24,28,33,17,0,0,0,0,20120228,78,102,3,14,31,24,24,180,24,2011,0,1,1944,0
New Orleans,26,24,20,25,0,0,0,0,Chicago,30,17,29,23,0,0,0,0,20120228,95,99,4,-3,6,4,4,194,4,2011,0,1,832,0
Philadelphia,22,28,25,22,0,0,0,0,Detroit,20,14,19,15,0,0,0,0,20120228,97,68,2,16,22,29,29,165,-29,2011,0,1,441,0
Brooklyn,28,28,23,14,0,0,0,0,Dallas,23,22,31,16,0,0,0,0,20120228,93,92,5,11,3,1,1,185,-1,2011,0,1,1370,0
Boston,28,15,21,22,0,0,0,0,Cleveland,15,23,28,17,0,0,0,0,20120228,86,83,13,5,-2,3,3,169,-3,2011,0,1,549,0
Toronto,15,21,28,21,0,0,0,0,Houston,27,18,24,19,0,0,0,0,20120228,85,88,12,9,5,3,3,173,3,2011,0,1,1299,0
Orlando,27,19,25,31,0,0,0,0,Washington,18,23,29,25,0,0,0,0,20120229,102,95,9,5,1,7,7,197,-7,2011,0,2,757,0
Houston,26,18,19,20,0,0,0,0,Utah,18,31,27,28,0,0,0,0,20120229,83,104,-8,5,13,21,21,187,21,2011,0,2,1199,0
Chicago,20,30,15,31,0,0,0,0,San Antonio,22,20,24,23,0,0,0,0,20120229,96,89,-2,8,-1,7,7,185,-7,2011,0,2,1050,0
Oklahoma City,26,27,10,29,0,0,0,0,Philadelphia,24,24,19,21,0,0,0,0,20120229,92,88,2,5,-4,4,4,180,-4,2011,0,2,1256,0
Toronto,29,22,11,33,0,0,0,0,New Orleans,25,21,23,15,0,0,0,0,20120229,95,84,4,5,-7,11,11,179,-11,2011,0,2,1112,0
Cleveland,31,30,19,23,0,0,0,0,New York,24,25,33,38,0,0,0,0,20120229,103,120,-7,-12,2,17,17,223,17,2011,0,2,403,0
Minnesota,18,26,15,26,0,0,0,0,LA Lakers,26,24,33,21,0,0,0,0,20120229,85,104,8,6,24,19,19,189,19,2011,0,2,1521,0
Charlotte,23,20,26,25,0,0,0,0,Detroit,24,34,25,26,0,0,0,0,20120229,94,109,1,15,14,15,15,203,15,2011,0,2,504,0
Portland,22,23,26,24,0,0,0,0,Denver,29,33,23,19,0,0,0,0,20120229,95,104,7,17,14,9,9,199,9,2011,0,2,981,0
Milwaukee,25,29,13,29,0,0,0,0,Boston,25,25,27,25,0,0,0,0,20120229,96,102,0,-4,10,6,6,198,6,2011,0,2,855,0
Golden State,20,28,16,21,0,0,0,0,Atlanta,21,17,23,21,0,0,0,0,20120229,85,82,-1,10,3,3,3,167,-3,2011,0,2,2135,0
Dallas,17,32,18,18,0,0,0,0,Memphis,25,22,27,22,0,0,0,0,20120229,85,96,8,-2,7,11,11,181,11,2011,0,2,419,0
Oklahoma City,20,30,20,35,0,0,0,0,Orlando,23,30,28,21,0,0,0,0,20120301,105,102,-3,-3,-11,3,3,207,-3,2011,0,3,1057,0
Minnesota,23,28,23,21,0,0,0,0,Phoenix,22,24,31,27,0,0,0,0,20120301,95,104,-1,-5,3,9,9,199,9,2011,0,3,1278,0
Miami,32,28,27,20,0,0,0,0,Portland,24,18,27,24,0,0,0,0,20120301,107,93,8,18,18,14,14,200,-14,2011,0,3,2704,0
LA Clippers,28,29,28,23,0,0,0,0,Sacramento,25,32,22,21,0,0,0,0,20120301,108,100,3,0,6,8,8,208,-8,2011,0,3,361,0
Golden State,23,24,18,18,0,0,0,0,Philadelphia,25,25,25,30,0,0,0,0,20120302,83,105,2,3,10,22,22,188,22,2011,0,4,2516,0
Memphis,23,22,32,25,0,0,0,0,Toronto,21,31,23,24,0,0,0,0,20120302,102,99,2,-7,2,3,3,201,-3,2011,0,4,815,0
Charlotte,20,21,18,13,0,0,0,0,San Antonio,29,22,23,28,0,0,0,0,20120302,72,102,9,10,15,30,30,174,30,2011,0,4,1103,0
Dallas,19,27,23,23,0,0,0,0,New Orleans,25,27,22,23,0,0,0,0,20120302,92,97,6,6,5,5,5,189,5,2011,0,4,442,0
Miami,26,18,27,27,0,0,0,0,Utah,27,30,21,21,0,0,0,0,20120302,98,99,1,13,7,1,1,197,1,2011,0,4,2086,0
Denver,26,25,31,35,0,0,0,0,Houston,25,29,24,27,0,0,0,0,20120302,117,105,1,-3,4,12,12,222,-12,2011,0,4,878,0
Sacramento,26,32,16,33,0,0,0,0,LA Lakers,31,34,27,23,0,0,0,0,20120302,107,115,5,7,18,8,8,222,8,2011,0,4,361,0
Milwaukee,25,26,25,18,0,0,0,0,Atlanta,27,12,26,34,0,0,0,0,20120302,94,99,2,-12,-11,5,5,193,5,2011,0,4,669,0
LA Clippers,21,14,17,26,0,0,0,0,Phoenix,17,15,31,18,0,0,0,0,20120302,78,81,-4,-3,11,3,3,159,3,2011,0,4,356,0
Chicago,30,26,38,18,0,0,0,0,Cleveland,28,16,27,20,0,0,0,0,20120302,112,91,2,12,23,21,21,203,-21,2011,0,4,308,0
Brooklyn,20,20,31,23,0,0,0,0,Boston,29,29,29,20,0,0,0,0,20120302,94,107,9,18,16,13,13,201,13,2011,0,4,190,0
Oklahoma City,24,23,28,15,0,0,0,0,Atlanta,27,26,23,21,0,0,0,0,20120303,90,97,3,6,1,7,7,187,7,2011,0,5,755,0
Utah,20,16,19,41,0,0,0,0,Dallas,24,19,31,28,0,0,0,0,20120303,96,102,4,7,19,6,6,198,6,2011,0,5,998,0
Detroit,28,19,23,13,0,0,0,0,Memphis,28,18,23,31,0,0,0,0,20120303,83,100,0,-1,-1,17,17,183,17,2011,0,5,622,0
Indiana,25,29,25,23,0,0,0,0,New Orleans,23,14,17,30,0,0,0,0,20120303,102,84,2,17,25,18,18,186,-18,2011,0,5,713,0
Milwaukee,21,39,20,18,0,0,0,0,Orlando,36,25,24,29,0,0,0,0,20120303,98,114,15,1,5,16,16,212,16,2011,0,5,1065,0
Minnesota,40,21,23,38,0,0,0,0,Portland,28,32,22,28,0,0,0,0,20120303,122,110,12,1,2,12,12,232,-12,2011,0,5,1423,0
Cleveland,33,22,23,20,0,0,0,0,Washington,24,26,28,23,0,0,0,0,20120303,98,101,-9,-5,0,3,3,199,3,2011,0,5,304,0
Golden State,20,27,11,17,0,0,0,0,Toronto,18,20,22,23,0,0,0,0,20120304,75,83,-2,-9,2,8,8,158,8,2011,0,6,2263,0
Denver,25,24,26,24,0,0,0,0,San Antonio,17,28,26,23,0,0,0,0,20120304,99,94,8,4,4,5,5,193,-5,2011,0,6,802,0
Sacramento,32,20,19,17,0,0,0,0,Phoenix,29,18,23,26,0,0,0,0,20120304,88,96,-3,-5,-1,8,8,184,8,2011,0,6,634,0
Chicago,26,14,24,32,0,0,0,0,Philadelphia,24,22,18,27,0,0,0,0,20120304,96,91,2,-6,0,5,5,187,-5,2011,0,6,664,0
Brooklyn,22,23,28,31,0,0,0,0,Charlotte,25,28,19,29,0,0,0,0,20120304,104,101,-3,-8,1,3,3,205,-3,2011,0,6,531,0
LA Clippers,25,20,32,20,8,0,0,0,Houston,30,17,27,23,6,0,0,0,20120304,105,103,-5,-2,3,0,2,208,-2,2011,1,6,1371,0
New York,29,27,16,31,8,0,0,0,Boston,27,24,29,23,12,0,0,0,20120304,111,115,-2,-5,8,0,4,226,4,2011,1,6,190,0
Miami,20,18,24,21,0,0,0,0,LA Lakers,28,22,21,22,0,0,0,0,20120304,83,93,8,12,9,10,10,176,10,2011,0,6,2335,0
Dallas,23,29,13,26,0,0,0,0,Oklahoma City,26,19,23,27,0,0,0,0,20120305,91,95,3,-7,3,4,4,186,4,2011,0,0,189,0
Orlando,23,20,25,24,0,0,0,0,Toronto,20,18,25,25,0,0,0,0,20120305,92,88,3,5,5,4,4,180,-4,2011,0,0,1048,0
New Orleans,17,21,10,26,0,0,0,0,Portland,27,19,24,16,0,0,0,0,20120305,74,86,10,8,22,12,12,160,12,2011,0,0,2059,0
LA Clippers,16,28,21,29,0,0,0,0,Minnesota,26,19,30,20,0,0,0,0,20120305,94,95,10,1,10,1,1,189,1,2011,0,0,1521,0
Golden State,41,24,24,31,0,0,0,0,Washington,24,27,20,29,0,0,0,0,20120305,120,100,17,14,18,20,20,220,-20,2011,0,0,2435,0
Sacramento,26,27,26,29,8,0,0,0,Denver,24,29,32,23,11,0,0,0,20120305,116,119,-2,0,6,0,3,235,3,2011,1,0,886,0
Utah,28,28,29,24,0,0,0,0,Cleveland,26,15,31,28,0,0,0,0,20120305,109,100,2,15,13,9,9,209,-9,2011,0,0,1564,0
Indiana,20,23,13,16,0,0,0,0,Chicago,22,20,33,17,0,0,0,0,20120305,72,92,2,-1,19,20,20,164,20,2011,0,0,163,0
Philadelphia,33,22,16,22,0,0,0,0,Milwaukee,28,23,23,23,0,0,0,0,20120305,93,97,-5,-4,3,4,4,190,4,2011,0,0,692,0
Houston,28,12,28,16,8,0,0,0,Boston,21,25,17,21,13,0,0,0,20120306,92,97,-7,6,-5,0,5,189,5,2011,1,1,1603,0
Orlando,25,23,23,13,0,0,0,0,Charlotte,15,28,29,28,0,0,0,0,20120306,84,100,-10,-5,1,16,16,184,16,2011,0,1,463,0
New York,15,29,19,22,0,0,0,0,Dallas,27,23,27,18,0,0,0,0,20120306,85,95,12,6,14,10,10,180,10,2011,0,1,1370,0
LA Lakers,24,17,20,17,7,0,0,0,Detroit,17,28,9,24,10,0,0,0,20120306,85,88,-7,4,-7,0,3,173,3,2011,1,1,1979,0
Atlanta,29,29,18,25,0,0,0,0,Indiana,22,32,17,25,0,0,0,0,20120306,101,96,7,4,5,5,5,197,-5,2011,0,1,427,0
Brooklyn,17,20,19,22,0,0,0,0,Miami,30,34,24,20,0,0,0,0,20120306,78,108,13,27,32,30,30,186,30,2011,0,1,1091,0
LA Lakers,29,35,19,18,0,0,0,0,Washington,21,28,32,25,0,0,0,0,20120307,101,106,-8,-15,-2,5,5,207,5,2011,0,2,2294,0
Houston,28,18,30,22,0,0,0,0,Toronto,28,30,24,34,0,0,0,0,20120307,98,116,0,12,6,18,18,214,18,2011,0,2,1299,0
New York,23,18,32,32,0,0,0,0,San Antonio,28,30,35,25,0,0,0,0,20120307,105,118,5,17,20,13,13,223,13,2011,0,2,1581,0
New Orleans,27,27,26,18,0,0,0,0,Sacramento,29,29,20,21,0,0,0,0,20120307,98,99,2,4,-2,1,1,197,1,2011,0,2,1879,0
Boston,17,16,20,18,0,0,0,0,Philadelphia,33,22,25,23,0,0,0,0,20120307,71,103,16,22,27,32,32,174,32,2011,0,2,270,0
Phoenix,34,30,24,16,0,0,0,0,Oklahoma City,25,33,26,31,0,0,0,0,20120307,104,115,-9,-6,-4,11,11,219,11,2011,0,2,840,0
Chicago,33,22,18,33,0,0,0,0,Milwaukee,30,20,23,31,0,0,0,0,20120307,106,104,3,5,0,2,2,210,-2,2011,0,2,83,0
Portland,31,23,18,22,0,0,0,0,Minnesota,37,24,20,25,0,0,0,0,20120307,94,106,6,7,9,12,12,200,12,2011,0,2,1423,0
Atlanta,22,23,23,18,0,0,0,0,Miami,25,18,25,21,0,0,0,0,20120307,86,89,3,-2,0,3,3,175,3,2011,0,2,605,0
Memphis,33,23,28,26,0,0,0,0,Golden State,23,28,22,19,0,0,0,0,20120307,110,92,10,5,11,18,18,202,-18,2011,0,2,1798,0
Cleveland,26,31,19,24,0,0,0,0,Denver,27,28,17,27,0,0,0,0,20120307,100,99,-1,2,4,1,1,199,-1,2011,0,2,1223,0
Utah,22,29,29,19,0,0,0,0,Charlotte,21,26,17,29,0,0,0,0,20120307,99,93,1,4,16,6,6,192,-6,2011,0,2,1723,0
LA Clippers,22,23,26,29,0,0,0,0,Brooklyn,27,30,23,21,0,0,0,0,20120307,100,101,5,12,9,1,1,201,1,2011,0,2,2445,0
Orlando,37,20,22,20,0,0,0,0,Chicago,22,30,19,23,0,0,0,0,20120308,99,94,15,5,8,5,5,193,-5,2011,0,3,984,0
Dallas,24,29,23,18,0,0,0,0,Phoenix,23,21,34,18,0,0,0,0,20120308,94,96,-1,-9,2,2,2,190,2,2011,0,3,884,0
LA Lakers,21,28,29,27,0,0,0,0,Minnesota,33,25,20,24,0,0,0,0,20120309,105,102,-12,-9,0,3,3,207,-3,2011,0,4,1521,0
Dallas,22,22,28,25,0,0,0,0,Sacramento,31,23,34,22,0,0,0,0,20120309,97,110,9,10,16,13,13,207,13,2011,0,4,1437,0
Utah,27,20,21,23,0,0,0,0,Philadelphia,25,24,29,26,0,0,0,0,20120309,91,104,-2,2,10,13,13,195,13,2011,0,4,1920,0
LA Clippers,33,31,30,26,0,0,0,0,San Antonio,34,22,34,18,0,0,0,0,20120309,120,108,-1,8,4,12,12,228,-12,2011,0,4,1201,0
Cleveland,26,23,20,27,0,0,0,0,Oklahoma City,27,24,18,21,0,0,0,0,20120309,96,90,-1,-2,0,6,6,186,-6,2011,0,4,949,0
New York,34,31,18,31,0,0,0,0,Milwaukee,36,25,32,26,0,0,0,0,20120309,114,119,2,-4,10,5,5,233,5,2011,0,4,732,0
New Orleans,26,20,25,26,0,0,0,0,Denver,32,18,29,31,0,0,0,0,20120309,97,110,6,4,8,13,13,207,13,2011,0,4,1079,0
Brooklyn,23,16,21,23,0,0,0,0,Charlotte,15,20,24,15,0,0,0,0,20120309,83,74,8,4,1,9,9,157,-9,2011,0,4,531,0
Portland,17,13,24,32,0,0,0,0,Boston,27,38,23,16,0,0,0,0,20120309,86,104,10,35,34,18,18,190,18,2011,0,4,2532,0
Atlanta,27,23,12,23,0,0,0,0,Detroit,24,17,26,19,0,0,0,0,20120309,85,86,-3,-9,5,1,1,171,1,2011,0,4,597,0
Portland,27,28,27,28,0,0,0,0,Washington,27,25,24,23,0,0,0,0,20120310,110,99,0,3,6,11,11,209,-11,2011,0,5,2347,0
Charlotte,25,15,30,25,0,0,0,0,Oklahoma City,28,30,33,31,0,0,0,0,20120310,95,122,3,18,21,27,27,217,27,2011,0,5,938,0
Houston,29,30,25,28,0,0,0,0,Brooklyn,21,28,34,23,0,0,0,0,20120310,112,106,8,10,1,6,6,218,-6,2011,0,5,1417,0
New Orleans,24,25,21,25,0,0,0,0,Minnesota,24,20,21,24,0,0,0,0,20120310,95,89,0,5,5,6,6,184,-6,2011,0,5,1052,0
Memphis,29,22,23,17,0,0,0,0,Phoenix,26,27,27,18,0,0,0,0,20120310,91,98,-3,2,6,7,7,189,7,2011,0,5,1260,0
Dallas,15,27,24,21,0,0,0,0,Golden State,26,26,31,28,0,0,0,0,20120310,87,111,11,10,17,24,24,198,24,2011,0,5,1480,0
Toronto,14,23,21,28,0,0,0,0,Detroit,37,24,28,16,0,0,0,0,20120310,86,105,23,24,31,19,19,191,19,2011,0,5,205,0
Utah,22,19,22,34,0,0,0,0,Chicago,22,26,31,32,0,0,0,0,20120310,97,111,0,7,16,14,14,208,14,2011,0,5,1256,0
Indiana,26,17,18,24,6,0,0,0,Miami,17,22,21,25,8,0,0,0,20120310,91,93,-9,-4,-1,0,2,184,2,2011,1,5,1026,0
Houston,26,31,27,23,0,0,0,0,Cleveland,30,24,27,37,0,0,0,0,20120311,107,118,4,-3,-3,11,11,225,11,2011,0,6,1113,0
Memphis,23,27,23,21,0,0,0,0,Denver,25,28,17,21,0,0,0,0,20120311,94,91,-2,-3,3,3,3,185,-3,2011,0,6,877,0
Golden State,28,27,23,19,0,0,0,0,LA Clippers,16,26,22,29,0,0,0,0,20120311,97,93,12,13,14,4,4,190,-4,2011,0,6,347,0
Boston,14,28,28,24,0,0,0,0,LA Lakers,24,20,28,25,0,0,0,0,20120311,94,97,10,2,2,3,3,191,3,2011,0,6,2590,0
Philadelphia,22,29,38,17,0,0,0,0,New York,24,25,24,21,0,0,0,0,20120311,106,94,-2,2,16,12,12,200,-12,2011,0,6,80,0
Indiana,22,23,21,28,0,0,0,0,Orlando,36,20,35,16,0,0,0,0,20120311,94,107,14,11,25,13,13,201,13,2011,0,6,822,0
Atlanta,23,28,29,26,0,0,0,0,Sacramento,24,28,22,25,0,0,0,0,20120311,106,99,-1,-1,6,7,7,205,-7,2011,0,6,2082,0
Milwaukee,21,30,27,27,0,0,0,0,Toronto,28,28,23,20,0,0,0,0,20120311,105,99,-7,-5,-1,6,6,204,-6,2011,0,6,429,0
Minnesota,28,35,29,35,0,0,0,0,Phoenix,34,22,34,34,0,0,0,0,20120312,127,124,-6,7,2,3,3,251,-3,2011,0,0,1278,0
Detroit,19,29,29,13,0,0,0,0,Utah,22,30,23,30,0,0,0,0,20120312,90,105,3,4,-2,15,15,195,15,2011,0,0,1488,0
Charlotte,14,21,26,12,0,0,0,0,New Orleans,20,17,18,16,0,0,0,0,20120312,73,71,-6,-2,6,2,2,144,-2,2011,0,0,648,0
Washington,24,25,25,23,0,0,0,0,San Antonio,32,31,25,24,0,0,0,0,20120312,97,112,8,14,14,15,15,209,15,2011,0,0,1385,0
Boston,25,14,23,32,0,0,0,0,LA Clippers,21,27,13,24,0,0,0,0,20120312,94,85,4,-9,1,9,9,179,-9,2011,0,0,2590,0
New York,25,25,28,21,0,0,0,0,Chicago,23,25,31,25,0,0,0,0,20120312,99,104,-2,-2,1,5,5,203,5,2011,0,0,711,0
Milwaukee,27,20,26,32,0,0,0,0,Brooklyn,32,22,19,26,0,0,0,0,20120312,105,99,-5,-7,0,6,6,204,-6,2011,0,0,732,0
Golden State,29,25,30,31,0,0,0,0,Sacramento,24,25,24,16,0,0,0,0,20120313,115,89,5,5,11,26,26,204,-26,2011,0,1,75,0
Miami,27,29,17,21,4,0,0,0,Orlando,30,15,27,22,10,0,0,0,20120313,98,104,3,-11,-1,0,6,202,6,2011,1,1,204,0
LA Lakers,21,30,20,26,6,13,0,0,Memphis,29,23,28,17,6,8,0,0,20120313,116,111,-8,-1,-9,0,5,227,-5,2011,2,1,1599,0
Houston,23,30,24,27,0,0,0,0,Oklahoma City,22,31,20,30,0,0,0,0,20120313,104,103,1,0,4,1,1,207,-1,2011,0,1,413,0
Atlanta,26,29,25,25,12,0,0,0,Denver,30,34,18,23,13,0,0,0,20120313,117,118,4,9,2,0,1,235,1,2011,1,1,1209,0
Washington,26,25,24,23,0,0,0,0,Dallas,27,33,23,24,0,0,0,0,20120313,98,107,1,9,8,9,9,205,9,2011,0,1,1181,0
Toronto,21,33,21,21,0,0,0,0,Cleveland,22,24,19,23,0,0,0,0,20120313,96,88,-1,8,10,8,8,184,-8,2011,0,1,187,0
Portland,15,23,14,23,0,0,0,0,Indiana,19,29,27,17,0,0,0,0,20120313,75,92,4,10,23,17,17,167,17,2011,0,1,1880,0
LA Lakers,20,20,30,23,14,0,0,0,New Orleans,28,26,16,23,8,0,0,0,20120314,107,101,-8,-14,0,0,6,208,-6,2011,1,2,1669,0
Detroit,25,32,40,27,0,0,0,0,Sacramento,32,26,23,31,0,0,0,0,20120314,124,112,-7,-1,16,12,12,236,-12,2011,0,2,2020,0
Utah,30,23,29,29,0,0,0,0,Phoenix,22,31,36,31,0,0,0,0,20120314,111,120,-8,0,7,9,9,231,9,2011,0,2,505,0
Portland,12,17,27,23,0,0,0,0,New York,25,30,23,43,0,0,0,0,20120314,79,121,13,26,22,42,42,200,42,2011,0,2,2439,0
Orlando,35,23,26,27,0,0,0,0,San Antonio,36,23,30,33,0,0,0,0,20120314,111,122,1,1,5,11,11,233,11,2011,0,2,1035,0
Toronto,22,24,15,23,0,0,0,0,Brooklyn,19,22,27,30,0,0,0,0,20120314,84,98,-3,-5,7,14,14,182,14,2011,0,2,341,0
Philadelphia,29,22,24,19,0,0,0,0,Indiana,24,30,29,28,0,0,0,0,20120314,94,111,-5,3,8,17,17,205,17,2011,0,2,582,0
Atlanta,27,15,20,20,0,0,0,0,LA Clippers,30,20,21,25,0,0,0,0,20120314,82,96,3,8,9,14,14,178,14,2011,0,2,1932,0
Charlotte,18,22,17,30,0,0,0,0,Houston,30,20,36,21,0,0,0,0,20120314,87,107,12,10,29,20,20,194,20,2011,0,2,925,0
Boston,21,34,26,24,0,0,0,0,Golden State,25,35,17,26,0,0,0,0,20120314,105,103,-4,-5,4,2,2,208,-2,2011,0,2,2692,0
Miami,23,19,28,32,0,0,0,0,Chicago,19,34,28,25,0,0,0,0,20120314,102,106,-4,11,11,4,4,208,4,2011,0,2,1189,0
Cleveland,28,27,23,27,0,0,0,0,Milwaukee,23,34,27,31,0,0,0,0,20120314,105,115,-5,2,6,10,10,220,10,2011,0,2,334,0
Charlotte,23,31,14,28,0,0,0,0,Dallas,23,25,26,27,0,0,0,0,20120315,96,101,0,-6,6,5,5,197,5,2011,0,3,928,0
Oklahoma City,29,21,28,25,0,0,0,0,Denver,25,26,14,25,0,0,0,0,20120315,103,90,4,-1,13,13,13,193,-13,2011,0,3,503,0
Phoenix,17,22,25,27,0,0,0,0,LA Clippers,29,18,28,12,0,0,0,0,20120315,91,87,-12,-8,-11,4,4,178,-4,2011,0,3,356,0
Washington,28,28,19,24,0,0,0,0,New Orleans,28,21,24,16,0,0,0,0,20120315,99,89,0,7,2,10,10,188,-10,2011,0,3,964,0
Minnesota,20,27,24,28,6,0,0,0,Utah,24,29,24,22,12,0,0,0,20120315,105,111,4,6,6,0,6,216,6,2011,1,3,984,0
Miami,31,26,12,15,0,0,0,0,Philadelphia,18,12,26,22,0,0,0,0,20120316,84,78,13,27,13,6,6,162,-6,2011,0,4,1021,0
Milwaukee,31,25,31,33,0,0,0,0,Golden State,12,31,32,23,0,0,0,0,20120316,120,98,19,13,12,22,22,218,-22,2011,0,4,1838,0
Boston,20,31,23,21,0,0,0,0,Sacramento,26,26,41,27,0,0,0,0,20120316,95,120,6,1,19,25,25,215,25,2011,0,4,2624,0
Brooklyn,18,18,24,10,0,0,0,0,Orlando,22,24,26,14,0,0,0,0,20120316,70,86,4,10,12,16,16,156,16,2011,0,4,939,0
Detroit,27,32,21,21,0,0,0,0,Phoenix,31,23,25,30,0,0,0,0,20120316,101,109,4,-5,-1,8,8,210,8,2011,0,4,1687,0
San Antonio,30,35,27,22,0,0,0,0,Oklahoma City,19,29,31,26,0,0,0,0,20120316,114,105,11,17,13,9,9,219,-9,2011,0,4,421,0
Washington,26,28,10,24,0,0,0,0,Atlanta,30,20,21,31,0,0,0,0,20120316,88,102,4,-4,7,14,14,190,14,2011,0,4,541,0
Toronto,26,21,25,31,11,0,0,0,Memphis,24,22,23,34,7,0,0,0,20120316,114,110,2,1,3,0,4,224,-4,2011,1,4,815,0
Portland,29,21,28,22,0,0,0,0,Chicago,32,21,26,10,0,0,0,0,20120316,100,89,-3,-3,-1,11,11,189,-11,2011,0,4,1754,0
Indiana,14,17,27,42,0,0,0,0,New York,24,26,38,27,0,0,0,0,20120316,100,115,10,19,30,15,15,215,15,2011,0,4,643,0
Minnesota,19,22,20,31,0,0,0,0,LA Lakers,23,27,24,23,0,0,0,0,20120316,92,97,4,9,13,5,5,189,5,2011,0,4,1521,0
Toronto,29,24,14,36,0,0,0,0,Charlotte,20,23,38,26,0,0,0,0,20120317,103,107,-9,-10,14,4,4,210,4,2011,0,5,585,0
Philadelphia,24,20,15,21,0,0,0,0,Chicago,11,27,26,25,0,0,0,0,20120317,80,89,-13,-6,5,9,9,169,9,2011,0,5,664,0
San Antonio,19,25,24,31,0,0,0,0,Dallas,28,18,32,28,0,0,0,0,20120317,99,106,9,2,10,7,7,205,7,2011,0,5,252,0
Boston,22,20,26,23,0,0,0,0,Denver,29,26,25,18,0,0,0,0,20120317,91,98,7,13,12,7,7,189,7,2011,0,5,1765,0
New York,33,27,17,25,0,0,0,0,Indiana,35,16,23,14,0,0,0,0,20120317,102,88,-2,9,3,14,14,190,-14,2011,0,5,643,0
Houston,23,24,19,25,0,0,0,0,LA Clippers,19,20,30,26,0,0,0,0,20120317,91,95,-4,-8,3,4,4,186,4,2011,0,5,1371,0
New Orleans,26,21,23,32,0,0,0,0,Brooklyn,29,22,31,12,0,0,0,0,20120317,102,94,-3,-4,-12,8,8,196,-8,2011,0,5,1168,0
Golden State,25,26,14,22,5,0,0,0,Utah,18,28,23,18,12,0,0,0,20120317,92,99,-7,-5,4,0,7,191,7,2011,1,5,599,0
Orlando,22,25,16,18,0,0,0,0,Miami,31,19,17,24,0,0,0,0,20120318,81,91,9,3,4,10,10,172,10,2011,0,6,204,0
Minnesota,31,26,25,17,0,0,0,0,Sacramento,28,29,33,25,0,0,0,0,20120318,99,115,-3,0,8,16,16,214,16,2011,0,6,1511,0
Houston,13,23,28,22,0,0,0,0,Phoenix,26,26,28,19,0,0,0,0,20120318,86,99,13,16,16,13,13,185,13,2011,0,6,1014,0
Portland,15,27,28,25,0,0,0,0,Oklahoma City,31,26,27,27,0,0,0,0,20120318,95,111,16,15,14,16,16,206,16,2011,0,6,1484,0
Utah,23,22,30,28,0,0,0,0,LA Lakers,20,24,25,30,0,0,0,0,20120318,103,99,3,1,6,4,4,202,-4,2011,0,6,579,0
Detroit,18,23,24,9,9,0,0,0,LA Clippers,24,14,19,17,13,0,0,0,20120318,83,87,6,-3,-8,0,4,170,4,2011,1,6,1979,0
Atlanta,31,28,17,27,0,0,0,0,Cleveland,19,26,23,19,0,0,0,0,20120318,103,87,12,14,8,16,16,190,-16,2011,0,6,555,0
Washington,20,28,18,26,0,0,0,0,Memphis,21,24,29,23,0,0,0,0,20120318,92,97,1,-3,8,5,5,189,5,2011,0,6,762,0
Chicago,22,26,12,25,0,0,0,0,Orlando,14,19,15,11,0,0,0,0,20120319,85,59,8,15,12,26,26,144,-26,2011,0,0,984,0
Boston,12,19,19,29,0,0,0,0,Atlanta,15,18,18,25,0,0,0,0,20120319,79,76,-3,-2,-1,3,3,155,-3,2011,0,0,935,0
Philadelphia,25,21,30,29,0,0,0,0,Charlotte,19,25,19,17,0,0,0,0,20120319,105,80,6,2,13,25,25,185,-25,2011,0,0,450,0
Dallas,33,30,29,20,0,0,0,0,Denver,29,27,22,17,0,0,0,0,20120319,112,95,4,7,14,17,17,207,-17,2011,0,0,661,0
Minnesota,21,28,22,26,0,0,0,0,Golden State,14,21,32,26,0,0,0,0,20120319,97,93,7,14,4,4,4,190,-4,2011,0,0,1581,0
Cleveland,30,23,23,29,0,0,0,0,Brooklyn,17,33,24,26,0,0,0,0,20120319,105,100,13,3,2,5,5,205,-5,2011,0,0,403,0
Memphis,28,28,30,24,0,0,0,0,Sacramento,37,29,27,26,0,0,0,0,20120320,110,119,9,10,7,9,9,229,9,2011,0,1,1745,0
Phoenix,22,31,22,20,0,0,0,0,Miami,28,21,23,27,0,0,0,0,20120320,95,99,6,-4,-3,4,4,194,4,2011,0,1,1978,0
Oklahoma City,25,19,26,20,0,0,0,0,Utah,24,28,24,21,0,0,0,0,20120320,90,97,-1,8,6,7,7,187,7,2011,0,1,861,0
Milwaukee,25,29,28,34,0,0,0,0,Portland,23,20,21,23,0,0,0,0,20120320,116,87,2,11,18,29,29,203,-29,2011,0,1,1714,0
LA Lakers,40,16,23,25,0,0,0,0,Houston,25,26,22,34,0,0,0,0,20120320,104,107,-15,-5,-6,3,3,211,3,2011,0,1,1371,0
LA Clippers,31,15,20,23,0,0,0,0,Indiana,31,23,24,24,0,0,0,0,20120320,89,102,0,8,12,13,13,191,13,2011,0,1,1805,0
Toronto,24,20,24,19,0,0,0,0,New York,27,26,26,27,0,0,0,0,20120320,87,106,3,9,11,19,19,193,19,2011,0,1,341,0
Chicago,27,16,19,32,0,0,0,0,Toronto,23,28,18,13,0,0,0,0,20120321,94,82,4,-8,-7,12,12,176,-12,2011,0,2,436,0
Minnesota,16,31,24,29,0,0,0,0,San Antonio,32,24,35,25,0,0,0,0,20120321,100,116,16,9,20,16,16,216,16,2011,0,2,1112,0
Phoenix,21,23,18,31,0,0,0,0,Orlando,27,30,24,22,0,0,0,0,20120321,93,103,6,13,19,10,10,196,10,2011,0,2,1842,0
LA Clippers,30,20,21,20,0,0,0,0,Oklahoma City,33,33,22,26,0,0,0,0,20120321,91,114,3,16,17,23,23,205,23,2011,0,2,1178,0
New York,19,24,16,23,0,0,0,0,Philadelphia,11,24,23,21,0,0,0,0,20120321,82,79,8,8,1,3,3,161,-3,2011,0,2,80,0
Washington,33,23,28,24,0,0,0,0,Brooklyn,25,28,19,17,0,0,0,0,20120321,108,89,8,3,12,19,19,197,-19,2011,0,2,204,0
Detroit,18,39,34,24,0,0,0,0,Denver,40,22,29,25,0,0,0,0,20120321,115,116,22,5,0,1,1,231,1,2011,0,2,1154,0
LA Lakers,27,30,23,29,0,0,0,0,Dallas,29,15,28,21,0,0,0,0,20120321,109,93,-2,13,8,16,16,202,-16,2011,0,2,1237,0
Cleveland,36,17,20,18,11,0,0,0,Atlanta,21,33,18,19,12,0,0,0,20120321,102,103,-15,1,-1,0,1,205,1,2011,1,2,555,0
Golden State,24,20,31,26,0,0,0,0,New Orleans,26,19,27,20,0,0,0,0,20120321,101,92,-2,-1,3,9,9,193,-9,2011,0,2,1921,0
Golden State,18,29,20,16,0,0,0,0,Houston,30,26,28,25,0,0,0,0,20120322,83,109,12,9,17,26,26,192,26,2011,0,3,1642,0
Boston,35,21,18,26,0,0,0,0,Milwaukee,29,29,13,20,0,0,0,0,20120322,100,91,6,-2,3,9,9,191,-9,2011,0,3,855,0
LA Clippers,35,23,21,11,0,0,0,0,New Orleans,29,25,22,21,0,0,0,0,20120322,90,97,-6,-4,-3,7,7,187,7,2011,0,3,1669,0
Memphis,20,24,25,24,0,0,0,0,Portland,26,23,17,31,0,0,0,0,20120322,93,97,6,5,-3,4,4,190,4,2011,0,3,1845,0
Utah,30,28,29,16,0,0,0,0,Sacramento,26,22,29,25,0,0,0,0,20120322,103,102,4,10,10,1,1,205,-1,2011,0,3,532,0
Indiana,18,13,26,28,0,0,0,0,Washington,34,17,15,17,0,0,0,0,20120322,85,83,-16,-20,-9,2,2,168,-2,2011,0,3,490,0
Boston,32,17,17,20,0,0,0,0,Philadelphia,26,17,37,19,0,0,0,0,20120323,86,99,-6,-6,14,13,13,185,13,2011,0,4,270,0
Dallas,21,24,18,24,0,0,0,0,San Antonio,24,28,18,34,0,0,0,0,20120323,87,104,3,7,7,17,17,191,17,2011,0,4,252,0
Portland,19,29,22,26,0,0,0,0,LA Lakers,30,23,18,32,0,0,0,0,20120323,96,103,11,5,1,7,7,199,7,2011,0,4,826,0
Denver,32,23,21,26,0,0,0,0,Utah,30,33,31,27,0,0,0,0,20120323,102,121,-2,8,18,19,19,223,19,2011,0,4,370,0
New York,16,20,17,26,0,0,0,0,Toronto,25,14,31,26,0,0,0,0,20120323,79,96,9,3,17,17,17,175,17,2011,0,4,341,0
Cleveland,20,20,23,17,0,0,0,0,Orlando,31,24,17,21,0,0,0,0,20120323,80,93,11,15,9,13,13,173,13,2011,0,4,895,0
Phoenix,28,26,32,27,0,0,0,0,Indiana,31,30,18,32,0,0,0,0,20120323,113,111,-3,-7,7,2,2,224,-2,2011,0,4,1496,0
Miami,27,32,13,16,0,0,0,0,Detroit,20,16,21,16,0,0,0,0,20120323,88,73,7,23,15,15,15,161,-15,2011,0,4,1155,0
Milwaukee,21,31,31,29,0,0,0,0,Charlotte,20,20,28,24,0,0,0,0,20120323,112,92,1,12,15,20,20,204,-20,2011,0,4,658,0
Brooklyn,20,24,25,15,0,0,0,0,Atlanta,21,22,19,31,0,0,0,0,20120323,84,93,1,-1,-7,9,9,177,9,2011,0,4,745,0
Minnesota,29,32,27,28,13,11,0,0,Oklahoma City,30,33,31,22,13,20,0,0,20120323,140,149,1,2,6,0,9,289,9,2011,2,4,694,0
Atlanta,23,18,27,27,0,0,0,0,Washington,23,29,26,14,0,0,0,0,20120324,95,92,0,-11,-10,3,3,187,-3,2011,0,5,541,0
Detroit,17,20,24,18,0,0,0,0,New York,21,28,27,25,0,0,0,0,20120324,79,101,4,12,15,22,22,180,22,2011,0,5,480,0
Charlotte,21,21,16,31,0,0,0,0,Brooklyn,26,22,33,21,0,0,0,0,20120324,89,102,5,6,23,13,13,191,13,2011,0,5,531,0
Indiana,29,28,35,33,0,0,0,0,Milwaukee,26,22,28,28,0,0,0,0,20120324,125,104,3,9,16,21,21,229,-21,2011,0,5,243,0
San Antonio,23,24,26,16,0,0,0,0,New Orleans,22,26,24,14,0,0,0,0,20120324,89,86,1,-1,1,3,3,175,-3,2011,0,5,506,0
Dallas,26,30,16,19,10,0,0,0,Houston,30,24,18,19,8,0,0,0,20120324,101,99,-4,2,0,0,2,200,-2,2011,1,5,225,0
Sacramento,24,27,37,20,0,0,0,0,Golden State,34,28,27,22,0,0,0,0,20120324,108,111,10,11,1,3,3,219,3,2011,0,5,75,0
Toronto,30,25,18,21,7,0,0,0,Chicago,20,30,21,23,8,0,0,0,20120324,101,102,-10,-5,-2,0,1,203,1,2011,1,5,436,0
Memphis,17,25,19,24,0,0,0,0,LA Clippers,33,23,25,20,0,0,0,0,20120324,85,101,16,14,20,16,16,186,16,2011,0,5,1599,0
Philadelphia,22,27,16,11,0,0,0,0,San Antonio,29,23,24,17,0,0,0,0,20120325,76,93,7,3,11,17,17,169,17,2011,0,6,1505,0
Utah,22,18,34,24,2,13,10,10,Atlanta,29,26,20,23,2,13,10,16,20120325,133,139,7,15,1,0,6,272,6,2011,4,6,1580,0
Washington,12,22,21,21,0,0,0,0,Boston,27,26,16,19,0,0,0,0,20120325,76,88,15,19,14,12,12,164,12,2011,0,6,394,0
Phoenix,29,30,26,23,0,0,0,0,Cleveland,21,17,24,21,0,0,0,0,20120325,108,83,8,21,23,25,25,191,-25,2011,0,6,1745,0
Memphis,28,28,17,29,0,0,0,0,LA Lakers,24,22,24,26,0,0,0,0,20120325,102,96,4,10,3,6,6,198,-6,2011,0,6,1599,0
Denver,20,23,32,25,0,0,0,0,Minnesota,33,35,25,24,0,0,0,0,20120325,100,117,13,25,18,17,17,217,17,2011,0,6,698,0
Miami,24,25,20,18,0,0,0,0,Oklahoma City,25,35,20,23,0,0,0,0,20120325,87,103,1,11,11,16,16,190,16,2011,0,6,1225,0
Golden State,27,20,16,24,0,0,0,0,Portland,26,14,29,21,0,0,0,0,20120325,87,90,-1,-7,6,3,3,177,3,2011,0,6,535,0
Milwaukee,26,26,12,16,0,0,0,0,New York,30,17,21,21,0,0,0,0,20120326,80,89,4,-5,4,9,9,169,9,2011,0,0,732,0
Miami,24,22,19,25,0,0,0,0,Indiana,24,25,29,27,0,0,0,0,20120326,90,105,0,3,13,15,15,195,15,2011,0,0,1026,0
Detroit,16,14,23,26,0,0,0,0,Washington,14,21,27,15,0,0,0,0,20120326,79,77,2,-5,-9,2,2,156,-2,2011,0,0,394,0
Orlando,28,33,32,24,0,0,0,0,Toronto,26,23,24,28,0,0,0,0,20120326,117,101,2,12,20,16,16,218,-16,2011,0,0,1048,0
Utah,15,34,23,33,0,0,0,0,Brooklyn,17,15,33,19,0,0,0,0,20120326,105,84,-2,17,7,21,21,189,-21,2011,0,0,1967,0
Sacramento,29,22,21,27,7,0,0,0,Houston,17,25,29,28,14,0,0,0,20120326,106,113,-12,-9,-1,0,7,219,7,2011,1,0,1606,0
Denver,25,29,27,27,0,0,0,0,Chicago,27,25,16,23,0,0,0,0,20120326,108,91,-2,2,13,17,17,199,-17,2011,0,0,916,0
Boston,33,19,30,20,0,0,0,0,Charlotte,15,35,25,20,0,0,0,0,20120326,102,95,18,2,7,7,7,197,-7,2011,0,0,720,0
New Orleans,20,18,17,30,0,0,0,0,LA Clippers,27,22,25,23,0,0,0,0,20120326,85,97,7,11,19,12,12,182,12,2011,0,0,1669,0
Oklahoma City,32,33,19,25,0,0,0,0,Portland,18,29,28,20,0,0,0,0,20120327,109,95,14,18,9,14,14,204,-14,2011,0,1,1484,0
Houston,30,19,12,20,0,0,0,0,Dallas,19,27,23,21,0,0,0,0,20120327,81,90,-11,-3,8,9,9,171,9,2011,0,1,225,0
LA Lakers,25,30,24,25,0,0,0,0,Golden State,16,32,24,29,0,0,0,0,20120327,104,101,9,7,7,3,3,205,-3,2011,0,1,347,0
Minnesota,22,19,26,19,0,0,0,0,Memphis,24,20,24,25,0,0,0,0,20120327,86,93,2,3,1,7,7,179,7,2011,0,1,700,0
Atlanta,23,23,33,22,0,0,0,0,Milwaukee,31,24,23,30,0,0,0,0,20120327,101,108,8,9,-1,7,7,209,7,2011,0,1,669,0
Cleveland,21,22,25,17,0,0,0,0,Philadelphia,29,28,25,21,0,0,0,0,20120327,85,103,8,14,14,18,18,188,18,2011,0,1,358,0
San Antonio,29,33,22,23,0,0,0,0,Phoenix,28,29,26,17,0,0,0,0,20120327,107,100,1,5,1,7,7,207,-7,2011,0,1,846,0
Orlando,29,12,18,27,0,0,0,0,New York,25,32,33,18,0,0,0,0,20120328,86,108,-4,16,31,22,22,194,22,2011,0,2,939,0
Indiana,22,21,24,17,0,0,0,0,Brooklyn,25,24,20,31,0,0,0,0,20120328,84,100,3,6,2,16,16,184,16,2011,0,2,643,0
Phoenix,27,14,23,22,0,0,0,0,LA Clippers,24,19,31,29,0,0,0,0,20120328,86,103,-3,2,10,17,17,189,17,2011,0,2,356,0
New Orleans,27,30,24,21,0,0,0,0,Golden State,24,16,25,22,0,0,0,0,20120328,102,87,3,17,16,15,15,189,-15,2011,0,2,1921,0
San Antonio,27,26,28,36,0,0,0,0,Sacramento,22,27,29,34,0,0,0,0,20120328,117,112,5,4,3,5,5,229,-5,2011,0,2,1456,0
Minnesota,24,21,23,20,0,0,0,0,Charlotte,21,26,18,18,0,0,0,0,20120328,88,83,3,-2,3,5,5,171,-5,2011,0,2,938,0
Utah,21,14,26,21,0,0,0,0,Boston,18,28,20,28,0,0,0,0,20120328,82,94,-3,11,5,12,12,176,12,2011,0,2,2093,0
Chicago,21,33,22,22,0,0,0,0,Atlanta,23,19,18,17,0,0,0,0,20120328,98,77,-2,12,16,21,21,175,-21,2011,0,2,587,0
Detroit,21,28,19,19,0,0,0,0,Cleveland,23,21,17,14,0,0,0,0,20120328,87,75,-2,5,7,12,12,162,-12,2011,0,2,90,0
Denver,22,31,32,11,0,0,0,0,Toronto,27,28,30,20,0,0,0,0,20120328,96,105,5,2,0,9,9,201,9,2011,0,2,1341,0
Dallas,29,24,19,13,0,0,0,0,Miami,24,36,20,26,0,0,0,0,20120329,85,106,-5,7,8,21,21,191,21,2011,0,3,1110,0
New Orleans,27,27,16,23,0,0,0,0,Portland,28,23,25,23,0,0,0,0,20120329,93,99,1,-3,6,6,6,192,6,2011,0,3,2059,0
Oklahoma City,18,26,34,24,0,0,0,0,LA Lakers,30,19,19,25,0,0,0,0,20120329,102,93,-12,-5,10,9,9,195,-9,2011,0,3,1178,0
Washington,26,23,20,20,0,0,0,0,Indiana,30,22,20,21,0,0,0,0,20120329,89,93,4,3,3,4,4,182,4,2011,0,3,490,0
Sacramento,32,24,24,24,0,0,0,0,Utah,29,30,25,19,0,0,0,0,20120330,104,103,3,-3,-4,1,1,207,-1,2011,0,4,532,0
Miami,31,28,24,30,0,0,0,0,Toronto,27,24,32,18,0,0,0,0,20120330,113,101,4,8,0,12,12,214,-12,2011,0,4,1234,0
Dallas,17,29,25,29,0,0,0,0,Orlando,27,28,23,20,0,0,0,0,20120330,100,98,-10,-9,-7,2,2,198,-2,2011,0,4,961,0
Boston,31,25,23,21,0,0,0,0,Minnesota,20,25,22,12,0,0,0,0,20120330,100,79,11,11,12,21,21,179,-21,2011,0,4,1120,0
Portland,18,25,27,27,0,0,0,0,LA Clippers,23,23,27,25,0,0,0,0,20120330,97,98,5,3,3,1,1,195,1,2011,0,4,826,0
Philadelphia,15,21,26,14,0,0,0,0,Washington,23,32,24,18,0,0,0,0,20120330,76,97,8,19,17,21,21,173,21,2011,0,4,123,0
Brooklyn,22,20,28,32,0,0,0,0,Golden State,26,25,33,16,0,0,0,0,20120330,102,100,-4,-9,-14,2,2,202,-2,2011,0,4,2565,0
Milwaukee,35,36,28,22,0,0,0,0,Cleveland,26,18,30,10,0,0,0,0,20120330,121,84,9,27,25,37,37,205,-37,2011,0,4,334,0
Detroit,25,10,26,10,0,0,0,0,Chicago,28,16,21,18,0,0,0,0,20120330,71,83,3,9,4,12,12,154,12,2011,0,4,238,0
Denver,23,29,22,25,0,0,0,0,Charlotte,28,23,15,22,0,0,0,0,20120330,99,88,-5,1,8,11,11,187,-11,2011,0,4,1355,0
New York,20,20,29,21,0,0,0,0,Atlanta,28,24,22,26,0,0,0,0,20120330,90,100,8,12,5,10,10,190,10,2011,0,4,745,0
Memphis,19,29,21,20,0,0,0,0,Houston,30,19,25,24,0,0,0,0,20120330,89,98,11,1,5,9,9,187,9,2011,0,4,484,0
Indiana,18,30,30,25,0,0,0,0,San Antonio,25,39,26,22,0,0,0,0,20120331,103,112,7,16,12,9,9,215,9,2011,0,5,999,0
Brooklyn,31,28,32,20,0,0,0,0,Sacramento,35,21,20,23,0,0,0,0,20120331,111,99,-4,3,15,12,12,210,-12,2011,0,5,2499,0
Atlanta,23,18,25,24,0,0,0,0,Philadelphia,17,26,19,33,0,0,0,0,20120331,90,95,-6,2,-4,5,5,185,5,2011,0,5,665,0
Cleveland,17,21,22,15,0,0,0,0,New York,25,21,20,25,0,0,0,0,20120331,75,91,8,8,6,16,16,166,16,2011,0,5,403,0
New Orleans,14,25,28,18,0,0,0,0,LA Lakers,20,23,18,27,0,0,0,0,20120331,85,88,6,4,-6,3,3,173,3,2011,0,5,1669,0
Utah,22,23,21,30,0,0,0,0,LA Clippers,38,19,22,26,0,0,0,0,20120331,96,105,16,12,13,9,9,201,9,2011,0,5,579,0
Charlotte,17,32,28,20,10,0,0,0,Detroit,21,27,20,29,13,0,0,0,20120331,107,110,4,-1,-9,0,3,217,3,2011,1,5,504,0
Memphis,11,36,31,21,0,0,0,0,Milwaukee,19,32,20,24,0,0,0,0,20120331,99,95,-8,-4,7,4,4,194,-4,2011,0,5,557,0
New Orleans,21,20,17,17,0,0,0,0,Phoenix,26,24,25,17,0,0,0,0,20120401,75,92,5,9,17,17,17,167,17,2011,0,6,1312,0
Washington,21,21,19,31,0,0,0,0,Toronto,22,24,25,28,0,0,0,0,20120401,92,99,1,4,10,7,7,191,7,2011,0,6,349,0
Minnesota,27,23,30,26,0,0,0,0,Portland,27,30,31,31,0,0,0,0,20120401,106,119,0,7,8,13,13,225,13,2011,0,6,1423,0
Chicago,20,19,12,27,0,0,0,0,Oklahoma City,27,22,31,12,0,0,0,0,20120401,78,92,7,10,29,14,14,170,14,2011,0,6,690,0
Miami,19,25,12,16,0,0,0,0,Boston,29,20,31,11,0,0,0,0,20120401,72,91,10,5,24,19,19,163,19,2011,0,6,1257,0
Golden State,26,28,22,36,0,0,0,0,LA Lakers,27,30,32,31,0,0,0,0,20120401,112,120,1,3,13,8,8,232,8,2011,0,6,347,0
Indiana,27,17,19,30,11,0,0,0,Houston,23,19,31,20,9,0,0,0,20120401,104,102,4,2,-10,0,2,206,-2,2011,1,6,865,0
Denver,27,21,28,28,0,0,0,0,Orlando,19,23,32,27,0,0,0,0,20120401,104,101,8,6,2,3,3,205,-3,2011,0,6,1548,0
Minnesota,30,28,28,22,0,0,0,0,Sacramento,33,32,22,29,0,0,0,0,20120402,108,116,3,7,1,8,8,224,8,2011,0,0,1511,0
Utah,22,32,29,19,0,0,0,0,Portland,35,22,21,19,0,0,0,0,20120402,102,97,-13,-3,5,5,5,199,-5,2011,0,0,634,0
Milwaukee,28,27,28,29,0,0,0,0,Washington,19,28,22,29,0,0,0,0,20120402,112,98,9,8,14,14,14,210,-14,2011,0,0,634,0
LA Clippers,25,22,25,22,0,0,0,0,Dallas,17,16,21,21,0,0,0,0,20120402,94,75,8,14,18,19,19,169,-19,2011,0,0,1237,0
Houston,26,14,31,28,0,0,0,0,Chicago,22,29,19,23,0,0,0,0,20120402,99,93,4,-11,1,6,6,192,-6,2011,0,0,939,0
Memphis,21,21,26,26,0,0,0,0,Oklahoma City,22,22,20,24,0,0,0,0,20120402,94,88,-1,-2,4,6,6,182,-6,2011,0,0,421,0
Charlotte,22,24,18,23,0,0,0,0,Toronto,24,29,18,21,0,0,0,0,20120403,87,92,2,7,7,5,5,179,5,2011,0,1,585,0
San Antonio,32,28,30,35,0,0,0,0,Cleveland,18,23,22,27,0,0,0,0,20120403,125,90,14,19,27,35,35,215,-35,2011,0,1,1256,0
Orlando,25,22,27,21,0,0,0,0,Detroit,27,23,24,28,0,0,0,0,20120403,95,102,2,3,0,7,7,197,7,2011,0,1,957,0
New York,31,28,28,17,0,0,0,0,Indiana,31,20,21,40,0,0,0,0,20120403,104,112,0,-8,-15,8,8,216,8,2011,0,1,643,0
Brooklyn,23,22,21,21,0,0,0,0,LA Lakers,32,26,20,13,0,0,0,0,20120403,87,91,9,13,12,4,4,178,4,2011,0,1,2445,0
Golden State,24,26,29,15,0,0,0,0,Memphis,20,30,20,28,0,0,0,0,20120403,94,98,-4,0,-9,4,4,192,4,2011,0,1,1798,0
Philadelphia,27,27,16,23,0,0,0,0,Miami,29,22,25,23,0,0,0,0,20120403,93,99,2,-3,6,6,6,192,6,2011,0,1,1021,0
Phoenix,29,30,20,30,0,0,0,0,Sacramento,18,33,27,22,0,0,0,0,20120403,109,100,11,8,1,9,9,209,-9,2011,0,1,634,0
Brooklyn,17,27,20,24,0,0,0,0,Portland,21,25,30,25,0,0,0,0,20120404,88,101,4,2,12,13,13,189,13,2011,0,2,2439,0
Toronto,29,26,24,20,0,0,0,0,Philadelphia,31,25,15,7,0,0,0,0,20120404,99,78,-2,-1,8,21,21,177,-21,2011,0,2,334,0
Indiana,37,15,34,23,0,0,0,0,Washington,28,23,23,22,0,0,0,0,20120404,109,96,9,1,12,13,13,205,-13,2011,0,2,490,0
Denver,18,28,21,25,0,0,0,0,New Orleans,20,25,30,19,0,0,0,0,20120404,92,94,2,-1,8,2,2,186,2,2011,0,2,1079,0
Phoenix,31,27,25,24,0,0,0,0,Utah,31,25,24,25,0,0,0,0,20120404,107,105,0,2,3,2,2,212,-2,2011,0,2,505,0
Golden State,21,18,38,20,0,0,0,0,Minnesota,26,25,20,23,0,0,0,0,20120404,97,94,-5,-12,6,3,3,191,-3,2011,0,2,1581,0
Cleveland,14,25,29,30,0,0,0,0,Milwaukee,29,24,26,28,0,0,0,0,20120404,98,107,15,14,11,9,9,205,9,2011,0,2,334,0
Oklahoma City,23,26,24,20,0,0,0,0,Miami,21,29,30,18,0,0,0,0,20120404,93,98,-2,1,7,5,5,191,5,2011,0,2,1225,0
LA Lakers,34,29,29,21,0,0,0,0,LA Clippers,29,26,26,27,0,0,0,0,20120404,113,108,5,8,11,5,5,221,-5,2011,0,2,0,0
Memphis,23,28,17,17,0,0,0,0,Dallas,20,27,19,29,0,0,0,0,20120404,85,95,-3,-4,-2,10,10,180,10,2011,0,2,419,0
San Antonio,27,32,9,19,0,0,0,0,Boston,20,28,16,22,0,0,0,0,20120404,87,86,7,11,4,1,1,173,-1,2011,0,2,1765,0
Charlotte,25,19,26,23,0,0,0,0,Atlanta,27,34,28,31,0,0,0,0,20120404,93,120,2,17,19,27,27,213,27,2011,0,2,226,0
Boston,22,27,17,20,0,0,0,0,Chicago,18,20,29,26,0,0,0,0,20120405,86,93,-4,-11,1,7,7,179,7,2011,0,3,849,0
Washington,21,19,24,30,0,0,0,0,Detroit,28,23,25,23,0,0,0,0,20120405,94,99,7,11,12,5,5,193,5,2011,0,3,394,0
New York,23,33,20,20,0,0,0,0,Orlando,21,23,17,19,0,0,0,0,20120405,96,80,2,12,15,16,16,176,-16,2011,0,3,939,0
LA Clippers,27,21,19,26,0,0,0,0,Sacramento,23,19,20,23,0,0,0,0,20120405,93,85,4,6,5,8,8,178,-8,2011,0,3,361,0
Golden State,27,28,25,18,0,0,0,0,Utah,28,27,23,26,0,0,0,0,20120406,98,104,1,0,-2,6,6,202,6,2011,0,4,599,0
Cleveland,20,19,12,33,0,0,0,0,Toronto,22,20,21,17,0,0,0,0,20120406,84,80,-2,-3,-12,4,4,164,-4,2011,0,4,187,0
New Orleans,24,21,28,30,0,0,0,0,San Antonio,34,38,27,29,0,0,0,0,20120406,103,128,10,27,26,25,25,231,25,2011,0,4,506,0
Washington,19,24,23,32,0,0,0,0,Brooklyn,33,24,26,27,0,0,0,0,20120406,98,110,14,14,17,12,12,208,12,2011,0,4,204,0
Charlotte,30,22,16,22,0,0,0,0,Milwaukee,28,25,19,23,0,0,0,0,20120406,90,95,-2,1,4,5,5,185,5,2011,0,4,658,0
Phoenix,29,23,23,24,0,0,0,0,Denver,21,31,26,27,0,0,0,0,20120406,99,105,-8,0,3,6,6,204,6,2011,0,4,585,0
Houston,29,21,34,28,0,0,0,0,LA Lakers,24,35,22,26,0,0,0,0,20120406,112,107,5,-9,3,5,5,219,-5,2011,0,4,1371,0
Oklahoma City,20,21,20,37,0,0,0,0,Indiana,32,24,19,28,0,0,0,0,20120406,98,103,12,15,14,5,5,201,5,2011,0,4,688,0
Portland,17,27,30,17,8,0,0,0,Dallas,27,29,10,25,6,0,0,0,20120406,99,97,-10,-12,8,0,2,196,-2,2011,1,4,1630,0
Detroit,20,23,25,28,0,0,0,0,Atlanta,24,28,26,23,0,0,0,0,20120406,96,101,4,9,10,5,5,197,5,2011,0,4,597,0
Memphis,25,23,25,24,0,0,0,0,Miami,12,20,29,21,0,0,0,0,20120406,97,82,13,16,12,15,15,179,-15,2011,0,4,873,0
Minnesota,21,20,26,23,0,0,0,0,New Orleans,20,26,33,20,0,0,0,0,20120407,90,99,-1,5,12,9,9,189,9,2011,0,5,1052,0
LA Lakers,32,25,26,22,0,0,0,0,Phoenix,24,38,37,26,0,0,0,0,20120407,105,125,-8,5,16,20,20,230,20,2011,0,5,356,0
Orlando,24,13,25,26,0,0,0,0,Philadelphia,19,26,16,21,0,0,0,0,20120407,88,82,5,-8,1,6,6,170,-6,2011,0,5,864,0
Portland,31,32,20,11,0,0,0,0,Milwaukee,33,21,32,30,0,0,0,0,20120407,94,116,2,-9,3,22,22,210,22,2011,0,5,1714,0
Sacramento,22,29,23,20,0,0,0,0,LA Clippers,29,27,26,27,0,0,0,0,20120407,94,109,7,5,8,15,15,203,15,2011,0,5,361,0
Boston,24,19,16,27,0,0,0,0,Indiana,19,14,18,21,0,0,0,0,20120407,86,72,5,10,8,14,14,158,-14,2011,0,5,805,0
Denver,27,22,26,22,0,0,0,0,Golden State,26,30,29,27,0,0,0,0,20120407,97,112,-1,7,10,15,15,209,15,2011,0,5,947,0
Atlanta,19,29,38,30,0,0,0,0,Charlotte,23,13,32,28,0,0,0,0,20120407,116,96,-4,12,18,20,20,212,-20,2011,0,5,226,0
Dallas,10,29,28,22,0,0,0,0,Memphis,29,21,22,22,0,0,0,0,20120407,89,94,19,11,5,5,5,183,5,2011,0,5,419,0
Utah,19,21,36,28,0,0,0,0,San Antonio,31,26,28,29,0,0,0,0,20120408,104,114,12,17,9,10,10,218,10,2011,0,6,1087,0
Philadelphia,22,14,27,16,0,0,0,0,Boston,25,25,34,19,0,0,0,0,20120408,79,103,3,14,21,24,24,182,24,2011,0,6,270,0
Detroit,21,19,14,21,0,0,0,0,Miami,19,31,19,29,0,0,0,0,20120408,75,98,-2,10,15,23,23,173,23,2011,0,6,1155,0
Cleveland,30,18,23,38,8,0,0,0,Brooklyn,26,30,20,33,13,0,0,0,20120408,117,122,-4,8,5,0,5,239,5,2011,1,6,403,0
Chicago,19,26,30,16,8,0,0,0,New York,31,22,19,19,9,0,0,0,20120408,99,100,12,8,-3,0,1,199,1,2011,1,6,711,0
Toronto,20,23,12,20,0,0,0,0,Oklahoma City,25,25,20,21,0,0,0,0,20120408,75,91,5,7,15,16,16,166,16,2011,0,6,1114,0
Houston,32,26,15,31,0,0,0,0,Sacramento,21,22,20,24,0,0,0,0,20120408,104,87,11,15,10,17,17,191,-17,2011,0,6,1606,0
Detroit,22,21,28,18,0,0,0,0,Orlando,29,35,30,25,0,0,0,0,20120409,89,119,7,21,23,30,30,208,30,2011,0,0,957,0
LA Lakers,21,23,21,28,0,0,0,0,New Orleans,19,24,29,19,0,0,0,0,20120409,93,91,2,1,-7,2,2,184,-2,2011,0,0,1669,0
Phoenix,21,32,30,31,0,0,0,0,Minnesota,18,27,23,22,0,0,0,0,20120409,114,90,3,8,15,24,24,204,-24,2011,0,0,1278,0
Oklahoma City,35,26,26,22,0,0,0,0,Milwaukee,18,29,21,21,0,0,0,0,20120409,109,89,17,14,19,20,20,198,-20,2011,0,0,732,0
Washington,31,29,25,28,0,0,0,0,Charlotte,20,20,18,27,0,0,0,0,20120409,113,85,11,20,27,28,28,198,-28,2011,0,0,329,0
Toronto,16,21,25,36,0,0,0,0,Indiana,21,30,26,26,0,0,0,0,20120409,98,103,5,14,15,5,5,201,5,2011,0,0,438,0
Golden State,13,25,20,26,0,0,0,0,Denver,37,28,25,33,0,0,0,0,20120409,84,123,24,27,32,39,39,207,39,2011,0,0,947,0
Houston,24,25,22,23,0,0,0,0,Portland,17,23,25,24,0,0,0,0,20120409,94,89,7,9,6,5,5,183,-5,2011,0,0,1833,0
LA Clippers,18,23,19,25,0,0,0,0,Memphis,24,28,19,23,0,0,0,0,20120409,85,94,6,11,11,9,9,179,9,2011,0,0,1599,0
San Antonio,19,25,24,16,0,0,0,0,Utah,23,24,17,27,0,0,0,0,20120409,84,91,4,3,-4,7,7,175,7,2011,0,0,1087,0
Philadelphia,20,32,32,23,0,0,0,0,Brooklyn,20,23,25,20,0,0,0,0,20120410,107,88,0,9,16,19,19,195,-19,2011,0,1,80,0
Boston,33,32,24,26,0,0,0,0,Miami,22,35,24,26,0,0,0,0,20120410,115,107,11,8,8,8,8,222,-8,2011,0,1,1257,0
Orlando,29,12,20,24,0,0,0,0,Washington,18,23,19,33,0,0,0,0,20120410,85,93,-11,0,-1,8,8,178,8,2011,0,1,757,0
Charlotte,22,23,26,19,0,0,0,0,Cleveland,30,19,23,31,0,0,0,0,20120410,90,103,8,4,1,13,13,193,13,2011,0,1,435,0
New York,25,10,27,24,0,0,0,0,Chicago,22,25,25,26,0,0,0,0,20120410,86,98,-3,12,10,12,12,184,12,2011,0,1,711,0
Sacramento,27,23,27,23,0,0,0,0,Dallas,25,32,26,27,0,0,0,0,20120410,100,110,-2,7,6,10,10,210,10,2011,0,1,1437,0
Golden State,25,30,20,35,0,0,0,0,Portland,30,32,23,33,0,0,0,0,20120411,110,118,5,7,10,8,8,228,8,2011,0,2,535,0
Utah,30,26,24,23,0,0,0,0,Houston,26,20,21,24,0,0,0,0,20120411,103,91,4,10,13,12,12,194,-12,2011,0,2,1199,0
Philadelphia,20,22,21,30,0,0,0,0,Toronto,20,17,20,18,0,0,0,0,20120411,93,75,0,5,6,18,18,168,-18,2011,0,2,334,0
LA Clippers,21,27,28,24,0,0,0,0,Oklahoma City,24,31,25,18,0,0,0,0,20120411,100,98,-3,-7,-4,2,2,198,-2,2011,0,2,1178,0
LA Lakers,24,24,27,23,0,0,0,0,San Antonio,21,22,16,25,0,0,0,0,20120411,98,84,3,5,16,14,14,182,-14,2011,0,2,1201,0
Sacramento,29,20,21,26,0,0,0,0,New Orleans,20,30,29,26,0,0,0,0,20120411,96,105,-9,1,9,9,9,201,9,2011,0,2,1879,0
Indiana,28,18,27,21,10,0,0,0,Cleveland,25,21,20,28,4,0,0,0,20120411,104,98,3,0,7,0,6,202,-6,2011,1,2,262,0
Phoenix,26,27,19,21,0,0,0,0,Memphis,32,27,21,24,0,0,0,0,20120411,93,104,6,6,8,11,11,197,11,2011,0,2,1260,0
Minnesota,24,23,33,27,0,0,0,0,Denver,37,31,21,24,0,0,0,0,20120411,107,113,13,21,9,6,6,220,6,2011,0,2,698,0
New York,36,26,22,27,0,0,0,0,Milwaukee,27,35,26,19,0,0,0,0,20120411,111,107,9,0,-4,4,4,218,-4,2011,0,2,732,0
Atlanta,25,23,20,16,2,0,0,0,Boston,26,14,27,17,4,0,0,0,20120411,86,88,1,-8,-1,0,2,174,2,2011,1,2,935,0
Detroit,22,30,40,17,0,0,0,0,Charlotte,18,22,22,23,0,0,0,0,20120412,109,85,4,12,30,24,24,194,-24,2011,0,3,504,0
Miami,22,19,21,22,2,0,0,0,Chicago,19,17,24,24,12,0,0,0,20120412,86,96,-3,-5,-2,0,10,182,10,2011,1,3,1189,0
Dallas,27,36,26,23,0,0,0,0,Golden State,20,29,30,24,0,0,0,0,20120412,112,103,7,14,10,9,9,215,-9,2011,0,3,1480,0
LA Clippers,21,26,26,22,0,0,0,0,Minnesota,26,22,20,14,0,0,0,0,20120412,95,82,-5,-1,5,13,13,177,-13,2011,0,3,1521,0
Memphis,21,28,25,23,0,0,0,0,San Antonio,27,18,37,25,0,0,0,0,20120412,97,107,6,-4,8,10,10,204,10,2011,0,3,631,0
Boston,20,16,11,32,0,0,0,0,Toronto,13,17,27,27,0,0,0,0,20120413,79,84,-7,-6,10,5,5,163,5,2011,0,4,430,0
Dallas,30,26,25,16,0,0,0,0,Portland,16,25,20,33,0,0,0,0,20120413,97,94,14,15,20,3,3,191,-3,2011,0,4,1630,0
Brooklyn,24,17,22,32,0,0,0,0,Philadelphia,18,26,22,23,0,0,0,0,20120413,95,89,6,-3,-3,6,6,184,-6,2011,0,4,80,0
Atlanta,36,26,27,20,0,0,0,0,Orlando,23,19,22,17,0,0,0,0,20120413,109,81,13,20,25,28,28,190,-28,2011,0,4,401,0
Sacramento,21,18,24,26,0,0,0,0,Oklahoma City,23,35,28,29,0,0,0,0,20120413,89,115,2,19,23,26,26,204,26,2011,0,4,1336,0
Washington,13,20,14,18,0,0,0,0,New York,26,28,25,24,0,0,0,0,20120413,65,103,13,21,32,38,38,168,38,2011,0,4,204,0
Charlotte,19,20,20,23,0,0,0,0,Miami,33,25,23,24,0,0,0,0,20120413,82,105,14,19,22,23,23,187,23,2011,0,4,654,0
Denver,19,29,23,26,0,0,0,0,LA Lakers,30,24,25,24,0,0,0,0,20120413,97,103,11,6,8,6,6,200,6,2011,0,4,830,0
Cleveland,19,24,13,27,0,0,0,0,Indiana,16,25,34,27,0,0,0,0,20120413,83,102,-3,-2,19,19,19,185,19,2011,0,4,262,0
Phoenix,21,30,30,31,0,0,0,0,Houston,28,27,14,36,0,0,0,0,20120413,112,105,-7,-4,12,7,7,217,-7,2011,0,4,1014,0
Milwaukee,30,22,33,28,0,0,0,0,Detroit,25,22,26,24,0,0,0,0,20120413,113,97,5,5,12,16,16,210,-16,2011,0,4,251,0
Utah,28,19,23,15,0,0,0,0,New Orleans,24,23,26,23,0,0,0,0,20120413,85,96,-4,0,3,11,11,181,11,2011,0,4,1432,0
Indiana,27,32,21,25,0,0,0,0,Milwaukee,27,21,30,21,0,0,0,0,20120414,105,99,0,11,2,6,6,204,-6,2011,0,5,243,0
Golden State,23,35,24,22,0,0,0,0,LA Clippers,35,24,27,26,0,0,0,0,20120414,104,112,12,1,4,8,8,216,8,2011,0,5,347,0
Utah,30,21,25,22,0,0,0,0,Memphis,28,22,20,33,0,0,0,0,20120414,98,103,-2,-1,-6,5,5,201,5,2011,0,5,1247,0
Oklahoma City,34,25,27,29,0,0,0,0,Minnesota,31,27,22,30,0,0,0,0,20120414,115,110,3,1,6,5,5,225,-5,2011,0,5,694,0
Boston,22,26,26,20,0,0,0,0,Brooklyn,28,20,13,21,0,0,0,0,20120414,94,82,-6,0,13,12,12,176,-12,2011,0,5,190,0
Phoenix,13,25,27,26,0,0,0,0,San Antonio,35,27,22,21,0,0,0,0,20120414,91,105,22,24,19,14,14,196,14,2011,0,5,846,0
Cleveland,22,28,23,25,0,0,0,0,Washington,22,21,28,18,0,0,0,0,20120414,98,89,0,7,2,9,9,187,-9,2011,0,5,304,0
Miami,29,17,25,22,0,0,0,0,New York,22,22,24,17,0,0,0,0,20120415,93,85,7,2,3,8,8,178,-8,2011,0,6,1091,0
Memphis,16,21,19,19,0,0,0,0,New Orleans,15,18,29,26,0,0,0,0,20120415,75,88,-1,-4,6,13,13,163,13,2011,0,6,358,0
Portland,28,26,27,22,0,0,0,0,Sacramento,22,24,33,25,0,0,0,0,20120415,103,104,-6,-8,-2,1,1,207,1,2011,0,6,483,0
Dallas,27,27,21,23,10,0,0,0,LA Lakers,22,26,28,22,14,0,0,0,20120415,108,112,-5,-6,1,0,4,220,4,2011,1,6,1237,0
Boston,34,18,21,21,0,0,0,0,Charlotte,23,26,18,15,0,0,0,0,20120415,94,82,11,3,6,12,12,176,-12,2011,0,6,720,0
Houston,27,22,19,18,0,0,0,0,Denver,22,21,37,21,0,0,0,0,20120415,86,101,-5,-6,12,15,15,187,15,2011,0,6,878,0
Orlando,23,20,31,26,0,0,0,0,Cleveland,15,15,30,24,0,0,0,0,20120415,100,84,8,13,14,16,16,184,-16,2011,0,6,895,0
Toronto,25,28,20,29,0,0,0,0,Atlanta,23,16,25,22,0,0,0,0,20120415,102,86,2,14,9,16,16,188,-16,2011,0,6,733,0
Chicago,26,23,15,22,14,0,0,0,Detroit,19,22,25,20,8,0,0,0,20120415,100,94,7,8,-2,0,6,194,-6,2011,1,6,238,0
Dallas,18,24,20,27,16,6,10,0,Utah,22,21,28,18,16,6,12,0,20120416,121,123,4,1,9,0,2,244,2,2011,3,0,998,0
Portland,24,29,27,27,0,0,0,0,Phoenix,35,31,31,28,0,0,0,0,20120416,107,125,11,13,17,18,18,232,18,2011,0,0,1005,0
Philadelphia,27,28,24,21,0,0,0,0,Orlando,21,40,29,23,0,0,0,0,20120416,100,113,-6,6,11,13,13,213,13,2011,0,0,864,0
Miami,29,23,18,31,0,0,0,0,Brooklyn,34,21,24,19,0,0,0,0,20120416,101,98,-5,-3,-9,3,3,199,-3,2011,0,0,1091,0
Oklahoma City,27,25,14,11,0,0,0,0,LA Clippers,21,22,23,26,0,0,0,0,20120416,77,92,-6,-9,0,15,15,169,15,2011,0,0,1178,0
Atlanta,30,24,25,30,0,0,0,0,Toronto,32,19,17,19,0,0,0,0,20120416,109,87,-2,3,11,22,22,196,-22,2011,0,0,733,0
Denver,21,23,31,30,0,0,0,0,Houston,32,19,23,28,0,0,0,0,20120416,105,102,-11,-7,1,3,3,207,-3,2011,0,0,878,0
San Antonio,39,31,26,24,0,0,0,0,Golden State,24,25,23,27,0,0,0,0,20120416,120,99,15,21,24,21,21,219,-21,2011,0,0,1487,0
Washington,19,24,14,30,0,0,0,0,Chicago,23,17,23,21,0,0,0,0,20120416,87,84,-4,3,-6,3,3,171,-3,2011,0,0,594,0
New Orleans,14,21,12,28,0,0,0,0,Charlotte,15,24,8,20,0,0,0,0,20120416,75,67,-1,-4,0,8,8,142,-8,2011,0,0,648,0
Minnesota,13,17,33,25,0,0,0,0,Indiana,32,32,29,18,0,0,0,0,20120416,88,111,19,34,30,23,23,199,23,2011,0,0,510,0
Indiana,23,24,23,32,0,0,0,0,Philadelphia,21,21,28,27,0,0,0,0,20120417,102,97,2,5,0,5,5,199,-5,2011,0,1,582,0
Memphis,32,23,22,14,0,0,0,0,Minnesota,22,34,13,15,0,0,0,0,20120417,91,84,10,-1,8,7,7,175,-7,2011,0,1,700,0
Boston,26,27,31,26,0,0,0,0,New York,32,40,24,22,0,0,0,0,20120417,110,118,6,19,12,8,8,228,8,2011,0,1,190,0
Cleveland,16,22,12,27,0,0,0,0,Detroit,27,34,39,16,0,0,0,0,20120417,77,116,11,23,50,39,39,193,39,2011,0,1,90,0
San Antonio,27,36,28,21,0,0,0,0,LA Lakers,28,19,23,21,0,0,0,0,20120417,112,91,-1,16,21,21,21,203,-21,2011,0,1,1201,0
Toronto,24,25,11,12,0,0,0,0,Miami,25,26,23,22,0,0,0,0,20120418,72,96,1,2,14,24,24,168,24,2011,0,2,1234,0
Milwaukee,31,31,19,31,0,0,0,0,Washington,28,32,28,33,0,0,0,0,20120418,112,121,-3,-2,7,9,9,233,9,2011,0,2,634,0
San Antonio,29,29,39,30,0,0,0,0,Sacramento,28,29,29,16,0,0,0,0,20120418,127,102,1,1,11,25,25,229,-25,2011,0,2,1456,0
Utah,26,31,24,31,0,0,0,0,Portland,23,16,21,31,0,0,0,0,20120418,112,91,3,18,21,21,21,203,-21,2011,0,2,634,0
Oklahoma City,29,23,30,27,0,0,0,0,Phoenix,25,20,32,20,0,0,0,0,20120418,109,97,4,7,5,12,12,206,-12,2011,0,2,840,0
New York,38,26,14,26,0,0,0,0,Brooklyn,22,25,24,24,0,0,0,0,20120418,104,95,16,17,7,9,9,199,-9,2011,0,2,0,0
New Orleans,21,27,12,31,0,0,0,0,Memphis,23,24,37,19,0,0,0,0,20120418,91,103,2,-1,24,12,12,194,12,2011,0,2,358,0
Orlando,22,29,19,28,0,0,0,0,Boston,33,22,24,23,0,0,0,0,20120418,98,102,11,4,9,4,4,200,4,2011,0,2,1115,0
LA Clippers,22,25,29,28,0,0,0,0,Denver,34,19,23,22,0,0,0,0,20120418,104,98,-12,-6,0,6,6,202,-6,2011,0,2,830,0
Houston,27,28,29,26,0,0,0,0,Dallas,27,28,23,39,0,0,0,0,20120418,110,117,0,0,-6,7,7,227,7,2011,0,2,225,0
Philadelphia,28,25,31,19,0,0,0,0,Cleveland,22,27,17,21,0,0,0,0,20120418,103,87,6,4,18,16,16,190,-16,2011,0,2,358,0
Chicago,34,18,25,23,0,0,0,0,Charlotte,20,17,22,9,0,0,0,0,20120418,100,68,14,15,18,32,32,168,-32,2011,0,2,586,0
LA Lakers,32,24,28,15,0,0,0,0,Golden State,26,22,19,20,0,0,0,0,20120418,99,87,6,8,17,12,12,186,-12,2011,0,2,347,0
Detroit,20,22,19,23,0,0,0,0,Atlanta,39,33,24,20,0,0,0,0,20120418,84,116,19,30,35,32,32,200,32,2011,0,2,597,0
LA Clippers,29,16,26,19,0,0,0,0,Phoenix,27,19,23,24,0,0,0,0,20120419,90,93,-2,1,-2,3,3,183,3,2011,0,3,356,0
Chicago,23,17,21,11,0,0,0,0,Miami,27,15,24,17,0,0,0,0,20120419,72,83,4,2,5,11,11,155,11,2011,0,3,1189,0
Houston,29,22,13,23,12,0,0,0,New Orleans,22,21,26,18,18,0,0,0,20120419,99,105,-7,-8,5,0,6,204,6,2011,1,3,317,0
Minnesota,24,25,19,23,0,0,0,0,Detroit,16,15,17,32,0,0,0,0,20120419,91,80,8,18,20,11,11,171,-11,2011,0,3,542,0
Milwaukee,29,21,28,31,0,0,0,0,Indiana,34,22,33,29,0,0,0,0,20120419,109,118,5,6,11,9,9,227,9,2011,0,3,243,0
Boston,27,22,22,21,0,0,0,0,Atlanta,34,24,16,23,0,0,0,0,20120420,92,97,7,9,3,5,5,189,5,2011,0,4,935,0
Memphis,17,20,20,28,0,0,0,0,Charlotte,21,18,26,15,0,0,0,0,20120420,85,80,-4,-2,-8,5,5,165,-5,2011,0,4,519,0
New York,20,14,22,34,0,0,0,0,Cleveland,25,20,27,26,0,0,0,0,20120420,90,98,5,11,16,8,8,188,8,2011,0,4,403,0
Golden State,22,27,21,24,0,0,0,0,Dallas,27,23,26,28,0,0,0,0,20120420,94,104,5,1,6,10,10,198,10,2011,0,4,1480,0
Oklahoma City,32,25,24,22,0,0,0,0,Sacramento,25,24,21,22,0,0,0,0,20120420,103,92,7,8,11,11,11,195,-11,2011,0,4,1336,0
LA Lakers,25,27,21,24,0,0,0,0,San Antonio,32,24,35,30,0,0,0,0,20120420,97,121,7,4,18,24,24,218,24,2011,0,4,1201,0
Brooklyn,23,19,27,26,0,0,0,0,Milwaukee,24,29,20,33,0,0,0,0,20120421,95,106,1,11,4,11,11,201,11,2011,0,5,732,0
Orlando,36,19,28,18,6,0,0,0,Utah,23,32,26,20,16,0,0,0,20120421,107,117,-13,0,-2,0,10,224,10,2011,1,5,1915,0
Washington,23,22,18,23,0,0,0,0,Miami,15,22,25,22,0,0,0,0,20120421,86,84,8,8,1,2,2,170,-2,2011,0,5,924,0
Denver,30,30,33,25,0,0,0,0,Phoenix,34,24,22,27,0,0,0,0,20120421,118,107,-4,2,13,11,11,225,-11,2011,0,5,585,0
Philadelphia,34,19,28,17,11,0,0,0,Indiana,23,31,20,24,8,0,0,0,20120421,109,106,11,-1,7,0,3,215,-3,2011,1,5,582,0
Golden State,21,34,16,25,0,0,0,0,Houston,31,27,19,22,0,0,0,0,20120421,96,99,10,3,6,3,3,195,3,2011,0,5,1642,0
Dallas,8,30,18,27,0,0,0,0,Chicago,21,23,22,27,0,0,0,0,20120421,83,93,13,6,10,10,10,176,10,2011,0,5,802,0
Portland,27,18,22,22,0,0,0,0,Memphis,24,30,25,14,0,0,0,0,20120421,89,93,-3,9,12,4,4,182,4,2011,0,5,1845,0
New York,31,29,34,19,0,0,0,0,Atlanta,31,34,28,19,0,0,0,0,20120422,113,112,0,-5,1,1,1,225,-1,2011,0,6,745,0
Sacramento,31,28,28,27,0,0,0,0,Charlotte,19,25,23,21,0,0,0,0,20120422,114,88,12,15,20,26,26,202,-26,2011,0,6,2239,0
Orlando,19,25,18,12,0,0,0,0,Denver,24,20,29,28,0,0,0,0,20120422,74,101,5,0,11,27,27,175,27,2011,0,6,1548,0
Toronto,15,19,16,23,0,0,0,0,Detroit,14,15,24,23,0,0,0,0,20120422,73,76,-1,-5,3,3,3,149,3,2011,0,6,205,0
New Orleans,27,25,32,14,0,0,0,0,LA Clippers,32,25,17,33,0,0,0,0,20120422,98,107,5,5,-10,9,9,205,9,2011,0,6,1669,0
Oklahoma City,26,26,25,14,6,9,0,0,LA Lakers,20,27,14,30,6,17,0,0,20120422,106,114,-6,-5,-16,0,8,220,8,2011,2,6,1178,0
Houston,27,17,25,19,0,0,0,0,Miami,22,23,21,31,0,0,0,0,20120422,88,97,-5,1,-3,9,9,185,9,2011,0,6,966,0
Golden State,17,22,30,24,0,0,0,0,Minnesota,32,23,20,13,0,0,0,0,20120422,93,88,-15,-16,-6,5,5,181,-5,2011,0,6,1581,0
Cleveland,22,22,26,28,0,0,0,0,San Antonio,29,23,29,33,0,0,0,0,20120422,98,114,7,8,11,16,16,212,16,2011,0,6,1256,0
Charlotte,22,17,23,11,0,0,0,0,Washington,31,32,20,18,0,0,0,0,20120423,73,101,9,24,21,28,28,174,28,2011,0,0,329,0
Portland,18,23,24,24,0,0,0,0,San Antonio,31,32,28,33,0,0,0,0,20120423,89,124,13,22,26,35,35,213,35,2011,0,0,1718,0
Philadelphia,31,22,23,29,0,0,0,0,Brooklyn,18,25,25,19,0,0,0,0,20120423,105,87,13,10,8,18,18,192,-18,2011,0,0,80,0
Detroit,26,26,23,22,0,0,0,0,Indiana,26,28,22,27,0,0,0,0,20120423,97,103,0,2,1,6,6,200,6,2011,0,0,240,0
Cleveland,32,20,26,23,0,0,0,0,Memphis,26,29,22,32,0,0,0,0,20120423,101,109,-6,3,-1,8,8,210,8,2011,0,0,629,0
Toronto,25,23,19,19,0,0,0,0,Milwaukee,17,26,19,30,0,0,0,0,20120423,86,92,-8,-5,-5,6,6,178,6,2011,0,0,429,0
LA Clippers,28,22,22,30,0,0,0,0,Atlanta,23,29,33,24,0,0,0,0,20120424,102,109,-5,2,13,7,7,211,7,2011,0,1,1932,0
Miami,17,17,16,16,0,0,0,0,Boston,10,18,22,28,0,0,0,0,20120424,66,78,-7,-6,0,12,12,144,12,2011,0,1,1257,0
New Orleans,21,22,18,22,0,0,0,0,Golden State,22,21,21,17,0,0,0,0,20120424,83,81,-1,0,-3,2,2,164,-2,2011,0,1,1921,0
Sacramento,40,19,27,24,0,0,0,0,Oklahoma City,35,22,25,36,0,0,0,0,20120424,110,118,-5,-2,-4,8,8,228,8,2011,0,1,1336,0
Phoenix,19,23,26,20,0,0,0,0,Utah,25,24,24,27,0,0,0,0,20120424,88,100,6,7,5,12,12,188,12,2011,0,1,505,0
Charlotte,24,23,26,22,0,0,0,0,Orlando,37,20,26,19,0,0,0,0,20120425,95,102,13,10,10,7,7,197,7,2011,0,2,463,0
San Antonio,26,32,24,28,0,0,0,0,Phoenix,29,24,29,24,0,0,0,0,20120425,110,106,-3,5,0,4,4,216,-4,2011,0,2,846,0
Denver,36,28,16,26,0,0,0,0,Oklahoma City,30,28,24,19,0,0,0,0,20120425,106,101,6,6,-2,5,5,207,-5,2011,0,2,503,0
Philadelphia,24,21,26,19,0,0,0,0,Milwaukee,29,21,13,22,0,0,0,0,20120425,90,85,-5,-5,8,5,5,175,-5,2011,0,2,692,0
LA Clippers,19,20,27,27,0,0,0,0,New York,24,24,26,25,0,0,0,0,20120425,93,99,5,9,8,6,6,192,6,2011,0,2,2445,0
Chicago,32,17,18,25,0,0,0,0,Indiana,24,12,23,28,0,0,0,0,20120425,92,87,8,13,8,5,5,179,-5,2011,0,2,163,0
Washington,21,28,28,19,0,0,0,0,Cleveland,27,18,18,22,0,0,0,0,20120425,96,85,-6,4,14,11,11,181,-11,2011,0,2,304,0
Miami,18,14,18,20,0,0,0,0,Washington,28,29,23,24,0,0,0,0,20120426,70,104,10,25,30,34,34,174,34,2011,0,3,924,0
Portland,16,24,35,19,0,0,0,0,Utah,23,24,31,18,0,0,0,0,20120426,94,96,7,7,3,2,2,190,2,2011,0,3,634,0
Brooklyn,15,12,16,24,0,0,0,0,Toronto,26,28,19,25,0,0,0,0,20120426,67,98,11,27,30,31,31,165,31,2011,0,3,341,0
Denver,29,32,32,38,0,0,0,0,Minnesota,25,17,27,33,0,0,0,0,20120426,131,102,4,19,24,29,29,233,-29,2011,0,3,698,0
Orlando,9,21,24,22,0,0,0,0,Memphis,27,27,13,21,0,0,0,0,20120426,76,88,18,24,13,12,12,164,12,2011,0,3,683,0
New Orleans,20,22,29,6,0,0,0,0,Houston,12,21,30,21,0,0,0,0,20120426,77,84,-8,-9,-8,7,7,161,7,2011,0,3,317,0
LA Lakers,24,19,31,22,0,0,0,0,Sacramento,35,21,34,23,0,0,0,0,20120426,96,113,11,13,16,17,17,209,17,2011,0,3,361,0
Philadelphia,15,28,23,20,0,0,0,0,Detroit,26,39,21,22,0,0,0,0,20120426,86,108,11,22,20,22,22,194,22,2011,0,3,441,0
Cleveland,25,20,17,13,0,0,0,0,Chicago,26,32,22,27,0,0,0,0,20120426,75,107,1,13,18,32,32,182,32,2011,0,3,308,0
New York,23,23,30,28,0,0,0,0,Charlotte,20,24,19,21,0,0,0,0,20120426,104,84,3,2,13,20,20,188,-20,2011,0,3,531,0
Milwaukee,18,24,19,13,0,0,0,0,Boston,21,39,18,9,0,0,0,0,20120426,74,87,3,18,17,13,13,161,13,2011,0,3,855,0
Dallas,21,23,28,17,0,0,0,0,Atlanta,38,22,26,20,0,0,0,0,20120426,89,106,17,16,14,17,17,195,17,2011,0,3,719,0
San Antonio,27,26,31,23,0,0,0,0,Golden State,29,25,28,19,0,0,0,0,20120426,107,101,-2,-1,2,6,6,208,-6,2011,0,3,1487,0
Philadelphia,24,18,24,25,0,0,0,0,Chicago,28,25,26,24,0,0,0,0,20120428,91,103,4,11,13,12,12,194,12,2011,0,5,664,1
Orlando,21,30,13,17,0,0,0,0,Indiana,22,22,19,14,0,0,0,0,20120428,81,77,-1,7,1,4,4,158,-4,2011,0,5,822,1
New York,18,13,16,20,0,0,0,0,Miami,24,30,27,19,0,0,0,0,20120428,67,100,6,23,34,33,33,167,33,2011,0,5,1091,1
Dallas,26,25,22,25,0,0,0,0,Oklahoma City,22,26,21,30,0,0,0,0,20120428,98,99,-4,-3,-4,1,1,197,1,2011,0,5,189,1
Utah,22,25,23,21,0,0,0,0,San Antonio,28,26,31,21,0,0,0,0,20120429,91,106,6,7,15,15,15,197,15,2011,0,6,1087,1
Boston,18,17,18,21,0,0,0,0,Atlanta,31,18,16,18,0,0,0,0,20120429,74,83,13,14,12,9,9,157,9,2011,0,6,935,1
Denver,14,26,24,24,0,0,0,0,LA Lakers,27,23,27,26,0,0,0,0,20120429,88,103,13,10,13,15,15,191,15,2011,0,6,830,1
LA Clippers,16,23,25,35,0,0,0,0,Memphis,34,24,27,13,0,0,0,0,20120429,99,98,-18,-19,-21,1,1,197,-1,2011,0,6,1599,1
Dallas,24,26,27,22,0,0,0,0,Oklahoma City,32,25,22,23,0,0,0,0,20120430,99,102,8,7,2,3,3,201,3,2011,0,0,189,1
New York,24,23,22,25,0,0,0,0,Miami,27,26,25,26,0,0,0,0,20120430,94,104,3,6,9,10,10,198,10,2011,0,0,1091,1
Orlando,21,23,13,21,0,0,0,0,Indiana,24,18,30,21,0,0,0,0,20120430,78,93,3,-2,15,15,15,171,15,2011,0,0,822,1
Boston,24,17,20,26,0,0,0,0,Atlanta,24,20,22,14,0,0,0,0,20120501,87,80,0,-3,-5,7,7,167,-7,2011,0,1,935,1
Philadelphia,25,22,36,26,0,0,0,0,Chicago,28,27,14,23,0,0,0,0,20120501,109,92,-3,-8,14,17,17,201,-17,2011,0,1,664,1
Denver,25,23,26,26,0,0,0,0,LA Lakers,32,23,26,23,0,0,0,0,20120501,100,104,7,7,7,4,4,204,4,2011,0,1,830,1
LA Clippers,26,21,22,29,0,0,0,0,Memphis,23,28,24,30,0,0,0,0,20120502,98,105,-3,4,6,7,7,203,7,2011,0,2,1599,1
Indiana,23,21,32,21,0,0,0,0,Orlando,14,24,17,19,0,0,0,0,20120502,97,74,9,6,21,23,23,171,-23,2011,0,2,822,1
Utah,17,11,25,30,0,0,0,0,San Antonio,28,25,34,27,0,0,0,0,20120502,83,114,11,25,34,31,31,197,31,2011,0,2,1087,1
Oklahoma City,32,18,25,20,0,0,0,0,Dallas,26,15,16,22,0,0,0,0,20120503,95,79,6,9,18,16,16,174,-16,2011,0,3,189,1
Miami,19,17,22,29,0,0,0,0,New York,19,21,16,14,0,0,0,0,20120503,87,70,0,-4,2,17,17,157,-17,2011,0,3,1091,1
Atlanta,19,19,20,22,4,0,0,0,Boston,17,23,20,20,10,0,0,0,20120504,84,90,-2,2,2,0,6,174,6,2011,1,4,935,1
LA Lakers,14,25,26,19,0,0,0,0,Denver,30,25,17,27,0,0,0,0,20120504,84,99,16,16,7,15,15,183,15,2011,0,4,830,1
Chicago,20,19,21,14,0,0,0,0,Philadelphia,19,21,11,28,0,0,0,0,20120504,74,79,-1,1,-9,5,5,153,5,2011,0,4,664,1
San Antonio,30,22,23,27,0,0,0,0,Utah,28,22,18,22,0,0,0,0,20120505,102,90,2,2,7,12,12,192,-12,2011,0,5,1087,1
Indiana,22,24,27,16,12,0,0,0,Orlando,19,25,17,28,10,0,0,0,20120505,101,99,3,2,12,0,2,200,-2,2011,1,5,822,1
Oklahoma City,26,21,21,35,0,0,0,0,Dallas,24,23,34,16,0,0,0,0,20120505,103,97,2,0,-13,6,6,200,-6,2011,0,5,189,1
Memphis,22,24,25,15,0,0,0,0,LA Clippers,23,27,14,23,0,0,0,0,20120505,86,87,1,4,-7,1,1,173,1,2011,0,5,1599,1
Atlanta,19,22,22,16,0,0,0,0,Boston,32,32,26,11,0,0,0,0,20120506,79,101,13,23,27,22,22,180,22,2011,0,6,935,1
LA Lakers,26,19,25,22,0,0,0,0,Denver,28,23,20,17,0,0,0,0,20120506,92,88,-2,-6,-1,4,4,180,-4,2011,0,6,830,1
Miami,18,26,17,26,0,0,0,0,New York,20,18,26,25,0,0,0,0,20120506,87,89,2,-6,3,2,2,176,2,2011,0,6,1091,1
Chicago,15,27,21,19,0,0,0,0,Philadelphia,24,20,20,25,0,0,0,0,20120506,82,89,9,2,1,7,7,171,7,2011,0,6,664,1
Memphis,26,19,19,23,10,0,0,0,LA Clippers,32,19,18,18,14,0,0,0,20120507,97,101,6,6,5,0,4,198,4,2011,1,0,1599,1
San Antonio,22,28,18,19,0,0,0,0,Utah,19,23,16,23,0,0,0,0,20120507,87,81,3,8,10,6,6,168,-6,2011,0,0,1087,1
Orlando,19,28,24,16,0,0,0,0,Indiana,28,22,19,36,0,0,0,0,20120508,87,105,9,3,-2,18,18,192,18,2011,0,1,822,1
Boston,21,19,24,22,0,0,0,0,Atlanta,15,25,26,21,0,0,0,0,20120508,86,87,-6,0,2,1,1,173,1,2011,0,1,935,1
Philadelphia,16,10,22,21,0,0,0,0,Chicago,17,18,22,20,0,0,0,0,20120508,69,77,1,9,9,8,8,146,8,2011,0,1,664,1
Denver,26,23,27,26,0,0,0,0,LA Lakers,23,20,22,34,0,0,0,0,20120508,102,99,3,6,11,3,3,201,-3,2011,0,1,830,1
New York,24,20,23,27,0,0,0,0,Miami,28,27,26,25,0,0,0,0,20120509,94,106,4,11,14,12,12,200,12,2011,0,2,1091,1
LA Clippers,22,20,23,15,0,0,0,0,Memphis,36,21,20,15,0,0,0,0,20120509,80,92,14,15,12,12,12,172,12,2011,0,2,1599,1
Atlanta,23,18,22,17,0,0,0,0,Boston,20,27,20,16,0,0,0,0,20120510,80,83,-3,6,4,3,3,163,3,2011,0,3,935,1
LA Lakers,20,25,23,28,0,0,0,0,Denver,30,24,36,23,0,0,0,0,20120510,96,113,10,9,22,17,17,209,17,2011,0,3,830,1
Chicago,22,18,23,15,0,0,0,0,Philadelphia,24,24,15,16,0,0,0,0,20120510,78,79,2,8,0,1,1,157,1,2011,0,3,664,1
Memphis,25,17,24,24,0,0,0,0,LA Clippers,16,22,28,22,0,0,0,0,20120511,90,88,9,4,0,2,2,178,-2,2011,0,4,1599,1
Philadelphia,28,19,24,20,0,0,0,0,Boston,18,24,25,25,0,0,0,0,20120512,91,92,-10,-5,-4,1,1,183,1,2011,0,5,270,1
Denver,24,18,26,19,0,0,0,0,LA Lakers,25,23,21,27,0,0,0,0,20120512,87,96,1,6,1,9,9,183,9,2011,0,5,830,1
LA Clippers,16,23,16,27,0,0,0,0,Memphis,13,25,18,16,0,0,0,0,20120513,82,72,3,1,-1,10,10,154,-10,2011,0,6,1599,1
Indiana,23,25,22,16,0,0,0,0,Miami,20,22,28,25,0,0,0,0,20120513,86,95,-3,-6,0,9,9,181,9,2011,0,6,1026,1
Philadelphia,21,15,21,25,0,0,0,0,Boston,25,13,11,32,0,0,0,0,20120514,82,81,-4,-2,8,1,1,163,-1,2011,0,0,270,1
LA Lakers,23,21,24,22,0,0,0,0,Oklahoma City,30,29,39,21,0,0,0,0,20120514,90,119,7,15,30,29,29,209,29,2011,0,0,1178,1
LA Clippers,29,20,23,20,0,0,0,0,San Antonio,29,28,30,21,0,0,0,0,20120515,92,108,0,8,15,16,16,200,16,2011,0,1,1201,1
Indiana,17,16,28,17,0,0,0,0,Miami,21,17,14,23,0,0,0,0,20120515,78,75,-4,-5,9,3,3,153,-3,2011,0,1,1026,1
LA Lakers,22,23,18,12,0,0,0,0,Oklahoma City,21,27,12,17,0,0,0,0,20120516,75,77,-1,3,-3,2,2,152,2,2011,0,2,1178,1
Boston,28,32,29,18,0,0,0,0,Philadelphia,33,16,17,25,0,0,0,0,20120516,107,91,-5,11,23,16,16,198,-16,2011,0,2,270,1
Miami,26,17,12,20,0,0,0,0,Indiana,17,26,26,25,0,0,0,0,20120517,75,94,-9,0,14,19,19,169,19,2011,0,3,1026,1
LA Clippers,21,21,25,21,0,0,0,0,San Antonio,29,17,32,27,0,0,0,0,20120517,88,105,8,4,11,17,17,193,17,2011,0,3,1201,1
Oklahoma City,15,32,23,26,0,0,0,0,LA Lakers,23,27,19,30,0,0,0,0,20120518,96,99,8,3,-1,3,3,195,3,2011,0,4,1178,1
Boston,24,22,17,20,0,0,0,0,Philadelphia,12,19,28,33,0,0,0,0,20120518,83,92,-12,-15,-4,9,9,175,9,2011,0,4,270,1
San Antonio,11,32,26,27,0,0,0,0,LA Clippers,33,20,8,25,0,0,0,0,20120519,96,86,-22,-10,8,10,10,182,-10,2011,0,5,1201,1
Oklahoma City,24,22,25,32,0,0,0,0,LA Lakers,29,27,24,20,0,0,0,0,20120519,103,100,-5,-10,-9,3,3,203,-3,2011,0,5,1178,1
Miami,18,28,30,25,0,0,0,0,Indiana,25,29,16,23,0,0,0,0,20120520,101,93,-7,-8,6,8,8,194,-8,2011,0,6,1026,1
San Antonio,26,25,23,28,0,0,0,0,LA Clippers,21,26,28,24,0,0,0,0,20120520,102,99,5,4,-1,3,3,201,-3,2011,0,6,1201,1
Philadelphia,27,23,16,19,0,0,0,0,Boston,23,24,28,26,0,0,0,0,20120521,85,101,-4,-3,9,16,16,186,16,2011,0,0,270,1
LA Lakers,21,30,26,13,0,0,0,0,Oklahoma City,26,28,29,23,0,0,0,0,20120521,90,106,5,3,6,16,16,196,16,2011,0,0,1178,1
Indiana,20,20,17,26,0,0,0,0,Miami,26,23,27,39,0,0,0,0,20120522,83,115,6,9,19,32,32,198,32,2011,0,1,1026,1
Boston,19,17,20,19,0,0,0,0,Philadelphia,22,11,27,22,0,0,0,0,20120523,75,82,3,-3,4,7,7,157,7,2011,0,2,270,1
Miami,21,30,28,26,0,0,0,0,Indiana,28,25,16,24,0,0,0,0,20120524,105,93,-7,-2,10,12,12,198,-12,2011,0,3,1026,1
Philadelphia,20,13,19,23,0,0,0,0,Boston,20,21,14,30,0,0,0,0,20120526,75,85,0,8,3,10,10,160,10,2011,0,5,270,1
Oklahoma City,18,29,24,27,0,0,0,0,San Antonio,24,22,16,39,0,0,0,0,20120527,98,101,6,-1,-9,3,3,199,3,2011,0,6,421,1
Boston,11,35,15,18,0,0,0,0,Miami,21,25,26,21,0,0,0,0,20120528,79,93,10,0,11,14,14,172,14,2011,0,0,1257,1
Oklahoma City,22,22,32,35,0,0,0,0,San Antonio,28,27,37,28,0,0,0,0,20120529,111,120,6,11,16,9,9,231,9,2011,0,1,421,1
Boston,24,29,22,24,12,0,0,0,Miami,18,28,35,18,16,0,0,0,20120530,111,115,-6,-7,6,0,4,226,4,2011,1,2,1257,1
San Antonio,24,17,19,22,0,0,0,0,Oklahoma City,22,32,24,24,0,0,0,0,20120531,82,102,-2,13,18,20,20,184,20,2011,0,3,421,1
Miami,28,14,21,28,0,0,0,0,Boston,30,25,30,16,0,0,0,0,20120601,91,101,2,13,22,10,10,192,10,2011,0,4,1257,1
San Antonio,26,17,28,32,0,0,0,0,Oklahoma City,26,29,20,34,0,0,0,0,20120602,103,109,0,12,4,6,6,212,6,2011,0,5,421,1
Miami,23,24,21,21,2,0,0,0,Boston,34,27,12,16,4,0,0,0,20120603,91,93,11,14,5,0,2,184,2,2011,1,6,1257,1
Oklahoma City,26,26,29,27,0,0,0,0,San Antonio,21,23,28,31,0,0,0,0,20120604,108,103,5,8,9,5,5,211,-5,2011,0,0,421,1
Boston,16,24,25,29,0,0,0,0,Miami,24,18,18,30,0,0,0,0,20120605,94,90,-8,-2,5,4,4,184,-4,2011,0,1,1257,1
San Antonio,34,29,18,18,0,0,0,0,Oklahoma City,20,28,32,27,0,0,0,0,20120606,99,107,-14,-15,-1,8,8,206,8,2011,0,2,421,1
Miami,26,29,19,24,0,0,0,0,Boston,16,26,19,18,0,0,0,0,20120607,98,79,10,13,13,19,19,177,-19,2011,0,3,1257,1
Boston,27,26,20,15,0,0,0,0,Miami,23,23,27,28,0,0,0,0,20120609,88,101,-4,-7,0,13,13,189,13,2011,0,5,1257,1
Miami,29,25,19,21,0,0,0,0,Oklahoma City,22,25,27,31,0,0,0,0,20120612,94,105,-7,-7,1,11,11,199,11,2011,0,1,1225,1
Miami,27,28,23,22,0,0,0,0,Oklahoma City,15,28,24,29,0,0,0,0,20120614,100,96,12,12,11,4,4,196,-4,2011,0,3,1225,1
Oklahoma City,20,26,21,18,0,0,0,0,Miami,26,21,22,22,0,0,0,0,20120617,85,91,6,1,2,6,6,176,6,2011,0,6,1225,1
Oklahoma City,33,16,26,23,0,0,0,0,Miami,19,27,33,25,0,0,0,0,20120619,98,104,-14,-3,4,6,6,202,6,2011,0,1,1225,1
Oklahoma City,26,23,22,35,0,0,0,0,Miami,31,28,36,26,0,0,0,0,20120621,106,121,5,10,24,15,15,227,15,2011,0,3,1225,1
Dallas,25,23,26,25,0,0,0,0,LA Lakers,29,17,20,25,0,0,0,0,20121030,99,91,-4,2,8,8,8,190,-8,2012,0,1,1237,0
Boston,25,29,22,31,0,0,0,0,Miami,31,31,31,27,0,0,0,0,20121030,107,120,6,8,17,13,13,227,13,2012,0,1,1257,0
Washington,24,15,23,22,0,0,0,0,Cleveland,31,19,24,20,0,0,0,0,20121030,84,94,7,11,12,10,10,178,10,2012,0,1,304,0
Dallas,26,37,13,18,0,0,0,0,Utah,25,30,37,21,0,0,0,0,20121031,94,113,-1,-8,16,19,19,207,19,2012,0,2,998,0
LA Lakers,26,31,19,30,0,0,0,0,Portland,30,32,30,24,0,0,0,0,20121031,106,116,4,5,16,10,10,222,10,2012,0,2,826,0
Indiana,27,21,15,27,0,0,0,0,Toronto,25,23,23,17,0,0,0,0,20121031,90,88,2,0,-8,2,2,178,-2,2012,0,2,438,0
Golden State,25,23,17,22,0,0,0,0,Phoenix,21,21,25,18,0,0,0,0,20121031,87,85,4,6,-2,2,2,172,-2,2012,0,2,652,0
Houston,27,28,17,33,0,0,0,0,Detroit,22,36,23,15,0,0,0,0,20121031,105,96,5,-3,-9,9,9,201,-9,2012,0,2,1105,0
San Antonio,28,15,28,28,0,0,0,0,New Orleans,31,19,21,24,0,0,0,0,20121031,99,95,-3,-7,0,4,4,194,-4,2012,0,2,506,0
Memphis,24,29,24,15,0,0,0,0,LA Clippers,26,23,24,28,0,0,0,0,20121031,92,101,2,-4,-4,9,9,193,9,2012,0,2,1599,0
Sacramento,23,17,23,24,0,0,0,0,Chicago,25,19,25,24,0,0,0,0,20121031,87,93,2,4,6,6,6,180,6,2012,0,2,1788,0
Denver,22,16,14,23,0,0,0,0,Philadelphia,25,21,19,19,0,0,0,0,20121031,75,84,3,8,13,9,9,159,9,2012,0,2,1574,0
Oklahoma City,24,16,26,18,0,0,0,0,San Antonio,21,24,21,20,0,0,0,0,20121101,84,86,-3,5,0,2,2,170,2,2012,0,3,421,0
Detroit,28,18,17,26,0,0,0,0,Phoenix,24,30,17,21,0,0,0,0,20121102,89,92,-4,8,8,3,3,181,3,2012,0,4,1687,0
Denver,18,19,31,21,0,0,0,0,Orlando,29,29,20,24,0,0,0,0,20121102,89,102,11,21,10,13,13,191,13,2012,0,4,1548,0
Portland,21,21,24,26,0,0,0,0,Oklahoma City,26,23,25,32,0,0,0,0,20121102,92,106,5,7,8,14,14,198,14,2012,0,4,1484,0
Miami,17,27,19,21,0,0,0,0,New York,33,22,26,23,0,0,0,0,20121102,84,104,16,11,18,20,20,188,20,2012,0,4,1091,0
Utah,19,22,22,23,0,0,0,0,New Orleans,19,21,27,21,0,0,0,0,20121102,86,88,0,-1,4,2,2,174,2,2012,0,4,1432,0
Sacramento,18,23,24,15,0,0,0,0,Minnesota,28,22,20,22,0,0,0,0,20121102,80,92,10,9,5,12,12,172,12,2012,0,4,1511,0
LA Clippers,28,24,30,23,0,0,0,0,LA Lakers,23,24,20,28,0,0,0,0,20121102,105,95,5,5,15,10,10,200,-10,2012,0,4,0,0
Memphis,28,23,24,29,0,0,0,0,Golden State,20,27,16,31,0,0,0,0,20121102,104,94,8,4,12,10,10,198,-10,2012,0,4,1798,0
Chicago,32,28,23,32,0,0,0,0,Cleveland,16,19,21,30,0,0,0,0,20121102,115,86,16,25,27,29,29,201,-29,2012,0,4,308,0
Indiana,20,23,27,19,0,0,0,0,Charlotte,17,22,35,16,0,0,0,0,20121102,89,90,-3,-4,4,1,1,179,1,2012,0,4,428,0
Milwaukee,25,21,30,23,0,0,0,0,Boston,18,12,28,30,0,0,0,0,20121102,99,88,7,16,18,11,11,187,-11,2012,0,4,855,0
Houston,28,25,28,28,0,0,0,0,Atlanta,21,23,30,28,0,0,0,0,20121102,109,102,7,9,7,7,7,211,-7,2012,0,4,700,0
Boston,26,23,22,18,0,0,0,0,Washington,12,30,25,19,0,0,0,0,20121103,89,86,14,7,4,3,3,175,-3,2012,0,5,394,0
Utah,17,27,35,21,0,0,0,0,San Antonio,28,34,17,31,0,0,0,0,20121103,100,110,11,18,0,10,10,210,10,2012,0,5,1087,0
Denver,34,32,25,25,0,0,0,0,Miami,35,29,23,32,0,0,0,0,20121103,116,119,1,-2,-4,3,3,235,3,2012,0,5,1724,0
Golden State,33,24,28,29,0,0,0,0,LA Clippers,24,29,26,31,0,0,0,0,20121103,114,110,9,4,6,4,4,224,-4,2012,0,5,347,0
Cleveland,27,22,30,23,0,0,0,0,Milwaukee,23,32,21,29,0,0,0,0,20121103,102,105,-4,6,-3,3,3,207,3,2012,0,5,334,0
Portland,17,20,27,17,14,0,0,0,Houston,19,26,18,18,4,0,0,0,20121103,95,85,-2,-8,1,0,10,180,-10,2012,1,5,1833,0
Charlotte,19,34,28,18,0,0,0,0,Dallas,31,30,36,29,0,0,0,0,20121103,99,126,12,8,16,27,27,225,27,2012,0,5,928,0
New Orleans,21,25,20,23,0,0,0,0,Chicago,18,26,16,22,0,0,0,0,20121103,89,82,3,2,6,7,7,171,-7,2012,0,5,832,0
Toronto,35,17,26,22,0,0,0,0,Brooklyn,27,33,24,23,0,0,0,0,20121103,100,107,-8,8,6,7,7,207,7,2012,0,5,341,0
Sacramento,24,18,24,25,5,2,0,0,Indiana,18,38,18,17,5,10,0,0,20121103,98,106,-6,14,8,0,8,204,8,2012,2,5,1882,0
Detroit,13,21,21,24,0,0,0,0,LA Lakers,34,28,24,22,0,0,0,0,20121104,79,108,21,28,31,29,29,187,29,2012,0,6,1979,0
Philadelphia,25,19,22,18,0,0,0,0,New York,31,26,18,25,0,0,0,0,20121104,84,100,6,13,9,16,16,184,16,2012,0,6,80,0
Atlanta,30,17,28,29,0,0,0,0,Oklahoma City,22,29,23,21,0,0,0,0,20121104,104,95,8,-4,1,9,9,199,-9,2012,0,6,755,0
Phoenix,33,23,20,18,0,0,0,0,Orlando,26,20,40,29,0,0,0,0,20121104,94,115,-7,-10,10,21,21,209,21,2012,0,6,1842,0
Minnesota,24,23,26,13,0,0,0,0,Toronto,25,31,23,26,0,0,0,0,20121104,86,105,1,9,6,19,19,191,19,2012,0,6,691,0
Indiana,18,20,22,19,0,0,0,0,San Antonio,26,21,26,28,0,0,0,0,20121105,79,101,8,9,13,22,22,180,22,2012,0,0,999,0
Golden State,22,22,20,28,0,0,0,0,Sacramento,21,31,23,19,0,0,0,0,20121105,92,94,-1,8,11,2,2,186,2,2012,0,0,75,0
New York,25,31,33,21,0,0,0,0,Philadelphia,21,27,20,20,0,0,0,0,20121105,110,88,4,8,21,22,22,198,-22,2012,0,0,80,0
Phoenix,25,28,21,25,0,0,0,0,Miami,34,31,33,26,0,0,0,0,20121105,99,124,9,12,24,25,25,223,25,2012,0,0,1978,0
Utah,25,25,18,26,0,0,0,0,Memphis,18,29,27,29,0,0,0,0,20121105,94,103,-7,-3,6,9,9,197,9,2012,0,0,1247,0
Portland,27,28,24,12,0,0,0,0,Dallas,31,26,26,31,0,0,0,0,20121105,91,114,4,2,4,23,23,205,23,2012,0,0,1630,0
Minnesota,27,20,28,32,0,0,0,0,Brooklyn,31,31,24,10,0,0,0,0,20121105,107,96,-4,-15,-11,11,11,203,-11,2012,0,0,1016,0
Cleveland,31,26,27,24,0,0,0,0,LA Clippers,28,22,28,23,0,0,0,0,20121105,108,101,3,7,6,7,7,209,-7,2012,0,0,2044,0
Orlando,24,24,22,23,0,0,0,0,Chicago,23,22,23,31,0,0,0,0,20121106,93,99,-1,-3,-2,6,6,192,6,2012,0,1,984,0
Detroit,21,30,25,21,0,0,0,0,Denver,24,34,27,24,0,0,0,0,20121106,97,109,3,7,9,12,12,206,12,2012,0,1,1154,0
Toronto,17,21,25,25,0,0,0,0,Oklahoma City,30,27,28,23,0,0,0,0,20121106,88,108,13,19,22,20,20,196,20,2012,0,1,1114,0
Brooklyn,22,19,15,17,0,0,0,0,Miami,26,24,29,24,0,0,0,0,20121107,73,103,4,9,23,30,30,176,30,2012,0,2,1091,0
Detroit,27,19,25,32,0,0,0,0,Sacramento,26,29,24,26,0,0,0,0,20121107,103,105,-1,9,8,2,2,208,2,2012,0,2,2020,0
Philadelphia,16,20,21,20,0,0,0,0,New Orleans,19,18,10,15,0,0,0,0,20121107,77,62,-3,-1,10,15,15,139,-15,2012,0,2,1088,0
Orlando,12,22,21,20,0,0,0,0,Minnesota,25,13,30,22,0,0,0,0,20121107,75,90,13,4,13,15,15,165,15,2012,0,2,1309,0
LA Lakers,17,24,16,29,0,0,0,0,Utah,25,26,14,30,0,0,0,0,20121107,86,95,8,10,8,9,9,181,9,2012,0,2,579,0
San Antonio,16,25,21,22,0,0,0,0,LA Clippers,22,25,35,24,0,0,0,0,20121107,84,106,6,6,20,22,22,190,22,2012,0,2,1201,0
Memphis,23,33,25,27,0,0,0,0,Milwaukee,22,21,25,22,0,0,0,0,20121107,108,90,1,13,13,18,18,198,-18,2012,0,2,557,0
Cleveland,21,30,23,22,0,0,0,0,Golden State,37,22,26,21,0,0,0,0,20121107,96,106,16,8,11,10,10,202,10,2012,0,2,2161,0
Toronto,24,26,24,30,0,0,0,0,Dallas,36,25,21,27,0,0,0,0,20121107,104,109,12,11,8,5,5,213,5,2012,0,2,1201,0
Phoenix,31,29,25,32,0,0,0,0,Charlotte,22,24,35,29,0,0,0,0,20121107,117,110,9,14,4,7,7,227,-7,2012,0,2,1778,0
Washington,16,26,16,30,6,0,0,0,Boston,21,16,29,22,12,0,0,0,20121107,94,100,5,-5,8,0,6,194,6,2012,1,2,394,0
Indiana,25,25,27,9,0,0,0,0,Atlanta,22,29,14,24,0,0,0,0,20121107,86,89,-3,1,-12,3,3,175,3,2012,0,2,427,0
Denver,25,31,13,24,0,0,0,0,Houston,18,23,23,23,0,0,0,0,20121107,93,87,7,15,5,6,6,180,-6,2012,0,2,878,0
Oklahoma City,24,24,18,31,0,0,0,0,Chicago,24,23,25,19,0,0,0,0,20121108,97,91,0,1,-6,6,6,188,-6,2012,0,3,690,0
LA Clippers,29,31,17,26,0,0,0,0,Portland,22,17,32,19,0,0,0,0,20121108,103,90,7,21,6,13,13,193,-13,2012,0,3,826,0
Milwaukee,30,26,19,26,0,0,0,0,Washington,28,19,25,19,0,0,0,0,20121109,101,91,2,9,3,10,10,192,-10,2012,0,4,634,0
San Antonio,24,23,22,28,0,0,0,0,Sacramento,27,12,29,18,0,0,0,0,20121109,97,86,-3,8,1,11,11,183,-11,2012,0,4,1456,0
Cleveland,37,25,21,22,0,0,0,0,Phoenix,16,33,27,31,0,0,0,0,20121109,105,107,-21,-13,-7,2,2,212,2,2012,0,4,1745,0
Brooklyn,19,31,25,32,0,0,0,0,Orlando,17,19,15,17,0,0,0,0,20121109,107,68,2,14,24,39,39,175,-39,2012,0,4,939,0
Detroit,19,23,27,25,0,0,0,0,Oklahoma City,18,31,25,31,0,0,0,0,20121109,94,105,-1,7,5,11,11,199,11,2012,0,4,909,0
Dallas,23,34,21,16,0,0,0,0,New York,25,30,29,20,0,0,0,0,20121109,94,104,2,-2,6,10,10,198,10,2012,0,4,1370,0
Houston,24,22,22,17,0,0,0,0,Memphis,17,25,27,24,0,0,0,0,20121109,85,93,-7,-4,1,8,8,178,8,2012,0,4,484,0
Indiana,19,24,21,30,0,0,0,0,Minnesota,21,21,27,27,0,0,0,0,20121109,94,96,2,-1,5,2,2,190,2,2012,0,4,510,0
Golden State,22,16,17,22,0,0,0,0,LA Lakers,23,24,25,29,0,0,0,0,20121109,77,101,1,9,17,24,24,178,24,2012,0,4,347,0
Utah,27,11,19,27,0,0,0,0,Denver,26,27,20,31,0,0,0,0,20121109,84,104,-1,15,16,20,20,188,20,2012,0,4,370,0
Philadelphia,23,34,26,23,0,0,0,0,Boston,20,25,29,26,0,0,0,0,20121109,106,100,3,12,9,6,6,206,-6,2012,0,4,270,0
Miami,25,17,30,23,0,0,0,0,Atlanta,25,21,25,18,0,0,0,0,20121109,95,89,0,-4,1,6,6,184,-6,2012,0,4,605,0
Charlotte,21,28,20,30,0,0,0,0,New Orleans,24,35,19,29,0,0,0,0,20121109,99,107,3,10,9,8,8,206,8,2012,0,4,648,0
Phoenix,19,24,18,20,0,0,0,0,Utah,29,21,27,17,0,0,0,0,20121110,81,94,10,7,16,13,13,175,13,2012,0,5,505,0
Philadelphia,20,32,17,24,0,0,0,0,Toronto,26,7,29,21,0,0,0,0,20121110,93,83,-6,19,7,10,10,176,-10,2012,0,5,334,0
San Antonio,26,17,30,39,0,0,0,0,Portland,26,26,27,30,0,0,0,0,20121110,112,109,0,-9,-6,3,3,221,-3,2012,0,5,1718,0
Washington,22,27,23,13,0,0,0,0,Indiana,23,26,21,19,0,0,0,0,20121110,85,89,1,0,-2,4,4,174,4,2012,0,5,490,0
Boston,20,19,25,32,0,0,0,0,Milwaukee,22,20,26,24,0,0,0,0,20121110,96,92,-2,-3,-4,4,4,188,-4,2012,0,5,855,0
Denver,24,16,22,24,8,13,0,0,Golden State,13,26,20,27,8,7,0,0,20121110,107,101,11,1,3,0,6,208,-6,2012,2,5,947,0
Minnesota,19,22,18,21,0,0,0,0,Chicago,20,20,23,24,0,0,0,0,20121110,80,87,1,-1,4,7,7,167,7,2012,0,5,355,0
Dallas,21,34,18,18,6,0,0,0,Charlotte,24,20,24,23,10,0,0,0,20121110,97,101,3,-11,-5,0,4,198,4,2012,1,5,928,0
Detroit,15,26,16,25,0,0,0,0,Houston,20,27,25,24,0,0,0,0,20121110,82,96,5,6,15,14,14,178,14,2012,0,5,1105,0
Orlando,17,18,18,21,0,0,0,0,Brooklyn,35,15,13,19,0,0,0,0,20121111,74,82,18,15,10,8,8,156,8,2012,0,6,939,0
Atlanta,19,18,23,16,0,0,0,0,LA Clippers,18,21,26,24,0,0,0,0,20121111,76,89,-1,2,5,13,13,165,13,2012,0,6,1932,0
Sacramento,22,26,18,24,0,0,0,0,LA Lakers,29,28,22,24,0,0,0,0,20121111,90,103,7,9,13,13,13,193,13,2012,0,6,361,0
Miami,21,20,25,20,0,0,0,0,Memphis,22,34,20,28,0,0,0,0,20121111,86,104,1,15,10,18,18,190,18,2012,0,6,873,0
Cleveland,21,25,27,18,0,0,0,0,Oklahoma City,27,30,22,27,0,0,0,0,20121111,91,106,6,11,6,15,15,197,15,2012,0,6,949,0
Utah,26,26,30,22,11,10,15,0,Toronto,28,29,30,17,11,10,8,0,20121112,140,133,-2,-5,-5,0,7,273,-7,2012,3,0,1664,0
Atlanta,28,28,19,20,0,0,0,0,Portland,22,25,20,20,0,0,0,0,20121112,95,87,6,9,8,8,8,182,-8,2012,0,0,2168,0
Denver,27,30,21,22,0,0,0,0,Phoenix,23,31,29,27,0,0,0,0,20121112,100,110,-4,-3,5,10,10,210,10,2012,0,0,585,0
Milwaukee,34,28,21,22,0,0,0,0,Philadelphia,26,24,33,13,0,0,0,0,20121112,105,96,8,12,0,9,9,201,-9,2012,0,0,692,0
Oklahoma City,25,20,17,30,0,0,0,0,Detroit,23,28,22,17,0,0,0,0,20121112,92,90,2,-6,-11,2,2,182,-2,2012,0,0,909,0
Minnesota,25,20,21,24,0,0,0,0,Dallas,17,22,19,24,0,0,0,0,20121112,90,82,8,6,8,8,8,172,-8,2012,0,0,863,0
Boston,33,25,24,19,0,0,0,0,Chicago,27,19,24,25,0,0,0,0,20121112,101,95,6,12,12,6,6,196,-6,2012,0,0,849,0
Miami,25,31,26,31,0,0,0,0,Houston,19,33,33,25,0,0,0,0,20121112,113,110,6,4,-3,3,3,223,-3,2012,0,0,966,0
Cleveland,30,12,33,26,0,0,0,0,Brooklyn,29,35,21,29,0,0,0,0,20121113,101,114,-1,22,10,13,13,215,13,2012,0,1,403,0
Washington,27,12,22,15,0,0,0,0,Charlotte,23,29,18,22,0,0,0,0,20121113,76,92,-4,13,9,16,16,168,16,2012,0,1,329,0
Toronto,29,17,23,5,0,0,0,0,Indiana,21,15,22,14,0,0,0,0,20121113,74,72,8,10,11,2,2,146,-2,2012,0,1,438,0
San Antonio,18,20,22,24,0,0,0,0,LA Lakers,24,19,16,23,0,0,0,0,20121113,84,82,-6,-5,1,2,2,166,-2,2012,0,1,1201,0
New York,27,22,28,22,0,0,0,0,Orlando,23,30,23,13,0,0,0,0,20121113,99,89,4,-4,1,10,10,188,-10,2012,0,1,939,0
Portland,25,21,28,29,0,0,0,0,Sacramento,18,24,16,28,0,0,0,0,20121113,103,86,7,4,16,17,17,189,-17,2012,0,1,483,0
Chicago,29,28,26,17,12,0,0,0,Phoenix,27,24,18,31,6,0,0,0,20121114,112,106,2,6,14,0,6,218,-6,2012,1,2,1450,0
Detroit,23,29,17,25,0,0,0,0,Philadelphia,17,17,20,22,0,0,0,0,20121114,94,76,6,18,15,18,18,170,-18,2012,0,2,441,0
Memphis,20,36,25,26,0,0,0,0,Oklahoma City,30,15,26,26,0,0,0,0,20121114,107,97,-10,11,10,10,10,204,-10,2012,0,2,421,0
Indiana,17,17,19,32,0,0,0,0,Milwaukee,33,27,22,17,0,0,0,0,20121114,85,99,16,26,29,14,14,184,14,2012,0,2,243,0
Charlotte,28,23,18,20,0,0,0,0,Minnesota,24,14,15,34,0,0,0,0,20121114,89,87,4,13,16,2,2,176,-2,2012,0,2,938,0
New Orleans,27,18,31,20,0,0,0,0,Houston,25,39,21,15,0,0,0,0,20121114,96,100,-2,19,9,4,4,196,4,2012,0,2,317,0
Atlanta,21,25,14,28,0,0,0,0,Golden State,22,32,17,21,0,0,0,0,20121114,88,92,1,8,11,4,4,180,4,2012,0,2,2135,0
Washington,19,26,22,34,0,0,0,0,Dallas,23,40,22,22,0,0,0,0,20121114,101,107,4,18,18,6,6,208,6,2012,0,2,1181,0
Utah,25,21,24,23,0,0,0,0,Boston,20,24,29,25,0,0,0,0,20121114,93,98,-5,-2,3,5,5,191,5,2012,0,2,2093,0
Miami,24,30,20,26,0,0,0,0,LA Clippers,25,27,33,22,0,0,0,0,20121114,100,107,1,-2,11,7,7,207,7,2012,0,2,2335,0
Boston,26,24,29,18,0,0,0,0,Brooklyn,31,28,15,28,0,0,0,0,20121115,97,102,5,9,-5,5,5,199,5,2012,0,3,190,0
Miami,28,26,25,19,0,0,0,0,Denver,20,22,24,27,0,0,0,0,20121115,98,93,8,12,13,5,5,191,-5,2012,0,3,1724,0
New York,33,22,17,32,0,0,0,0,San Antonio,31,26,19,24,0,0,0,0,20121115,104,100,2,-2,-4,4,4,204,-4,2012,0,3,1581,0
Atlanta,34,24,28,26,0,0,0,0,Sacramento,20,36,14,26,0,0,0,0,20121116,112,96,14,2,16,16,16,208,-16,2012,0,4,2082,0
Houston,27,31,21,32,6,0,0,0,Portland,22,29,27,33,8,0,0,0,20121116,117,119,-5,-7,-1,0,2,236,2,2012,1,4,1833,0
Utah,20,23,21,29,0,0,0,0,Philadelphia,30,22,19,28,0,0,0,0,20121116,93,99,10,9,7,6,6,192,6,2012,0,4,1920,0
Oklahoma City,36,30,28,16,0,0,0,0,New Orleans,18,19,30,28,0,0,0,0,20121116,110,95,18,29,27,15,15,205,-15,2012,0,4,576,0
Dallas,24,25,18,16,0,0,0,0,Indiana,24,24,28,27,0,0,0,0,20121116,83,103,0,-1,9,20,20,186,20,2012,0,4,763,0
New York,25,24,18,28,0,0,0,0,Memphis,29,25,31,20,0,0,0,0,20121116,95,105,4,5,18,10,10,200,10,2012,0,4,953,0
Phoenix,30,27,27,18,0,0,0,0,LA Lakers,35,27,30,22,0,0,0,0,20121116,102,114,5,5,8,12,12,216,12,2012,0,4,356,0
Orlando,22,22,27,39,0,0,0,0,Detroit,25,25,25,31,0,0,0,0,20121116,110,106,-3,-6,-4,4,4,216,-4,2012,0,4,957,0
Golden State,22,31,29,24,0,0,0,0,Minnesota,27,23,19,29,0,0,0,0,20121116,106,98,-5,3,13,8,8,204,-8,2012,0,4,1581,0
Miami,23,29,23,22,0,0,0,0,Phoenix,23,29,19,17,0,0,0,0,20121117,97,88,0,0,4,9,9,185,-9,2012,0,5,1978,0
Denver,15,25,28,32,0,0,0,0,San Antonio,33,27,30,36,0,0,0,0,20121117,100,126,18,20,22,26,26,226,26,2012,0,5,802,0
New Orleans,27,31,33,22,0,0,0,0,Milwaukee,25,35,31,26,0,0,0,0,20121117,113,117,-2,2,0,4,4,230,4,2012,0,5,911,0
Utah,15,23,27,18,0,0,0,0,Washington,17,23,23,13,0,0,0,0,20121117,83,76,-2,-2,2,7,7,159,-7,2012,0,5,1841,0
Dallas,24,27,24,28,0,0,0,0,Cleveland,24,28,21,22,0,0,0,0,20121117,103,95,0,-1,2,8,8,198,-8,2012,0,5,1024,0
Memphis,25,22,28,19,0,0,0,0,Charlotte,19,19,22,27,0,0,0,0,20121117,94,87,6,9,15,7,7,181,-7,2012,0,5,519,0
Toronto,17,25,22,25,0,0,0,0,Boston,30,17,32,28,0,0,0,0,20121117,89,107,13,5,15,18,18,196,18,2012,0,5,430,0
Chicago,15,25,21,19,0,0,0,0,LA Clippers,18,35,25,23,0,0,0,0,20121117,80,101,3,13,17,21,21,181,21,2012,0,5,1741,0
Boston,25,18,14,26,0,0,0,0,Detroit,23,25,23,32,0,0,0,0,20121118,83,103,-2,5,14,20,20,186,20,2012,0,6,611,0
Houston,29,31,27,21,0,0,0,0,LA Lakers,40,28,30,21,0,0,0,0,20121118,108,119,11,8,11,11,11,227,11,2012,0,6,1371,0
Indiana,18,12,26,20,0,0,0,0,New York,21,20,27,20,0,0,0,0,20121118,76,88,3,11,12,12,12,164,12,2012,0,6,643,0
Golden State,25,21,27,36,0,0,0,0,Oklahoma City,26,33,35,25,0,0,0,0,20121118,109,119,1,13,21,10,10,228,10,2012,0,6,1386,0
Cleveland,21,21,15,22,0,0,0,0,Philadelphia,19,24,19,24,0,0,0,0,20121118,79,86,-2,1,5,7,7,165,7,2012,0,6,358,0
Chicago,30,13,25,26,0,0,0,0,Portland,23,28,22,29,0,0,0,0,20121118,94,102,-7,8,5,8,8,196,8,2012,0,6,1754,0
Brooklyn,21,33,20,25,0,0,0,0,Sacramento,20,22,23,25,0,0,0,0,20121118,99,90,1,12,9,9,9,189,-9,2012,0,6,2499,0
Orlando,22,19,28,17,0,0,0,0,Toronto,32,17,18,30,0,0,0,0,20121118,86,97,10,8,-2,11,11,183,11,2012,0,6,1048,0
Indiana,28,22,21,25,0,0,0,0,Washington,13,28,26,22,0,0,0,0,20121119,96,89,15,9,4,7,7,185,-7,2012,0,0,490,0
Houston,26,18,26,21,0,0,0,0,Utah,29,32,24,17,0,0,0,0,20121119,91,102,3,17,15,11,11,193,11,2012,0,0,1199,0
LA Clippers,18,29,24,21,0,0,0,0,San Antonio,28,14,21,24,0,0,0,0,20121119,92,87,-10,5,8,5,5,179,-5,2012,0,0,1201,0
Milwaukee,23,31,27,17,0,0,0,0,Charlotte,30,25,22,25,0,0,0,0,20121119,98,102,7,1,-4,4,4,200,4,2012,0,0,658,0
Golden State,23,20,24,23,15,0,0,0,Dallas,20,18,27,25,11,0,0,0,20121119,105,101,3,5,2,0,4,206,-4,2012,1,0,1480,0
Orlando,23,14,12,23,0,0,0,0,Atlanta,21,20,24,16,0,0,0,0,20121119,72,81,-2,4,16,9,9,153,9,2012,0,0,401,0
Denver,27,25,17,28,0,0,0,0,Memphis,26,23,21,22,0,0,0,0,20121119,97,92,1,3,-1,5,5,189,-5,2012,0,0,877,0
Brooklyn,23,34,16,17,0,0,0,0,LA Lakers,29,27,20,19,0,0,0,0,20121120,90,95,6,-1,3,5,5,185,5,2012,0,1,2445,0
New York,29,24,30,19,0,0,0,0,New Orleans,17,31,16,16,0,0,0,0,20121120,102,80,12,5,19,22,22,182,-22,2012,0,1,1168,0
Toronto,29,22,29,18,0,0,0,0,Philadelphia,22,29,22,33,0,0,0,0,20121120,98,106,-7,0,-7,8,8,204,8,2012,0,1,334,0
Milwaukee,15,29,29,25,8,0,0,0,Miami,29,17,25,27,15,0,0,0,20121121,106,113,14,2,-2,0,7,219,7,2012,1,2,1269,0
Portland,25,19,27,16,0,0,0,0,Phoenix,29,28,32,25,0,0,0,0,20121121,87,114,4,13,18,27,27,201,27,2012,0,2,1005,0
Detroit,27,21,8,18,0,0,0,0,Orlando,21,24,26,19,0,0,0,0,20121121,74,90,-6,-3,15,16,16,164,16,2012,0,2,957,0
LA Lakers,21,20,28,28,0,0,0,0,Sacramento,15,27,31,40,0,0,0,0,20121121,97,113,-6,1,4,16,16,210,16,2012,0,2,361,0
Denver,15,29,25,32,0,0,0,0,Minnesota,26,32,15,21,0,0,0,0,20121121,101,94,-11,-14,-4,7,7,195,-7,2012,0,2,698,0
New Orleans,29,18,27,23,10,0,0,0,Indiana,21,22,32,22,18,0,0,0,20121121,107,115,-8,-4,1,0,8,222,8,2012,1,2,713,0
LA Clippers,22,27,20,33,9,0,0,0,Oklahoma City,28,31,17,26,15,0,0,0,20121121,111,117,6,10,7,0,6,228,6,2012,1,2,1178,0
Brooklyn,30,16,20,27,0,0,0,0,Golden State,18,23,33,28,0,0,0,0,20121121,93,102,-12,-5,8,9,9,195,9,2012,0,2,2565,0
New York,28,26,26,31,0,0,0,0,Dallas,24,25,35,30,0,0,0,0,20121121,111,114,-4,-5,4,3,3,225,3,2012,0,2,1370,0
Philadelphia,15,20,23,25,0,0,0,0,Cleveland,28,19,21,24,0,0,0,0,20121121,83,92,13,12,10,9,9,175,9,2012,0,2,358,0
Toronto,25,28,21,23,0,0,0,0,Charlotte,22,31,22,23,0,0,0,0,20121121,97,98,-3,0,1,1,1,195,1,2012,0,2,585,0
San Antonio,30,26,26,30,0,0,0,0,Boston,27,21,26,26,0,0,0,0,20121121,112,100,3,8,8,12,12,212,-12,2012,0,2,1765,0
Washington,24,23,19,24,10,0,0,0,Atlanta,26,24,18,22,11,0,0,0,20121121,100,101,2,3,2,0,1,201,1,2012,1,2,541,0
Chicago,22,24,19,24,0,0,0,0,Houston,20,22,24,27,0,0,0,0,20121121,89,93,-2,-4,1,4,4,182,4,2012,0,2,939,0
Sacramento,32,21,27,22,0,0,0,0,Utah,28,24,21,31,0,0,0,0,20121123,102,104,-4,-1,-7,2,2,206,2,2012,0,4,532,0
Minnesota,33,22,23,17,0,0,0,0,Portland,28,22,31,22,0,0,0,0,20121123,95,103,-5,-5,3,8,8,198,8,2012,0,4,1423,0
New Orleans,31,22,28,22,5,0,0,0,Phoenix,23,24,30,26,8,0,0,0,20121123,108,111,-8,-6,-4,0,3,219,3,2012,1,4,1312,0
Cleveland,26,25,25,28,0,0,0,0,Orlando,24,21,31,32,0,0,0,0,20121123,104,108,-2,-6,0,4,4,212,4,2012,0,4,895,0
San Antonio,28,20,25,31,0,0,0,0,Indiana,25,27,25,20,0,0,0,0,20121123,104,97,3,-4,-4,7,7,201,-7,2012,0,4,999,0
LA Lakers,18,31,21,28,0,0,0,0,Memphis,34,22,26,24,0,0,0,0,20121123,98,106,16,7,12,8,8,204,8,2012,0,4,1599,0
Toronto,20,23,25,22,0,0,0,0,Detroit,21,26,25,19,0,0,0,0,20121123,90,91,1,4,4,1,1,181,1,2012,0,4,205,0
Golden State,21,32,17,21,0,0,0,0,Denver,23,24,31,24,0,0,0,0,20121123,91,102,2,-6,8,11,11,193,11,2012,0,4,947,0
Atlanta,30,27,23,21,0,0,0,0,Charlotte,23,28,23,17,0,0,0,0,20121123,101,91,7,6,6,10,10,192,-10,2012,0,4,226,0
LA Clippers,25,22,16,13,0,0,0,0,Brooklyn,25,15,23,23,0,0,0,0,20121123,76,86,0,-7,0,10,10,162,10,2012,0,4,2445,0
Oklahoma City,28,17,20,35,0,0,0,0,Boston,21,27,29,31,0,0,0,0,20121123,100,108,-7,3,12,8,8,208,8,2012,0,4,1492,0
New York,32,25,23,23,0,0,0,0,Houston,35,37,32,27,0,0,0,0,20121123,103,131,3,15,24,28,28,234,28,2012,0,4,1417,0
Charlotte,25,25,22,20,7,9,0,0,Washington,24,27,21,20,7,7,0,0,20121124,108,106,1,-1,0,0,2,214,-2,2012,2,5,329,0
Utah,29,27,19,22,0,0,0,0,Sacramento,23,28,32,25,0,0,0,0,20121124,97,108,-6,-5,8,11,11,205,11,2012,0,5,532,0
Oklahoma City,29,21,35,13,18,0,0,0,Philadelphia,21,28,30,19,11,0,0,0,20121124,116,109,8,1,6,0,7,225,-7,2012,1,5,1256,0
Chicago,28,24,20,21,0,0,0,0,Milwaukee,30,22,17,17,0,0,0,0,20121124,93,86,-2,0,3,7,7,179,-7,2012,0,5,83,0
Minnesota,18,33,23,11,0,0,0,0,Golden State,16,31,23,26,0,0,0,0,20121124,85,96,-2,-4,-4,11,11,181,11,2012,0,5,1581,0
LA Lakers,36,29,24,26,0,0,0,0,Dallas,23,15,27,24,0,0,0,0,20121124,115,89,13,27,24,26,26,204,-26,2012,0,5,1237,0
LA Clippers,24,17,19,33,0,0,0,0,Atlanta,21,30,34,19,0,0,0,0,20121124,93,104,-3,10,25,11,11,197,11,2012,0,5,1932,0
Cleveland,29,30,20,29,0,0,0,0,Miami,26,22,29,33,0,0,0,0,20121124,108,110,-3,-11,-2,2,2,218,2,2012,0,5,1089,0
San Antonio,24,25,20,19,9,14,0,0,Toronto,25,24,21,18,9,9,0,0,20121125,111,106,-1,0,-1,0,5,217,-5,2012,2,6,1438,0
Phoenix,20,21,34,26,0,0,0,0,Philadelphia,23,23,34,24,0,0,0,0,20121125,101,104,3,5,5,3,3,205,3,2012,0,6,2078,0
Boston,28,30,22,22,14,0,0,0,Orlando,22,26,34,20,8,0,0,0,20121125,116,110,6,10,-2,0,6,226,-6,2012,1,6,1115,0
New Orleans,23,18,20,23,0,0,0,0,Denver,26,25,32,19,0,0,0,0,20121125,84,102,3,10,22,18,18,186,18,2012,0,6,1079,0
Portland,27,23,20,15,0,0,0,0,Brooklyn,25,21,24,28,0,0,0,0,20121125,85,98,-2,-4,0,13,13,183,13,2012,0,6,2439,0
Detroit,22,22,28,28,0,0,0,0,New York,32,32,22,35,0,0,0,0,20121125,100,121,10,20,14,21,21,221,21,2012,0,6,480,0
New York,23,24,20,17,5,0,0,0,Brooklyn,26,19,23,16,12,0,0,0,20121126,89,96,3,-2,1,0,7,185,7,2012,1,0,0,0
Milwaukee,19,21,23,30,0,0,0,0,Chicago,26,24,30,12,0,0,0,0,20121126,93,92,-7,-10,-17,1,1,185,-1,2012,0,0,83,0
Portland,19,30,24,28,0,0,0,0,Detroit,28,26,28,26,0,0,0,0,20121126,101,108,9,5,9,7,7,209,7,2012,0,0,1964,0
New Orleans,22,29,30,24,0,0,0,0,LA Clippers,19,25,26,28,0,0,0,0,20121126,105,98,3,7,11,7,7,203,-7,2012,0,0,1669,0
Cleveland,27,20,22,9,0,0,0,0,Memphis,24,18,20,22,0,0,0,0,20121126,78,84,-3,-5,-7,6,6,162,6,2012,0,0,629,0
Charlotte,12,12,19,26,0,0,0,0,Oklahoma City,28,36,24,26,0,0,0,0,20121126,69,114,16,40,45,45,45,183,45,2012,0,0,938,0
Denver,35,30,19,19,0,0,0,0,Utah,24,30,30,21,0,0,0,0,20121126,103,105,-11,-11,0,2,2,208,2,2012,0,0,370,0
San Antonio,29,31,32,26,0,0,0,0,Washington,25,23,22,22,0,0,0,0,20121126,118,92,4,12,22,26,26,210,-26,2012,0,0,1385,0
Minnesota,27,21,27,22,0,0,0,0,Sacramento,26,19,22,22,0,0,0,0,20121127,97,89,1,3,8,8,8,186,-8,2012,0,1,1511,0
Indiana,25,15,21,18,0,0,0,0,LA Lakers,21,12,24,20,0,0,0,0,20121127,79,77,4,7,4,2,2,156,-2,2012,0,1,1805,0
Dallas,31,25,17,25,0,0,0,0,Philadelphia,28,25,22,25,0,0,0,0,20121127,98,100,-3,-3,2,2,2,198,2,2012,0,1,1297,0
Phoenix,19,18,34,20,0,0,0,0,Cleveland,13,19,27,19,0,0,0,0,20121127,91,78,6,5,12,13,13,169,-13,2012,0,1,1745,0
Toronto,23,28,28,22,0,0,0,0,Houston,29,32,38,18,0,0,0,0,20121127,101,117,6,10,20,16,16,218,16,2012,0,1,1299,0
Portland,27,16,16,23,0,0,0,0,Washington,23,20,25,16,0,0,0,0,20121128,82,84,-4,0,9,2,2,166,2,2012,0,2,2347,0
Charlotte,18,27,20,26,0,0,0,0,Atlanta,20,23,28,23,0,0,0,0,20121128,91,94,2,-2,6,3,3,185,3,2012,0,2,226,0
Brooklyn,28,23,19,25,0,0,0,0,Boston,20,18,17,28,0,0,0,0,20121128,95,83,8,13,15,12,12,178,-12,2012,0,2,190,0
Dallas,23,19,16,20,0,0,0,0,Chicago,24,34,19,24,0,0,0,0,20121128,78,101,1,16,19,23,23,179,23,2012,0,2,802,0
Phoenix,24,20,16,17,0,0,0,0,Detroit,24,31,26,36,0,0,0,0,20121128,77,117,0,11,21,40,40,194,40,2012,0,2,1687,0
Minnesota,28,27,22,18,0,0,0,0,LA Clippers,23,34,19,25,0,0,0,0,20121128,95,101,-5,2,-1,6,6,196,6,2012,0,2,1521,0
Toronto,27,20,14,21,0,0,0,0,Memphis,24,24,33,22,0,0,0,0,20121128,82,103,-3,1,20,21,21,185,21,2012,0,2,815,0
New York,23,35,30,14,0,0,0,0,Milwaukee,26,22,22,18,0,0,0,0,20121128,102,88,-3,10,18,14,14,190,-14,2012,0,2,732,0
Utah,20,21,31,24,0,0,0,0,New Orleans,20,19,17,28,0,0,0,0,20121128,96,84,0,2,16,12,12,180,-12,2012,0,2,1432,0
Houston,25,20,29,24,0,0,0,0,Oklahoma City,27,30,29,34,0,0,0,0,20121128,98,120,2,12,12,22,22,218,22,2012,0,2,413,0
San Antonio,29,26,26,29,0,0,0,0,Orlando,18,23,23,25,0,0,0,0,20121128,110,89,11,14,17,21,21,199,-21,2012,0,2,1035,0
San Antonio,27,17,32,24,0,0,0,0,Miami,22,25,26,32,0,0,0,0,20121129,100,105,-5,3,-3,5,5,205,5,2012,0,3,1147,0
Denver,25,35,26,19,0,0,0,0,Golden State,30,21,27,28,0,0,0,0,20121129,105,106,5,-9,-8,1,1,211,1,2012,0,3,947,0
Cleveland,27,29,26,31,0,0,0,0,Atlanta,29,38,24,20,0,0,0,0,20121130,113,111,-2,-11,-9,2,2,224,-2,2012,0,4,555,0
Portland,18,15,26,19,0,0,0,0,Boston,25,31,19,21,0,0,0,0,20121130,78,96,7,23,16,18,18,174,18,2012,0,4,2532,0
Philadelphia,27,27,22,28,0,0,0,0,Charlotte,25,25,23,25,0,0,0,0,20121130,104,98,2,4,3,6,6,202,-6,2012,0,4,450,0
Denver,27,30,25,21,0,0,0,0,LA Lakers,34,37,26,25,0,0,0,0,20121130,103,122,7,14,15,19,19,225,19,2012,0,4,830,0
Detroit,21,24,21,12,0,0,0,0,Memphis,22,31,23,14,0,0,0,0,20121130,78,90,1,8,10,12,12,168,12,2012,0,4,622,0
Milwaukee,30,17,16,22,0,0,0,0,Minnesota,29,28,11,27,0,0,0,0,20121130,85,95,-1,10,5,10,10,180,10,2012,0,4,298,0
Washington,17,29,19,22,0,0,0,0,New York,26,31,29,22,0,0,0,0,20121130,87,108,9,11,21,21,21,195,21,2012,0,4,204,0
Utah,20,22,25,27,0,0,0,0,Oklahoma City,22,32,29,23,0,0,0,0,20121130,94,106,2,12,16,12,12,200,12,2012,0,4,861,0
Brooklyn,25,20,31,22,0,0,0,0,Orlando,21,23,21,21,0,0,0,0,20121130,98,86,4,1,11,12,12,184,-12,2012,0,4,939,0
Indiana,20,23,29,25,0,0,0,0,Sacramento,17,23,27,25,0,0,0,0,20121130,97,92,3,3,5,5,5,189,-5,2012,0,4,1882,0
Phoenix,25,27,24,21,0,0,0,0,Toronto,19,32,29,21,0,0,0,0,20121130,97,101,-6,-1,4,4,4,198,4,2012,0,4,1885,0
Memphis,22,24,27,14,8,0,0,0,San Antonio,21,24,15,27,12,0,0,0,20121201,95,99,-1,-1,-13,0,4,194,4,2012,1,5,631,0
Oklahoma City,30,24,30,16,0,0,0,0,New Orleans,21,23,13,22,0,0,0,0,20121201,100,79,9,10,27,21,21,179,-21,2012,0,5,576,0
Boston,27,21,21,19,0,0,0,0,Milwaukee,11,36,22,22,0,0,0,0,20121201,88,91,-16,-1,0,3,3,179,3,2012,0,5,855,0
Brooklyn,24,35,19,11,0,0,0,0,Miami,16,34,32,20,0,0,0,0,20121201,89,102,-8,-9,4,13,13,191,13,2012,0,5,1091,0
Sacramento,17,17,24,23,0,0,0,0,LA Clippers,28,30,29,29,0,0,0,0,20121201,81,116,11,24,29,35,35,197,35,2012,0,5,361,0
Portland,21,26,23,21,12,15,0,0,Cleveland,28,20,26,17,12,14,0,0,20121201,118,117,-7,-1,-4,0,1,235,-1,2012,2,5,2049,0
Indiana,20,24,28,20,0,0,0,0,Golden State,20,31,31,21,0,0,0,0,20121201,92,103,0,7,10,11,11,195,11,2012,0,5,1944,0
Detroit,27,21,11,18,0,0,0,0,Dallas,24,18,25,25,0,0,0,0,20121201,77,92,-3,-6,8,15,15,169,15,2012,0,5,999,0
Philadelphia,19,22,23,24,0,0,0,0,Chicago,22,19,26,26,0,0,0,0,20121201,88,93,3,0,3,5,5,181,5,2012,0,5,664,0
Utah,28,21,37,30,0,0,0,0,Houston,28,30,27,39,0,0,0,0,20121201,116,124,0,9,-1,8,8,240,8,2012,0,5,1199,0
Orlando,23,29,21,40,0,0,0,0,LA Lakers,27,25,25,26,0,0,0,0,20121202,113,103,-4,0,-4,10,10,216,-10,2012,0,6,2197,0
Phoenix,20,22,30,27,0,0,0,0,New York,24,35,30,17,0,0,0,0,20121202,99,106,4,17,17,7,7,205,7,2012,0,6,2139,0
LA Clippers,19,32,22,32,0,0,0,0,Utah,31,27,25,21,0,0,0,0,20121203,105,104,-12,-7,-10,1,1,209,-1,2012,0,0,579,0
Milwaukee,28,22,17,14,0,0,0,0,New Orleans,30,23,24,25,0,0,0,0,20121203,81,102,2,3,10,21,21,183,21,2012,0,0,911,0
Orlando,28,23,18,33,0,0,0,0,Golden State,27,20,22,25,0,0,0,0,20121203,102,94,1,4,0,8,8,196,-8,2012,0,0,2437,0
Toronto,24,20,31,35,0,0,0,0,Denver,29,32,28,24,0,0,0,0,20121203,110,113,5,17,14,3,3,223,3,2012,0,0,1341,0
Portland,26,25,19,32,16,0,0,0,Charlotte,34,20,21,27,10,0,0,0,20121203,118,112,-8,-3,-5,0,6,230,-6,2012,1,0,2284,0
Cleveland,17,22,24,16,0,0,0,0,Detroit,30,26,19,14,0,0,0,0,20121203,79,89,13,17,12,10,10,168,10,2012,0,0,90,0
Oklahoma City,31,30,29,27,0,0,0,0,Brooklyn,28,20,38,25,0,0,0,0,20121204,117,111,3,13,4,6,6,228,-6,2012,0,1,1324,0
Indiana,20,15,25,20,0,0,0,0,Chicago,18,19,18,21,0,0,0,0,20121204,80,76,2,-2,5,4,4,156,-4,2012,0,1,163,0
LA Lakers,30,28,25,22,0,0,0,0,Houston,22,23,28,34,0,0,0,0,20121204,105,107,-8,-13,-10,2,2,212,2,2012,0,1,1371,0
Phoenix,25,27,20,22,4,0,0,0,Memphis,18,27,23,26,14,0,0,0,20121204,98,108,-7,-7,-4,0,10,206,10,2012,1,1,1260,0
Minnesota,34,31,22,18,0,0,0,0,Philadelphia,21,26,20,21,0,0,0,0,20121204,105,88,13,18,20,17,17,193,-17,2012,0,1,983,0
Miami,25,29,24,23,0,0,0,0,Washington,30,30,22,23,0,0,0,0,20121204,101,105,5,6,4,4,4,206,4,2012,0,1,924,0
Golden State,21,19,39,25,0,0,0,0,Detroit,20,18,23,36,0,0,0,0,20121205,104,97,1,2,18,7,7,201,-7,2012,0,2,2087,0
Orlando,15,19,23,24,0,0,0,0,Utah,24,21,23,19,0,0,0,0,20121205,81,87,9,11,11,6,6,168,6,2012,0,2,1915,0
Milwaukee,32,26,18,23,0,0,0,0,San Antonio,29,23,24,34,0,0,0,0,20121205,99,110,-3,-6,0,11,11,209,11,2012,0,2,1108,0
Toronto,29,18,29,24,0,0,0,0,Sacramento,29,26,23,29,0,0,0,0,20121205,100,107,0,8,2,7,7,207,7,2012,0,2,2195,0
LA Lakers,20,27,30,26,0,0,0,0,New Orleans,23,25,16,23,0,0,0,0,20121205,103,87,-3,-1,13,16,16,190,-16,2012,0,2,1669,0
Dallas,18,24,26,22,0,0,0,0,LA Clippers,29,31,23,29,0,0,0,0,20121205,90,112,11,18,15,22,22,202,22,2012,0,2,1237,0
New York,26,25,21,28,0,0,0,0,Charlotte,24,29,22,23,0,0,0,0,20121205,100,98,2,-2,-3,2,2,198,-2,2012,0,2,531,0
Chicago,27,18,27,23,0,0,0,0,Cleveland,11,24,28,22,0,0,0,0,20121205,95,85,16,10,9,10,10,180,-10,2012,0,2,308,0
Minnesota,30,21,21,22,0,0,0,0,Boston,27,20,32,25,0,0,0,0,20121205,94,104,-3,-4,7,10,10,198,10,2012,0,2,1120,0
Denver,26,25,27,26,0,0,0,0,Atlanta,27,28,30,23,0,0,0,0,20121205,104,108,1,4,7,4,4,212,4,2012,0,2,1209,0
Portland,21,29,14,28,0,0,0,0,Indiana,20,28,31,20,0,0,0,0,20121205,92,99,-1,-2,15,7,7,191,7,2012,0,2,1880,0
New York,23,30,37,22,0,0,0,0,Miami,26,27,27,12,0,0,0,0,20121206,112,92,-3,0,10,20,20,204,-20,2012,0,3,1091,0
Dallas,23,17,29,28,0,0,0,0,Phoenix,23,21,18,32,0,0,0,0,20121206,97,94,0,-4,7,3,3,191,-3,2012,0,3,884,0
Boston,28,22,20,19,5,0,0,0,Philadelphia,28,18,26,17,6,0,0,0,20121207,94,95,0,-4,2,0,1,189,1,2012,1,4,270,0
Orlando,16,18,30,18,0,0,0,0,Sacramento,25,21,16,29,0,0,0,0,20121207,82,91,9,12,-2,9,9,173,9,2012,0,4,2390,0
LA Lakers,27,26,22,33,0,0,0,0,Oklahoma City,26,41,22,25,0,0,0,0,20121207,108,114,-1,14,14,6,6,222,6,2012,0,4,1178,0
Toronto,29,23,24,23,0,0,0,0,Utah,25,38,32,36,0,0,0,0,20121207,99,131,-4,11,19,32,32,230,32,2012,0,4,1664,0
Houston,21,24,21,26,0,0,0,0,San Antonio,29,28,30,27,0,0,0,0,20121207,92,114,8,12,21,22,22,206,22,2012,0,4,189,0
Memphis,22,29,20,25,0,0,0,0,New Orleans,17,22,27,23,0,0,0,0,20121207,96,89,5,12,5,7,7,185,-7,2012,0,4,358,0
Cleveland,16,21,20,16,0,0,0,0,Minnesota,25,19,22,25,0,0,0,0,20121207,73,91,9,7,9,18,18,164,18,2012,0,4,629,0
Charlotte,20,20,21,32,0,0,0,0,Milwaukee,33,25,28,22,0,0,0,0,20121207,93,108,13,18,25,15,15,201,15,2012,0,4,658,0
Denver,22,29,18,23,0,0,0,0,Indiana,28,22,18,21,0,0,0,0,20121207,92,89,-6,1,1,3,3,181,-3,2012,0,4,998,0
Chicago,26,24,28,30,0,0,0,0,Detroit,30,25,19,30,0,0,0,0,20121207,108,104,-4,-5,4,4,4,212,-4,2012,0,4,238,0
Golden State,24,31,29,25,0,0,0,0,Brooklyn,31,32,19,20,0,0,0,0,20121207,109,102,-7,-8,2,7,7,211,-7,2012,0,4,2565,0
Washington,19,22,30,24,0,0,0,0,Atlanta,31,23,26,24,0,0,0,0,20121207,95,104,12,13,9,9,9,199,9,2012,0,4,541,0
Golden State,28,22,21,30,0,0,0,0,Washington,21,26,23,27,0,0,0,0,20121208,101,97,7,3,1,4,4,198,-4,2012,0,5,2435,0
Sacramento,30,13,34,22,0,0,0,0,Portland,18,23,24,15,0,0,0,0,20121208,99,80,12,2,12,19,19,179,-19,2012,0,5,483,0
New Orleans,32,15,25,18,0,0,0,0,Miami,31,33,22,20,0,0,0,0,20121208,90,106,-1,17,14,16,16,196,16,2012,0,5,668,0
Phoenix,31,26,26,16,0,0,0,0,LA Clippers,28,35,22,32,0,0,0,0,20121208,99,117,-3,6,2,18,18,216,18,2012,0,5,356,0
Atlanta,21,20,32,20,0,0,0,0,Memphis,22,25,13,23,0,0,0,0,20121208,93,83,-1,-6,13,10,10,176,-10,2012,0,5,336,0
Detroit,25,24,27,28,0,0,0,0,Cleveland,22,30,18,27,0,0,0,0,20121208,104,97,3,-3,6,7,7,201,-7,2012,0,5,90,0
New York,23,18,24,20,0,0,0,0,Chicago,26,17,24,26,0,0,0,0,20121208,85,93,3,2,2,8,8,178,8,2012,0,5,711,0
San Antonio,32,27,38,35,0,0,0,0,Charlotte,23,21,23,35,0,0,0,0,20121208,132,102,9,15,30,30,30,234,-30,2012,0,5,1103,0
Philadelphia,16,12,29,22,0,0,0,0,Boston,24,24,22,22,0,0,0,0,20121208,79,92,8,20,13,13,13,171,13,2012,0,5,270,0
Dallas,39,24,21,32,0,0,0,0,Houston,24,42,23,20,0,0,0,0,20121208,116,109,15,-3,-5,7,7,225,-7,2012,0,5,225,0
Milwaukee,25,23,27,22,0,0,0,0,Brooklyn,18,13,24,33,0,0,0,0,20121209,97,88,7,17,20,9,9,185,-9,2012,0,6,732,0
Toronto,21,26,26,10,0,0,0,0,LA Clippers,25,19,33,25,0,0,0,0,20121209,83,102,4,-3,4,19,19,185,19,2012,0,6,2170,0
Utah,25,35,28,29,0,0,0,0,LA Lakers,27,24,34,25,0,0,0,0,20121209,117,110,-2,9,3,7,7,227,-7,2012,0,6,579,0
Denver,25,33,26,22,0,0,0,0,New York,23,38,19,32,0,0,0,0,20121209,106,112,-2,3,-4,6,6,218,6,2012,0,6,1627,0
Indiana,22,34,18,19,0,0,0,0,Oklahoma City,25,32,27,20,0,0,0,0,20121209,93,104,3,1,10,11,11,197,11,2012,0,6,688,0
Orlando,20,33,18,27,0,0,0,0,Phoenix,23,25,22,20,0,0,0,0,20121209,98,90,-3,5,1,8,8,188,-8,2012,0,6,1842,0
Detroit,21,28,26,22,0,0,0,0,Philadelphia,25,21,30,28,0,0,0,0,20121210,97,104,4,-3,1,7,7,201,7,2012,0,0,441,0
Atlanta,26,28,20,18,0,0,0,0,Miami,28,28,26,19,0,0,0,0,20121210,92,101,2,2,8,9,9,193,9,2012,0,0,605,0
Toronto,19,21,19,15,0,0,0,0,Portland,18,26,20,28,0,0,0,0,20121210,74,92,-1,4,5,18,18,166,18,2012,0,0,2108,0
Sacramento,29,14,27,26,0,0,0,0,Dallas,36,29,23,31,0,0,0,0,20121210,96,119,7,22,18,23,23,215,23,2012,0,0,1437,0
Golden State,38,20,35,11,0,0,0,0,Charlotte,23,17,34,22,0,0,0,0,20121210,104,96,15,18,19,8,8,200,-8,2012,0,0,2296,0
San Antonio,23,41,27,29,14,0,0,0,Houston,27,36,30,27,6,0,0,0,20121210,134,126,-4,1,-2,0,8,260,-8,2012,1,0,189,0
New York,16,33,25,26,0,0,0,0,Brooklyn,30,23,26,18,0,0,0,0,20121211,100,97,-14,-4,-5,3,3,197,-3,2012,0,1,0,0
LA Clippers,21,26,22,25,0,0,0,0,Chicago,18,22,25,24,0,0,0,0,20121211,94,89,3,7,4,5,5,183,-5,2012,0,1,1741,0
LA Lakers,23,16,23,32,0,0,0,0,Cleveland,29,25,14,32,0,0,0,0,20121211,94,100,6,15,6,6,6,194,6,2012,0,1,2044,0
Denver,17,31,24,29,0,0,0,0,Detroit,25,17,24,28,0,0,0,0,20121211,101,94,-8,6,6,7,7,195,-7,2012,0,1,1154,0
Washington,11,25,20,21,0,0,0,0,New Orleans,22,20,18,10,0,0,0,0,20121211,77,70,-11,-6,-4,7,7,147,-7,2012,0,1,964,0
San Antonio,28,16,27,25,0,0,0,0,Utah,22,31,18,28,0,0,0,0,20121212,96,99,-6,9,0,3,3,195,3,2012,0,2,1087,0
Brooklyn,20,17,31,26,0,0,0,0,Toronto,27,18,19,24,0,0,0,0,20121212,94,88,-7,-8,4,6,6,182,-6,2012,0,2,341,0
Memphis,27,19,17,17,0,0,0,0,Phoenix,21,22,20,19,0,0,0,0,20121212,80,82,-6,-3,0,2,2,162,2,2012,0,2,1260,0
Chicago,21,20,28,27,0,0,0,0,Philadelphia,24,20,22,23,0,0,0,0,20121212,96,89,-3,-3,3,7,7,185,-7,2012,0,2,664,0
Atlanta,20,26,26,14,0,0,0,0,Orlando,15,19,26,20,0,0,0,0,20121212,86,80,5,12,12,6,6,166,-6,2012,0,2,401,0
New Orleans,19,25,18,26,0,0,0,0,Oklahoma City,17,19,22,34,0,0,0,0,20121212,88,92,-2,-8,-4,4,4,180,4,2012,0,2,576,0
Denver,29,21,20,35,0,0,0,0,Minnesota,21,30,26,31,0,0,0,0,20121212,105,108,-8,1,7,3,3,213,3,2012,0,2,698,0
Golden State,29,24,24,20,0,0,0,0,Miami,28,24,22,21,0,0,0,0,20121212,97,95,1,1,3,2,2,192,-2,2012,0,2,2590,0
Cleveland,29,29,12,11,0,0,0,0,Indiana,25,27,28,16,0,0,0,0,20121212,81,96,-4,-6,10,15,15,177,15,2012,0,2,262,0
Washington,17,25,22,29,0,0,0,0,Houston,27,18,23,31,0,0,0,0,20121212,93,99,10,3,4,6,6,192,6,2012,0,2,1217,0
LA Clippers,23,26,29,22,0,0,0,0,Charlotte,21,23,27,23,0,0,0,0,20121212,100,94,2,5,7,6,6,194,-6,2012,0,2,2115,0
Dallas,25,18,27,26,9,10,0,0,Boston,27,21,28,20,9,12,0,0,20121212,115,117,2,5,6,0,2,232,2,2012,2,2,1548,0
Sacramento,19,20,23,23,0,0,0,0,Milwaukee,29,20,19,30,0,0,0,0,20121212,85,98,10,10,6,13,13,183,13,2012,0,2,1771,0
Charlotte,19,24,31,16,0,0,0,0,Atlanta,30,30,31,22,0,0,0,0,20121213,90,113,11,17,17,23,23,203,23,2012,0,3,226,0
LA Lakers,27,22,31,27,0,0,0,0,New York,41,27,25,23,0,0,0,0,20121213,107,116,14,19,13,9,9,223,9,2012,0,3,2445,0
San Antonio,21,24,24,21,0,0,0,0,Portland,23,26,27,22,0,0,0,0,20121213,90,98,2,4,7,8,8,188,8,2012,0,3,1718,0
Golden State,14,21,29,21,0,0,0,0,Orlando,19,32,30,18,0,0,0,0,20121214,85,99,5,16,17,14,14,184,14,2012,0,4,2437,0
LA Lakers,27,31,25,19,0,0,0,0,Washington,25,30,14,27,0,0,0,0,20121214,102,96,2,3,14,6,6,198,-6,2012,0,4,2294,0
Dallas,25,16,14,19,0,0,0,0,Toronto,24,30,15,26,0,0,0,0,20121214,74,95,-1,13,14,21,21,169,21,2012,0,4,1201,0
Utah,22,20,23,19,0,0,0,0,Phoenix,34,22,21,22,0,0,0,0,20121214,84,99,12,14,12,15,15,183,15,2012,0,4,505,0
Minnesota,28,22,32,31,0,0,0,0,New Orleans,23,27,23,29,0,0,0,0,20121214,113,102,5,0,9,11,11,215,-11,2012,0,4,1052,0
Sacramento,26,16,26,35,0,0,0,0,Oklahoma City,29,32,21,31,0,0,0,0,20121214,103,113,3,19,14,10,10,216,10,2012,0,4,1336,0
Philadelphia,20,24,22,19,0,0,0,0,Indiana,25,17,29,24,0,0,0,0,20121214,85,95,5,-2,5,10,10,180,10,2012,0,4,582,0
Boston,19,26,25,19,0,0,0,0,Houston,27,16,32,26,0,0,0,0,20121214,89,101,8,-2,5,12,12,190,12,2012,0,4,1603,0
Memphis,16,25,28,25,0,0,0,0,Denver,17,28,24,30,0,0,0,0,20121214,94,99,1,4,0,5,5,193,5,2012,0,4,877,0
Milwaukee,25,27,20,18,0,0,0,0,Cleveland,17,26,24,19,0,0,0,0,20121214,90,86,8,9,5,4,4,176,-4,2012,0,4,334,0
Detroit,25,22,30,13,10,5,0,0,Brooklyn,23,36,14,17,10,7,0,0,20121214,105,107,-2,12,-4,0,2,212,2,2012,2,4,480,0
Boston,21,28,20,19,0,0,0,0,San Antonio,26,26,25,26,0,0,0,0,20121215,88,103,5,3,8,15,15,191,15,2012,0,5,1765,0
Cleveland,28,17,28,29,0,0,0,0,New York,27,21,30,25,0,0,0,0,20121215,102,103,-1,3,5,1,1,205,1,2012,0,5,403,0
Dallas,32,13,25,32,4,0,0,0,Minnesota,22,32,26,22,12,0,0,0,20121215,106,114,-10,9,10,0,8,220,8,2012,1,5,863,0
LA Clippers,28,27,24,32,0,0,0,0,Milwaukee,15,20,27,23,0,0,0,0,20121215,111,85,13,20,17,26,26,196,-26,2012,0,5,1741,0
Memphis,19,25,28,27,0,0,0,0,Utah,21,33,10,22,0,0,0,0,20121215,99,86,-2,-10,8,13,13,185,-13,2012,0,5,1247,0
Indiana,26,16,21,25,0,0,0,0,Detroit,22,16,22,17,0,0,0,0,20121215,88,77,4,4,3,11,11,165,-11,2012,0,5,240,0
Brooklyn,24,17,21,20,0,0,0,0,Chicago,23,23,21,16,0,0,0,0,20121215,82,83,-1,5,5,1,1,165,1,2012,0,5,711,0
Orlando,29,27,25,26,0,0,0,0,Charlotte,21,27,29,21,0,0,0,0,20121215,107,98,8,8,4,9,9,205,-9,2012,0,5,463,0
Golden State,26,36,26,27,0,0,0,0,Atlanta,26,23,19,25,0,0,0,0,20121215,115,93,0,13,20,22,22,208,-22,2012,0,5,2135,0
Washington,14,22,10,26,0,0,0,0,Miami,26,24,29,23,0,0,0,0,20121215,72,102,12,14,33,30,30,174,30,2012,0,5,924,0
LA Lakers,28,32,27,24,0,0,0,0,Philadelphia,24,26,23,25,0,0,0,0,20121216,111,98,4,10,14,13,13,209,-13,2012,0,6,2388,0
New Orleans,19,24,20,31,0,0,0,0,Portland,25,29,21,20,0,0,0,0,20121216,94,95,6,11,12,1,1,189,1,2012,0,6,2059,0
Denver,32,32,33,25,0,0,0,0,Sacramento,23,23,21,30,0,0,0,0,20121216,122,97,9,18,30,25,25,219,-25,2012,0,6,886,0
Houston,28,21,22,25,0,0,0,0,Toronto,26,23,28,26,0,0,0,0,20121216,96,103,-2,0,6,7,7,199,7,2012,0,6,1299,0
Sacramento,22,32,14,22,0,0,0,0,Phoenix,16,27,31,27,0,0,0,0,20121217,90,101,-6,-11,6,11,11,191,11,2012,0,0,634,0
Minnesota,29,32,17,15,0,0,0,0,Orlando,27,22,25,28,0,0,0,0,20121217,93,102,-2,-12,-4,9,9,195,9,2012,0,0,1309,0
San Antonio,26,22,16,29,0,0,0,0,Oklahoma City,30,23,29,25,0,0,0,0,20121217,93,107,4,5,18,14,14,200,14,2012,0,0,421,0
LA Clippers,21,21,21,25,0,0,0,0,Detroit,20,20,20,16,0,0,0,0,20121217,88,76,1,2,3,12,12,164,-12,2012,0,0,1979,0
Chicago,20,14,19,18,0,0,0,0,Memphis,11,28,22,19,0,0,0,0,20121217,71,80,-9,5,8,9,9,151,9,2012,0,0,480,0
Houston,29,27,27,26,0,0,0,0,New York,31,11,18,36,0,0,0,0,20121217,109,96,-2,14,23,13,13,205,-13,2012,0,0,1417,0
Charlotte,25,33,26,16,0,0,0,0,LA Lakers,27,26,24,24,0,0,0,0,20121218,100,101,2,-5,-7,1,1,201,1,2012,0,1,2115,0
Atlanta,28,24,20,18,10,0,0,0,Washington,22,24,23,21,5,0,0,0,20121218,100,95,6,6,3,0,5,195,-5,2012,1,1,541,0
Indiana,25,23,18,27,0,0,0,0,Milwaukee,21,24,27,26,0,0,0,0,20121218,93,98,-4,-3,6,5,5,191,5,2012,0,1,243,0
Minnesota,27,22,23,20,0,0,0,0,Miami,21,31,28,23,0,0,0,0,20121218,92,103,-6,3,8,11,11,195,11,2012,0,1,1513,0
New Orleans,21,29,22,24,0,0,0,0,Golden State,31,28,23,21,0,0,0,0,20121218,96,103,10,9,10,7,7,199,7,2012,0,1,1921,0
Boston,23,25,22,19,0,0,0,0,Chicago,28,27,24,21,0,0,0,0,20121218,89,100,5,7,9,11,11,189,11,2012,0,1,849,0
Philadelphia,23,29,22,26,0,0,0,0,Dallas,28,29,19,31,0,0,0,0,20121218,100,107,5,5,2,7,7,207,7,2012,0,1,1297,0
Toronto,22,27,29,35,0,0,0,0,Cleveland,29,24,23,23,0,0,0,0,20121218,113,99,-7,-4,2,14,14,212,-14,2012,0,1,187,0
Utah,20,24,26,22,0,0,0,0,Brooklyn,24,33,17,16,0,0,0,0,20121218,92,90,-4,-13,-4,2,2,182,-2,2012,0,1,1967,0
San Antonio,28,20,27,31,0,0,0,0,Denver,26,29,35,22,0,0,0,0,20121218,106,112,-2,7,15,6,6,218,6,2012,0,1,802,0
Detroit,23,26,22,20,0,0,0,0,Toronto,27,22,24,24,0,0,0,0,20121219,91,97,4,0,2,6,6,188,6,2012,0,2,205,0
Golden State,24,31,33,39,0,0,0,0,Sacramento,33,30,36,32,0,0,0,0,20121219,127,131,9,8,11,4,4,258,4,2012,0,2,75,0
Charlotte,27,19,22,36,0,0,0,0,Phoenix,28,36,33,24,0,0,0,0,20121219,104,121,1,18,29,17,17,225,17,2012,0,2,1778,0
Brooklyn,23,25,19,19,0,0,0,0,New York,26,26,23,25,0,0,0,0,20121219,86,100,3,4,8,14,14,186,14,2012,0,2,0,0
Milwaukee,22,12,17,29,0,0,0,0,Memphis,21,22,23,24,0,0,0,0,20121219,80,90,-1,9,15,10,10,170,10,2012,0,2,557,0
Washington,26,24,13,20,0,0,0,0,Orlando,27,25,24,14,0,0,0,0,20121219,83,90,1,2,13,7,7,173,7,2012,0,2,757,0
Utah,23,8,20,33,0,0,0,0,Indiana,31,22,23,28,0,0,0,0,20121219,84,104,8,22,25,20,20,188,20,2012,0,2,1353,0
Philadelphia,24,27,28,24,0,0,0,0,Houston,33,23,33,36,0,0,0,0,20121219,103,125,9,5,10,22,22,228,22,2012,0,2,1339,0
Cleveland,25,21,26,19,0,0,0,0,Boston,27,27,28,21,0,0,0,0,20121219,91,103,2,8,10,12,12,194,12,2012,0,2,549,0
Oklahoma City,23,32,18,27,0,0,0,0,Atlanta,20,21,25,26,0,0,0,0,20121219,100,92,3,14,7,8,8,192,-8,2012,0,2,755,0
New Orleans,16,22,18,21,0,0,0,0,LA Clippers,22,26,27,18,0,0,0,0,20121219,77,93,6,10,19,16,16,170,16,2012,0,2,1669,0
Miami,31,27,33,19,0,0,0,0,Dallas,20,22,19,34,0,0,0,0,20121220,110,95,11,16,30,15,15,205,-15,2012,0,3,1110,0
Oklahoma City,18,26,25,24,0,0,0,0,Minnesota,30,23,23,23,0,0,0,0,20121220,93,99,12,9,7,6,6,192,6,2012,0,3,694,0
Denver,14,26,21,32,0,0,0,0,Portland,25,25,19,32,0,0,0,0,20121220,93,101,11,10,8,8,8,194,8,2012,0,3,981,0
Chicago,30,24,29,27,0,0,0,0,New York,23,16,22,45,0,0,0,0,20121221,110,106,7,15,22,4,4,216,-4,2012,0,4,711,0
Orlando,15,24,23,28,0,0,0,0,Toronto,20,22,29,22,0,0,0,0,20121221,90,93,5,3,9,3,3,183,3,2012,0,4,1048,0
New Orleans,21,21,19,33,0,0,0,0,San Antonio,26,28,18,27,0,0,0,0,20121221,94,99,5,12,11,5,5,193,5,2012,0,4,506,0
Atlanta,23,22,19,16,0,0,0,0,Philadelphia,30,21,21,27,0,0,0,0,20121221,80,99,7,6,8,19,19,179,19,2012,0,4,665,0
Dallas,16,23,18,25,0,0,0,0,Memphis,25,15,29,23,0,0,0,0,20121221,82,92,9,1,12,10,10,174,10,2012,0,4,419,0
Charlotte,23,26,27,24,0,0,0,0,Golden State,31,27,31,26,0,0,0,0,20121221,100,115,8,9,13,15,15,215,15,2012,0,4,2296,0
Washington,14,20,17,17,0,0,0,0,Detroit,29,24,24,23,0,0,0,0,20121221,68,100,15,19,26,32,32,168,32,2012,0,4,394,0
Indiana,23,21,33,22,0,0,0,0,Cleveland,23,22,22,22,0,0,0,0,20121221,99,89,0,-1,10,10,10,188,-10,2012,0,4,262,0
Milwaukee,17,26,19,26,11,0,0,0,Boston,25,21,24,18,6,0,0,0,20121221,99,94,-8,-3,-8,0,5,193,-5,2012,1,4,855,0
Sacramento,21,18,23,23,0,0,0,0,LA Clippers,29,24,20,24,0,0,0,0,20121221,85,97,8,14,11,12,12,182,12,2012,0,4,361,0
Indiana,11,18,24,28,0,0,0,0,New Orleans,18,28,7,22,0,0,0,0,20121222,81,75,-7,-17,0,6,6,156,-6,2012,0,5,713,0
Chicago,21,16,17,21,0,0,0,0,Atlanta,17,36,25,14,0,0,0,0,20121222,75,92,-4,16,24,17,17,167,17,2012,0,5,587,0
Charlotte,23,23,19,23,0,0,0,0,Denver,29,35,24,22,0,0,0,0,20121222,88,110,6,18,23,22,22,198,22,2012,0,5,1355,0
LA Lakers,31,22,21,34,10,0,0,0,Golden State,27,34,26,21,7,0,0,0,20121222,118,115,4,-8,-13,0,3,233,-3,2012,1,5,347,0
Memphis,32,22,24,18,0,0,0,0,Houston,33,31,30,27,0,0,0,0,20121222,96,121,1,10,16,25,25,217,25,2012,0,5,484,0
Utah,25,18,20,26,0,0,0,0,Miami,28,19,26,32,0,0,0,0,20121222,89,105,3,4,10,16,16,194,16,2012,0,5,2086,0
Cleveland,19,27,25,23,0,0,0,0,Milwaukee,19,18,26,19,0,0,0,0,20121222,94,82,0,9,8,12,12,176,-12,2012,0,5,334,0
Phoenix,25,28,22,18,0,0,0,0,Portland,23,21,31,21,0,0,0,0,20121222,93,96,-2,-9,0,3,3,189,3,2012,0,5,1005,0
Detroit,22,32,20,22,0,0,0,0,Washington,13,22,29,23,0,0,0,0,20121222,96,87,9,19,10,9,9,183,-9,2012,0,5,394,0
Dallas,26,26,14,25,0,0,0,0,San Antonio,33,31,36,29,0,0,0,0,20121223,91,129,7,12,34,38,38,220,38,2012,0,6,252,0
Portland,27,15,29,25,0,0,0,0,Sacramento,21,28,31,28,0,0,0,0,20121223,96,108,-6,7,9,12,12,204,12,2012,0,6,483,0
LA Clippers,28,30,33,12,0,0,0,0,Phoenix,24,19,17,17,0,0,0,0,20121223,103,77,4,15,31,26,26,180,-26,2012,0,6,356,0
Minnesota,29,26,18,18,0,0,0,0,New York,22,24,25,23,0,0,0,0,20121223,91,94,-7,-9,-2,3,3,185,3,2012,0,6,1016,0
Philadelphia,17,24,23,28,0,0,0,0,Brooklyn,24,19,26,26,0,0,0,0,20121223,92,95,7,2,5,3,3,187,3,2012,0,6,80,0
Utah,18,28,25,26,0,0,0,0,Orlando,30,17,26,20,0,0,0,0,20121223,97,93,-12,-1,-2,4,4,190,-4,2012,0,6,1915,0
Oklahoma City,24,24,24,25,0,0,0,0,Miami,27,27,20,29,0,0,0,0,20121225,97,103,3,6,2,6,6,200,6,2012,0,1,1225,0
New York,23,26,29,16,0,0,0,0,LA Lakers,25,26,26,23,0,0,0,0,20121225,94,100,2,2,-1,6,6,194,6,2012,0,1,2445,0
Denver,26,22,28,24,0,0,0,0,LA Clippers,25,42,26,19,0,0,0,0,20121225,100,112,-1,19,17,12,12,212,12,2012,0,1,830,0
Houston,27,31,36,26,0,0,0,0,Chicago,22,19,27,29,0,0,0,0,20121225,120,97,5,17,26,23,23,217,-23,2012,0,1,939,0
Boston,22,34,17,20,0,0,0,0,Brooklyn,24,18,16,18,0,0,0,0,20121225,93,76,-2,14,15,17,17,169,-17,2012,0,1,190,0
Golden State,24,25,26,19,0,0,0,0,Utah,19,18,21,25,0,0,0,0,20121226,94,83,5,12,17,11,11,177,-11,2012,0,2,599,0
New York,27,27,22,23,0,0,0,0,Phoenix,29,15,32,21,0,0,0,0,20121226,99,97,-2,10,0,2,2,196,-2,2012,0,2,2139,0
Toronto,18,19,20,23,0,0,0,0,San Antonio,22,22,26,30,0,0,0,0,20121226,80,100,4,7,13,20,20,180,20,2012,0,2,1438,0
Sacramento,26,18,23,24,0,0,0,0,Portland,31,31,29,18,0,0,0,0,20121226,91,109,5,18,24,18,18,200,18,2012,0,2,483,0
Cleveland,22,23,23,19,0,0,0,0,Washington,26,17,25,16,0,0,0,0,20121226,87,84,-4,2,0,3,3,171,-3,2012,0,2,304,0
New Orleans,26,23,29,19,0,0,0,0,Orlando,24,29,23,18,0,0,0,0,20121226,97,94,2,-4,2,3,3,191,-3,2012,0,2,533,0
Miami,27,28,23,27,0,0,0,0,Charlotte,18,20,33,21,0,0,0,0,20121226,105,92,9,17,7,13,13,197,-13,2012,0,2,654,0
Brooklyn,24,18,25,26,0,0,0,0,Milwaukee,22,33,23,30,0,0,0,0,20121226,93,108,-2,13,11,15,15,201,15,2012,0,2,732,0
Philadelphia,26,23,26,24,0,0,0,0,Memphis,29,18,23,19,0,0,0,0,20121226,99,89,-3,2,5,10,10,188,-10,2012,0,2,878,0
LA Lakers,26,28,33,27,0,0,0,0,Denver,29,28,39,30,0,0,0,0,20121226,114,126,3,3,9,12,12,240,12,2012,0,2,830,0
Detroit,13,32,17,39,7,11,0,0,Atlanta,28,22,31,20,7,18,0,0,20121226,119,126,15,5,19,0,7,245,7,2012,2,2,597,0
Houston,22,22,17,26,0,0,0,0,Minnesota,17,30,17,20,0,0,0,0,20121226,87,84,5,-3,-3,3,3,171,-3,2012,0,2,1057,0
Boston,20,27,20,10,0,0,0,0,LA Clippers,30,30,22,24,0,0,0,0,20121227,77,106,10,13,15,29,29,183,29,2012,0,3,2590,0
Dallas,29,16,36,17,7,0,0,0,Oklahoma City,21,22,30,25,13,0,0,0,20121227,105,111,-8,-2,-8,0,6,216,6,2012,1,3,189,0
Toronto,21,27,22,21,13,0,0,0,New Orleans,23,19,22,27,6,0,0,0,20121228,104,97,-2,6,6,0,7,201,-7,2012,1,4,1112,0
LA Clippers,29,19,36,32,0,0,0,0,Utah,22,36,30,26,0,0,0,0,20121228,116,114,7,-10,-4,2,2,230,-2,2012,0,4,579,0
Houston,29,36,27,24,0,0,0,0,San Antonio,41,28,29,24,0,0,0,0,20121228,116,122,12,4,6,6,6,238,6,2012,0,4,189,0
New York,23,27,31,24,0,0,0,0,Sacramento,32,39,16,19,0,0,0,0,20121228,105,106,9,21,6,1,1,211,1,2012,0,4,2499,0
Portland,25,23,18,21,0,0,0,0,LA Lakers,34,28,26,16,0,0,0,0,20121228,87,104,9,14,22,17,17,191,17,2012,0,4,826,0
Orlando,31,20,21,25,0,0,0,0,Washington,25,29,26,25,0,0,0,0,20121228,97,105,-6,3,8,8,8,202,8,2012,0,4,757,0
Philadelphia,24,18,29,18,0,0,0,0,Golden State,25,32,23,16,0,0,0,0,20121228,89,96,1,15,9,7,7,185,7,2012,0,4,2516,0
Miami,32,20,19,28,0,0,0,0,Detroit,17,41,23,28,0,0,0,0,20121228,99,109,-15,6,10,10,10,208,10,2012,0,4,1155,0
Denver,29,26,32,19,0,0,0,0,Dallas,18,29,23,15,0,0,0,0,20121228,106,85,11,8,17,21,21,191,-21,2012,0,4,661,0
Atlanta,25,30,20,27,0,0,0,0,Cleveland,26,28,26,14,0,0,0,0,20121228,102,94,-1,1,-5,8,8,196,-8,2012,0,4,555,0
Charlotte,15,23,20,23,0,0,0,0,Brooklyn,33,23,24,17,0,0,0,0,20121228,81,97,18,18,22,16,16,178,16,2012,0,4,531,0
Phoenix,20,24,27,20,0,0,0,0,Indiana,27,31,17,22,0,0,0,0,20121228,91,97,7,14,4,6,6,188,6,2012,0,4,1496,0
Phoenix,29,29,29,20,0,0,0,0,Minnesota,32,32,25,22,0,0,0,0,20121229,107,111,3,6,2,4,4,218,4,2012,0,5,1278,0
Miami,20,24,27,14,0,0,0,0,Milwaukee,25,31,13,35,0,0,0,0,20121229,85,104,5,12,-2,19,19,189,19,2012,0,5,1269,0
Philadelphia,23,21,23,18,0,0,0,0,Portland,30,19,21,19,0,0,0,0,20121229,85,89,7,5,3,4,4,174,4,2012,0,5,2405,0
Toronto,36,31,20,36,0,0,0,0,Orlando,21,26,24,17,0,0,0,0,20121229,123,88,15,20,16,35,35,211,-35,2012,0,5,1048,0
Denver,15,21,21,15,0,0,0,0,Memphis,19,18,16,28,0,0,0,0,20121229,72,81,4,1,-4,9,9,153,9,2012,0,5,877,0
Cleveland,24,29,21,26,0,0,0,0,Brooklyn,34,27,18,24,0,0,0,0,20121229,100,103,10,8,5,3,3,203,3,2012,0,5,403,0
Boston,23,17,27,16,0,0,0,0,Golden State,29,28,19,25,0,0,0,0,20121229,83,101,6,17,9,18,18,184,18,2012,0,5,2692,0
Washington,26,13,24,14,0,0,0,0,Chicago,22,23,25,17,0,0,0,0,20121229,77,87,-4,6,7,10,10,164,10,2012,0,5,594,0
New Orleans,22,18,33,25,0,0,0,0,Charlotte,25,32,16,22,0,0,0,0,20121229,98,95,-3,-17,0,3,3,193,-3,2012,0,5,648,0
Oklahoma City,31,37,28,28,0,0,0,0,Houston,26,24,24,20,0,0,0,0,20121229,124,94,5,18,22,30,30,218,-30,2012,0,5,413,0
Indiana,26,22,22,30,0,0,0,0,Atlanta,33,22,28,26,0,0,0,0,20121229,100,109,7,7,13,9,9,209,9,2012,0,5,427,0
San Antonio,27,30,25,29,0,0,0,0,Dallas,22,23,25,16,0,0,0,0,20121230,111,86,5,12,12,25,25,197,-25,2012,0,6,252,0
Milwaukee,23,22,26,23,0,0,0,0,Detroit,30,25,23,18,0,0,0,0,20121230,94,96,7,10,7,2,2,190,2,2012,0,6,251,0
Utah,24,21,31,20,0,0,0,0,LA Clippers,29,25,25,28,0,0,0,0,20121230,96,107,5,9,3,11,11,203,11,2012,0,6,579,0
Boston,18,31,24,23,0,0,0,0,Sacramento,24,30,30,34,0,0,0,0,20121230,96,118,6,5,11,22,22,214,22,2012,0,6,2624,0
Brooklyn,22,25,5,21,0,0,0,0,San Antonio,31,24,30,19,0,0,0,0,20121231,73,104,9,8,33,31,31,177,31,2012,0,0,1581,0
Phoenix,28,25,25,18,0,0,0,0,Oklahoma City,32,22,30,30,0,0,0,0,20121231,96,114,4,1,6,18,18,210,18,2012,0,0,840,0
Miami,31,17,22,29,13,0,0,0,Orlando,22,32,23,22,11,0,0,0,20121231,112,110,9,-6,-7,0,2,222,-2,2012,1,0,204,0
Atlanta,27,19,29,29,0,0,0,0,Houston,26,38,26,33,0,0,0,0,20121231,104,123,-1,18,15,19,19,227,19,2012,0,0,700,0
Charlotte,28,19,18,26,0,0,0,0,Chicago,18,24,23,16,0,0,0,0,20121231,91,81,10,5,0,10,10,172,-10,2012,0,0,586,0
Memphis,19,22,26,16,0,0,0,0,Indiana,19,19,22,28,0,0,0,0,20121231,83,88,0,-3,-7,5,5,171,5,2012,0,0,383,0
LA Clippers,19,24,16,19,0,0,0,0,Denver,21,27,27,17,0,0,0,0,20130101,78,92,2,5,16,14,14,170,14,2012,0,1,830,0
Sacramento,28,20,19,30,0,0,0,0,Detroit,27,31,22,23,0,0,0,0,20130101,97,103,-1,10,13,6,6,200,6,2012,0,1,2020,0
Philadelphia,28,26,27,22,0,0,0,0,LA Lakers,25,25,23,26,0,0,0,0,20130101,103,99,3,4,8,4,4,202,-4,2012,0,1,2388,0
Atlanta,22,22,28,23,0,0,0,0,New Orleans,26,24,14,22,0,0,0,0,20130101,95,86,-4,-6,8,9,9,181,-9,2012,0,1,424,0
Portland,30,28,20,27,0,0,0,0,New York,23,24,24,29,0,0,0,0,20130101,105,100,7,11,7,5,5,205,-5,2012,0,1,2439,0
Dallas,23,25,35,20,0,0,0,0,Washington,29,23,19,23,0,0,0,0,20130101,103,94,-6,-4,12,9,9,197,-9,2012,0,1,1181,0
Brooklyn,33,28,15,34,0,0,0,0,Oklahoma City,19,26,27,21,0,0,0,0,20130102,110,93,14,16,4,17,17,203,-17,2012,0,2,1324,0
Minnesota,24,21,21,18,0,0,0,0,Utah,23,30,26,27,0,0,0,0,20130102,84,106,-1,8,13,22,22,190,22,2012,0,2,984,0
Portland,17,22,22,18,0,0,0,0,Toronto,24,31,23,24,0,0,0,0,20130102,79,102,7,16,17,23,23,181,23,2012,0,2,2108,0
Philadelphia,24,25,17,23,0,0,0,0,Phoenix,31,17,27,20,0,0,0,0,20130102,89,95,7,-1,9,6,6,184,6,2012,0,2,2078,0
Chicago,29,25,28,14,0,0,0,0,Orlando,28,18,25,23,0,0,0,0,20130102,96,94,1,8,11,2,2,190,-2,2012,0,2,984,0
San Antonio,33,36,24,24,0,0,0,0,Milwaukee,22,30,29,29,0,0,0,0,20130102,117,110,11,17,12,7,7,227,-7,2012,0,2,1108,0
Washington,18,21,19,23,0,0,0,0,Indiana,31,16,20,22,0,0,0,0,20130102,81,89,13,8,9,8,8,170,8,2012,0,2,490,0
New Orleans,23,21,22,26,0,0,0,0,Houston,21,28,25,30,0,0,0,0,20130102,92,104,-2,5,8,12,12,196,12,2012,0,2,317,0
LA Clippers,24,25,15,30,0,0,0,0,Golden State,33,29,20,33,0,0,0,0,20130102,94,115,9,13,18,21,21,209,21,2012,0,2,347,0
Sacramento,28,24,22,23,0,0,0,0,Cleveland,25,28,18,23,0,0,0,0,20130102,97,94,3,-1,3,3,3,191,-3,2012,0,2,2096,0
Memphis,25,25,25,18,0,0,0,0,Boston,26,15,18,24,0,0,0,0,20130102,93,83,-1,9,16,10,10,176,-10,2012,0,2,1134,0
Dallas,30,22,27,24,6,0,0,0,Miami,22,28,31,22,16,0,0,0,20130102,109,119,-8,-2,2,0,10,228,10,2012,1,2,1110,0
Minnesota,23,24,22,32,0,0,0,0,Denver,25,18,27,27,0,0,0,0,20130103,101,97,-2,4,-1,4,4,198,-4,2012,0,3,698,0
San Antonio,19,21,20,23,0,0,0,0,New York,22,20,25,33,0,0,0,0,20130103,83,100,3,2,7,17,17,183,17,2012,0,3,1581,0
Portland,24,23,25,14,0,0,0,0,Memphis,25,25,22,12,0,0,0,0,20130104,86,84,-1,-3,0,2,2,170,-2,2012,0,4,1845,0
Sacramento,23,31,28,23,0,0,0,0,Toronto,22,31,10,33,0,0,0,0,20130104,105,96,1,1,19,9,9,201,-9,2012,0,4,2195,0
Utah,25,17,29,16,0,0,0,0,Phoenix,31,9,22,18,0,0,0,0,20130104,87,80,-6,2,9,7,7,167,-7,2012,0,4,505,0
Philadelphia,21,21,24,19,0,0,0,0,Oklahoma City,22,24,32,31,0,0,0,0,20130104,85,109,1,4,12,24,24,194,24,2012,0,4,1256,0
Houston,23,24,30,38,0,0,0,0,Milwaukee,21,37,14,29,0,0,0,0,20130104,115,101,2,-11,5,14,14,216,-14,2012,0,4,1005,0
Atlanta,20,16,26,22,0,0,0,0,Detroit,25,26,23,11,0,0,0,0,20130104,84,85,5,15,12,1,1,169,1,2012,0,4,597,0
LA Lakers,22,29,20,31,0,0,0,0,LA Clippers,29,32,26,20,0,0,0,0,20130104,102,107,7,10,16,5,5,209,5,2012,0,4,0,0
Brooklyn,20,32,26,15,11,11,0,0,Washington,30,25,24,14,11,9,0,0,20130104,115,113,-10,-3,-1,0,2,228,-2,2012,2,4,204,0
Cleveland,29,33,24,20,0,0,0,0,Charlotte,23,25,26,30,0,0,0,0,20130104,106,104,6,14,12,2,2,210,-2,2012,0,4,435,0
Indiana,16,19,16,24,0,0,0,0,Boston,15,32,22,25,0,0,0,0,20130104,75,94,-1,12,18,19,19,169,19,2012,0,4,805,0
Chicago,26,23,26,21,0,0,0,0,Miami,22,26,18,23,0,0,0,0,20130104,96,89,4,1,9,7,7,185,-7,2012,0,4,1189,0
Portland,23,30,26,23,0,0,0,0,Minnesota,21,22,18,36,0,0,0,0,20130105,102,97,2,10,18,5,5,199,-5,2012,0,5,1423,0
Golden State,12,31,23,23,0,0,0,0,LA Clippers,35,32,36,12,0,0,0,0,20130105,89,115,23,24,37,26,26,204,26,2012,0,5,347,0
Philadelphia,21,21,21,23,0,0,0,0,San Antonio,31,23,27,28,0,0,0,0,20130105,86,109,10,12,18,23,23,195,23,2012,0,5,1505,0
New York,27,32,22,33,0,0,0,0,Orlando,36,19,34,17,0,0,0,0,20130105,114,106,-9,4,-8,8,8,220,-8,2012,0,5,939,0
Milwaukee,21,26,17,16,0,0,0,0,Indiana,21,31,25,18,0,0,0,0,20130105,80,95,0,5,13,15,15,175,15,2012,0,5,243,0
Utah,23,22,27,19,0,0,0,0,Denver,21,28,34,27,0,0,0,0,20130105,91,110,-2,4,11,19,19,201,19,2012,0,5,370,0
New Orleans,25,15,23,26,10,0,0,0,Dallas,23,24,20,22,7,0,0,0,20130105,99,96,2,-7,-4,0,3,195,-3,2012,1,5,442,0
Houston,20,34,24,34,0,0,0,0,Cleveland,26,24,28,26,0,0,0,0,20130105,112,104,-6,4,0,8,8,216,-8,2012,0,5,1113,0
Sacramento,31,16,25,21,0,0,0,0,Brooklyn,36,29,23,25,0,0,0,0,20130105,93,113,5,18,16,20,20,206,20,2012,0,5,2499,0
Boston,18,20,33,18,0,0,0,0,Atlanta,31,22,9,19,0,0,0,0,20130105,89,81,-13,-15,9,8,8,170,-8,2012,0,5,935,0
Charlotte,21,38,20,17,12,0,0,0,Detroit,30,30,22,14,5,0,0,0,20130106,108,101,-9,-1,-3,0,7,209,-7,2012,1,6,504,0
Denver,34,26,29,23,0,0,0,0,LA Lakers,26,34,23,22,0,0,0,0,20130106,112,105,8,0,6,7,7,217,-7,2012,0,6,830,0
Washington,19,25,16,11,0,0,0,0,Miami,27,25,17,30,0,0,0,0,20130106,71,99,8,8,9,28,28,170,28,2012,0,6,924,0
Memphis,21,20,30,21,0,0,0,0,Phoenix,16,22,24,19,0,0,0,0,20130106,92,81,5,3,9,11,11,173,-11,2012,0,6,1260,0
Oklahoma City,23,29,26,26,0,0,0,0,Toronto,18,32,17,25,0,0,0,0,20130106,104,92,5,2,11,12,12,196,-12,2012,0,6,1114,0
Oklahoma City,20,33,20,26,0,0,0,0,Washington,30,21,25,25,0,0,0,0,20130107,99,101,10,-2,3,2,2,200,2,2012,0,0,1149,0
Dallas,26,27,27,14,0,0,0,0,Utah,19,34,21,26,0,0,0,0,20130107,94,100,-7,0,-6,6,6,194,6,2012,0,0,998,0
Memphis,22,29,36,26,0,0,0,0,Sacramento,23,22,20,16,0,0,0,0,20130107,113,81,-1,6,22,32,32,194,-32,2012,0,0,1745,0
Orlando,24,33,28,23,11,0,0,0,Portland,25,23,37,23,17,0,0,0,20130107,119,125,1,-9,0,0,6,244,6,2012,1,0,2525,0
Boston,22,31,23,26,0,0,0,0,New York,21,35,16,24,0,0,0,0,20130107,102,96,1,-3,4,6,6,198,-6,2012,0,0,190,0
San Antonio,19,22,24,23,0,0,0,0,New Orleans,24,25,21,25,0,0,0,0,20130107,88,95,5,8,5,7,7,183,7,2012,0,0,506,0
Cleveland,30,20,22,20,0,0,0,0,Chicago,22,31,35,30,0,0,0,0,20130107,92,118,-8,3,16,26,26,210,26,2012,0,0,308,0
LA Lakers,34,28,26,24,0,0,0,0,Houston,28,31,38,28,0,0,0,0,20130108,112,125,-6,-3,9,13,13,237,13,2012,0,1,1371,0
Miami,19,23,15,20,0,0,0,0,Indiana,20,22,25,20,0,0,0,0,20130108,77,87,1,0,10,10,10,164,10,2012,0,1,1026,0
Phoenix,33,23,20,23,0,0,0,0,Milwaukee,26,24,30,28,0,0,0,0,20130108,99,108,-7,-6,4,9,9,207,9,2012,0,1,1462,0
Atlanta,20,22,29,32,0,0,0,0,Minnesota,30,28,27,23,0,0,0,0,20130108,103,108,10,16,14,5,5,211,5,2012,0,1,908,0
Brooklyn,26,22,35,26,0,0,0,0,Philadelphia,24,23,14,28,0,0,0,0,20130108,109,89,2,1,22,20,20,198,-20,2012,0,1,80,0
Philadelphia,21,19,21,11,0,0,0,0,Toronto,24,18,29,19,0,0,0,0,20130109,72,90,3,2,10,18,18,162,18,2012,0,2,334,0
LA Lakers,17,28,30,30,0,0,0,0,San Antonio,24,30,31,23,0,0,0,0,20130109,105,108,7,9,10,3,3,213,3,2012,0,2,1201,0
Minnesota,16,26,22,20,0,0,0,0,Oklahoma City,16,31,29,30,0,0,0,0,20130109,84,106,0,5,12,22,22,190,22,2012,0,2,694,0
Houston,22,14,33,10,0,0,0,0,New Orleans,18,16,25,29,0,0,0,0,20130109,79,88,-4,-2,-10,9,9,167,9,2012,0,2,317,0
Dallas,21,29,25,18,0,0,0,0,LA Clippers,25,27,20,27,0,0,0,0,20130109,93,99,4,2,-3,6,6,192,6,2012,0,2,1237,0
Atlanta,28,12,23,20,0,0,0,0,Cleveland,29,20,28,22,0,0,0,0,20130109,83,99,1,9,14,16,16,182,16,2012,0,2,555,0
Orlando,30,25,22,28,0,0,0,0,Denver,22,31,17,38,0,0,0,0,20130109,105,108,-8,-2,-7,3,3,213,3,2012,0,2,1548,0
Milwaukee,23,27,31,23,0,0,0,0,Chicago,33,24,23,16,0,0,0,0,20130109,104,96,-10,-7,1,8,8,200,-8,2012,0,2,83,0
Utah,27,36,27,22,0,0,0,0,Charlotte,20,24,29,29,0,0,0,0,20130109,112,102,7,19,17,10,10,214,-10,2012,0,2,1723,0
Phoenix,24,17,23,15,0,0,0,0,Boston,23,30,14,20,0,0,0,0,20130109,79,87,-1,12,3,8,8,166,8,2012,0,2,2295,0
Memphis,27,28,13,26,0,0,0,0,Golden State,26,20,17,24,0,0,0,0,20130109,94,87,1,9,5,7,7,181,-7,2012,0,2,1798,0
New York,14,20,26,16,0,0,0,0,Indiana,16,23,19,23,0,0,0,0,20130110,76,81,2,5,-2,5,5,157,5,2012,0,3,643,0
Miami,21,31,16,22,0,0,0,0,Portland,18,21,24,29,0,0,0,0,20130110,90,92,-3,-13,-5,2,2,182,2,2012,0,3,2704,0
Dallas,23,19,26,33,16,0,0,0,Sacramento,25,24,29,23,11,0,0,0,20130110,117,112,-2,-7,-10,0,5,229,-5,2012,1,3,1437,0
Charlotte,16,23,19,20,0,0,0,0,Toronto,29,24,23,23,0,0,0,0,20130111,78,99,13,14,18,21,21,177,21,2012,0,4,585,0
Chicago,29,28,25,26,0,0,0,0,New York,18,18,24,41,0,0,0,0,20130111,108,101,11,21,22,7,7,209,-7,2012,0,4,711,0
Minnesota,29,17,15,31,0,0,0,0,New Orleans,14,26,30,34,0,0,0,0,20130111,92,104,-15,-6,9,12,12,196,12,2012,0,4,1052,0
Detroit,25,16,33,29,0,0,0,0,Milwaukee,20,29,11,27,0,0,0,0,20130111,103,87,5,-8,14,16,16,190,-16,2012,0,4,251,0
San Antonio,25,18,28,24,3,0,0,0,Memphis,22,29,17,27,6,0,0,0,20130111,98,101,-3,8,-3,0,3,199,3,2012,1,4,631,0
Phoenix,25,28,13,13,0,0,0,0,Brooklyn,21,25,28,25,0,0,0,0,20130111,79,99,-4,-7,8,20,20,178,20,2012,0,4,2139,0
Portland,19,16,28,34,0,0,0,0,Golden State,28,22,28,25,0,0,0,0,20130111,97,103,9,15,15,6,6,200,6,2012,0,4,535,0
Cleveland,30,26,20,15,0,0,0,0,Denver,23,22,27,26,0,0,0,0,20130111,91,98,-7,-11,-4,7,7,189,7,2012,0,4,1223,0
Houston,21,24,21,25,0,0,0,0,Boston,24,29,25,25,0,0,0,0,20130111,91,103,3,8,12,12,12,194,12,2012,0,4,1603,0
Utah,25,22,29,19,0,0,0,0,Atlanta,22,21,25,35,0,0,0,0,20130111,95,103,-3,-4,-8,8,8,198,8,2012,0,4,1580,0
Oklahoma City,25,39,29,23,0,0,0,0,LA Lakers,25,23,25,28,0,0,0,0,20130111,116,101,0,16,20,15,15,217,-15,2012,0,4,1178,0
Houston,25,25,26,24,0,0,0,0,Philadelphia,29,29,27,22,0,0,0,0,20130112,100,107,4,8,9,7,7,207,7,2012,0,5,1339,0
Miami,28,38,37,25,0,0,0,0,Sacramento,17,27,28,27,0,0,0,0,20130112,128,99,11,22,31,29,29,227,-29,2012,0,5,2547,0
Orlando,26,23,26,29,0,0,0,0,LA Clippers,31,26,26,18,0,0,0,0,20130112,104,101,-5,-8,-8,3,3,205,-3,2012,0,5,2197,0
Atlanta,17,33,16,17,0,0,0,0,Washington,27,24,22,20,0,0,0,0,20130112,83,93,10,1,7,10,10,176,10,2012,0,5,541,0
Utah,13,26,25,26,0,0,0,0,Detroit,26,24,11,26,0,0,0,0,20130112,90,87,-13,-11,3,3,3,177,-3,2012,0,5,1488,0
Memphis,18,21,23,21,0,0,0,0,Dallas,25,29,34,16,0,0,0,0,20130112,83,104,7,15,26,21,21,187,21,2012,0,5,419,0
Phoenix,20,29,28,20,0,0,0,0,Chicago,21,21,21,18,0,0,0,0,20130112,97,81,-1,7,14,16,16,178,-16,2012,0,5,1450,0
Charlotte,24,21,20,23,0,0,0,0,Indiana,23,20,26,27,0,0,0,0,20130112,88,96,-1,-2,4,8,8,184,8,2012,0,5,428,0
Indiana,21,28,26,11,0,0,0,0,Brooklyn,27,19,23,28,0,0,0,0,20130113,86,97,6,-3,-6,11,11,183,11,2012,0,6,643,0
Golden State,25,29,33,18,0,0,0,0,Denver,27,25,27,37,0,0,0,0,20130113,105,116,2,-2,-8,11,11,221,11,2012,0,6,947,0
Cleveland,20,25,24,24,0,0,0,0,LA Lakers,37,20,29,27,0,0,0,0,20130113,93,113,17,12,17,20,20,206,20,2012,0,6,2044,0
New Orleans,29,12,25,21,0,0,0,0,New York,22,27,22,29,0,0,0,0,20130113,87,100,-7,8,5,13,13,187,13,2012,0,6,1168,0
Oklahoma City,22,20,26,19,0,0,0,0,Portland,19,24,16,24,0,0,0,0,20130113,87,83,3,-1,9,4,4,170,-4,2012,0,6,1484,0
Minnesota,21,29,21,17,0,0,0,0,San Antonio,24,31,23,28,0,0,0,0,20130113,88,106,3,5,7,18,18,194,18,2012,0,6,1112,0
Milwaukee,16,31,27,33,0,0,0,0,Toronto,34,15,29,18,0,0,0,0,20130113,107,96,-18,-2,-4,11,11,203,-11,2012,0,6,429,0
Orlando,22,31,24,14,0,0,0,0,Washington,28,31,37,24,0,0,0,0,20130114,91,120,6,6,19,29,29,211,29,2012,0,0,757,0
Miami,25,19,21,32,0,0,0,0,Utah,30,29,25,20,0,0,0,0,20130114,97,104,5,15,19,7,7,201,7,2012,0,0,2086,0
Cleveland,24,33,30,31,0,0,0,0,Sacramento,31,38,24,31,0,0,0,0,20130114,118,124,7,12,6,6,6,242,6,2012,0,0,2096,0
Oklahoma City,21,30,21,30,0,0,0,0,Phoenix,24,21,23,22,0,0,0,0,20130114,102,90,-3,6,4,12,12,192,-12,2012,0,0,840,0
LA Clippers,25,28,20,26,0,0,0,0,Memphis,19,15,18,21,0,0,0,0,20130114,99,73,6,19,21,26,26,172,-26,2012,0,0,1599,0
Minnesota,19,26,25,28,0,0,0,0,Dallas,26,29,36,22,0,0,0,0,20130114,98,113,7,10,21,15,15,211,15,2012,0,0,863,0
Atlanta,15,5,17,21,0,0,0,0,Chicago,26,22,23,26,0,0,0,0,20130114,58,97,11,28,34,39,39,155,39,2012,0,0,587,0
Charlotte,18,27,25,19,0,0,0,0,Boston,28,28,20,24,0,0,0,0,20130114,89,100,10,11,6,11,11,189,11,2012,0,0,720,0
Toronto,27,23,26,30,0,0,0,0,Brooklyn,27,27,29,30,0,0,0,0,20130115,106,113,0,4,7,7,7,219,7,2012,0,1,341,0
Indiana,27,23,33,20,0,0,0,0,Charlotte,20,20,17,19,0,0,0,0,20130115,103,76,7,10,26,27,27,179,-27,2012,0,1,428,0
Portland,35,22,19,23,12,0,0,0,Denver,33,21,27,18,16,0,0,0,20130115,111,115,-2,-3,5,0,4,226,4,2012,1,1,981,0
LA Clippers,28,30,32,27,0,0,0,0,Houston,29,30,18,32,0,0,0,0,20130115,117,109,-1,-1,13,8,8,226,-8,2012,0,1,1371,0
Milwaukee,27,23,23,15,0,0,0,0,LA Lakers,29,28,22,25,0,0,0,0,20130115,88,104,2,7,6,16,16,192,16,2012,0,1,1741,0
New Orleans,35,18,33,25,0,0,0,0,Philadelphia,28,19,21,31,0,0,0,0,20130115,111,99,7,6,18,12,12,210,-12,2012,0,1,1088,0
Chicago,29,23,27,21,7,0,0,0,Toronto,22,22,29,27,5,0,0,0,20130116,107,105,7,8,6,0,2,212,-2,2012,1,2,436,0
Memphis,25,29,15,13,0,0,0,0,San Antonio,19,38,25,21,0,0,0,0,20130116,82,103,-6,3,13,21,21,185,21,2012,0,2,631,0
Washington,31,25,21,17,0,0,0,0,Sacramento,32,16,24,23,0,0,0,0,20130116,94,95,1,-8,-5,1,1,189,1,2012,0,2,2371,0
Cleveland,26,27,21,19,0,0,0,0,Portland,21,15,29,23,0,0,0,0,20130116,93,88,5,17,9,5,5,181,-5,2012,0,2,2049,0
Indiana,17,18,29,22,0,0,0,0,Orlando,22,29,26,20,0,0,0,0,20130116,86,97,5,16,13,11,11,183,11,2012,0,2,822,0
Brooklyn,20,20,29,26,0,0,0,0,Atlanta,27,29,32,21,0,0,0,0,20130116,95,109,7,16,19,14,14,204,14,2012,0,2,745,0
Miami,28,24,28,12,0,0,0,0,Golden State,21,17,12,25,0,0,0,0,20130116,92,75,7,14,30,17,17,167,-17,2012,0,2,2590,0
Houston,18,26,29,27,0,0,0,0,Dallas,29,23,28,25,0,0,0,0,20130116,100,105,11,8,7,5,5,205,5,2012,0,2,225,0
New Orleans,20,24,24,22,0,0,0,0,Boston,25,18,20,15,0,0,0,0,20130116,90,78,-5,1,5,12,12,168,-12,2012,0,2,1358,0
Denver,18,29,23,27,0,0,0,0,Oklahoma City,34,33,28,22,0,0,0,0,20130116,97,117,16,20,25,20,20,214,20,2012,0,2,503,0
New York,29,27,19,27,0,0,0,0,Detroit,17,24,22,24,0,0,0,0,20130117,102,87,12,15,12,15,15,189,-15,2012,0,3,480,0
Miami,26,18,29,26,0,0,0,0,LA Lakers,22,23,20,25,0,0,0,0,20130117,99,90,4,-1,8,9,9,189,-9,2012,0,3,2335,0
LA Clippers,27,20,21,22,0,0,0,0,Minnesota,22,21,20,14,0,0,0,0,20130117,90,77,5,4,5,13,13,167,-13,2012,0,3,1521,0
Milwaukee,32,21,17,28,0,0,0,0,Phoenix,22,34,19,19,0,0,0,0,20130117,98,94,10,-3,-5,4,4,192,-4,2012,0,3,1462,0
Golden State,26,21,26,15,0,0,0,0,San Antonio,19,27,32,17,0,0,0,0,20130118,88,95,-7,-1,5,7,7,183,7,2012,0,4,1487,0
Toronto,28,32,13,23,5,0,0,0,Philadelphia,20,23,29,24,12,0,0,0,20130118,101,108,-8,-17,-1,0,7,209,7,2012,1,4,334,0
Charlotte,28,29,19,30,0,0,0,0,Orlando,28,17,26,29,0,0,0,0,20130118,106,100,0,12,5,6,6,206,-6,2012,0,4,463,0
Sacramento,14,16,17,22,0,0,0,0,Memphis,18,24,18,25,0,0,0,0,20130118,69,85,4,12,13,16,16,154,16,2012,0,4,1745,0
Atlanta,29,20,25,15,0,0,0,0,Brooklyn,29,20,25,20,0,0,0,0,20130118,89,94,0,0,0,5,5,183,5,2012,0,4,745,0
Washington,19,26,35,32,0,0,0,0,Denver,19,31,37,21,0,0,0,0,20130118,112,108,0,-5,-7,4,4,220,-4,2012,0,4,1489,0
Oklahoma City,30,23,28,24,12,0,0,0,Dallas,22,24,26,33,9,0,0,0,20130118,117,114,8,7,9,0,3,231,-3,2012,1,4,189,0
Chicago,23,22,23,20,12,0,0,0,Boston,19,20,23,26,11,0,0,0,20130118,100,99,4,6,6,0,1,199,-1,2012,1,4,849,0
Houston,18,34,17,26,0,0,0,0,Indiana,31,28,24,22,0,0,0,0,20130118,95,105,13,7,14,10,10,200,10,2012,0,4,865,0
Golden State,33,34,18,31,0,0,0,0,New Orleans,27,30,32,23,0,0,0,0,20130119,116,112,6,10,-4,4,4,228,-4,2012,0,5,1921,0
Cleveland,23,25,20,30,0,0,0,0,Utah,26,27,31,25,0,0,0,0,20130119,98,109,3,5,16,11,11,207,11,2012,0,5,1564,0
Houston,16,22,21,20,0,0,0,0,Minnesota,21,23,19,29,0,0,0,0,20130119,79,92,5,6,4,13,13,171,13,2012,0,5,1057,0
Milwaukee,30,32,22,26,0,0,0,0,Portland,19,26,31,28,0,0,0,0,20130119,110,104,11,17,8,6,6,214,-6,2012,0,5,1714,0
Memphis,18,26,16,16,9,0,0,0,Chicago,22,12,13,29,6,0,0,0,20130119,85,82,-4,10,13,0,3,167,-3,2012,1,5,480,0
Sacramento,25,26,27,19,0,0,0,0,Charlotte,20,26,30,17,0,0,0,0,20130119,97,93,5,5,2,4,4,190,-4,2012,0,5,2239,0
San Antonio,25,27,20,26,0,0,0,0,Atlanta,16,26,28,23,0,0,0,0,20130119,98,93,9,10,2,5,5,191,-5,2012,0,5,881,0
Washington,22,18,24,23,0,0,0,0,LA Clippers,24,23,26,21,0,0,0,0,20130119,87,94,2,7,9,7,7,181,7,2012,0,5,2294,0
Oklahoma City,25,25,29,30,9,0,0,0,Denver,25,26,30,28,12,0,0,0,20130120,118,121,0,1,2,0,3,239,3,2012,1,6,503,0
Boston,18,30,23,17,0,0,0,0,Detroit,27,25,29,22,0,0,0,0,20130120,88,103,9,4,10,15,15,191,15,2012,0,6,611,0
Dallas,26,31,28,26,0,0,0,0,Orlando,24,24,27,30,0,0,0,0,20130120,111,105,2,9,10,6,6,216,-6,2012,0,6,961,0
LA Lakers,20,29,21,33,0,0,0,0,Toronto,29,24,30,25,0,0,0,0,20130120,103,108,9,4,13,5,5,211,5,2012,0,6,2170,0
Washington,34,16,19,29,0,0,0,0,Portland,31,20,13,31,0,0,0,0,20130121,98,95,3,-1,5,3,3,193,-3,2012,0,0,2347,0
San Antonio,25,24,22,19,0,0,0,0,Philadelphia,17,18,29,21,0,0,0,0,20130121,90,85,8,14,7,5,5,175,-5,2012,0,0,1505,0
Brooklyn,26,21,18,23,0,0,0,0,New York,24,17,27,17,0,0,0,0,20130121,88,85,2,6,-3,3,3,173,-3,2012,0,0,0,0
Sacramento,18,21,37,29,0,0,0,0,New Orleans,30,34,23,27,0,0,0,0,20130121,105,114,12,25,11,9,9,219,9,2012,0,0,1879,0
Indiana,26,17,22,17,0,0,0,0,Memphis,27,12,24,18,0,0,0,0,20130121,82,81,-1,4,2,1,1,163,-1,2012,0,0,383,0
LA Clippers,33,19,28,19,0,0,0,0,Golden State,33,20,20,33,0,0,0,0,20130121,99,106,0,1,-7,7,7,205,7,2012,0,0,347,0
LA Lakers,20,20,29,14,0,0,0,0,Chicago,27,20,22,26,0,0,0,0,20130121,83,95,7,7,0,12,12,178,12,2012,0,0,1741,0
Houston,22,23,29,26,0,0,0,0,Charlotte,30,26,25,13,0,0,0,0,20130121,100,94,-8,-11,-7,6,6,194,-6,2012,0,0,925,0
Minnesota,31,27,19,19,0,0,0,0,Atlanta,18,26,26,34,0,0,0,0,20130121,96,104,-13,-14,-7,8,8,200,8,2012,0,0,908,0
Boston,27,26,20,17,0,0,0,0,Cleveland,31,23,16,25,0,0,0,0,20130122,90,95,4,1,-3,5,5,185,5,2012,0,1,549,0
Orlando,25,27,14,24,0,0,0,0,Detroit,26,28,28,23,0,0,0,0,20130122,90,105,1,2,16,15,15,195,15,2012,0,1,957,0
Oklahoma City,22,27,33,27,0,0,0,0,LA Clippers,22,23,23,29,0,0,0,0,20130122,109,97,0,4,14,12,12,206,-12,2012,0,1,1178,0
Philadelphia,18,29,24,31,0,0,0,0,Milwaukee,28,27,28,27,0,0,0,0,20130122,102,110,10,8,12,8,8,212,8,2012,0,1,692,0
New Orleans,35,29,15,23,0,0,0,0,San Antonio,32,28,18,28,0,0,0,0,20130123,102,106,-3,-4,-1,4,4,208,4,2012,0,2,506,0
Phoenix,30,19,25,32,0,0,0,0,Sacramento,27,30,20,19,0,0,0,0,20130123,106,96,3,-8,-3,10,10,202,-10,2012,0,2,634,0
Washington,19,19,20,30,0,0,0,0,Utah,25,27,21,19,0,0,0,0,20130123,88,92,6,14,15,4,4,180,4,2012,0,2,1841,0
Brooklyn,24,29,15,23,0,0,0,0,Minnesota,17,25,20,21,0,0,0,0,20130123,91,83,7,11,6,8,8,174,-8,2012,0,2,1016,0
Toronto,28,29,27,25,7,0,0,0,Miami,22,28,38,21,14,0,0,0,20130123,116,123,-6,-7,4,0,7,239,7,2012,1,2,1234,0
Indiana,17,15,27,21,0,0,0,0,Portland,20,24,26,30,0,0,0,0,20130123,80,100,3,12,11,20,20,180,20,2012,0,2,1880,0
Denver,27,19,36,23,0,0,0,0,Houston,21,23,22,29,0,0,0,0,20130123,105,95,6,2,16,10,10,200,-10,2012,0,2,878,0
Oklahoma City,26,31,22,20,0,0,0,0,Golden State,27,25,24,28,0,0,0,0,20130123,99,104,1,-5,-3,5,5,203,5,2012,0,2,1386,0
Detroit,23,24,21,14,0,0,0,0,Chicago,14,24,19,28,0,0,0,0,20130123,82,85,-9,-9,-11,3,3,167,3,2012,0,2,238,0
Atlanta,28,25,26,25,0,0,0,0,Charlotte,20,26,21,25,0,0,0,0,20130123,104,92,8,7,12,12,12,196,-12,2012,0,2,226,0
LA Lakers,23,27,23,20,0,0,0,0,Memphis,24,35,24,23,0,0,0,0,20130123,93,106,1,9,10,13,13,199,13,2012,0,2,1599,0
New York,20,30,22,17,0,0,0,0,Boston,24,24,18,20,0,0,0,0,20130124,89,86,-4,2,6,3,3,175,-3,2012,0,3,190,0
Toronto,22,26,27,22,0,0,0,0,Orlando,20,27,19,29,0,0,0,0,20130124,97,95,2,1,9,2,2,192,-2,2012,0,3,1048,0
LA Clippers,20,26,20,22,0,0,0,0,Phoenix,24,26,18,25,0,0,0,0,20130124,88,93,4,4,2,5,5,181,5,2012,0,3,356,0
Minnesota,25,21,27,28,0,0,0,0,Washington,29,31,31,23,0,0,0,0,20130125,101,114,4,14,18,13,13,215,13,2012,0,4,931,0
Oklahoma City,27,31,28,19,0,0,0,0,Sacramento,30,21,16,28,0,0,0,0,20130125,105,95,-3,7,19,10,10,200,-10,2012,0,4,1336,0
Detroit,31,20,17,20,0,0,0,0,Miami,30,30,24,26,0,0,0,0,20130125,88,110,-1,9,16,22,22,198,22,2012,0,4,1155,0
Brooklyn,22,22,23,10,0,0,0,0,Memphis,32,35,18,16,0,0,0,0,20130125,77,101,10,23,18,24,24,178,24,2012,0,4,953,0
Houston,27,21,32,20,0,0,0,0,New Orleans,18,22,25,17,0,0,0,0,20130125,100,82,9,8,15,18,18,182,-18,2012,0,4,317,0
San Antonio,27,26,35,25,0,0,0,0,Dallas,20,23,25,39,0,0,0,0,20130125,113,107,7,10,20,6,6,220,-6,2012,0,4,252,0
Milwaukee,21,38,31,18,0,0,0,0,Cleveland,18,32,31,32,0,0,0,0,20130125,108,113,-3,-9,-9,5,5,221,5,2012,0,4,334,0
Golden State,13,37,16,21,0,0,0,0,Chicago,31,32,21,19,0,0,0,0,20130125,87,103,18,13,18,16,16,190,16,2012,0,4,1853,0
Boston,29,28,16,25,9,4,0,0,Atlanta,10,28,31,29,9,16,0,0,20130125,111,123,-19,-19,-4,0,12,234,12,2012,2,4,935,0
Utah,19,18,26,21,0,0,0,0,LA Lakers,26,21,25,30,0,0,0,0,20130125,84,102,7,10,9,18,18,186,18,2012,0,4,579,0
Chicago,24,20,11,18,0,0,0,0,Washington,23,27,23,13,0,0,0,0,20130126,73,86,-1,6,18,13,13,159,13,2012,0,5,594,0
Indiana,24,24,20,30,12,0,0,0,Utah,27,18,31,22,16,0,0,0,20130126,110,114,3,-3,8,0,4,224,4,2012,1,5,1353,0
Cleveland,19,27,20,33,0,0,0,0,Toronto,25,25,25,23,0,0,0,0,20130126,99,98,-6,-4,-9,1,1,197,-1,2012,0,5,187,0
Phoenix,26,30,26,17,0,0,0,0,San Antonio,26,33,22,27,0,0,0,0,20130126,99,108,0,3,-1,9,9,207,9,2012,0,5,846,0
LA Clippers,22,23,31,24,0,0,0,0,Portland,25,26,31,19,0,0,0,0,20130126,100,101,3,6,6,1,1,201,1,2012,0,5,826,0
Golden State,26,29,19,28,0,0,0,0,Milwaukee,23,28,35,23,0,0,0,0,20130126,102,109,-3,-4,12,7,7,211,7,2012,0,5,1838,0
Brooklyn,29,20,31,26,0,0,0,0,Houston,28,34,27,30,0,0,0,0,20130126,106,119,-1,13,9,13,13,225,13,2012,0,5,1417,0
Sacramento,25,24,20,24,0,0,0,0,Denver,39,32,30,20,0,0,0,0,20130126,93,121,14,22,32,28,28,214,28,2012,0,5,886,0
Minnesota,34,24,19,24,0,0,0,0,Charlotte,22,25,26,29,0,0,0,0,20130126,101,102,-12,-11,-4,1,1,203,1,2012,0,5,938,0
New York,19,22,17,22,0,0,0,0,Philadelphia,24,29,31,13,0,0,0,0,20130126,80,97,5,12,26,17,17,177,17,2012,0,5,80,0
Atlanta,25,27,22,30,0,0,0,0,New York,27,25,30,24,0,0,0,0,20130127,104,106,2,0,8,2,2,210,2,2012,0,6,745,0
Detroit,29,25,24,26,0,0,0,0,Orlando,25,19,33,25,0,0,0,0,20130127,104,102,4,10,1,2,2,206,-2,2012,0,6,957,0
Oklahoma City,23,30,22,21,0,0,0,0,LA Lakers,27,25,23,30,0,0,0,0,20130127,96,105,4,-1,0,9,9,201,9,2012,0,6,1178,0
New Orleans,24,19,21,27,0,0,0,0,Memphis,23,22,23,15,0,0,0,0,20130127,91,83,1,-2,-4,8,8,174,-8,2012,0,6,358,0
Phoenix,21,21,30,23,0,0,0,0,Dallas,29,28,24,29,0,0,0,0,20130127,95,110,8,15,9,15,15,205,15,2012,0,6,884,0
Miami,26,19,23,19,6,5,0,0,Boston,22,23,19,23,6,7,0,0,20130127,98,100,-4,0,-4,0,2,198,2,2012,2,6,1257,0
Portland,27,23,12,21,0,0,0,0,LA Clippers,33,22,23,18,0,0,0,0,20130127,83,96,6,5,16,13,13,179,13,2012,0,6,826,0
Sacramento,27,26,19,24,0,0,0,0,Washington,32,25,19,18,0,0,0,0,20130128,96,94,-5,-4,-4,2,2,190,-2,2012,0,0,2371,0
Orlando,20,20,23,14,0,0,0,0,Brooklyn,30,26,14,27,0,0,0,0,20130128,77,97,10,16,7,20,20,174,20,2012,0,0,939,0
Charlotte,18,22,15,30,0,0,0,0,Chicago,21,28,14,30,0,0,0,0,20130128,85,93,3,9,8,8,8,178,8,2012,0,0,586,0
Indiana,29,24,21,27,0,0,0,0,Denver,24,31,27,20,0,0,0,0,20130128,101,102,-5,2,8,1,1,203,1,2012,0,0,998,0
Memphis,20,37,22,24,0,0,0,0,Philadelphia,33,21,25,21,0,0,0,0,20130128,103,100,-13,3,0,3,3,203,-3,2012,0,0,878,0
Golden State,25,27,32,30,0,0,0,0,Toronto,28,24,30,20,0,0,0,0,20130128,114,102,-3,0,2,12,12,216,-12,2012,0,0,2263,0
Houston,28,29,36,32,0,0,0,0,Utah,22,17,20,21,0,0,0,0,20130128,125,80,6,18,34,45,45,205,-45,2012,0,0,1199,0
Dallas,32,27,21,24,0,0,0,0,Portland,28,14,32,32,0,0,0,0,20130129,104,106,-4,-17,-6,2,2,210,2,2012,0,1,1630,0
New Orleans,24,18,31,33,0,0,0,0,LA Lakers,25,29,29,28,0,0,0,0,20130129,106,111,1,12,10,5,5,217,5,2012,0,1,1669,0
Golden State,23,32,29,24,0,0,0,0,Cleveland,23,21,24,27,0,0,0,0,20130129,108,95,0,11,16,13,13,203,-13,2012,0,1,2161,0
Milwaukee,19,33,39,26,0,0,0,0,Detroit,28,14,26,22,0,0,0,0,20130129,117,90,-9,10,23,27,27,207,-27,2012,0,1,251,0
LA Clippers,23,29,24,20,0,0,0,0,Minnesota,25,23,23,19,0,0,0,0,20130130,96,90,-2,4,5,6,6,186,-6,2012,0,2,1521,0
LA Lakers,22,19,32,13,0,0,0,0,Phoenix,26,15,22,29,0,0,0,0,20130130,86,92,4,0,-10,6,6,178,6,2012,0,2,356,0
Washington,28,11,24,21,0,0,0,0,Philadelphia,25,23,25,19,0,0,0,0,20130130,84,92,-3,9,10,8,8,176,8,2012,0,2,123,0
Orlando,31,20,22,24,0,0,0,0,New York,31,20,28,34,0,0,0,0,20130130,97,113,0,0,6,16,16,210,16,2012,0,2,939,0
Chicago,23,32,24,25,0,0,0,0,Milwaukee,19,18,31,20,0,0,0,0,20130130,104,88,4,18,11,16,16,192,-16,2012,0,2,83,0
Charlotte,23,14,23,18,0,0,0,0,San Antonio,25,24,25,28,0,0,0,0,20130130,78,102,2,12,14,24,24,180,24,2012,0,2,1103,0
Houston,29,28,29,24,0,0,0,0,Denver,29,27,27,35,0,0,0,0,20130130,110,118,0,-1,-3,8,8,228,8,2012,0,2,878,0
Miami,30,19,36,20,0,0,0,0,Brooklyn,20,29,14,22,0,0,0,0,20130130,105,85,10,0,22,20,20,190,-20,2012,0,2,1091,0
Sacramento,24,14,22,21,0,0,0,0,Boston,22,37,21,19,0,0,0,0,20130130,81,99,-2,21,20,18,18,180,18,2012,0,2,2624,0
Toronto,23,32,14,23,0,0,0,0,Atlanta,20,25,30,18,0,0,0,0,20130130,92,93,-3,-10,6,1,1,185,1,2012,0,2,733,0
Detroit,23,13,20,23,0,0,0,0,Indiana,29,25,16,28,0,0,0,0,20130130,79,98,6,18,14,19,19,177,19,2012,0,2,240,0
New Orleans,29,18,28,24,0,0,0,0,Utah,19,32,27,26,0,0,0,0,20130130,99,104,-10,4,3,5,5,203,5,2012,0,2,1432,0
Memphis,22,12,33,22,0,0,0,0,Oklahoma City,32,26,21,27,0,0,0,0,20130131,89,106,10,24,12,17,17,195,17,2012,0,3,421,0
Dallas,23,30,26,18,0,0,0,0,Golden State,28,27,25,20,0,0,0,0,20130131,97,100,5,2,1,3,3,197,3,2012,0,3,1480,0
LA Clippers,17,13,15,28,0,0,0,0,Toronto,22,24,26,26,0,0,0,0,20130201,73,98,5,16,27,25,25,171,25,2012,0,4,2170,0
Portland,19,17,25,16,0,0,0,0,Utah,26,25,22,13,0,0,0,0,20130201,77,86,7,15,12,9,9,163,9,2012,0,4,634,0
Dallas,29,25,20,35,0,0,0,0,Phoenix,31,23,21,24,0,0,0,0,20130201,109,99,-2,0,-1,10,10,208,-10,2012,0,4,884,0
Sacramento,23,16,29,12,0,0,0,0,Philadelphia,27,27,18,17,0,0,0,0,20130201,80,89,4,15,4,9,9,169,9,2012,0,4,2451,0
LA Lakers,37,31,17,26,0,0,0,0,Minnesota,24,29,23,24,0,0,0,0,20130201,111,100,13,15,9,11,11,211,-11,2012,0,4,1521,0
Milwaukee,28,25,20,13,0,0,0,0,New York,25,22,27,22,0,0,0,0,20130201,86,96,-3,-6,1,10,10,182,10,2012,0,4,732,0
Miami,23,22,20,24,0,0,0,0,Indiana,25,28,27,22,0,0,0,0,20130201,89,102,2,8,15,13,13,191,13,2012,0,4,1026,0
Cleveland,16,31,21,31,0,0,0,0,Detroit,24,30,31,32,0,0,0,0,20130201,99,117,8,7,17,18,18,216,18,2012,0,4,90,0
New Orleans,26,22,30,20,0,0,0,0,Denver,26,25,34,28,0,0,0,0,20130201,98,113,0,3,7,15,15,211,15,2012,0,4,1079,0
Chicago,14,28,25,22,0,0,0,0,Brooklyn,24,17,22,30,0,0,0,0,20130201,89,93,10,-1,-4,4,4,182,4,2012,0,4,711,0
Orlando,18,17,24,25,0,0,0,0,Boston,25,21,26,25,0,0,0,0,20130201,84,97,7,11,13,13,13,181,13,2012,0,4,1115,0
Washington,30,10,16,20,0,0,0,0,Memphis,23,16,22,24,0,0,0,0,20130201,76,85,-7,-1,5,9,9,161,9,2012,0,4,762,0
New Orleans,14,17,24,31,0,0,0,0,Minnesota,33,25,23,34,0,0,0,0,20130202,86,115,19,27,26,29,29,201,29,2012,0,5,1052,0
Utah,23,23,21,32,0,0,0,0,Portland,24,19,29,33,0,0,0,0,20130202,99,105,1,-3,5,6,6,204,6,2012,0,5,634,0
Sacramento,22,11,19,29,0,0,0,0,New York,25,31,41,23,0,0,0,0,20130202,81,120,3,23,45,39,39,201,39,2012,0,5,2499,0
Orlando,22,26,19,31,0,0,0,0,Milwaukee,31,21,27,28,0,0,0,0,20130202,98,107,9,4,12,9,9,205,9,2012,0,5,1065,0
Washington,17,9,30,30,0,0,0,0,San Antonio,27,24,17,28,0,0,0,0,20130202,86,96,10,25,12,10,10,182,10,2012,0,5,1385,0
Phoenix,29,23,22,19,0,0,0,0,Golden State,26,22,33,32,0,0,0,0,20130202,93,113,-3,-4,7,20,20,206,20,2012,0,5,652,0
Oklahoma City,25,32,21,32,0,0,0,0,Cleveland,23,29,24,39,0,0,0,0,20130202,110,115,-2,-5,-2,5,5,225,5,2012,0,5,949,0
Chicago,24,19,26,24,0,0,0,0,Atlanta,17,27,16,16,0,0,0,0,20130202,93,76,7,-1,9,17,17,169,-17,2012,0,5,587,0
Charlotte,27,24,26,18,0,0,0,0,Houston,32,30,17,30,0,0,0,0,20130202,95,109,5,11,2,14,14,204,14,2012,0,5,925,0
Miami,24,20,27,29,0,0,0,0,Toronto,21,29,17,18,0,0,0,0,20130203,100,85,3,-6,4,15,15,185,-15,2012,0,6,1234,0
LA Lakers,32,30,16,20,0,0,0,0,Detroit,27,24,21,25,0,0,0,0,20130203,98,97,5,11,6,1,1,195,-1,2012,0,6,1979,0
LA Clippers,30,10,37,27,0,0,0,0,Boston,33,26,33,14,0,0,0,0,20130203,104,106,3,19,15,2,2,210,2,2012,0,6,2590,0
Sacramento,22,21,23,18,7,0,0,0,Utah,20,24,18,22,14,0,0,0,20130204,91,98,-2,1,-4,0,7,189,7,2012,1,0,532,0
Orlando,16,19,11,15,0,0,0,0,Philadelphia,28,14,18,18,0,0,0,0,20130204,61,78,12,7,14,17,17,139,17,2012,0,0,864,0
LA Clippers,16,30,20,24,0,0,0,0,Washington,24,27,21,26,0,0,0,0,20130204,90,98,8,5,6,8,8,188,8,2012,0,0,2294,0
Dallas,22,22,23,24,0,0,0,0,Oklahoma City,29,39,24,20,0,0,0,0,20130204,91,112,7,24,25,21,21,203,21,2012,0,0,189,0
Portland,25,24,28,23,0,0,0,0,Minnesota,18,20,20,40,0,0,0,0,20130204,100,98,7,11,19,2,2,198,-2,2012,0,0,1423,0
Charlotte,21,22,20,31,0,0,0,0,Miami,22,25,19,33,0,0,0,0,20130204,94,99,1,4,3,5,5,193,5,2012,0,0,654,0
Detroit,13,23,22,27,0,0,0,0,New York,28,29,19,23,0,0,0,0,20130204,85,99,15,21,18,14,14,184,14,2012,0,0,480,0
Chicago,29,25,22,25,0,0,0,0,Indiana,28,32,27,24,0,0,0,0,20130204,101,111,-1,6,11,10,10,212,10,2012,0,0,163,0
LA Lakers,18,31,18,25,0,0,0,0,Brooklyn,24,16,24,19,0,0,0,0,20130205,92,83,-6,9,3,9,9,175,-9,2012,0,1,2445,0
Milwaukee,29,37,20,18,0,0,0,0,Denver,27,24,28,33,0,0,0,0,20130205,104,112,-2,-15,-7,8,8,216,8,2012,0,1,912,0
Golden State,37,25,24,23,0,0,0,0,Houston,38,39,27,36,0,0,0,0,20130205,109,140,1,15,18,31,31,249,31,2012,0,1,1642,0
Atlanta,21,28,21,33,0,0,0,0,Indiana,18,32,31,33,0,0,0,0,20130205,103,114,-3,1,11,11,11,217,11,2012,0,1,427,0
Phoenix,27,23,15,31,0,0,0,0,Memphis,27,25,19,19,0,0,0,0,20130205,96,90,0,-2,-6,6,6,186,-6,2012,0,1,1260,0
Brooklyn,23,17,29,24,0,0,0,0,Detroit,24,22,27,17,0,0,0,0,20130206,93,90,-1,-6,-4,3,3,183,-3,2012,0,2,480,0
Milwaukee,25,18,19,24,0,0,0,0,Utah,19,32,26,23,0,0,0,0,20130206,86,100,-6,8,15,14,14,186,14,2012,0,2,1239,0
Boston,20,30,19,30,0,0,0,0,Toronto,23,22,34,16,0,0,0,0,20130206,99,95,-3,5,-10,4,4,194,-4,2012,0,2,430,0
Indiana,18,19,22,29,0,0,0,0,Philadelphia,15,19,14,21,0,0,0,0,20130206,88,69,3,3,11,19,19,157,-19,2012,0,2,582,0
LA Clippers,17,23,24,22,0,0,0,0,Orlando,17,25,13,21,0,0,0,0,20130206,86,76,0,-2,9,10,10,162,-10,2012,0,2,2197,0
Golden State,22,27,30,19,0,0,0,0,Oklahoma City,34,33,23,29,0,0,0,0,20130206,98,119,12,18,11,21,21,217,21,2012,0,2,1386,0
Portland,33,28,21,17,0,0,0,0,Dallas,27,30,23,25,0,0,0,0,20130206,99,105,-6,-4,-2,6,6,204,6,2012,0,2,1630,0
San Antonio,21,26,21,36,0,0,0,0,Minnesota,23,18,23,30,0,0,0,0,20130206,104,94,-2,6,4,10,10,198,-10,2012,0,2,1112,0
Houston,30,26,27,25,0,0,0,0,Miami,32,31,26,25,0,0,0,0,20130206,108,114,2,7,6,6,6,222,6,2012,0,2,966,0
New York,29,19,25,23,0,0,0,0,Washington,28,23,19,36,0,0,0,0,20130206,96,106,-1,3,-3,10,10,202,10,2012,0,2,204,0
Charlotte,21,20,26,28,0,0,0,0,Cleveland,32,33,35,22,0,0,0,0,20130206,95,122,11,24,33,27,27,217,27,2012,0,2,435,0
Memphis,22,26,14,30,0,0,0,0,Atlanta,26,32,22,23,0,0,0,0,20130206,92,103,4,10,18,11,11,195,11,2012,0,2,336,0
Phoenix,27,26,18,13,0,0,0,0,New Orleans,26,28,24,15,0,0,0,0,20130206,84,93,-1,1,7,9,9,177,9,2012,0,2,1312,0
Chicago,25,33,16,22,0,0,0,0,Denver,33,30,37,28,0,0,0,0,20130207,96,128,8,5,26,32,32,224,32,2012,0,3,916,0
LA Lakers,23,21,25,26,0,0,0,0,Boston,27,31,37,21,0,0,0,0,20130207,95,116,4,14,26,21,21,211,21,2012,0,3,2590,0
New Orleans,25,25,29,32,0,0,0,0,Atlanta,26,29,16,29,0,0,0,0,20130208,111,100,-1,-5,8,11,11,211,-11,2012,0,4,424,0
Brooklyn,20,11,22,21,0,0,0,0,Washington,21,30,14,24,0,0,0,0,20130208,74,89,1,20,12,15,15,163,15,2012,0,4,204,0
Phoenix,27,23,20,26,0,0,0,0,Oklahoma City,33,22,36,36,0,0,0,0,20130208,96,127,6,5,21,31,31,223,31,2012,0,4,840,0
New York,25,27,18,30,0,0,0,0,Minnesota,23,22,31,18,0,0,0,0,20130208,100,94,2,7,-6,6,6,194,-6,2012,0,4,1016,0
LA Clippers,29,21,18,21,0,0,0,0,Miami,30,32,31,18,0,0,0,0,20130208,89,111,1,12,25,22,22,200,22,2012,0,4,2335,0
Golden State,24,32,20,17,0,0,0,0,Memphis,32,31,14,22,0,0,0,0,20130208,93,99,8,7,1,6,6,192,6,2012,0,4,1798,0
Chicago,31,27,11,24,0,0,0,0,Utah,27,23,19,20,0,0,0,0,20130208,93,89,4,8,0,4,4,182,-4,2012,0,4,1256,0
Portland,28,25,27,23,0,0,0,0,Houston,34,28,33,23,0,0,0,0,20130208,103,118,6,9,15,15,15,221,15,2012,0,4,1833,0
San Antonio,23,29,26,31,0,0,0,0,Detroit,31,34,30,24,0,0,0,0,20130208,109,119,8,13,17,10,10,228,10,2012,0,4,1238,0
Orlando,24,32,24,28,0,0,0,0,Cleveland,24,32,29,34,0,0,0,0,20130208,108,119,0,0,5,11,11,227,11,2012,0,4,895,0
LA Lakers,20,21,28,31,0,0,0,0,Charlotte,30,23,25,15,0,0,0,0,20130208,100,93,-10,-12,-9,7,7,193,-7,2012,0,4,2115,0
Toronto,25,19,20,26,10,0,0,0,Indiana,26,25,21,18,8,0,0,0,20130208,100,98,-1,-7,-8,0,2,198,-2,2012,1,4,438,0
Denver,30,28,26,27,0,0,0,0,Cleveland,32,20,21,30,0,0,0,0,20130209,111,103,-2,6,11,8,8,214,-8,2012,0,5,1223,0
Golden State,16,20,30,25,0,0,0,0,Dallas,30,32,23,31,0,0,0,0,20130209,91,116,14,26,19,25,25,207,25,2012,0,5,1480,0
Detroit,33,24,24,24,0,0,0,0,Milwaukee,22,34,26,18,0,0,0,0,20130209,105,100,11,1,-1,5,5,205,-5,2012,0,5,251,0
Charlotte,17,20,17,22,0,0,0,0,Philadelphia,23,15,25,24,0,0,0,0,20130209,76,87,6,1,9,11,11,163,11,2012,0,5,450,0
Utah,29,25,20,35,0,0,0,0,Sacramento,31,31,25,33,0,0,0,0,20130209,109,120,2,8,13,11,11,229,11,2012,0,5,532,0
Portland,26,23,23,32,0,0,0,0,Orlando,22,33,24,31,0,0,0,0,20130210,104,110,-4,6,7,6,6,214,6,2012,0,6,2525,0
New Orleans,21,26,19,23,0,0,0,0,Toronto,32,18,19,33,0,0,0,0,20130210,89,102,11,3,3,13,13,191,13,2012,0,6,1112,0
Oklahoma City,27,24,23,23,0,0,0,0,Phoenix,16,18,14,21,0,0,0,0,20130210,97,69,11,17,26,28,28,166,-28,2012,0,6,840,0
LA Clippers,22,30,19,31,0,0,0,0,New York,17,27,26,18,0,0,0,0,20130210,102,88,5,8,1,14,14,190,-14,2012,0,6,2445,0
Houston,25,28,33,25,0,0,0,0,Sacramento,28,29,27,33,0,0,0,0,20130210,111,117,3,4,-2,6,6,228,6,2012,0,6,1606,0
Minnesota,20,17,19,32,0,0,0,0,Memphis,21,26,29,29,0,0,0,0,20130210,88,105,1,10,20,17,17,193,17,2012,0,6,700,0
San Antonio,25,26,30,30,0,0,0,0,Brooklyn,35,22,14,15,0,0,0,0,20130210,111,86,-10,-6,10,25,25,197,-25,2012,0,6,1581,0
Denver,19,27,24,22,7,8,7,0,Boston,29,21,28,14,7,8,11,0,20130210,114,118,10,4,8,0,4,232,4,2012,3,6,1765,0
LA Lakers,26,27,20,24,0,0,0,0,Miami,25,28,25,29,0,0,0,0,20130210,97,107,-1,0,5,10,10,204,10,2012,0,6,2335,0
LA Clippers,30,26,32,19,0,0,0,0,Philadelphia,22,11,26,31,0,0,0,0,20130211,107,90,8,23,29,17,17,197,-17,2012,0,0,2388,0
Brooklyn,20,15,23,18,13,0,0,0,Indiana,13,27,14,22,8,0,0,0,20130211,89,84,7,-5,4,0,5,173,-5,2012,1,0,643,0
Washington,29,26,19,28,0,0,0,0,Milwaukee,32,15,24,19,0,0,0,0,20130211,102,90,-3,8,3,12,12,192,-12,2012,0,0,634,0
New Orleans,27,28,22,28,0,0,0,0,Detroit,23,18,20,25,0,0,0,0,20130211,105,86,4,14,16,19,19,191,-19,2012,0,0,939,0
Boston,26,22,24,19,0,0,0,0,Charlotte,24,18,33,19,0,0,0,0,20130211,91,94,-2,-6,3,3,3,185,3,2012,0,0,720,0
Minnesota,25,24,23,28,0,0,0,0,Cleveland,27,19,19,27,0,0,0,0,20130211,100,92,-2,3,7,8,8,192,-8,2012,0,0,629,0
San Antonio,20,31,25,27,0,0,0,0,Chicago,24,18,29,18,0,0,0,0,20130211,103,89,-4,9,5,14,14,192,-14,2012,0,0,1050,0
Atlanta,31,18,33,23,0,0,0,0,Dallas,23,25,33,20,0,0,0,0,20130211,105,101,8,1,1,4,4,206,-4,2012,0,0,719,0
Houston,30,27,31,28,0,0,0,0,Golden State,34,22,23,28,0,0,0,0,20130212,116,107,-4,1,9,9,9,223,-9,2012,0,1,1642,0
Phoenix,22,25,24,14,0,0,0,0,LA Lakers,30,26,9,26,0,0,0,0,20130212,85,91,8,9,-6,6,6,176,6,2012,0,1,356,0
Sacramento,25,30,18,28,0,0,0,0,Memphis,26,32,26,24,0,0,0,0,20130212,101,108,1,3,11,7,7,209,7,2012,0,1,1745,0
Portland,33,26,23,22,0,0,0,0,Miami,29,29,28,31,0,0,0,0,20130212,104,117,-4,-1,4,13,13,221,13,2012,0,1,2704,0
Denver,21,31,26,30,0,0,0,0,Toronto,28,26,28,27,0,0,0,0,20130212,108,109,7,2,4,1,1,217,1,2012,0,1,1341,0
Oklahoma City,26,26,27,15,0,0,0,0,Utah,28,30,28,23,0,0,0,0,20130212,94,109,2,6,7,15,15,203,15,2012,0,1,861,0
Atlanta,25,32,33,18,0,0,0,0,Orlando,19,17,20,20,0,0,0,0,20130213,108,76,6,21,34,32,32,184,-32,2012,0,2,401,0
Toronto,14,23,28,27,0,0,0,0,New York,18,24,18,28,0,0,0,0,20130213,92,88,-4,-5,5,4,4,180,-4,2012,0,2,341,0
Portland,14,12,18,19,0,0,0,0,New Orleans,19,19,29,32,0,0,0,0,20130213,63,99,5,12,23,36,36,162,36,2012,0,2,2059,0
Utah,10,32,26,29,0,0,0,0,Minnesota,17,23,23,30,0,0,0,0,20130213,97,93,-7,2,5,4,4,190,-4,2012,0,2,984,0
Philadelphia,28,22,25,17,0,0,0,0,Milwaukee,18,25,29,22,0,0,0,0,20130213,92,94,-10,-7,-3,2,2,186,2,2012,0,2,692,0
Houston,28,21,23,24,0,0,0,0,LA Clippers,46,23,19,18,0,0,0,0,20130213,96,106,18,20,16,10,10,202,10,2012,0,2,1371,0
Washington,19,26,23,17,0,0,0,0,Detroit,21,23,21,31,0,0,0,0,20130213,85,96,2,-1,-3,11,11,181,11,2012,0,2,394,0
Sacramento,27,17,33,23,0,0,0,0,Dallas,30,29,33,31,0,0,0,0,20130213,100,123,3,15,15,23,23,223,23,2012,0,2,1437,0
San Antonio,21,25,28,22,0,0,0,0,Cleveland,22,32,19,22,0,0,0,0,20130213,96,95,-1,-8,1,1,1,191,-1,2012,0,2,1256,0
Denver,26,31,24,27,0,0,0,0,Brooklyn,23,39,33,24,0,0,0,0,20130213,108,119,-3,5,14,11,11,227,11,2012,0,2,1627,0
Chicago,15,21,13,20,0,0,0,0,Boston,24,11,8,28,0,0,0,0,20130213,69,71,9,-1,-6,2,2,140,2,2012,0,2,849,0
Charlotte,29,17,14,17,0,0,0,0,Indiana,30,19,21,31,0,0,0,0,20130213,77,101,1,3,10,24,24,178,24,2012,0,2,428,0
LA Clippers,31,33,37,24,0,0,0,0,LA Lakers,17,35,28,21,0,0,0,0,20130214,125,101,14,12,21,24,24,226,-24,2012,0,3,0,0
Miami,32,31,25,22,0,0,0,0,Oklahoma City,17,29,23,31,0,0,0,0,20130214,110,100,15,17,19,10,10,210,-10,2012,0,3,1225,0
Toronto,27,28,18,23,0,0,0,0,Washington,19,27,19,23,0,0,0,0,20130219,96,88,8,9,8,8,8,184,-8,2012,0,1,349,0
Golden State,19,34,26,22,0,0,0,0,Utah,26,32,29,28,0,0,0,0,20130219,101,115,7,5,8,14,14,216,14,2012,0,1,599,0
San Antonio,28,22,33,25,0,0,0,0,Sacramento,19,22,33,28,0,0,0,0,20130219,108,102,9,9,9,6,6,210,-6,2012,0,1,1456,0
Phoenix,36,27,21,18,0,0,0,0,Portland,23,24,26,25,0,0,0,0,20130219,102,98,13,16,11,4,4,200,-4,2012,0,1,1005,0
Memphis,22,31,31,21,0,0,0,0,Detroit,30,12,18,31,0,0,0,0,20130219,105,91,-8,11,24,14,14,196,-14,2012,0,1,622,0
Chicago,26,21,27,22,0,0,0,0,New Orleans,21,22,25,19,0,0,0,0,20130219,96,87,5,4,6,9,9,183,-9,2012,0,1,832,0
Boston,22,28,20,20,0,0,0,0,Denver,21,28,29,19,0,0,0,0,20130219,90,97,-1,-1,8,7,7,187,7,2012,0,1,1765,0
Milwaukee,24,27,30,24,6,0,0,0,Brooklyn,31,30,19,25,8,0,0,0,20130219,111,113,7,10,-1,0,2,224,2,2012,1,1,732,0
Charlotte,37,26,17,25,0,0,0,0,Orlando,27,16,27,22,0,0,0,0,20130219,105,92,10,20,10,13,13,197,-13,2012,0,1,463,0
Memphis,19,24,23,22,0,0,0,0,Toronto,14,18,25,25,0,0,0,0,20130220,88,82,5,11,9,6,6,170,-6,2012,0,2,815,0
Philadelphia,25,16,26,20,0,0,0,0,Minnesota,35,21,20,18,0,0,0,0,20130220,87,94,10,15,9,7,7,181,7,2012,0,2,983,0
Brooklyn,21,21,26,29,0,0,0,0,Milwaukee,29,25,22,18,0,0,0,0,20130220,97,94,-8,-12,-8,3,3,191,-3,2012,0,2,732,0
New York,18,26,22,25,0,0,0,0,Indiana,30,44,28,23,0,0,0,0,20130220,91,125,12,30,36,34,34,216,34,2012,0,2,643,0
Oklahoma City,29,33,30,27,0,0,0,0,Houston,36,21,30,35,0,0,0,0,20130220,119,122,7,-5,-5,3,3,241,3,2012,0,2,413,0
Boston,27,28,21,23,0,0,0,0,LA Lakers,36,28,26,23,0,0,0,0,20130220,99,113,9,9,14,14,14,212,14,2012,0,2,2590,0
Orlando,30,23,29,14,0,0,0,0,Dallas,42,17,24,28,0,0,0,0,20130220,96,111,12,6,1,15,15,207,15,2012,0,2,961,0
New Orleans,20,21,28,31,0,0,0,0,Cleveland,20,23,25,37,0,0,0,0,20130220,100,105,0,2,-1,5,5,205,5,2012,0,2,924,0
Detroit,28,27,22,28,0,0,0,0,Charlotte,25,31,20,23,0,0,0,0,20130220,105,99,3,-1,1,6,6,204,-6,2012,0,2,504,0
Miami,24,21,18,40,0,0,0,0,Atlanta,17,32,24,17,0,0,0,0,20130220,103,90,7,-4,-10,13,13,193,-13,2012,0,2,605,0
Phoenix,26,23,27,22,0,0,0,0,Golden State,33,24,28,23,0,0,0,0,20130220,98,108,7,8,9,10,10,206,10,2012,0,2,652,0
Miami,22,23,20,21,0,0,0,0,Chicago,22,13,19,13,0,0,0,0,20130221,86,67,0,10,11,19,19,153,-19,2012,0,3,1189,0
San Antonio,34,24,34,24,0,0,0,0,LA Clippers,21,22,21,26,0,0,0,0,20130221,116,90,13,15,28,26,26,206,-26,2012,0,3,1201,0
Denver,28,36,14,35,0,0,0,0,Washington,33,31,30,25,0,0,0,0,20130222,113,119,5,0,16,6,6,232,6,2012,0,4,1489,0
New York,32,19,19,28,0,0,0,0,Toronto,32,16,31,21,0,0,0,0,20130222,98,100,0,-3,9,2,2,198,2,2012,0,4,341,0
Boston,28,25,28,32,0,0,0,0,Phoenix,20,21,26,21,0,0,0,0,20130222,113,88,8,12,14,25,25,201,-25,2012,0,4,2295,0
Minnesota,23,35,25,28,0,0,0,0,Oklahoma City,33,33,34,27,0,0,0,0,20130222,111,127,10,8,17,16,16,238,16,2012,0,4,694,0
Dallas,35,18,30,21,0,0,0,0,New Orleans,29,29,21,21,0,0,0,0,20130222,104,100,6,-5,4,4,4,204,-4,2012,0,4,442,0
Orlando,21,17,15,29,0,0,0,0,Memphis,22,21,24,21,0,0,0,0,20130222,82,88,1,5,14,6,6,170,6,2012,0,4,683,0
Detroit,17,19,16,30,0,0,0,0,Indiana,34,26,30,24,0,0,0,0,20130222,82,114,17,24,38,32,32,196,32,2012,0,4,240,0
San Antonio,25,14,29,25,8,0,0,0,Golden State,25,13,29,26,14,0,0,0,20130222,101,107,0,-1,-1,0,6,208,6,2012,1,4,1487,0
Sacramento,33,30,25,20,0,0,0,0,Atlanta,25,36,32,29,0,0,0,0,20130222,108,122,-8,-2,5,14,14,230,14,2012,0,4,2082,0
Portland,28,27,27,25,0,0,0,0,LA Lakers,30,23,27,31,0,0,0,0,20130222,107,111,2,-2,-2,4,4,218,4,2012,0,4,826,0
Chicago,24,27,27,27,0,0,0,0,Charlotte,15,22,20,18,0,0,0,0,20130222,105,75,9,14,21,30,30,180,-30,2012,0,4,586,0
Houston,34,27,23,22,0,0,0,0,Brooklyn,31,22,22,21,0,0,0,0,20130222,106,96,3,8,9,10,10,202,-10,2012,0,4,1417,0
Houston,32,25,26,20,0,0,0,0,Washington,22,24,31,28,0,0,0,0,20130223,103,105,-10,-11,-6,2,2,208,2,2012,0,5,1217,0
Cleveland,26,25,28,39,0,0,0,0,Orlando,25,26,21,22,0,0,0,0,20130223,118,94,1,0,7,24,24,212,-24,2012,0,5,895,0
Atlanta,19,35,22,27,0,0,0,0,Milwaukee,27,26,27,22,0,0,0,0,20130223,103,102,-8,1,-4,1,1,205,-1,2012,0,5,669,0
Miami,27,29,31,27,0,0,0,0,Philadelphia,24,23,24,19,0,0,0,0,20130223,114,90,3,9,16,24,24,204,-24,2012,0,5,1021,0
Indiana,16,23,24,27,0,0,0,0,Detroit,9,19,20,24,0,0,0,0,20130223,90,72,7,11,15,18,18,162,-18,2012,0,5,240,0
Denver,31,29,23,30,0,0,0,0,Charlotte,29,25,20,25,0,0,0,0,20130223,113,99,2,6,9,14,14,212,-14,2012,0,5,1355,0
Utah,23,26,20,25,0,0,0,0,LA Clippers,25,26,36,20,0,0,0,0,20130223,94,107,2,2,18,13,13,201,13,2012,0,5,579,0
Boston,21,21,25,19,0,0,0,0,Portland,27,22,22,21,0,0,0,0,20130224,86,92,6,7,4,6,6,178,6,2012,0,6,2532,0
LA Lakers,27,27,25,24,0,0,0,0,Dallas,30,24,21,24,0,0,0,0,20130224,103,99,-3,0,4,4,4,202,-4,2012,0,6,1237,0
Cleveland,20,26,36,23,0,0,0,0,Miami,33,31,17,28,0,0,0,0,20130224,105,109,13,18,-1,4,4,214,4,2012,0,6,1089,0
Golden State,18,34,24,24,0,0,0,0,Minnesota,32,23,26,18,0,0,0,0,20130224,100,99,-14,-3,-5,1,1,199,-1,2012,0,6,1581,0
Sacramento,27,20,26,22,0,0,0,0,New Orleans,30,23,26,31,0,0,0,0,20130224,95,110,3,6,6,15,15,205,15,2012,0,6,1879,0
Philadelphia,22,18,27,26,0,0,0,0,New York,24,28,24,23,0,0,0,0,20130224,93,99,2,12,9,6,6,192,6,2012,0,6,80,0
Chicago,16,20,18,18,0,0,0,0,Oklahoma City,24,25,31,22,0,0,0,0,20130224,72,102,8,13,26,30,30,174,30,2012,0,6,690,0
San Antonio,19,35,24,19,0,0,0,0,Phoenix,21,19,21,26,0,0,0,0,20130224,97,87,-2,14,17,10,10,184,-10,2012,0,6,846,0
Memphis,16,27,12,21,0,0,0,0,Brooklyn,19,19,13,21,0,0,0,0,20130224,76,72,-3,5,4,4,4,148,-4,2012,0,6,953,0
Boston,28,20,32,17,13,0,0,0,Utah,26,27,19,25,10,0,0,0,20130225,110,107,2,-5,8,0,3,217,-3,2012,1,0,2093,0
Washington,17,23,23,27,0,0,0,0,Toronto,16,16,22,30,0,0,0,0,20130225,90,84,1,8,9,6,6,174,-6,2012,0,0,349,0
LA Lakers,29,25,29,25,0,0,0,0,Denver,35,32,28,24,0,0,0,0,20130225,108,119,6,13,12,11,11,227,11,2012,0,0,830,0
Atlanta,27,34,27,26,0,0,0,0,Detroit,24,27,19,33,0,0,0,0,20130225,114,103,3,10,18,11,11,217,-11,2012,0,0,597,0
Cleveland,19,29,27,26,0,0,0,0,Chicago,22,26,23,27,0,0,0,0,20130226,101,98,-3,0,4,3,3,199,-3,2012,0,1,308,0
Milwaukee,17,27,22,29,0,0,0,0,Dallas,21,28,21,20,0,0,0,0,20130226,95,90,-4,-5,-4,5,5,185,-5,2012,0,1,857,0
Golden State,25,28,20,24,0,0,0,0,Indiana,31,23,31,23,0,0,0,0,20130226,97,108,6,1,12,11,11,205,11,2012,0,1,1944,0
Charlotte,30,15,18,21,0,0,0,0,LA Clippers,24,30,28,24,0,0,0,0,20130226,84,106,-6,9,19,22,22,190,22,2012,0,1,2115,0
Sacramento,22,31,32,27,12,5,0,0,Miami,27,24,33,28,12,17,0,0,20130226,129,141,5,-2,-1,0,12,270,12,2012,2,1,2547,0
Brooklyn,31,26,16,28,0,0,0,0,New Orleans,20,21,24,32,0,0,0,0,20130226,101,97,11,16,8,4,4,198,-4,2012,0,1,1168,0
Orlando,18,29,21,30,0,0,0,0,Philadelphia,20,22,19,23,0,0,0,0,20130226,98,84,-2,5,7,14,14,182,-14,2012,0,1,864,0
Minnesota,15,18,18,26,6,0,0,0,Phoenix,16,31,11,19,7,0,0,0,20130226,83,84,1,14,7,0,1,167,1,2012,1,1,1278,0
Detroit,28,23,31,14,0,0,0,0,Washington,24,31,13,27,0,0,0,0,20130227,96,95,4,-4,14,1,1,191,-1,2012,0,2,394,0
Atlanta,30,26,26,20,0,0,0,0,Utah,25,23,18,25,0,0,0,0,20130227,102,91,5,8,16,11,11,193,-11,2012,0,2,1580,0
Phoenix,25,20,22,33,5,0,0,0,San Antonio,27,25,25,23,1,0,0,0,20130227,105,101,-2,-7,-10,0,4,206,-4,2012,1,2,846,0
Denver,31,27,21,32,0,0,0,0,Portland,25,25,32,27,0,0,0,0,20130227,111,109,6,8,-3,2,2,220,-2,2012,0,2,981,0
Sacramento,36,31,31,27,0,0,0,0,Orlando,22,22,24,33,0,0,0,0,20130227,125,101,14,23,30,24,24,226,-24,2012,0,2,2390,0
Milwaukee,33,22,26,29,0,0,0,0,Houston,36,19,25,27,0,0,0,0,20130227,110,107,-3,0,1,3,3,217,-3,2012,0,2,1005,0
Golden State,18,37,26,24,0,0,0,0,New York,27,31,26,25,0,0,0,0,20130227,105,109,9,3,3,4,4,214,4,2012,0,2,2565,0
Dallas,38,17,5,24,0,0,0,0,Memphis,19,23,24,24,0,0,0,0,20130227,84,90,-19,-13,6,6,6,174,6,2012,0,2,419,0
Toronto,25,23,23,21,0,0,0,0,Cleveland,20,37,23,23,0,0,0,0,20130227,92,103,-5,9,9,11,11,195,11,2012,0,2,187,0
New Orleans,21,24,15,14,0,0,0,0,Oklahoma City,30,32,34,23,0,0,0,0,20130227,74,119,9,17,36,45,45,193,45,2012,0,2,576,0
Minnesota,22,25,28,19,0,0,0,0,LA Lakers,28,29,34,25,0,0,0,0,20130228,94,116,6,10,16,22,22,210,22,2012,0,3,1521,0
Philadelphia,22,17,23,20,0,0,0,0,Chicago,23,22,23,25,0,0,0,0,20130228,82,93,1,6,6,11,11,175,11,2012,0,3,664,0
LA Clippers,26,23,27,23,0,0,0,0,Indiana,25,22,22,22,0,0,0,0,20130228,99,91,1,2,7,8,8,190,-8,2012,0,3,1805,0
Indiana,17,22,25,29,0,0,0,0,Toronto,13,21,17,30,0,0,0,0,20130301,93,81,4,5,13,12,12,174,-12,2012,0,4,438,0
Sacramento,21,28,20,33,0,0,0,0,San Antonio,34,29,34,33,0,0,0,0,20130301,102,130,13,14,28,28,28,232,28,2012,0,4,1456,0
New York,26,28,19,23,0,0,0,0,Washington,23,25,29,11,0,0,0,0,20130301,96,88,3,6,-4,8,8,184,-8,2012,0,4,204,0
Charlotte,9,15,24,20,0,0,0,0,Utah,21,26,21,30,0,0,0,0,20130301,68,98,12,23,20,30,30,166,30,2012,0,4,1723,0
Atlanta,19,20,22,26,0,0,0,0,Phoenix,21,23,28,20,0,0,0,0,20130301,87,92,2,5,11,5,5,179,5,2012,0,4,1588,0
Houston,31,33,22,32,0,0,0,0,Orlando,32,29,26,23,0,0,0,0,20130301,118,110,-1,3,-1,8,8,228,-8,2012,0,4,847,0
Detroit,27,22,20,26,0,0,0,0,New Orleans,23,24,27,26,0,0,0,0,20130301,95,100,-4,-2,5,5,5,195,5,2012,0,4,939,0
Memphis,20,21,25,25,0,0,0,0,Miami,16,26,25,31,0,0,0,0,20130301,91,98,-4,1,1,7,7,189,7,2012,0,4,873,0
Oklahoma City,29,18,28,28,0,0,0,0,Denver,26,30,29,20,0,0,0,0,20130301,103,105,-3,9,10,2,2,208,2,2012,0,4,503,0
LA Clippers,31,23,23,28,0,0,0,0,Cleveland,23,22,23,21,0,0,0,0,20130301,105,89,8,9,9,16,16,194,-16,2012,0,4,2044,0
Dallas,22,26,29,21,0,0,0,0,Brooklyn,21,28,14,27,0,0,0,0,20130301,98,90,1,-1,14,8,8,188,-8,2012,0,4,1370,0
Golden State,20,26,16,24,0,0,0,0,Boston,31,19,19,25,0,0,0,0,20130301,86,94,11,4,7,8,8,180,8,2012,0,4,2692,0
Brooklyn,27,12,20,26,0,0,0,0,Chicago,27,26,24,19,0,0,0,0,20130302,85,96,0,14,18,11,11,181,11,2012,0,5,711,0
Toronto,32,23,19,30,10,0,0,0,Milwaukee,23,31,28,22,18,0,0,0,20130302,114,122,-9,-1,8,0,8,236,8,2012,1,5,429,0
Golden State,31,23,27,16,0,0,0,0,Philadelphia,20,31,31,22,0,0,0,0,20130302,97,104,-11,-3,1,7,7,201,7,2012,0,5,2516,0
Minnesota,19,25,27,23,0,0,0,0,Portland,31,20,32,26,0,0,0,0,20130302,94,109,12,7,12,15,15,203,15,2012,0,5,1423,0
Philadelphia,22,27,19,19,0,0,0,0,Washington,26,24,22,18,0,0,0,0,20130303,87,90,4,1,4,3,3,177,3,2012,0,6,123,0
Detroit,19,21,16,19,0,0,0,0,San Antonio,32,28,29,25,0,0,0,0,20130303,75,114,13,20,33,39,39,189,39,2012,0,6,1238,0
Charlotte,27,13,19,24,0,0,0,0,Sacramento,27,27,43,22,0,0,0,0,20130303,83,119,0,14,38,36,36,202,36,2012,0,6,2239,0
Memphis,29,31,22,26,0,0,0,0,Orlando,19,16,22,25,0,0,0,0,20130303,108,82,10,25,25,26,26,190,-26,2012,0,6,683,0
Dallas,33,28,17,25,0,0,0,0,Houston,31,33,44,28,0,0,0,0,20130303,103,136,-2,3,30,33,33,239,33,2012,0,6,225,0
Atlanta,26,19,28,25,0,0,0,0,LA Lakers,30,22,27,20,0,0,0,0,20130303,98,99,4,7,6,1,1,197,1,2012,0,6,1932,0
Oklahoma City,27,27,28,26,0,0,0,0,LA Clippers,20,21,32,31,0,0,0,0,20130303,108,104,7,13,9,4,4,212,-4,2012,0,6,1178,0
Chicago,21,19,26,26,0,0,0,0,Indiana,32,15,22,28,0,0,0,0,20130303,92,97,11,7,3,5,5,189,5,2012,0,6,163,0
Miami,23,22,28,26,0,0,0,0,New York,22,37,18,16,0,0,0,0,20130303,99,93,1,-14,-4,6,6,192,-6,2012,0,6,1091,0
Miami,22,28,19,28,0,0,0,0,Minnesota,16,27,20,18,0,0,0,0,20130304,97,81,6,7,6,16,16,178,-16,2012,0,0,1513,0
Orlando,20,16,34,35,0,0,0,0,New Orleans,23,23,30,26,0,0,0,0,20130304,105,102,-3,-10,-6,3,3,207,-3,2012,0,0,533,0
Utah,24,24,17,34,9,0,0,0,Milwaukee,20,25,30,24,10,0,0,0,20130304,108,109,-4,-3,10,0,1,217,1,2012,1,0,1239,0
Charlotte,25,30,24,26,0,0,0,0,Portland,31,37,23,31,0,0,0,0,20130304,105,122,6,13,12,17,17,227,17,2012,0,0,2284,0
Atlanta,27,23,23,15,0,0,0,0,Denver,28,30,23,23,0,0,0,0,20130304,88,104,1,8,8,16,16,192,16,2012,0,0,1209,0
New York,24,25,21,32,0,0,0,0,Cleveland,34,27,13,23,0,0,0,0,20130304,102,97,-10,-12,-4,5,5,199,-5,2012,0,0,403,0
Toronto,28,26,36,28,0,0,0,0,Golden State,31,31,21,42,0,0,0,0,20130304,118,125,3,8,-7,7,7,243,7,2012,0,0,2263,0
LA Lakers,28,27,34,16,0,0,0,0,Oklahoma City,37,34,26,25,0,0,0,0,20130305,105,122,9,16,8,17,17,227,17,2012,0,1,1178,0
Boston,26,27,26,30,0,0,0,0,Philadelphia,23,23,28,27,0,0,0,0,20130305,109,101,3,7,5,8,8,210,-8,2012,0,1,270,0
Denver,24,26,36,34,0,0,0,0,Sacramento,22,28,29,34,0,0,0,0,20130305,120,113,2,0,7,7,7,233,-7,2012,0,1,886,0
Chicago,23,29,16,15,0,0,0,0,San Antonio,22,25,25,29,0,0,0,0,20130306,83,101,-1,-5,4,18,18,184,18,2012,0,2,1050,0
Toronto,28,26,18,26,0,0,0,0,Phoenix,24,16,15,16,0,0,0,0,20130306,98,71,4,14,17,27,27,169,-27,2012,0,2,1885,0
LA Lakers,28,20,27,33,0,0,0,0,New Orleans,28,39,26,9,0,0,0,0,20130306,108,102,0,-19,-18,6,6,210,-6,2012,0,2,1669,0
Washington,29,14,20,19,0,0,0,0,Minnesota,24,24,17,22,0,0,0,0,20130306,82,87,-5,5,2,5,5,169,5,2012,0,2,931,0
Orlando,18,22,34,22,0,0,0,0,Miami,25,30,22,20,0,0,0,0,20130306,96,97,7,15,3,1,1,193,1,2012,0,2,204,0
Portland,26,24,17,18,0,0,0,0,Memphis,18,20,27,26,0,0,0,0,20130306,85,91,-8,-12,-2,6,6,176,6,2012,0,2,1845,0
Milwaukee,32,26,24,19,0,0,0,0,LA Clippers,34,32,23,28,0,0,0,0,20130306,101,117,2,8,7,16,16,218,16,2012,0,2,1741,0
Sacramento,21,23,19,20,0,0,0,0,Golden State,28,13,28,18,0,0,0,0,20130306,83,87,7,-3,6,4,4,170,4,2012,0,2,75,0
New York,24,20,21,22,0,0,0,0,Detroit,19,19,27,12,0,0,0,0,20130306,87,77,5,6,0,10,10,164,-10,2012,0,2,480,0
Houston,25,31,27,25,0,0,0,0,Dallas,34,26,27,25,0,0,0,0,20130306,108,112,9,4,4,4,4,220,4,2012,0,2,225,0
Utah,19,32,25,25,0,0,0,0,Cleveland,23,26,19,36,0,0,0,0,20130306,101,104,4,-2,-8,3,3,205,3,2012,0,2,1564,0
Brooklyn,26,17,28,28,0,0,0,0,Charlotte,29,24,9,16,0,0,0,0,20130306,99,78,-3,-10,9,21,21,177,-21,2012,0,2,531,0
Philadelphia,19,28,23,26,0,0,0,0,Atlanta,26,33,32,16,0,0,0,0,20130306,96,107,7,12,21,11,11,203,11,2012,0,2,665,0
Boston,19,23,16,25,0,0,0,0,Indiana,27,22,19,13,0,0,0,0,20130306,83,81,-8,-7,-10,2,2,164,-2,2012,0,2,805,0
LA Clippers,25,24,26,17,0,0,0,0,Denver,27,22,36,22,0,0,0,0,20130307,92,107,2,0,10,15,15,199,15,2012,0,3,830,0
Oklahoma City,35,24,16,20,0,0,0,0,New York,26,30,25,13,0,0,0,0,20130307,95,94,9,3,-6,1,1,189,-1,2012,0,3,1324,0
Toronto,37,22,30,20,7,0,0,0,LA Lakers,25,28,26,30,9,0,0,0,20130308,116,118,-12,-6,-10,0,2,234,2,2012,1,4,2170,0
Portland,27,30,33,46,0,0,0,0,San Antonio,29,28,25,24,0,0,0,0,20130308,136,106,-2,0,8,30,30,242,-30,2012,0,4,1718,0
Phoenix,30,27,25,30,0,0,0,0,Sacramento,32,27,30,32,0,0,0,0,20130308,112,121,2,2,7,9,9,233,9,2012,0,4,634,0
Indiana,22,31,35,27,0,0,0,0,Orlando,15,23,25,23,0,0,0,0,20130308,115,86,7,15,25,29,29,201,-29,2012,0,4,822,0
Philadelphia,24,27,24,18,0,0,0,0,Miami,28,19,29,26,0,0,0,0,20130308,93,102,4,-4,1,9,9,195,9,2012,0,4,1021,0
Houston,21,29,23,21,0,0,0,0,Golden State,30,18,28,12,0,0,0,0,20130308,94,88,-9,2,-3,6,6,182,-6,2012,0,4,1642,0
Memphis,23,25,32,23,0,0,0,0,Cleveland,19,32,18,23,0,0,0,0,20130308,103,92,4,-3,11,11,11,195,-11,2012,0,4,629,0
Dallas,22,28,26,26,0,0,0,0,Detroit,17,25,29,28,0,0,0,0,20130308,102,99,5,8,5,3,3,201,-3,2012,0,4,999,0
Utah,23,23,24,18,0,0,0,0,Chicago,26,29,17,17,0,0,0,0,20130308,88,89,3,9,2,1,1,177,1,2012,0,4,1256,0
Oklahoma City,28,36,26,26,0,0,0,0,Charlotte,29,21,16,28,0,0,0,0,20130308,116,94,-1,14,24,22,22,210,-22,2012,0,4,938,0
Washington,14,19,25,20,0,0,0,0,Brooklyn,38,21,15,21,0,0,0,0,20130308,78,95,24,26,16,17,17,173,17,2012,0,4,204,0
Atlanta,26,21,21,26,8,0,0,0,Boston,28,24,20,22,13,0,0,0,20130308,102,107,2,5,4,0,5,209,5,2012,1,4,935,0
Houston,28,18,30,29,0,0,0,0,Phoenix,24,26,27,30,0,0,0,0,20130309,105,107,-4,4,1,2,2,212,2,2012,0,5,1014,0
Utah,21,17,21,25,0,0,0,0,New York,25,30,23,35,0,0,0,0,20130309,84,113,4,17,19,29,29,197,29,2012,0,5,1967,0
New Orleans,19,22,19,25,0,0,0,0,Memphis,25,22,31,18,0,0,0,0,20130309,85,96,6,6,18,11,11,181,11,2012,0,5,358,0
Charlotte,24,18,22,23,0,0,0,0,Washington,27,32,21,24,0,0,0,0,20130309,87,104,3,17,16,17,17,191,17,2012,0,5,329,0
Minnesota,24,25,21,18,0,0,0,0,Denver,27,23,33,28,0,0,0,0,20130309,88,111,3,1,13,23,23,199,23,2012,0,5,698,0
Brooklyn,23,28,25,17,0,0,0,0,Atlanta,23,14,20,23,0,0,0,0,20130309,93,80,0,14,19,13,13,173,-13,2012,0,5,745,0
Milwaukee,24,23,30,26,0,0,0,0,Golden State,28,20,22,23,0,0,0,0,20130309,103,93,-4,-1,7,10,10,196,-10,2012,0,5,1838,0
Detroit,22,30,18,27,0,0,0,0,LA Clippers,32,38,28,31,0,0,0,0,20130310,97,129,10,18,28,32,32,226,32,2012,0,6,1979,0
Chicago,16,24,21,20,0,0,0,0,LA Lakers,20,24,29,17,0,0,0,0,20130310,81,90,4,4,12,9,9,171,9,2012,0,6,1741,0
Indiana,20,26,19,26,0,0,0,0,Miami,29,27,23,26,0,0,0,0,20130310,91,105,9,10,14,14,14,196,14,2012,0,6,1026,0
Dallas,21,35,22,22,0,0,0,0,Minnesota,20,24,17,16,0,0,0,0,20130310,100,77,1,12,17,23,23,177,-23,2012,0,6,863,0
Portland,22,22,25,27,0,0,0,0,New Orleans,22,31,23,22,0,0,0,0,20130310,96,98,0,9,7,2,2,194,2,2012,0,6,2059,0
Boston,22,23,20,14,0,0,0,0,Oklahoma City,23,27,18,23,0,0,0,0,20130310,79,91,1,5,3,12,12,170,12,2012,0,6,1492,0
Philadelphia,30,21,21,19,0,0,0,0,Orlando,28,28,17,26,0,0,0,0,20130310,91,99,-2,5,1,8,8,190,8,2012,0,6,864,0
Milwaukee,26,35,24,30,0,0,0,0,Sacramento,29,21,30,33,0,0,0,0,20130310,115,113,-3,11,5,2,2,228,-2,2012,0,6,1771,0
Cleveland,27,28,19,22,0,0,0,0,Toronto,20,26,33,21,0,0,0,0,20130310,96,100,-7,-9,5,4,4,196,4,2012,0,6,187,0
Oklahoma City,32,18,24,19,0,0,0,0,San Antonio,22,35,26,22,0,0,0,0,20130311,93,105,-10,7,9,12,12,198,12,2012,0,0,421,0
Detroit,19,18,33,20,0,0,0,0,Utah,20,31,25,27,0,0,0,0,20130311,90,103,1,14,6,13,13,193,13,2012,0,0,1488,0
Denver,25,28,27,28,0,0,0,0,Phoenix,26,24,24,19,0,0,0,0,20130311,108,93,-1,3,6,15,15,201,-15,2012,0,0,585,0
Brooklyn,28,18,29,22,0,0,0,0,Philadelphia,24,29,29,24,0,0,0,0,20130311,97,106,-4,7,7,9,9,203,9,2012,0,0,80,0
New York,23,12,19,9,0,0,0,0,Golden State,26,24,25,17,0,0,0,0,20130311,63,92,3,15,21,29,29,155,29,2012,0,0,2565,0
New Orleans,19,29,30,20,0,0,0,0,Brooklyn,28,29,23,28,0,0,0,0,20130312,98,108,9,9,2,10,10,206,10,2012,0,1,1168,0
Boston,20,26,15,13,0,0,0,0,Charlotte,19,30,27,24,0,0,0,0,20130312,74,100,-1,3,15,26,26,174,26,2012,0,1,720,0
Washington,33,16,16,25,0,0,0,0,Cleveland,20,30,26,19,0,0,0,0,20130312,90,95,-13,1,11,5,5,185,5,2012,0,1,304,0
Atlanta,18,26,21,16,0,0,0,0,Miami,26,31,22,19,0,0,0,0,20130312,81,98,8,13,14,17,17,179,17,2012,0,1,605,0
Dallas,28,35,27,25,0,0,0,0,Milwaukee,35,20,24,29,0,0,0,0,20130312,115,108,-7,8,11,7,7,223,-7,2012,0,1,857,0
San Antonio,28,10,22,23,0,0,0,0,Minnesota,24,29,24,30,0,0,0,0,20130312,83,107,-4,15,17,24,24,190,24,2012,0,1,1112,0
LA Lakers,22,28,26,30,0,0,0,0,Orlando,23,23,22,29,0,0,0,0,20130312,106,97,-1,4,8,9,9,203,-9,2012,0,1,2197,0
Memphis,21,27,20,34,0,0,0,0,Portland,21,19,18,39,0,0,0,0,20130312,102,97,0,8,10,5,5,199,-5,2012,0,1,1845,0
Miami,21,30,20,27,0,0,0,0,Philadelphia,22,17,27,28,0,0,0,0,20130313,98,94,-1,12,5,4,4,192,-4,2012,0,2,1021,0
Utah,19,9,28,31,0,0,0,0,Oklahoma City,29,21,29,31,0,0,0,0,20130313,87,110,10,22,23,23,23,197,23,2012,0,2,861,0
Memphis,24,30,21,21,0,0,0,0,LA Clippers,24,28,17,16,0,0,0,0,20130313,96,85,0,2,6,11,11,181,-11,2012,0,2,1599,0
Minnesota,28,26,15,22,0,0,0,0,Indiana,35,27,20,25,0,0,0,0,20130313,91,107,7,8,13,16,16,198,16,2012,0,2,510,0
LA Lakers,19,24,31,18,0,0,0,0,Atlanta,26,29,21,20,0,0,0,0,20130313,92,96,7,12,2,4,4,188,4,2012,0,2,1932,0
Detroit,20,30,23,24,0,0,0,0,Golden State,28,22,30,25,0,0,0,0,20130313,97,105,8,0,7,8,8,202,8,2012,0,2,2087,0
New York,26,16,27,25,0,0,0,0,Denver,31,33,33,20,0,0,0,0,20130313,94,117,5,22,28,23,23,211,23,2012,0,2,1627,0
Toronto,22,18,22,26,0,0,0,0,Boston,21,28,32,31,0,0,0,0,20130313,88,112,-1,9,19,24,24,200,24,2012,0,2,430,0
Chicago,20,16,24,19,0,0,0,0,Sacramento,34,31,28,28,0,0,0,0,20130313,79,121,14,29,33,42,42,200,42,2012,0,2,1788,0
Phoenix,25,20,17,19,0,0,0,0,Houston,30,28,32,21,0,0,0,0,20130313,81,111,5,13,28,30,30,192,30,2012,0,2,1014,0
Milwaukee,21,23,34,15,0,0,0,0,Washington,30,30,15,31,0,0,0,0,20130313,93,106,9,16,-3,13,13,199,13,2012,0,2,634,0
New York,30,18,14,28,0,0,0,0,Portland,22,29,27,27,0,0,0,0,20130314,90,105,-8,3,16,15,15,195,15,2012,0,3,2439,0
Dallas,17,24,25,25,0,0,0,0,San Antonio,22,28,23,19,0,0,0,0,20130314,91,92,5,9,7,1,1,183,1,2012,0,3,252,0
Charlotte,17,25,26,10,0,0,0,0,Toronto,22,26,21,23,0,0,0,0,20130315,78,92,5,6,1,14,14,170,14,2012,0,4,585,0
Orlando,26,30,28,20,0,0,0,0,Oklahoma City,39,34,22,22,0,0,0,0,20130315,104,117,13,17,11,13,13,221,13,2012,0,4,1057,0
New Orleans,30,20,14,23,0,0,0,0,Washington,26,24,24,22,0,0,0,0,20130315,87,96,-4,0,10,9,9,183,9,2012,0,4,964,0
Miami,26,25,33,23,0,0,0,0,Milwaukee,27,15,26,26,0,0,0,0,20130315,107,94,-1,9,16,13,13,201,-13,2012,0,4,1269,0
LA Lakers,16,30,22,31,0,0,0,0,Indiana,19,22,28,24,0,0,0,0,20130315,99,93,-3,5,-1,6,6,192,-6,2012,0,4,1805,0
Chicago,28,28,38,19,0,0,0,0,Golden State,27,19,17,32,0,0,0,0,20130315,113,95,1,10,31,18,18,208,-18,2012,0,4,1853,0
Memphis,18,29,19,14,0,0,0,0,Denver,23,25,10,29,0,0,0,0,20130315,80,87,5,1,-8,7,7,167,7,2012,0,4,877,0
Cleveland,24,22,22,18,0,0,0,0,Dallas,16,22,29,29,0,0,0,0,20130315,86,96,-8,-8,-1,10,10,182,10,2012,0,4,1024,0
Phoenix,23,23,22,26,0,0,0,0,Atlanta,27,30,25,25,0,0,0,0,20130315,94,107,4,11,14,13,13,201,13,2012,0,4,1588,0
Minnesota,27,30,23,20,0,0,0,0,Houston,22,17,35,34,0,0,0,0,20130315,100,108,-5,-18,-6,8,8,208,8,2012,0,4,1057,0
Memphis,21,29,9,25,0,0,0,0,Utah,22,23,24,21,0,0,0,0,20130316,84,90,1,-5,10,6,6,174,6,2012,0,5,1247,0
Charlotte,24,19,23,22,0,0,0,0,Boston,24,26,33,22,0,0,0,0,20130316,88,105,0,7,17,17,17,193,17,2012,0,5,720,0
Indiana,24,25,23,19,0,0,0,0,Philadelphia,23,25,23,27,0,0,0,0,20130316,91,98,-1,-1,-1,7,7,189,7,2012,0,5,582,0
Detroit,30,27,18,26,0,0,0,0,Portland,24,28,25,35,0,0,0,0,20130316,101,112,-6,-5,2,11,11,213,11,2012,0,5,1964,0
Cleveland,30,31,29,23,0,0,0,0,San Antonio,34,32,25,28,0,0,0,0,20130316,113,119,4,5,1,6,6,232,6,2012,0,5,1256,0
Phoenix,29,30,24,22,0,0,0,0,Washington,27,39,36,25,0,0,0,0,20130316,105,127,-2,7,19,22,22,232,22,2012,0,5,1977,0
New Orleans,27,25,21,22,0,0,0,0,Minnesota,28,22,26,21,0,0,0,0,20130317,95,97,1,-2,3,2,2,192,2,2012,0,6,1052,0
Orlando,25,29,27,28,0,0,0,0,Milwaukee,18,26,26,45,0,0,0,0,20130317,109,115,-7,-10,-11,6,6,224,6,2012,0,6,1065,0
Sacramento,27,29,20,26,0,0,0,0,LA Lakers,33,23,30,27,0,0,0,0,20130317,102,113,6,0,10,11,11,215,11,2012,0,6,361,0
Atlanta,21,30,20,34,0,0,0,0,Brooklyn,24,25,24,20,0,0,0,0,20130317,105,93,-3,2,-2,12,12,198,-12,2012,0,6,745,0
Golden State,18,36,21,33,0,0,0,0,Houston,10,21,29,18,0,0,0,0,20130317,108,78,8,23,15,30,30,186,-30,2012,0,6,1642,0
Oklahoma City,24,26,23,34,0,0,0,0,Dallas,26,23,23,29,0,0,0,0,20130317,107,101,-2,1,1,6,6,208,-6,2012,0,6,189,0
Miami,27,28,21,32,0,0,0,0,Toronto,19,24,30,18,0,0,0,0,20130317,108,91,8,12,3,17,17,199,-17,2012,0,6,1234,0
New York,18,19,23,20,0,0,0,0,LA Clippers,21,23,28,21,0,0,0,0,20130317,80,93,3,7,12,13,13,173,13,2012,0,6,2445,0
Portland,28,22,22,28,0,0,0,0,Philadelphia,32,26,20,23,0,0,0,0,20130318,100,101,4,8,6,1,1,201,1,2012,0,0,2405,0
Golden State,19,26,24,24,0,0,0,0,New Orleans,22,14,25,11,0,0,0,0,20130318,93,72,-3,9,8,21,21,165,-21,2012,0,0,1921,0
New York,23,19,24,24,0,0,0,0,Utah,21,23,19,20,0,0,0,0,20130318,90,83,2,-2,3,7,7,173,-7,2012,0,0,1967,0
LA Lakers,25,19,22,10,0,0,0,0,Phoenix,21,26,24,28,0,0,0,0,20130318,76,99,-4,3,5,23,23,175,23,2012,0,0,356,0
Minnesota,20,19,14,24,0,0,0,0,Memphis,22,23,29,18,0,0,0,0,20130318,77,92,2,6,21,15,15,169,15,2012,0,0,700,0
Brooklyn,36,23,31,29,0,0,0,0,Detroit,23,22,14,23,0,0,0,0,20130318,119,82,13,14,31,37,37,201,-37,2012,0,0,480,0
Indiana,27,33,27,24,0,0,0,0,Cleveland,24,21,17,28,0,0,0,0,20130318,111,90,3,15,25,21,21,201,-21,2012,0,0,262,0
Denver,21,32,26,26,14,0,0,0,Chicago,20,25,28,32,13,0,0,0,20130318,119,118,1,8,6,0,1,237,-1,2012,1,0,916,0
Washington,29,30,30,25,0,0,0,0,Charlotte,32,31,31,25,0,0,0,0,20130318,114,119,3,4,5,5,5,233,5,2012,0,0,329,0
Miami,19,34,25,27,0,0,0,0,Boston,31,28,23,21,0,0,0,0,20130318,105,103,-12,-6,-4,2,2,208,-2,2012,0,0,1257,0
Dallas,34,34,30,29,0,0,0,0,Atlanta,25,30,30,28,0,0,0,0,20130318,127,113,9,13,13,14,14,240,-14,2012,0,0,719,0
Orlando,12,17,26,18,0,0,0,0,Indiana,19,23,27,26,0,0,0,0,20130319,73,95,7,13,14,22,22,168,22,2012,0,1,822,0
Portland,23,8,26,38,0,0,0,0,Milwaukee,27,31,19,25,0,0,0,0,20130319,95,102,4,27,20,7,7,197,7,2012,0,1,1714,0
Denver,26,39,24,25,0,0,0,0,Oklahoma City,34,32,16,22,0,0,0,0,20130319,114,104,-8,-1,7,10,10,218,-10,2012,0,1,503,0
LA Clippers,23,31,29,18,0,0,0,0,Sacramento,23,33,22,38,0,0,0,0,20130319,101,116,0,2,-5,15,15,217,15,2012,0,1,361,0
Golden State,22,25,23,23,0,0,0,0,San Antonio,22,38,19,25,0,0,0,0,20130320,93,104,0,13,9,11,11,197,11,2012,0,2,1487,0
Washington,25,34,15,14,0,0,0,0,Phoenix,26,19,20,14,0,0,0,0,20130320,88,79,-1,14,9,9,9,167,-9,2012,0,2,1977,0
Orlando,15,31,19,29,0,0,0,0,New York,26,25,32,23,0,0,0,0,20130320,94,106,11,5,18,12,12,200,12,2012,0,2,939,0
Boston,31,24,12,19,0,0,0,0,New Orleans,22,23,22,20,0,0,0,0,20130320,86,87,-9,-10,0,1,1,173,1,2012,0,2,1358,0
Oklahoma City,15,23,19,26,6,0,0,0,Memphis,21,23,14,25,7,0,0,0,20130320,89,90,6,6,1,0,1,179,1,2012,1,2,421,0
Brooklyn,22,29,34,28,0,0,0,0,Dallas,32,19,26,19,0,0,0,0,20130320,113,96,-10,0,8,17,17,209,-17,2012,0,2,1370,0
Utah,17,16,28,32,0,0,0,0,Houston,25,27,28,20,0,0,0,0,20130320,93,100,8,19,19,7,7,193,7,2012,0,2,1199,0
Miami,24,10,34,30,0,0,0,0,Cleveland,32,23,22,18,0,0,0,0,20130320,98,95,-8,-21,-9,3,3,193,-3,2012,0,2,1089,0
Toronto,26,22,23,30,0,0,0,0,Charlotte,22,31,21,33,0,0,0,0,20130320,101,107,-4,5,3,6,6,208,6,2012,0,2,585,0
Milwaukee,18,25,16,31,0,0,0,0,Atlanta,18,30,29,21,0,0,0,0,20130320,90,98,0,5,18,8,8,188,8,2012,0,2,669,0
Philadelphia,20,16,22,14,0,0,0,0,LA Clippers,20,26,28,27,0,0,0,0,20130320,72,101,0,10,16,29,29,173,29,2012,0,2,2388,0
Portland,20,32,28,19,0,0,0,0,Chicago,21,16,16,36,0,0,0,0,20130321,99,89,-1,15,27,10,10,188,-10,2012,0,3,1754,0
Philadelphia,22,22,27,29,0,0,0,0,Denver,17,34,24,26,0,0,0,0,20130321,100,101,-5,7,4,1,1,201,1,2012,0,3,1574,0
Minnesota,26,31,20,21,0,0,0,0,Sacramento,25,28,26,22,0,0,0,0,20130321,98,101,-1,-4,2,3,3,199,3,2012,0,3,1511,0
Oklahoma City,22,25,23,27,0,0,0,0,Orlando,14,20,32,23,0,0,0,0,20130322,97,89,8,13,4,8,8,186,-8,2012,0,4,1057,0
Minnesota,31,36,28,22,0,0,0,0,Phoenix,18,21,30,17,0,0,0,0,20130322,117,86,13,28,26,31,31,203,-31,2012,0,4,1278,0
Washington,19,22,31,31,0,0,0,0,LA Lakers,35,22,17,26,0,0,0,0,20130322,103,100,-16,-16,-2,3,3,203,-3,2012,0,4,2294,0
New York,25,25,27,22,0,0,0,0,Toronto,22,15,34,23,0,0,0,0,20130322,99,94,3,13,6,5,5,193,-5,2012,0,4,341,0
Utah,21,20,24,25,7,0,0,0,San Antonio,18,20,25,27,14,0,0,0,20130322,97,104,-3,-3,-2,0,7,201,7,2012,1,4,1087,0
Memphis,21,22,15,25,0,0,0,0,New Orleans,14,34,19,23,0,0,0,0,20130322,83,90,-7,5,9,7,7,173,7,2012,0,4,358,0
Cleveland,25,18,18,17,0,0,0,0,Houston,28,30,29,29,0,0,0,0,20130322,78,116,3,15,26,38,38,194,38,2012,0,4,1113,0
Milwaukee,23,20,11,24,0,0,0,0,Indiana,23,22,28,29,0,0,0,0,20130322,78,102,0,2,19,24,24,180,24,2012,0,4,243,0
Portland,21,24,28,31,0,0,0,0,Atlanta,24,21,31,17,0,0,0,0,20130322,104,93,-3,0,-3,11,11,197,-11,2012,0,4,2168,0
Detroit,28,26,14,21,0,0,0,0,Miami,22,29,22,30,0,0,0,0,20130322,89,103,-6,-3,5,14,14,192,14,2012,0,4,1155,0
Boston,21,23,24,26,0,0,0,0,Dallas,30,25,24,25,0,0,0,0,20130322,94,104,9,11,11,10,10,198,10,2012,0,4,1548,0
Toronto,17,30,20,17,0,0,0,0,New York,21,38,23,28,0,0,0,0,20130323,84,110,4,12,15,26,26,194,26,2012,0,5,341,0
Detroit,23,24,22,23,0,0,0,0,Charlotte,24,26,26,15,0,0,0,0,20130323,92,91,-1,-3,-7,1,1,183,-1,2012,0,5,504,0
Indiana,22,22,23,17,0,0,0,0,Chicago,16,23,29,19,0,0,0,0,20130323,84,87,-6,-5,1,3,3,171,3,2012,0,5,163,0
Sacramento,17,23,31,24,0,0,0,0,Denver,27,23,20,31,0,0,0,0,20130323,95,101,10,10,-1,6,6,196,6,2012,0,5,886,0
Washington,17,23,24,28,0,0,0,0,Golden State,29,29,24,19,0,0,0,0,20130323,92,101,12,18,18,9,9,193,9,2012,0,5,2435,0
Brooklyn,24,25,26,20,0,0,0,0,LA Clippers,25,22,23,31,0,0,0,0,20130323,95,101,1,-2,-5,6,6,196,6,2012,0,5,2445,0
Boston,31,20,22,33,0,0,0,0,Memphis,29,32,24,25,0,0,0,0,20130323,106,110,-2,10,12,4,4,216,4,2012,0,5,1134,0
Philadelphia,22,36,33,26,0,0,0,0,Sacramento,31,27,24,21,0,0,0,0,20130324,117,103,-9,0,9,14,14,220,-14,2012,0,6,2451,0
Brooklyn,25,30,20,27,0,0,0,0,Phoenix,25,18,33,24,0,0,0,0,20130324,102,100,0,12,-1,2,2,202,-2,2012,0,6,2139,0
Portland,19,28,21,15,0,0,0,0,Oklahoma City,24,21,30,28,0,0,0,0,20130324,83,103,5,-2,7,20,20,186,20,2012,0,6,1484,0
Chicago,23,33,22,26,0,0,0,0,Minnesota,16,27,25,29,0,0,0,0,20130324,104,97,7,13,10,7,7,201,-7,2012,0,6,355,0
Utah,27,25,19,37,0,0,0,0,Dallas,24,29,30,30,0,0,0,0,20130324,108,113,-3,1,12,5,5,221,5,2012,0,6,998,0
Charlotte,19,20,18,20,0,0,0,0,Miami,23,24,26,36,0,0,0,0,20130324,77,109,4,8,16,32,32,186,32,2012,0,6,654,0
San Antonio,20,26,21,28,0,0,0,0,Houston,22,21,31,22,0,0,0,0,20130324,95,96,2,-3,7,1,1,191,1,2012,0,6,189,0
Atlanta,24,26,24,30,0,0,0,0,Milwaukee,24,25,25,25,0,0,0,0,20130324,104,99,0,1,0,5,5,203,-5,2012,0,6,669,0
Philadelphia,23,19,26,23,0,0,0,0,Utah,27,31,27,22,0,0,0,0,20130325,91,107,4,16,17,16,16,198,16,2012,0,0,1920,0
Memphis,24,31,19,20,0,0,0,0,Washington,26,29,21,31,0,0,0,0,20130325,94,107,2,0,2,13,13,201,13,2012,0,0,762,0
Miami,28,27,23,30,0,0,0,0,Orlando,28,18,22,26,0,0,0,0,20130325,108,94,0,9,10,14,14,202,-14,2012,0,0,204,0
Atlanta,26,17,20,31,0,0,0,0,Indiana,26,32,27,15,0,0,0,0,20130325,94,100,0,15,22,6,6,194,6,2012,0,0,427,0
LA Lakers,16,24,36,27,0,0,0,0,Golden State,28,35,31,15,0,0,0,0,20130325,103,109,12,23,18,6,6,212,6,2012,0,0,347,0
Denver,18,20,30,18,0,0,0,0,New Orleans,27,32,27,24,0,0,0,0,20130325,86,110,9,21,18,24,24,196,24,2012,0,0,1079,0
New York,28,30,26,16,0,0,0,0,Boston,24,20,25,16,0,0,0,0,20130326,100,85,4,14,15,15,15,185,-15,2012,0,1,190,0
LA Clippers,27,21,25,24,5,0,0,0,Dallas,22,28,24,23,12,0,0,0,20130326,102,109,-5,2,1,0,7,211,7,2012,1,1,1237,0
Minnesota,19,25,38,23,0,0,0,0,Detroit,16,22,16,28,0,0,0,0,20130326,105,82,3,6,28,23,23,187,-23,2012,0,1,542,0
Phoenix,23,21,27,17,0,0,0,0,Utah,34,19,22,28,0,0,0,0,20130327,88,103,11,9,4,15,15,191,15,2012,0,2,505,0
Atlanta,20,24,31,32,0,0,0,0,Toronto,25,29,21,13,0,0,0,0,20130327,107,88,-5,-10,0,19,19,195,-19,2012,0,2,733,0
Denver,20,34,21,24,0,0,0,0,San Antonio,22,29,32,17,0,0,0,0,20130327,99,100,2,-3,8,1,1,199,1,2012,0,2,802,0
Brooklyn,37,27,31,16,0,0,0,0,Portland,17,24,28,24,0,0,0,0,20130327,111,93,20,23,26,18,18,204,-18,2012,0,2,2439,0
Milwaukee,20,28,30,14,0,0,0,0,Philadelphia,27,27,22,24,0,0,0,0,20130327,92,100,7,6,-2,8,8,192,8,2012,0,2,692,0
Washington,23,22,21,14,0,0,0,0,Oklahoma City,29,24,30,20,0,0,0,0,20130327,80,103,6,8,17,23,23,183,23,2012,0,2,1149,0
Memphis,25,16,29,31,0,0,0,0,New York,37,32,17,22,0,0,0,0,20130327,101,108,12,28,16,7,7,209,7,2012,0,2,953,0
LA Lakers,26,24,41,29,0,0,0,0,Minnesota,23,23,33,38,0,0,0,0,20130327,120,117,3,4,12,3,3,237,-3,2012,0,2,1521,0
Indiana,35,23,24,18,0,0,0,0,Houston,19,30,22,20,0,0,0,0,20130327,100,91,16,9,11,9,9,191,-9,2012,0,2,865,0
Sacramento,24,23,30,28,0,0,0,0,Golden State,27,17,22,32,0,0,0,0,20130327,105,98,-3,3,11,7,7,203,-7,2012,0,2,75,0
Boston,24,22,21,26,0,0,0,0,Cleveland,18,27,28,19,0,0,0,0,20130327,93,92,6,1,-6,1,1,185,-1,2012,0,2,549,0
Miami,22,24,22,29,0,0,0,0,Chicago,32,23,14,32,0,0,0,0,20130327,97,101,10,9,1,4,4,198,4,2012,0,2,1189,0
Orlando,39,19,24,26,0,0,0,0,Charlotte,20,31,32,31,0,0,0,0,20130327,108,114,-19,-7,1,6,6,222,6,2012,0,2,463,0
LA Clippers,27,29,23,26,0,0,0,0,New Orleans,26,22,29,14,0,0,0,0,20130327,105,91,1,8,2,14,14,196,-14,2012,0,2,1669,0
Sacramento,38,26,24,29,0,0,0,0,Phoenix,32,18,28,25,0,0,0,0,20130328,117,103,6,14,10,14,14,220,-14,2012,0,3,634,0
Indiana,23,18,34,28,0,0,0,0,Dallas,18,23,17,20,0,0,0,0,20130328,103,78,5,0,17,25,25,181,-25,2012,0,3,763,0
LA Lakers,25,31,21,26,0,0,0,0,Milwaukee,18,35,29,31,0,0,0,0,20130328,103,113,-7,-3,5,10,10,216,10,2012,0,3,1741,0
Charlotte,20,27,22,33,0,0,0,0,New York,38,31,19,23,0,0,0,0,20130329,102,111,18,22,19,9,9,213,9,2012,0,4,531,0
Miami,32,28,21,27,0,0,0,0,New Orleans,22,21,17,29,0,0,0,0,20130329,108,89,10,17,21,19,19,197,-19,2012,0,4,668,0
Utah,22,20,32,31,0,0,0,0,Portland,30,22,23,20,0,0,0,0,20130329,105,95,-8,-10,-1,10,10,200,-10,2012,0,4,634,0
Washington,23,23,25,21,0,0,0,0,Orlando,24,34,20,19,0,0,0,0,20130329,92,97,1,12,7,5,5,189,5,2012,0,4,757,0
Oklahoma City,23,25,29,16,0,0,0,0,Minnesota,23,30,27,21,0,0,0,0,20130329,93,101,0,5,3,8,8,194,8,2012,0,4,694,0
LA Clippers,28,34,17,23,0,0,0,0,San Antonio,30,31,24,19,0,0,0,0,20130329,102,104,2,-1,6,2,2,206,2,2012,0,4,1201,0
Toronto,19,27,36,17,0,0,0,0,Detroit,26,19,15,22,0,0,0,0,20130329,99,82,-7,1,22,17,17,181,-17,2012,0,4,205,0
Brooklyn,23,15,28,21,0,0,0,0,Denver,26,29,25,29,0,0,0,0,20130329,87,109,3,17,14,22,22,196,22,2012,0,4,1627,0
Philadelphia,19,26,32,20,0,0,0,0,Cleveland,24,21,21,21,0,0,0,0,20130329,97,87,-5,0,11,10,10,184,-10,2012,0,4,358,0
Atlanta,30,26,24,27,0,0,0,0,Boston,32,34,26,26,0,0,0,0,20130329,107,118,2,10,12,11,11,225,11,2012,0,4,935,0
Houston,29,24,16,25,0,0,0,0,Memphis,31,30,23,19,0,0,0,0,20130329,94,103,2,8,15,9,9,197,9,2012,0,4,484,0
Indiana,27,30,29,26,0,0,0,0,Phoenix,21,28,27,28,0,0,0,0,20130330,112,104,6,8,10,8,8,216,-8,2012,0,5,1496,0
Charlotte,31,15,25,21,0,0,0,0,Philadelphia,22,27,24,27,0,0,0,0,20130330,92,100,-9,3,2,8,8,192,8,2012,0,5,450,0
Brooklyn,28,26,20,33,0,0,0,0,Utah,33,19,31,33,0,0,0,0,20130330,107,116,5,-2,9,9,9,223,9,2012,0,5,1967,0
LA Lakers,25,28,29,21,0,0,0,0,Sacramento,37,20,18,23,0,0,0,0,20130330,103,98,-12,-4,7,5,5,201,-5,2012,0,5,361,0
Memphis,23,22,20,34,0,0,0,0,Minnesota,30,20,17,19,0,0,0,0,20130330,99,86,-7,-5,-2,13,13,185,-13,2012,0,5,700,0
Oklahoma City,32,24,27,26,0,0,0,0,Milwaukee,28,18,37,16,0,0,0,0,20130330,109,99,4,10,0,10,10,208,-10,2012,0,5,732,0
LA Clippers,29,21,13,18,0,0,0,0,Houston,28,27,30,13,0,0,0,0,20130330,81,98,-1,5,22,17,17,179,17,2012,0,5,1371,0
Portland,31,24,23,20,0,0,0,0,Golden State,36,29,31,29,0,0,0,0,20130330,98,125,5,10,18,27,27,223,27,2012,0,5,535,0
Chicago,23,33,19,23,0,0,0,0,Dallas,24,29,22,25,0,0,0,0,20130330,98,100,1,-3,0,2,2,198,2,2012,0,5,802,0
Orlando,27,17,16,28,0,0,0,0,Atlanta,23,22,22,30,0,0,0,0,20130330,88,97,-4,1,7,9,9,185,9,2012,0,5,401,0
Detroit,24,33,17,20,0,0,0,0,Chicago,20,33,18,24,0,0,0,0,20130331,94,95,-4,-4,-3,1,1,189,1,2012,0,6,238,0
Cleveland,21,28,24,19,0,0,0,0,New Orleans,23,25,36,28,0,0,0,0,20130331,92,112,2,-1,11,20,20,204,20,2012,0,6,924,0
Boston,23,25,21,20,0,0,0,0,New York,28,37,21,22,0,0,0,0,20130331,89,108,5,17,17,19,19,197,19,2012,0,6,190,0
Miami,22,18,31,17,0,0,0,0,San Antonio,24,21,19,22,0,0,0,0,20130331,88,86,-2,-5,7,2,2,174,-2,2012,0,6,1147,0
Toronto,25,25,26,16,0,0,0,0,Washington,27,33,30,19,0,0,0,0,20130331,92,109,2,10,14,17,17,201,17,2012,0,6,349,0
Portland,19,30,25,28,0,0,0,0,Utah,29,27,31,25,0,0,0,0,20130401,102,112,10,7,13,10,10,214,10,2012,0,0,634,0
Detroit,25,29,21,33,0,0,0,0,Toronto,24,31,24,19,0,0,0,0,20130401,108,98,1,-1,-4,10,10,206,-10,2012,0,0,205,0
Boston,25,27,26,22,0,0,0,0,Minnesota,27,30,27,26,0,0,0,0,20130401,100,110,2,5,6,10,10,210,10,2012,0,0,1120,0
Charlotte,25,35,24,18,0,0,0,0,Milwaukee,29,40,31,31,0,0,0,0,20130401,102,131,4,9,16,29,29,233,29,2012,0,0,658,0
San Antonio,21,23,24,22,0,0,0,0,Memphis,21,16,25,30,0,0,0,0,20130401,90,92,0,-7,-6,2,2,182,2,2012,0,0,631,0
Indiana,29,22,30,28,0,0,0,0,LA Clippers,21,22,22,41,0,0,0,0,20130401,109,106,8,8,16,3,3,215,-3,2012,0,0,1805,0
Orlando,14,29,31,29,0,0,0,0,Houston,32,33,25,21,0,0,0,0,20130401,103,111,18,22,16,8,8,214,8,2012,0,0,847,0
Cleveland,19,25,24,26,0,0,0,0,Atlanta,25,27,27,23,0,0,0,0,20130401,94,102,6,8,11,8,8,196,8,2012,0,0,555,0
Dallas,21,19,21,20,0,0,0,0,LA Lakers,24,31,17,29,0,0,0,0,20130402,81,101,3,15,11,20,20,182,20,2012,0,1,1237,0
New York,27,23,28,24,0,0,0,0,Miami,25,33,18,14,0,0,0,0,20130402,102,90,2,-8,2,12,12,192,-12,2012,0,1,1091,0
Chicago,24,25,20,17,0,0,0,0,Washington,18,24,28,20,0,0,0,0,20130402,86,90,-6,-7,1,4,4,176,4,2012,0,1,594,0
Denver,28,28,25,32,0,0,0,0,Utah,23,28,17,28,0,0,0,0,20130403,113,96,5,5,13,17,17,209,-17,2012,0,2,370,0
Washington,24,26,12,16,0,0,0,0,Toronto,23,16,29,20,0,0,0,0,20130403,78,88,-1,-11,6,10,10,166,10,2012,0,2,349,0
Orlando,23,23,19,19,0,0,0,0,San Antonio,28,23,22,25,0,0,0,0,20130403,84,98,5,5,8,14,14,182,14,2012,0,2,1035,0
Houston,27,32,29,24,0,0,0,0,Sacramento,26,29,28,19,0,0,0,0,20130403,112,102,1,4,5,10,10,214,-10,2012,0,2,1606,0
Memphis,32,25,20,17,0,0,0,0,Portland,21,25,18,12,0,0,0,0,20130403,94,76,11,11,13,18,18,170,-18,2012,0,2,1845,0
Minnesota,34,21,32,20,0,0,0,0,Milwaukee,23,29,29,17,0,0,0,0,20130403,107,98,11,3,6,9,9,205,-9,2012,0,2,298,0
New Orleans,28,14,28,18,0,0,0,0,Golden State,19,32,23,24,0,0,0,0,20130403,88,98,-9,9,4,10,10,186,10,2012,0,2,1921,0
Brooklyn,28,38,29,18,0,0,0,0,Cleveland,20,16,32,27,0,0,0,0,20130403,113,95,8,30,27,18,18,208,-18,2012,0,2,403,0
Philadelphia,27,18,16,22,0,0,0,0,Charlotte,19,21,24,24,0,0,0,0,20130403,83,88,-8,-5,3,5,5,171,5,2012,0,2,450,0
Detroit,30,14,23,26,0,0,0,0,Boston,25,29,20,24,0,0,0,0,20130403,93,98,-5,10,7,5,5,191,5,2012,0,2,611,0
New York,23,24,21,27,0,0,0,0,Atlanta,18,22,28,14,0,0,0,0,20130403,95,82,5,7,0,13,13,177,-13,2012,0,2,745,0
Phoenix,19,31,20,31,0,0,0,0,LA Clippers,29,28,38,31,0,0,0,0,20130403,101,126,10,7,25,25,25,227,25,2012,0,2,356,0
Chicago,13,23,29,27,0,0,0,0,Brooklyn,26,21,20,23,0,0,0,0,20130404,92,90,-13,-11,-2,2,2,182,-2,2012,0,3,711,0
Dallas,23,24,30,17,0,0,0,0,Denver,19,28,23,25,0,0,0,0,20130404,94,95,-4,0,-7,1,1,189,1,2012,0,3,661,0
San Antonio,18,26,27,17,0,0,0,0,Oklahoma City,29,23,25,23,0,0,0,0,20130404,88,100,11,8,6,12,12,188,12,2012,0,3,421,0
Orlando,19,24,27,16,0,0,0,0,Chicago,14,26,26,21,0,0,0,0,20130405,86,87,-5,-3,-4,1,1,173,1,2012,0,4,984,0
Houston,35,28,29,24,0,0,0,0,Portland,31,25,21,21,0,0,0,0,20130405,116,98,4,7,15,18,18,214,-18,2012,0,4,1833,0
Golden State,23,32,32,24,0,0,0,0,Phoenix,37,27,14,29,0,0,0,0,20130405,111,107,-14,-9,9,4,4,218,-4,2012,0,4,652,0
Milwaukee,19,26,21,17,0,0,0,0,New York,19,17,42,23,0,0,0,0,20130405,83,101,0,-9,12,18,18,184,18,2012,0,4,732,0
Toronto,18,28,25,24,0,0,0,0,Minnesota,24,24,25,20,0,0,0,0,20130405,95,93,-6,-2,-2,2,2,188,-2,2012,0,4,691,0
Cleveland,26,26,22,23,0,0,0,0,Boston,28,24,16,23,0,0,0,0,20130405,97,91,-2,0,6,6,6,188,-6,2012,0,4,549,0
Oklahoma City,26,18,28,25,0,0,0,0,Indiana,23,20,24,8,0,0,0,0,20130405,97,75,3,1,5,22,22,172,-22,2012,0,4,688,0
Miami,26,22,18,23,0,0,0,0,Charlotte,22,23,8,26,0,0,0,0,20130405,89,79,4,3,13,10,10,168,-10,2012,0,4,654,0
Dallas,18,41,33,25,0,0,0,0,Sacramento,27,26,28,27,0,0,0,0,20130405,117,108,-9,6,11,9,9,225,-9,2012,0,4,1437,0
Philadelphia,40,18,25,18,0,0,0,0,Atlanta,26,19,20,25,0,0,0,0,20130405,101,90,14,13,18,11,11,191,-11,2012,0,4,665,0
Memphis,18,21,23,22,0,0,0,0,LA Lakers,25,21,22,18,0,0,0,0,20130405,84,86,7,7,6,2,2,170,2,2012,0,4,1599,0
New Orleans,24,19,24,16,0,0,0,0,Utah,17,28,26,24,0,0,0,0,20130405,83,95,-7,2,4,12,12,178,12,2012,0,4,1432,0
Detroit,25,30,23,23,0,0,0,0,Minnesota,33,28,20,26,0,0,0,0,20130406,101,107,8,6,3,6,6,208,6,2012,0,5,542,0
Indiana,26,22,18,19,0,0,0,0,Washington,31,20,26,27,0,0,0,0,20130406,85,104,5,3,11,19,19,189,19,2012,0,5,490,0
Toronto,16,26,13,28,0,0,0,0,Milwaukee,26,35,19,20,0,0,0,0,20130406,83,100,10,19,25,17,17,183,17,2012,0,5,429,0
Atlanta,20,20,29,28,0,0,0,0,San Antonio,21,30,22,26,0,0,0,0,20130406,97,99,1,11,4,2,2,196,2,2012,0,5,881,0
Houston,35,21,27,31,0,0,0,0,Denver,25,39,38,30,0,0,0,0,20130406,114,132,-10,8,19,18,18,246,18,2012,0,5,878,0
Charlotte,23,31,21,21,0,0,0,0,Brooklyn,29,24,30,22,0,0,0,0,20130406,96,105,6,-1,8,9,9,201,9,2012,0,5,531,0
Philadelphia,18,28,30,11,0,0,0,0,Miami,33,17,27,29,0,0,0,0,20130406,87,106,15,4,1,19,19,193,19,2012,0,5,1021,0
Washington,27,25,19,25,0,0,0,0,Boston,28,28,31,20,0,0,0,0,20130407,96,107,1,4,16,11,11,203,11,2012,0,6,394,0
Orlando,24,24,18,19,0,0,0,0,Cleveland,22,22,18,29,0,0,0,0,20130407,85,91,-2,-4,-4,6,6,176,6,2012,0,6,895,0
Chicago,26,20,21,18,0,0,0,0,Detroit,23,27,25,24,0,0,0,0,20130407,85,99,-3,4,8,14,14,184,14,2012,0,6,238,0
Utah,24,32,21,20,0,0,0,0,Golden State,27,21,21,21,0,0,0,0,20130407,97,90,-3,8,8,7,7,187,-7,2012,0,6,599,0
LA Lakers,25,24,21,25,0,0,0,0,LA Clippers,30,26,26,27,0,0,0,0,20130407,95,109,5,7,12,14,14,204,14,2012,0,6,0,0
New York,30,35,31,29,0,0,0,0,Oklahoma City,31,25,33,31,0,0,0,0,20130407,125,120,-1,9,7,5,5,245,-5,2012,0,6,1324,0
New Orleans,17,22,35,21,0,0,0,0,Phoenix,26,17,19,30,0,0,0,0,20130407,95,92,-9,-4,12,3,3,187,-3,2012,0,6,1312,0
Dallas,29,27,25,15,0,0,0,0,Portland,18,14,29,30,0,0,0,0,20130407,96,91,11,24,20,5,5,187,-5,2012,0,6,1630,0
Memphis,25,18,25,21,0,0,0,0,Sacramento,16,28,20,23,0,0,0,0,20130407,89,87,9,-1,4,2,2,176,-2,2012,0,6,1745,0
Oklahoma City,26,19,23,22,0,0,0,0,Utah,19,16,26,19,0,0,0,0,20130409,90,80,7,10,7,10,10,170,-10,2012,0,1,861,0
Washington,23,20,28,28,0,0,0,0,New York,36,22,37,25,0,0,0,0,20130409,99,120,13,15,24,21,21,219,21,2012,0,1,204,0
Milwaukee,21,25,13,24,0,0,0,0,Miami,26,21,24,23,0,0,0,0,20130409,83,94,5,1,12,11,11,177,11,2012,0,1,1269,0
Charlotte,19,21,17,18,0,0,0,0,Memphis,28,21,14,31,0,0,0,0,20130409,75,94,9,9,6,19,19,169,19,2012,0,1,519,0
New Orleans,22,28,20,26,0,0,0,0,LA Lakers,27,18,25,34,0,0,0,0,20130409,96,104,5,-5,0,8,8,200,8,2012,0,1,1669,0
Minnesota,26,28,16,19,0,0,0,0,Golden State,26,29,31,19,0,0,0,0,20130409,89,105,0,1,16,16,16,194,16,2012,0,1,1581,0
Phoenix,21,32,21,24,0,0,0,0,Houston,29,22,27,23,0,0,0,0,20130409,98,101,8,-2,4,3,3,199,3,2012,0,1,1014,0
Toronto,31,23,27,20,0,0,0,0,Chicago,22,28,18,30,0,0,0,0,20130409,101,98,9,4,13,3,3,199,-3,2012,0,1,436,0
Cleveland,26,27,31,10,0,0,0,0,Indiana,29,19,16,35,0,0,0,0,20130409,94,99,3,-5,-20,5,5,193,5,2012,0,1,262,0
Philadelphia,18,20,24,21,0,0,0,0,Brooklyn,31,25,29,19,0,0,0,0,20130409,83,104,13,18,23,21,21,187,21,2012,0,1,80,0
Miami,25,21,23,34,0,0,0,0,Washington,22,28,22,26,0,0,0,0,20130410,103,98,3,-4,-3,5,5,201,-5,2012,0,2,924,0
Atlanta,29,30,34,31,0,0,0,0,Philadelphia,27,24,22,28,0,0,0,0,20130410,124,101,2,8,20,23,23,225,-23,2012,0,2,665,0
New Orleans,28,20,25,37,0,0,0,0,Sacramento,35,30,30,26,0,0,0,0,20130410,110,121,7,17,22,11,11,231,11,2012,0,2,1879,0
LA Lakers,33,28,27,25,0,0,0,0,Portland,41,28,21,16,0,0,0,0,20130410,113,106,-8,-8,-2,7,7,219,-7,2012,0,2,826,0
Milwaukee,16,29,21,29,8,0,0,0,Orlando,30,18,22,25,18,0,0,0,20130410,103,113,14,3,4,0,10,216,10,2012,1,2,1065,0
San Antonio,18,19,26,23,0,0,0,0,Denver,11,27,31,27,0,0,0,0,20130410,86,96,-7,1,6,10,10,182,10,2012,0,2,802,0
Phoenix,28,33,20,21,0,0,0,0,Dallas,21,30,20,20,0,0,0,0,20130410,102,91,7,10,10,11,11,193,-11,2012,0,2,884,0
Detroit,28,25,21,37,0,0,0,0,Cleveland,24,25,26,29,0,0,0,0,20130410,111,104,4,4,-1,7,7,215,-7,2012,0,2,90,0
Brooklyn,22,31,26,22,0,0,0,0,Boston,21,22,26,24,0,0,0,0,20130410,101,93,1,10,10,8,8,194,-8,2012,0,2,190,0
Minnesota,20,26,26,23,0,0,0,0,LA Clippers,26,32,30,23,0,0,0,0,20130410,95,111,6,12,16,16,16,206,16,2012,0,2,1521,0
New York,30,29,23,23,6,0,0,0,Chicago,23,31,26,25,13,0,0,0,20130411,111,118,-7,-5,-2,0,7,229,7,2012,1,3,711,0
Oklahoma City,31,29,36,20,0,0,0,0,Golden State,27,27,23,20,0,0,0,0,20130411,116,97,4,6,19,19,19,213,-19,2012,0,3,1386,0
Philadelphia,24,24,26,23,0,0,0,0,Washington,31,18,16,21,0,0,0,0,20130412,97,86,-7,-1,9,11,11,183,-11,2012,0,4,123,0
Minnesota,22,32,27,19,0,0,0,0,Utah,30,23,29,25,0,0,0,0,20130412,100,107,8,-1,1,7,7,207,7,2012,0,4,984,0
Chicago,22,21,22,23,0,0,0,0,Toronto,20,27,26,24,0,0,0,0,20130412,88,97,-2,4,8,9,9,185,9,2012,0,4,436,0
Sacramento,13,37,24,27,0,0,0,0,San Antonio,23,37,24,24,0,0,0,0,20130412,101,108,10,10,10,7,7,209,7,2012,0,4,1456,0
Oklahoma City,30,25,26,25,0,0,0,0,Portland,26,28,7,29,0,0,0,0,20130412,106,90,4,1,20,16,16,196,-16,2012,0,4,1484,0
LA Clippers,24,19,14,39,0,0,0,0,New Orleans,25,15,23,30,0,0,0,0,20130412,96,93,-1,3,-6,3,3,189,-3,2012,0,4,1669,0
Boston,27,23,25,26,0,0,0,0,Miami,17,41,29,22,0,0,0,0,20130412,101,109,-10,8,12,8,8,210,8,2012,0,4,1257,0
Golden State,32,25,33,26,0,0,0,0,LA Lakers,26,31,28,33,0,0,0,0,20130412,116,118,-6,0,-5,2,2,234,2,2012,0,4,347,0
Memphis,24,25,15,18,0,0,0,0,Houston,15,21,23,19,0,0,0,0,20130412,82,78,9,13,5,4,4,160,-4,2012,0,4,484,0
Charlotte,30,23,20,20,0,0,0,0,Detroit,23,36,28,26,0,0,0,0,20130412,93,113,-7,6,14,20,20,206,20,2012,0,4,504,0
Denver,26,29,22,22,6,0,0,0,Dallas,21,27,30,21,9,0,0,0,20130412,105,108,-5,-7,1,0,3,213,3,2012,1,4,661,0
New York,27,25,23,26,0,0,0,0,Cleveland,24,19,21,27,0,0,0,0,20130412,101,91,3,9,11,10,10,192,-10,2012,0,4,403,0
Milwaukee,30,24,28,22,0,0,0,0,Atlanta,24,16,35,34,0,0,0,0,20130412,104,109,-6,-14,-7,5,5,213,5,2012,0,4,669,0
Brooklyn,34,35,23,25,0,0,0,0,Indiana,27,23,35,24,0,0,0,0,20130412,117,109,7,19,7,8,8,226,-8,2012,0,4,643,0
Milwaukee,23,21,15,26,0,0,0,0,Charlotte,24,25,27,19,0,0,0,0,20130413,85,95,1,5,17,10,10,180,10,2012,0,5,658,0
LA Clippers,24,27,17,23,0,0,0,0,Memphis,23,28,22,14,0,0,0,0,20130413,91,87,1,0,-5,4,4,178,-4,2012,0,5,1599,0
Phoenix,28,25,20,20,0,0,0,0,Minnesota,22,28,27,28,0,0,0,0,20130413,93,105,-6,-3,4,12,12,198,12,2012,0,5,1278,0
Boston,23,34,28,35,0,0,0,0,Orlando,17,20,27,24,0,0,0,0,20130413,120,88,6,20,21,32,32,208,-32,2012,0,5,1115,0
Cleveland,19,15,17,26,0,0,0,0,Philadelphia,32,21,21,17,0,0,0,0,20130414,77,91,13,19,23,14,14,168,14,2012,0,6,358,0
Brooklyn,20,12,27,28,0,0,0,0,Toronto,24,27,19,23,0,0,0,0,20130414,87,93,4,19,11,6,6,180,6,2012,0,6,341,0
Dallas,33,29,19,26,0,0,0,0,New Orleans,19,21,27,22,0,0,0,0,20130414,107,89,14,22,14,18,18,196,-18,2012,0,6,442,0
Indiana,15,25,20,20,0,0,0,0,New York,23,24,22,21,0,0,0,0,20130414,80,90,8,7,9,10,10,170,10,2012,0,6,643,0
San Antonio,23,20,18,25,0,0,0,0,LA Lakers,22,21,18,30,0,0,0,0,20130414,86,91,-1,0,0,5,5,177,5,2012,0,6,1201,0
Chicago,22,32,23,16,0,0,0,0,Miami,30,26,30,19,0,0,0,0,20130414,93,105,8,2,9,12,12,198,12,2012,0,6,1189,0
Sacramento,24,20,32,24,0,0,0,0,Houston,33,29,32,27,0,0,0,0,20130414,100,121,9,18,18,21,21,221,21,2012,0,6,1606,0
Portland,21,29,28,31,0,0,0,0,Denver,37,30,22,29,0,0,0,0,20130414,109,118,16,17,11,9,9,227,9,2012,0,6,981,0
Houston,28,33,22,29,0,0,0,0,Phoenix,39,28,23,29,0,0,0,0,20130415,112,119,11,6,7,7,7,231,7,2012,0,0,1014,0
Chicago,21,28,28,25,0,0,0,0,Orlando,23,14,18,29,0,0,0,0,20130415,102,84,-2,12,22,18,18,186,-18,2012,0,0,984,0
Sacramento,19,24,24,28,0,0,0,0,Oklahoma City,25,29,29,21,0,0,0,0,20130415,95,104,6,11,16,9,9,199,9,2012,0,0,1336,0
Denver,32,24,25,31,0,0,0,0,Milwaukee,26,27,24,34,0,0,0,0,20130415,112,111,6,3,4,1,1,223,-1,2012,0,0,912,0
San Antonio,28,29,22,27,0,0,0,0,Golden State,27,27,28,34,0,0,0,0,20130415,106,116,-1,-3,3,10,10,222,10,2012,0,0,1487,0
Utah,26,23,22,25,0,0,0,0,Minnesota,18,23,19,20,0,0,0,0,20130415,96,80,8,8,11,16,16,176,-16,2012,0,0,984,0
Memphis,21,17,30,35,0,0,0,0,Dallas,29,17,21,30,0,0,0,0,20130415,103,97,-8,-8,1,6,6,200,-6,2012,0,0,419,0
Miami,18,31,31,16,0,0,0,0,Cleveland,22,30,19,24,0,0,0,0,20130415,96,95,-4,-3,9,1,1,191,-1,2012,0,0,1089,0
New York,17,28,22,28,0,0,0,0,Charlotte,30,24,30,22,0,0,0,0,20130415,95,106,13,9,17,11,11,201,11,2012,0,0,531,0
Washington,34,22,21,24,0,0,0,0,Brooklyn,21,29,23,33,0,0,0,0,20130415,101,106,-13,-6,-4,5,5,207,5,2012,0,0,204,0
Philadelphia,23,31,21,26,0,0,0,0,Detroit,30,21,33,25,0,0,0,0,20130415,101,109,7,-3,9,8,8,210,8,2012,0,0,441,0
Toronto,30,38,28,17,0,0,0,0,Atlanta,27,24,24,21,0,0,0,0,20130416,113,96,3,17,21,17,17,209,-17,2012,0,1,733,0
Portland,24,13,20,20,0,0,0,0,LA Clippers,28,26,28,11,0,0,0,0,20130416,77,93,4,17,25,16,16,170,16,2012,0,1,826,0
Orlando,20,27,27,19,0,0,0,0,Miami,29,26,30,20,0,0,0,0,20130417,93,105,9,8,11,12,12,198,12,2012,0,2,204,0
Minnesota,30,26,24,28,0,0,0,0,San Antonio,24,37,15,19,0,0,0,0,20130417,108,95,6,-5,4,13,13,203,-13,2012,0,2,1112,0
LA Clippers,27,27,24,34,0,0,0,0,Sacramento,26,20,24,38,0,0,0,0,20130417,112,108,1,8,8,4,4,220,-4,2012,0,2,361,0
Golden State,24,26,16,33,0,0,0,0,Portland,17,19,27,25,0,0,0,0,20130417,99,88,7,14,3,11,11,187,-11,2012,0,2,535,0
Boston,30,19,21,20,0,0,0,0,Toronto,31,28,37,18,0,0,0,0,20130417,90,114,1,10,26,24,24,204,24,2012,0,2,430,0
Atlanta,16,23,29,24,0,0,0,0,New York,25,20,29,24,0,0,0,0,20130417,92,98,9,6,6,6,6,190,6,2012,0,2,745,0
Utah,17,21,13,19,0,0,0,0,Memphis,17,23,25,21,0,0,0,0,20130417,70,86,0,2,14,16,16,156,16,2012,0,2,1247,0
Milwaukee,21,24,23,27,0,0,0,0,Oklahoma City,30,21,19,19,0,0,0,0,20130417,95,89,-9,-6,-2,6,6,184,-6,2012,0,2,732,0
Philadelphia,25,34,26,20,0,0,0,0,Indiana,16,21,31,27,0,0,0,0,20130417,105,95,9,22,17,10,10,200,-10,2012,0,2,582,0
Phoenix,20,20,29,29,0,0,0,0,Denver,35,31,25,27,0,0,0,0,20130417,98,118,15,26,22,20,20,216,20,2012,0,2,585,0
New Orleans,18,21,25,23,0,0,0,0,Dallas,19,28,28,24,0,0,0,0,20130417,87,99,1,8,11,12,12,186,12,2012,0,2,442,0
Washington,15,32,21,24,0,0,0,0,Chicago,31,21,22,21,0,0,0,0,20130417,92,95,16,5,6,3,3,187,3,2012,0,2,594,0
Cleveland,16,31,22,29,0,0,0,0,Charlotte,34,19,23,29,0,0,0,0,20130417,98,105,18,6,7,7,7,203,7,2012,0,2,435,0
Detroit,18,30,18,33,0,0,0,0,Brooklyn,29,31,23,20,0,0,0,0,20130417,99,103,11,12,17,4,4,202,4,2012,0,2,480,0
Houston,24,26,21,19,5,0,0,0,LA Lakers,21,23,22,24,9,0,0,0,20130417,95,99,-3,-6,-5,0,4,194,4,2012,1,2,1371,0
Chicago,14,21,27,27,0,0,0,0,Brooklyn,25,35,29,17,0,0,0,0,20130420,89,106,11,25,27,17,17,195,17,2012,0,5,711,1
Golden State,25,23,16,31,0,0,0,0,Denver,28,16,27,26,0,0,0,0,20130420,95,97,3,-4,7,2,2,192,2,2012,0,5,947,1
Memphis,21,30,18,22,0,0,0,0,LA Clippers,29,28,18,37,0,0,0,0,20130420,91,112,8,6,6,21,21,203,21,2012,0,5,1599,1
Boston,29,24,17,8,0,0,0,0,New York,26,23,18,18,0,0,0,0,20130420,78,85,-3,-4,-3,7,7,163,7,2012,0,5,190,1
Atlanta,26,24,19,21,0,0,0,0,Indiana,34,24,26,23,0,0,0,0,20130421,90,107,8,8,15,17,17,197,17,2012,0,6,427,1
Milwaukee,24,21,20,22,0,0,0,0,Miami,26,26,28,30,0,0,0,0,20130421,87,110,2,7,15,23,23,197,23,2012,0,6,1269,1
Houston,19,28,19,25,0,0,0,0,Oklahoma City,26,34,29,31,0,0,0,0,20130421,91,120,7,13,23,29,29,211,29,2012,0,6,413,1
LA Lakers,15,22,20,22,0,0,0,0,San Antonio,24,21,25,21,0,0,0,0,20130421,79,91,9,8,13,12,12,170,12,2012,0,6,1201,1
Memphis,26,18,27,20,0,0,0,0,LA Clippers,26,24,25,18,0,0,0,0,20130422,91,93,0,6,4,2,2,184,2,2012,0,0,1599,1
Chicago,20,27,22,21,0,0,0,0,Brooklyn,17,29,11,25,0,0,0,0,20130422,90,82,3,1,12,8,8,172,-8,2012,0,0,711,1
Golden State,26,35,35,35,0,0,0,0,Denver,28,25,27,37,0,0,0,0,20130423,131,117,-2,8,16,14,14,248,-14,2012,0,1,947,1
Milwaukee,23,20,22,21,0,0,0,0,Miami,25,22,21,30,0,0,0,0,20130423,86,98,2,4,3,12,12,184,12,2012,0,1,1269,1
Boston,20,28,11,12,0,0,0,0,New York,26,16,32,13,0,0,0,0,20130423,71,87,6,-6,15,16,16,158,16,2012,0,1,190,1
Atlanta,19,31,26,22,0,0,0,0,Indiana,28,31,29,25,0,0,0,0,20130424,98,113,9,9,12,15,15,211,15,2012,0,2,427,1
Houston,28,27,17,30,0,0,0,0,Oklahoma City,29,28,21,27,0,0,0,0,20130424,102,105,1,2,6,3,3,207,3,2012,0,2,413,1
LA Lakers,23,25,20,23,0,0,0,0,San Antonio,28,28,22,24,0,0,0,0,20130424,91,102,5,8,10,11,11,193,11,2012,0,2,1201,1
Brooklyn,17,17,18,24,0,0,0,0,Chicago,19,22,24,14,0,0,0,0,20130425,76,79,2,7,13,3,3,155,3,2012,0,3,711,1
LA Clippers,20,19,23,20,0,0,0,0,Memphis,23,24,23,24,0,0,0,0,20130425,82,94,3,8,8,12,12,176,12,2012,0,3,1599,1
Miami,21,27,30,26,0,0,0,0,Milwaukee,30,20,18,23,0,0,0,0,20130425,104,91,-9,-2,10,13,13,195,-13,2012,0,3,1269,1
New York,23,24,21,22,0,0,0,0,Boston,18,13,21,24,0,0,0,0,20130426,90,76,5,16,16,14,14,166,-14,2012,0,4,190,1
Denver,32,34,18,24,0,0,0,0,Golden State,32,22,33,23,0,0,0,0,20130426,108,110,0,-12,3,2,2,218,2,2012,0,4,947,1
San Antonio,30,25,30,35,0,0,0,0,LA Lakers,18,26,19,26,0,0,0,0,20130426,120,89,12,11,22,31,31,209,-31,2012,0,4,1201,1
LA Clippers,25,22,20,16,0,0,0,0,Memphis,33,13,25,33,0,0,0,0,20130427,83,104,8,-1,4,21,21,187,21,2012,0,5,1599,1
Oklahoma City,39,27,14,24,0,0,0,0,Houston,19,30,27,25,0,0,0,0,20130427,104,101,20,17,4,3,3,205,-3,2012,0,5,413,1
Indiana,14,16,19,20,0,0,0,0,Atlanta,27,27,21,15,0,0,0,0,20130427,69,90,13,24,26,21,21,159,21,2012,0,5,427,1
Brooklyn,26,29,29,27,10,6,7,0,Chicago,25,33,18,35,10,6,15,0,20130427,134,142,-1,3,-8,0,8,276,8,2012,3,5,711,1
New York,17,18,30,19,6,0,0,0,Boston,22,32,14,16,13,0,0,0,20130428,90,97,5,19,3,0,7,187,7,2012,1,6,190,1
Denver,21,23,28,29,0,0,0,0,Golden State,25,31,35,24,0,0,0,0,20130428,101,115,4,12,19,14,14,216,14,2012,0,6,947,1
San Antonio,26,26,26,25,0,0,0,0,LA Lakers,20,14,24,24,0,0,0,0,20130428,103,82,6,18,20,21,21,185,-21,2012,0,6,1201,1
Miami,24,21,22,21,0,0,0,0,Milwaukee,17,24,21,15,0,0,0,0,20130428,88,77,7,4,5,11,11,165,-11,2012,0,6,1269,1
Indiana,21,19,22,29,0,0,0,0,Atlanta,22,35,12,33,0,0,0,0,20130429,91,102,1,17,7,11,11,193,11,2012,0,0,427,1
Chicago,21,23,29,18,0,0,0,0,Brooklyn,26,26,25,33,0,0,0,0,20130429,91,110,5,8,4,19,19,201,19,2012,0,0,711,1
Oklahoma City,24,36,24,19,0,0,0,0,Houston,29,24,38,14,0,0,0,0,20130429,103,105,5,-7,7,2,2,208,2,2012,0,0,413,1
Golden State,22,24,23,31,0,0,0,0,Denver,36,30,20,21,0,0,0,0,20130430,100,107,14,20,17,7,7,207,7,2012,0,1,947,1
Memphis,26,28,19,30,0,0,0,0,LA Clippers,28,20,17,28,0,0,0,0,20130430,103,93,-2,6,8,10,10,196,-10,2012,0,1,1599,1
Atlanta,22,21,24,16,0,0,0,0,Indiana,21,29,31,25,0,0,0,0,20130501,83,106,-1,7,14,23,23,189,23,2012,0,2,427,1
Boston,20,25,24,23,0,0,0,0,New York,22,17,21,26,0,0,0,0,20130501,92,86,-2,6,9,6,6,178,-6,2012,0,2,190,1
Houston,30,20,37,20,0,0,0,0,Oklahoma City,26,17,32,25,0,0,0,0,20130501,107,100,4,7,12,7,7,207,-7,2012,0,2,413,1
Denver,25,17,20,26,0,0,0,0,Golden State,21,19,33,19,0,0,0,0,20130502,88,92,-4,-2,11,4,4,180,4,2012,0,3,947,1
Brooklyn,33,27,15,20,0,0,0,0,Chicago,27,27,17,21,0,0,0,0,20130502,95,92,6,6,4,3,3,187,-3,2012,0,3,711,1
Indiana,21,16,28,16,0,0,0,0,Atlanta,20,9,21,23,0,0,0,0,20130503,81,73,1,8,15,8,8,154,-8,2012,0,4,427,1
New York,24,15,28,21,0,0,0,0,Boston,10,17,20,33,0,0,0,0,20130503,88,80,14,12,20,8,8,168,-8,2012,0,4,190,1
Oklahoma City,26,32,20,25,0,0,0,0,Houston,29,25,23,17,0,0,0,0,20130503,103,94,-3,4,1,9,9,197,-9,2012,0,4,413,1
LA Clippers,26,27,26,26,0,0,0,0,Memphis,29,29,34,26,0,0,0,0,20130503,105,118,3,5,13,13,13,223,13,2012,0,4,1599,1
Chicago,29,32,21,17,0,0,0,0,Brooklyn,25,19,31,18,0,0,0,0,20130504,99,93,4,17,7,6,6,192,-6,2012,0,5,711,1
Indiana,22,30,29,21,0,0,0,0,New York,27,19,19,30,0,0,0,0,20130505,102,95,-5,6,16,7,7,197,-7,2012,0,6,643,1
Memphis,16,30,27,18,0,0,0,0,Oklahoma City,14,33,17,29,0,0,0,0,20130505,91,93,-2,1,-9,2,2,184,2,2012,0,6,421,1
Chicago,21,16,21,35,0,0,0,0,Miami,15,22,25,24,0,0,0,0,20130506,93,86,6,0,-4,7,7,179,-7,2012,0,0,1189,1
Golden State,28,25,39,14,9,12,0,0,San Antonio,25,24,31,26,9,14,0,0,20130506,127,129,-3,-4,-12,0,2,256,2,2012,2,0,1487,1
Indiana,20,22,24,13,0,0,0,0,New York,29,18,25,33,0,0,0,0,20130507,79,105,9,5,6,26,26,184,26,2012,0,1,643,1
Memphis,23,31,15,30,0,0,0,0,Oklahoma City,21,30,23,19,0,0,0,0,20130507,99,93,2,3,-5,6,6,192,-6,2012,0,1,421,1
Golden State,28,34,21,17,0,0,0,0,San Antonio,23,20,29,19,0,0,0,0,20130508,100,91,5,19,11,9,9,191,-9,2012,0,2,1487,1
Chicago,20,21,15,22,0,0,0,0,Miami,25,30,30,30,0,0,0,0,20130508,78,115,5,14,29,37,37,193,37,2012,0,2,1189,1
Miami,25,27,18,34,0,0,0,0,Chicago,25,25,20,24,0,0,0,0,20130510,104,94,0,2,0,10,10,198,-10,2012,0,4,1189,1
San Antonio,32,25,22,23,0,0,0,0,Golden State,23,25,21,23,0,0,0,0,20130510,102,92,9,9,10,10,10,194,-10,2012,0,4,1487,1
New York,15,18,20,18,0,0,0,0,Indiana,18,18,26,20,0,0,0,0,20130511,71,82,3,3,9,11,11,153,11,2012,0,5,643,1
Oklahoma City,18,27,15,21,0,0,0,0,Memphis,22,22,22,21,0,0,0,0,20130511,81,87,4,-1,6,6,6,168,6,2012,0,5,421,1
San Antonio,26,19,17,22,3,0,0,0,Golden State,19,18,23,24,13,0,0,0,20130512,87,97,-7,-8,-2,0,10,184,10,2012,1,6,1487,1
Miami,21,23,17,27,0,0,0,0,Chicago,15,18,9,23,0,0,0,0,20130513,88,65,6,11,19,23,23,153,-23,2012,0,0,1189,1
Oklahoma City,29,27,20,18,3,0,0,0,Memphis,18,30,28,18,9,0,0,0,20130513,97,103,-11,-8,0,0,6,200,6,2012,1,0,421,1
New York,16,18,22,26,0,0,0,0,Indiana,23,25,19,26,0,0,0,0,20130514,82,93,7,14,11,11,11,175,11,2012,0,1,643,1
Golden State,28,23,21,19,0,0,0,0,San Antonio,37,17,29,26,0,0,0,0,20130514,91,109,9,3,11,18,18,200,18,2012,0,1,1487,1
Chicago,21,32,24,14,0,0,0,0,Miami,30,17,22,25,0,0,0,0,20130515,91,94,9,-6,-8,3,3,185,3,2012,0,2,1189,1
Memphis,18,32,14,24,0,0,0,0,Oklahoma City,23,15,24,22,0,0,0,0,20130515,88,84,-5,12,2,4,4,172,-4,2012,0,2,421,1
Indiana,15,19,23,18,0,0,0,0,New York,19,21,27,18,0,0,0,0,20130516,75,85,4,6,10,10,10,160,10,2012,0,3,643,1
San Antonio,21,26,19,28,0,0,0,0,Golden State,19,21,19,23,0,0,0,0,20130516,94,82,2,7,7,12,12,176,-12,2012,0,3,1487,1
New York,27,20,34,18,0,0,0,0,Indiana,29,26,26,25,0,0,0,0,20130518,99,106,2,8,0,7,7,205,7,2012,0,5,643,1
Memphis,14,23,20,26,0,0,0,0,San Antonio,31,20,22,32,0,0,0,0,20130519,83,105,17,14,16,22,22,188,22,2012,0,6,631,1
Memphis,13,18,33,21,4,0,0,0,San Antonio,15,31,30,9,8,0,0,0,20130521,89,93,2,15,12,0,4,182,4,2012,1,1,631,1
Indiana,21,21,23,27,10,0,0,0,Miami,22,15,27,28,11,0,0,0,20130522,102,103,1,-5,-1,0,1,205,1,2012,1,2,1026,1
Indiana,28,25,23,21,0,0,0,0,Miami,22,25,27,19,0,0,0,0,20130524,97,93,6,6,2,4,4,190,-4,2012,0,4,1026,1
San Antonio,13,27,24,22,18,0,0,0,Memphis,29,15,21,21,7,0,0,0,20130525,104,93,-16,-4,-1,0,11,197,-11,2012,1,5,631,1
Miami,34,36,21,23,0,0,0,0,Indiana,30,26,20,20,0,0,0,0,20130526,114,96,4,14,15,18,18,210,-18,2012,0,6,1026,1
San Antonio,24,20,28,21,0,0,0,0,Memphis,14,24,28,20,0,0,0,0,20130527,93,86,10,6,6,7,7,179,-7,2012,0,0,631,1
Miami,22,25,23,22,0,0,0,0,Indiana,26,22,29,22,0,0,0,0,20130528,92,99,4,1,7,7,7,191,7,2012,0,1,1026,1
Indiana,23,21,13,22,0,0,0,0,Miami,19,21,30,20,0,0,0,0,20130530,79,90,-4,-4,13,11,11,169,11,2012,0,3,1026,1
Miami,23,17,15,22,0,0,0,0,Indiana,21,18,29,23,0,0,0,0,20130601,77,91,-2,-1,13,14,14,168,14,2012,0,5,1026,1
Indiana,21,16,18,21,0,0,0,0,Miami,19,33,24,23,0,0,0,0,20130603,76,99,-2,15,21,23,23,175,23,2012,0,0,1026,1
San Antonio,23,26,20,23,0,0,0,0,Miami,24,28,20,16,0,0,0,0,20130606,92,88,-1,-3,-3,4,4,180,-4,2012,0,3,1147,1
San Antonio,22,23,20,19,0,0,0,0,Miami,22,28,25,28,0,0,0,0,20130609,84,103,0,5,10,19,19,187,19,2012,0,6,1147,1
Miami,20,24,19,14,0,0,0,0,San Antonio,24,26,28,35,0,0,0,0,20130611,77,113,4,6,15,36,36,190,36,2012,0,1,1147,1
Miami,29,20,32,28,0,0,0,0,San Antonio,26,23,27,17,0,0,0,0,20130613,109,93,3,0,5,16,16,202,-16,2012,0,3,1147,1
Miami,19,33,23,29,0,0,0,0,San Antonio,32,29,26,27,0,0,0,0,20130616,104,114,13,9,12,10,10,218,10,2012,0,6,1147,1
San Antonio,25,25,25,20,5,0,0,0,Miami,27,17,21,30,8,0,0,0,20130618,100,103,2,-6,-10,0,3,203,3,2012,1,1,1147,1
San Antonio,16,28,27,17,0,0,0,0,Miami,18,28,26,23,0,0,0,0,20130620,88,95,2,2,1,7,7,183,7,2012,0,3,1147,1
Orlando,18,26,20,23,0,0,0,0,Indiana,23,17,29,28,0,0,0,0,20131029,87,97,5,-4,5,10,10,184,10,2013,0,1,822,0
LA Clippers,30,27,22,24,0,0,0,0,LA Lakers,28,27,20,41,0,0,0,0,20131029,103,116,-2,-2,-4,13,13,219,13,2013,0,1,0,0
Chicago,15,18,25,37,0,0,0,0,Miami,17,37,24,29,0,0,0,0,20131029,95,107,2,21,20,12,12,202,12,2013,0,1,1189,0
Oklahoma City,29,28,24,20,0,0,0,0,Utah,29,19,25,25,0,0,0,0,20131030,101,98,0,9,8,3,3,199,-3,2013,0,2,861,0
Boston,26,11,34,16,0,0,0,0,Toronto,21,28,22,22,0,0,0,0,20131030,87,93,-5,12,0,6,6,180,6,2013,0,2,430,0
Memphis,20,7,31,36,0,0,0,0,San Antonio,18,30,24,29,0,0,0,0,20131030,94,101,-2,21,14,7,7,195,7,2013,0,2,631,0
Denver,22,23,27,16,0,0,0,0,Sacramento,25,23,22,20,0,0,0,0,20131030,88,90,3,3,-2,2,2,178,2,2013,0,2,886,0
Portland,16,30,23,22,0,0,0,0,Phoenix,30,20,31,23,0,0,0,0,20131030,91,104,14,4,12,13,13,195,13,2013,0,2,1005,0
Miami,14,35,45,16,0,0,0,0,Philadelphia,33,18,34,29,0,0,0,0,20131030,110,114,19,2,-9,4,4,224,4,2013,0,2,1021,0
Milwaukee,18,13,33,19,0,0,0,0,New York,24,32,18,16,0,0,0,0,20131030,83,90,6,25,10,7,7,173,7,2013,0,2,732,0
Indiana,14,22,23,36,0,0,0,0,New Orleans,24,26,16,24,0,0,0,0,20131030,95,90,-10,-14,-7,5,5,185,-5,2013,0,2,713,0
Orlando,27,25,28,23,12,0,0,0,Minnesota,38,22,27,16,17,0,0,0,20131030,115,120,11,8,7,0,5,235,5,2013,1,2,1309,0
Charlotte,19,20,22,22,0,0,0,0,Houston,17,28,22,29,0,0,0,0,20131030,83,96,-2,6,6,13,13,179,13,2013,0,2,925,0
LA Lakers,16,24,23,31,0,0,0,0,Golden State,26,33,37,29,0,0,0,0,20131030,94,125,10,19,33,31,31,219,31,2013,0,2,347,0
Washington,22,21,30,29,0,0,0,0,Detroit,25,30,26,32,0,0,0,0,20131030,102,113,3,12,8,11,11,215,11,2013,0,2,394,0
Atlanta,28,27,24,30,0,0,0,0,Dallas,33,20,33,32,0,0,0,0,20131030,109,118,5,-2,7,9,9,227,9,2013,0,2,719,0
Brooklyn,26,22,22,24,0,0,0,0,Cleveland,27,22,30,19,0,0,0,0,20131030,94,98,1,1,9,4,4,192,4,2013,0,2,403,0
New York,16,22,23,20,0,0,0,0,Chicago,26,17,28,11,0,0,0,0,20131031,81,82,10,5,10,1,1,163,1,2013,0,3,711,0
Golden State,26,29,25,35,0,0,0,0,LA Clippers,36,32,25,33,0,0,0,0,20131031,115,126,10,13,13,11,11,241,11,2013,0,3,347,0
Philadelphia,21,23,30,35,0,0,0,0,Washington,33,21,20,28,0,0,0,0,20131101,109,102,-12,-10,0,7,7,211,-7,2013,0,4,123,0
LA Clippers,24,30,25,31,0,0,0,0,Sacramento,22,23,32,24,0,0,0,0,20131101,110,101,2,9,2,9,9,211,-9,2013,0,4,361,0
Utah,23,23,16,22,0,0,0,0,Phoenix,29,14,20,24,0,0,0,0,20131101,84,87,6,-3,1,3,3,171,3,2013,0,4,505,0
New Orleans,20,15,25,30,0,0,0,0,Orlando,22,31,32,25,0,0,0,0,20131101,90,110,2,18,25,20,20,200,20,2013,0,4,533,0
Oklahoma City,19,20,21,21,0,0,0,0,Minnesota,34,25,29,12,0,0,0,0,20131101,81,100,15,20,28,19,19,181,19,2013,0,4,694,0
Detroit,21,20,28,26,13,0,0,0,Memphis,17,30,20,28,16,0,0,0,20131101,108,111,-4,6,-2,0,3,219,3,2013,1,4,622,0
Milwaukee,16,31,24,34,0,0,0,0,Boston,29,34,20,15,0,0,0,0,20131101,105,98,-13,-16,-12,7,7,203,-7,2013,0,4,855,0
Dallas,22,28,22,33,0,0,0,0,Houston,38,23,24,28,0,0,0,0,20131101,105,113,16,11,13,8,8,218,8,2013,0,4,225,0
Portland,24,40,27,22,0,0,0,0,Denver,23,27,21,27,0,0,0,0,20131101,113,98,1,14,20,15,15,211,-15,2013,0,4,981,0
Cleveland,23,26,17,18,0,0,0,0,Charlotte,30,24,21,15,0,0,0,0,20131101,84,90,7,5,9,6,6,174,6,2013,0,4,435,0
Miami,18,29,20,33,0,0,0,0,Brooklyn,27,20,31,23,0,0,0,0,20131101,100,101,9,0,11,1,1,201,1,2013,0,4,1091,0
Toronto,24,15,29,27,0,0,0,0,Atlanta,25,24,30,23,0,0,0,0,20131101,95,102,1,10,11,7,7,197,7,2013,0,4,733,0
San Antonio,16,25,22,28,0,0,0,0,LA Lakers,23,19,19,24,0,0,0,0,20131101,91,85,-7,-1,2,6,6,176,-6,2013,0,4,1201,0
Houston,16,24,33,31,0,0,0,0,Utah,24,32,17,20,0,0,0,0,20131102,104,93,-8,-16,0,11,11,197,-11,2013,0,5,1199,0
San Antonio,19,20,35,31,0,0,0,0,Portland,21,29,32,33,0,0,0,0,20131102,105,115,2,11,8,10,10,220,10,2013,0,5,1718,0
Chicago,34,30,19,21,0,0,0,0,Philadelphia,22,27,33,25,0,0,0,0,20131102,104,107,-12,-15,-1,3,3,211,3,2013,0,5,664,0
Charlotte,15,26,21,22,0,0,0,0,New Orleans,33,23,21,28,0,0,0,0,20131102,84,105,18,15,15,21,21,189,21,2013,0,5,648,0
Cleveland,16,21,18,19,0,0,0,0,Indiana,21,22,19,27,0,0,0,0,20131102,74,89,5,6,7,15,15,163,15,2013,0,5,262,0
Sacramento,17,19,23,28,0,0,0,0,Golden State,27,29,23,19,0,0,0,0,20131102,87,98,10,20,20,11,11,185,11,2013,0,5,75,0
Memphis,16,27,20,36,0,0,0,0,Dallas,32,17,24,38,0,0,0,0,20131102,99,111,16,6,10,12,12,210,12,2013,0,5,419,0
Toronto,25,26,26,20,0,0,0,0,Milwaukee,19,27,19,25,0,0,0,0,20131102,97,90,6,5,12,7,7,187,-7,2013,0,5,429,0
Boston,21,14,23,19,0,0,0,0,Detroit,24,21,18,24,0,0,0,0,20131103,77,87,3,10,5,10,10,164,10,2013,0,6,611,0
Atlanta,22,27,27,27,0,0,0,0,LA Lakers,33,29,26,17,0,0,0,0,20131103,103,105,11,13,12,2,2,208,2,2013,0,6,1932,0
Washington,27,21,16,29,0,0,0,0,Miami,33,28,26,16,0,0,0,0,20131103,93,103,6,13,23,10,10,196,10,2013,0,6,924,0
Minnesota,40,24,29,16,0,0,0,0,New York,19,30,29,22,0,0,0,0,20131103,109,100,21,15,15,9,9,209,-9,2013,0,6,1016,0
Phoenix,24,21,25,26,0,0,0,0,Oklahoma City,21,23,23,36,0,0,0,0,20131103,96,103,-3,-1,-3,7,7,199,7,2013,0,6,840,0
Brooklyn,22,16,21,27,0,0,0,0,Orlando,22,19,33,33,0,0,0,0,20131103,86,107,0,3,15,21,21,193,21,2013,0,6,939,0
Golden State,36,30,32,12,0,0,0,0,Philadelphia,22,20,23,25,0,0,0,0,20131104,110,90,14,24,33,20,20,200,-20,2013,0,0,2516,0
Boston,24,26,22,16,0,0,0,0,Memphis,27,19,20,29,0,0,0,0,20131104,88,95,3,-4,-6,7,7,183,7,2013,0,0,1134,0
Houston,25,41,23,29,0,0,0,0,LA Clippers,42,36,26,33,0,0,0,0,20131104,118,137,17,12,15,19,19,255,19,2013,0,0,1371,0
Minnesota,23,15,23,31,0,0,0,0,Cleveland,31,24,21,17,0,0,0,0,20131104,92,93,8,17,15,1,1,185,1,2013,0,0,629,0
Utah,18,20,23,27,0,0,0,0,Brooklyn,28,26,31,19,0,0,0,0,20131105,88,104,10,16,24,16,16,192,16,2013,0,1,1967,0
LA Lakers,22,26,29,27,0,0,0,0,Dallas,35,32,27,29,0,0,0,0,20131105,104,123,13,19,17,19,19,227,19,2013,0,1,1237,0
San Antonio,24,19,29,30,0,0,0,0,Denver,27,25,26,16,0,0,0,0,20131105,102,94,-3,-9,-6,8,8,196,-8,2013,0,1,802,0
Indiana,29,9,36,25,0,0,0,0,Detroit,14,27,22,28,0,0,0,0,20131105,99,91,15,-3,11,8,8,190,-8,2013,0,1,240,0
Phoenix,17,24,37,26,0,0,0,0,New Orleans,28,17,24,29,0,0,0,0,20131105,104,98,-11,-4,9,6,6,202,-6,2013,0,1,1312,0
Charlotte,31,33,18,20,0,0,0,0,New York,28,26,22,21,0,0,0,0,20131105,102,97,3,10,6,5,5,199,-5,2013,0,1,531,0
Houston,30,25,29,32,0,0,0,0,Portland,31,19,23,28,0,0,0,0,20131105,116,101,-1,5,11,15,15,217,-15,2013,0,1,1833,0
Atlanta,25,29,28,23,0,0,0,0,Sacramento,32,13,20,35,0,0,0,0,20131105,105,100,-7,9,17,5,5,205,-5,2013,0,1,2082,0
Miami,23,29,26,26,0,0,0,0,Toronto,25,25,24,21,0,0,0,0,20131105,104,95,-2,2,4,9,9,199,-9,2013,0,1,1234,0
Phoenix,21,32,20,23,0,0,0,0,San Antonio,29,22,22,26,0,0,0,0,20131106,96,99,8,-2,0,3,3,195,3,2013,0,2,846,0
Washington,39,21,29,27,0,0,0,0,Philadelphia,27,24,25,26,0,0,0,0,20131106,116,102,12,9,13,14,14,218,-14,2013,0,2,123,0
LA Clippers,20,22,32,16,0,0,0,0,Orlando,29,28,15,26,0,0,0,0,20131106,90,98,9,15,-2,8,8,188,8,2013,0,2,2197,0
Dallas,31,20,24,18,0,0,0,0,Oklahoma City,33,24,28,22,0,0,0,0,20131106,93,107,2,6,10,14,14,200,14,2013,0,2,189,0
Golden State,26,24,29,27,0,0,0,0,Minnesota,28,19,24,22,0,0,0,0,20131106,106,93,-2,3,8,13,13,199,-13,2013,0,2,1581,0
Cleveland,23,30,26,25,0,0,0,0,Milwaukee,30,25,28,26,0,0,0,0,20131106,104,109,7,2,4,5,5,213,5,2013,0,2,334,0
New Orleans,33,18,28,20,0,0,0,0,Memphis,18,23,16,27,0,0,0,0,20131106,99,84,15,10,22,15,15,183,-15,2013,0,2,358,0
Chicago,19,24,19,18,0,0,0,0,Indiana,25,12,26,34,0,0,0,0,20131106,80,97,6,-6,1,17,17,177,17,2013,0,2,163,0
Toronto,18,35,17,20,0,0,0,0,Charlotte,32,21,23,16,0,0,0,0,20131106,90,92,14,0,6,2,2,182,2,2013,0,2,585,0
Utah,26,8,28,25,0,0,0,0,Boston,23,27,34,13,0,0,0,0,20131106,87,97,-3,16,22,10,10,184,10,2013,0,2,2093,0
Atlanta,26,25,32,24,0,0,0,0,Denver,26,28,29,26,0,0,0,0,20131107,107,109,0,3,0,2,2,216,2,2013,0,3,1209,0
LA Lakers,36,28,17,18,0,0,0,0,Houston,19,31,27,21,0,0,0,0,20131107,99,98,17,14,4,1,1,197,-1,2013,0,3,1371,0
LA Clippers,31,25,17,24,0,0,0,0,Miami,28,24,24,26,0,0,0,0,20131107,97,102,-3,-4,3,5,5,199,5,2013,0,3,2335,0
Brooklyn,33,25,15,26,9,0,0,0,Washington,27,26,20,26,13,0,0,0,20131108,108,112,-6,-5,0,0,4,220,4,2013,1,4,204,0
Golden State,20,13,22,19,0,0,0,0,San Antonio,27,13,24,12,0,0,0,0,20131108,74,76,7,7,9,2,2,150,2,2013,0,4,1487,0
Sacramento,22,27,17,25,0,0,0,0,Portland,29,25,23,27,0,0,0,0,20131108,91,104,7,5,11,13,13,195,13,2013,0,4,483,0
Denver,29,18,40,16,0,0,0,0,Phoenix,35,29,20,30,0,0,0,0,20131108,103,114,6,17,-3,11,11,217,11,2013,0,4,585,0
Cleveland,28,14,19,18,0,0,0,0,Philadelphia,14,30,33,17,0,0,0,0,20131108,79,94,-14,2,16,15,15,173,15,2013,0,4,358,0
Boston,17,29,25,20,0,0,0,0,Orlando,24,25,19,21,0,0,0,0,20131108,91,89,-7,-3,3,2,2,180,-2,2013,0,4,1115,0
Oklahoma City,20,35,29,35,0,0,0,0,Detroit,22,29,25,34,0,0,0,0,20131108,119,110,-2,4,8,9,9,229,-9,2013,0,4,909,0
Dallas,24,32,25,27,0,0,0,0,Minnesota,28,27,30,31,0,0,0,0,20131108,108,116,4,-1,4,8,8,224,8,2013,0,4,863,0
Toronto,32,14,13,25,0,0,0,0,Indiana,22,22,28,19,0,0,0,0,20131108,84,91,-10,-2,13,7,7,175,7,2013,0,4,438,0
Utah,18,22,16,17,0,0,0,0,Chicago,30,21,27,19,0,0,0,0,20131108,73,97,12,11,22,24,24,170,24,2013,0,4,1256,0
New York,28,23,34,16,0,0,0,0,Charlotte,22,25,22,22,0,0,0,0,20131108,101,91,6,4,16,10,10,192,-10,2013,0,4,531,0
LA Lakers,27,21,18,19,0,0,0,0,New Orleans,28,27,14,27,0,0,0,0,20131108,85,96,1,7,3,11,11,181,11,2013,0,4,1669,0
Utah,16,20,24,31,0,0,0,0,Toronto,30,32,29,24,0,0,0,0,20131109,91,115,14,26,31,24,24,206,24,2013,0,5,1664,0
Portland,21,24,24,27,0,0,0,0,Sacramento,18,20,16,31,0,0,0,0,20131109,96,85,3,7,15,11,11,181,-11,2013,0,5,483,0
Dallas,34,21,13,23,0,0,0,0,Milwaukee,19,21,24,19,0,0,0,0,20131109,91,83,15,15,4,8,8,174,-8,2013,0,5,857,0
Golden State,29,21,27,13,0,0,0,0,Memphis,32,22,36,18,0,0,0,0,20131109,90,108,3,4,13,18,18,198,18,2013,0,5,1798,0
Boston,25,35,20,31,0,0,0,0,Miami,31,28,23,28,0,0,0,0,20131109,111,110,-6,1,-2,1,1,221,-1,2013,0,5,1257,0
Philadelphia,27,21,37,22,9,9,0,0,Cleveland,30,23,22,32,9,11,0,0,20131109,125,127,3,5,-10,0,2,252,2,2013,2,5,358,0
Indiana,23,21,28,24,0,0,0,0,Brooklyn,21,25,21,24,0,0,0,0,20131109,96,91,2,-2,5,5,5,187,-5,2013,0,5,643,0
Orlando,22,23,26,23,0,0,0,0,Atlanta,28,18,26,32,0,0,0,0,20131109,94,104,6,1,1,10,10,198,10,2013,0,5,401,0
LA Clippers,22,24,27,34,0,0,0,0,Houston,26,29,16,23,0,0,0,0,20131109,107,94,-4,-9,2,13,13,201,-13,2013,0,5,1371,0
Minnesota,47,20,23,23,0,0,0,0,LA Lakers,23,25,28,14,0,0,0,0,20131110,113,90,24,19,14,23,23,203,-23,2013,0,6,1521,0
San Antonio,35,26,29,30,0,0,0,0,New York,17,28,15,29,0,0,0,0,20131110,120,89,18,16,30,31,31,209,-31,2013,0,6,1581,0
Washington,24,18,31,23,9,0,0,0,Oklahoma City,27,10,28,31,10,0,0,0,20131110,105,106,3,-5,-8,0,1,211,1,2013,1,6,1149,0
New Orleans,16,22,27,29,0,0,0,0,Phoenix,19,23,29,30,0,0,0,0,20131110,94,101,3,4,6,7,7,195,7,2013,0,6,1312,0
San Antonio,31,26,26,26,0,0,0,0,Philadelphia,13,25,26,21,0,0,0,0,20131111,109,85,18,19,19,24,24,194,-24,2013,0,0,1505,0
Denver,20,26,24,30,0,0,0,0,Utah,26,19,23,13,0,0,0,0,20131111,100,81,-6,1,2,19,19,181,-19,2013,0,0,370,0
Detroit,30,25,23,25,0,0,0,0,Portland,34,24,25,26,0,0,0,0,20131111,103,109,4,3,5,6,6,212,6,2013,0,0,1964,0
Memphis,16,23,16,24,0,0,0,0,Indiana,23,23,26,23,0,0,0,0,20131111,79,95,7,7,17,16,16,174,16,2013,0,0,383,0
Minnesota,26,32,22,27,0,0,0,0,LA Clippers,23,36,26,24,0,0,0,0,20131111,107,109,-3,1,5,2,2,216,2,2013,0,0,1521,0
Toronto,20,13,29,25,8,9,0,0,Houston,24,23,24,16,8,15,0,0,20131111,104,110,4,14,9,0,6,214,6,2013,2,0,1299,0
Cleveland,17,19,24,21,0,0,0,0,Chicago,20,25,19,32,0,0,0,0,20131111,81,96,3,9,4,15,15,177,15,2013,0,0,308,0
Atlanta,26,20,34,23,0,0,0,0,Charlotte,29,25,16,24,0,0,0,0,20131111,103,94,-3,-8,10,9,9,197,-9,2013,0,0,226,0
Orlando,25,25,24,31,0,0,0,0,Boston,31,28,28,33,0,0,0,0,20131111,105,120,6,9,13,15,15,225,15,2013,0,0,1115,0
Washington,34,15,30,16,0,0,0,0,Dallas,33,28,27,17,0,0,0,0,20131112,95,105,-1,12,9,10,10,200,10,2013,0,1,1181,0
Detroit,16,25,30,24,0,0,0,0,Golden State,35,27,32,19,0,0,0,0,20131112,95,113,19,21,23,18,18,208,18,2013,0,1,2087,0
New Orleans,19,20,23,33,0,0,0,0,LA Lakers,22,33,31,30,0,0,0,0,20131112,95,116,3,16,24,21,21,211,21,2013,0,1,1669,0
Milwaukee,23,22,17,33,0,0,0,0,Miami,32,24,28,34,0,0,0,0,20131112,95,118,9,11,22,23,23,213,23,2013,0,1,1269,0
New Orleans,29,26,22,28,0,0,0,0,Utah,22,23,28,38,0,0,0,0,20131113,105,111,-7,-10,-4,6,6,216,6,2013,0,2,1432,0
Washington,17,25,15,22,0,0,0,0,San Antonio,25,27,18,22,0,0,0,0,20131113,79,92,8,10,13,13,13,171,13,2013,0,2,1385,0
Brooklyn,19,21,19,27,0,0,0,0,Sacramento,23,29,28,27,0,0,0,0,20131113,86,107,4,12,21,21,21,193,21,2013,0,2,2499,0
Phoenix,22,21,25,21,0,0,0,0,Portland,25,16,21,28,0,0,0,0,20131113,89,90,3,-2,-6,1,1,179,1,2013,0,2,1005,0
Houston,31,26,33,16,11,0,0,0,Philadelphia,28,32,20,26,17,0,0,0,20131113,117,123,-3,3,-10,0,6,240,6,2013,1,2,1339,0
Milwaukee,36,18,20,17,0,0,0,0,Orlando,23,22,27,22,0,0,0,0,20131113,91,94,-13,-9,-2,3,3,185,3,2013,0,2,1065,0
Cleveland,24,23,29,19,0,0,0,0,Minnesota,38,32,38,16,0,0,0,0,20131113,95,124,14,23,32,29,29,219,29,2013,0,2,629,0
Toronto,26,29,23,25,0,0,0,0,Memphis,20,24,27,16,0,0,0,0,20131113,103,87,6,11,7,16,16,190,-16,2013,0,2,815,0
Oklahoma City,33,29,16,25,0,0,0,0,LA Clippers,25,28,30,28,0,0,0,0,20131113,103,111,-8,-9,5,8,8,214,8,2013,0,2,1178,0
LA Lakers,28,26,25,20,0,0,0,0,Denver,33,27,23,28,0,0,0,0,20131113,99,111,5,6,4,12,12,210,12,2013,0,2,830,0
Charlotte,27,24,20,18,0,0,0,0,Boston,21,22,21,19,0,0,0,0,20131113,89,83,6,8,7,6,6,172,-6,2013,0,2,720,0
New York,29,26,10,30,0,0,0,0,Atlanta,24,21,23,23,0,0,0,0,20131113,95,91,5,10,-3,4,4,186,-4,2013,0,2,745,0
Oklahoma City,33,29,24,29,0,0,0,0,Golden State,32,30,33,21,0,0,0,0,20131114,115,116,-1,0,9,1,1,231,1,2013,0,3,1386,0
Houston,28,25,22,34,0,0,0,0,New York,23,29,20,34,0,0,0,0,20131114,109,106,5,1,3,3,3,215,-3,2013,0,3,1417,0
San Antonio,16,25,19,31,0,0,0,0,Utah,29,17,21,15,0,0,0,0,20131115,91,82,-13,-5,-7,9,9,173,-9,2013,0,4,1087,0
Chicago,27,18,29,22,0,0,0,0,Toronto,16,15,23,26,0,0,0,0,20131115,96,80,11,14,20,16,16,176,-16,2013,0,4,436,0
Detroit,27,27,26,17,0,0,0,0,Sacramento,21,30,19,20,0,0,0,0,20131115,97,90,6,3,10,7,7,187,-7,2013,0,4,2020,0
Brooklyn,18,28,27,19,8,0,0,0,Phoenix,29,21,17,25,6,0,0,0,20131115,100,98,-11,-4,6,0,2,198,-2,2013,1,4,2139,0
Dallas,32,19,27,26,0,0,0,0,Miami,31,29,26,24,0,0,0,0,20131115,104,110,-1,9,8,6,6,214,6,2013,0,4,1110,0
Memphis,24,16,23,26,0,0,0,0,LA Lakers,17,23,26,20,0,0,0,0,20131115,89,86,7,0,-3,3,3,175,-3,2013,0,4,1599,0
Milwaukee,21,16,24,16,0,0,0,0,Indiana,31,21,23,29,0,0,0,0,20131115,77,104,10,15,14,27,27,181,27,2013,0,4,243,0
Minnesota,26,34,21,32,0,0,0,0,Denver,35,21,30,31,0,0,0,0,20131115,113,117,9,-4,5,4,4,230,4,2013,0,4,698,0
Charlotte,12,21,24,29,0,0,0,0,Cleveland,18,19,21,22,0,0,0,0,20131115,86,80,-6,-4,-1,6,6,166,-6,2013,0,4,435,0
Portland,23,34,33,19,0,0,0,0,Boston,21,30,27,18,0,0,0,0,20131115,109,96,2,6,12,13,13,205,-13,2013,0,4,2532,0
Philadelphia,17,39,17,30,0,0,0,0,Atlanta,25,29,28,31,0,0,0,0,20131115,103,113,8,-2,9,10,10,216,10,2013,0,4,665,0
Cleveland,18,26,20,26,13,0,0,0,Washington,25,24,20,21,6,0,0,0,20131116,103,96,-7,-5,-5,0,7,199,-7,2013,1,5,304,0
Dallas,31,28,28,21,0,0,0,0,Orlando,24,22,34,20,0,0,0,0,20131116,108,100,7,13,7,8,8,208,-8,2013,0,5,961,0
Atlanta,24,30,26,30,0,0,0,0,New York,26,21,22,21,0,0,0,0,20131116,110,90,-2,7,11,20,20,200,-20,2013,0,5,745,0
Boston,24,26,20,18,0,0,0,0,Minnesota,33,22,34,17,0,0,0,0,20131116,88,106,9,5,19,18,18,194,18,2013,0,5,1120,0
Oklahoma City,23,17,32,20,0,0,0,0,Milwaukee,23,17,25,14,0,0,0,0,20131116,92,79,0,0,7,13,13,171,-13,2013,0,5,732,0
Philadelphia,22,24,20,32,0,0,0,0,New Orleans,34,33,36,32,0,0,0,0,20131116,98,135,12,21,37,37,37,233,37,2013,0,5,1088,0
Denver,23,23,29,36,0,0,0,0,Houston,33,30,27,32,0,0,0,0,20131116,111,122,10,17,15,11,11,233,11,2013,0,5,878,0
Utah,13,21,29,25,0,0,0,0,Golden State,27,24,23,28,0,0,0,0,20131116,88,102,14,17,11,14,14,190,14,2013,0,5,599,0
Indiana,20,15,24,35,0,0,0,0,Chicago,31,29,24,26,0,0,0,0,20131116,94,110,11,25,25,16,16,204,16,2013,0,5,163,0
Miami,26,19,23,29,0,0,0,0,Charlotte,16,25,19,21,0,0,0,0,20131116,97,81,10,4,8,16,16,178,-16,2013,0,5,654,0
Brooklyn,26,29,20,28,0,0,0,0,LA Clippers,29,25,22,34,0,0,0,0,20131116,103,110,3,-1,1,7,7,213,7,2013,0,5,2445,0
Detroit,29,27,15,28,0,0,0,0,LA Lakers,27,23,29,35,0,0,0,0,20131117,99,114,-2,-6,8,15,15,213,15,2013,0,6,1979,0
Memphis,25,22,27,23,0,0,0,0,Sacramento,18,16,31,21,0,0,0,0,20131117,97,86,7,13,9,11,11,183,-11,2013,0,6,1745,0
Portland,31,26,22,23,16,0,0,0,Toronto,29,25,15,33,8,0,0,0,20131117,118,110,2,3,10,0,8,228,-8,2013,1,6,2108,0
Denver,39,24,29,21,0,0,0,0,Oklahoma City,28,32,23,32,0,0,0,0,20131118,113,115,-11,-3,-9,2,2,228,2,2013,0,0,503,0
Portland,31,25,27,25,0,0,0,0,Brooklyn,40,23,15,20,0,0,0,0,20131118,108,98,-9,-7,5,10,10,206,-10,2013,0,0,2439,0
Charlotte,21,23,15,22,0,0,0,0,Chicago,26,14,22,24,0,0,0,0,20131118,81,86,5,-4,3,5,5,167,5,2013,0,0,586,0
Philadelphia,21,26,24,23,0,0,0,0,Dallas,18,25,31,23,0,0,0,0,20131118,94,97,-3,-4,3,3,3,191,3,2013,0,0,1297,0
Memphis,29,23,29,25,0,0,0,0,LA Clippers,20,31,30,21,0,0,0,0,20131118,106,102,9,1,0,4,4,208,-4,2013,0,0,1599,0
Golden State,22,37,19,20,0,0,0,0,Utah,19,17,29,22,0,0,0,0,20131118,98,87,3,23,13,11,11,185,-11,2013,0,0,599,0
Boston,18,26,13,28,0,0,0,0,Houston,40,28,20,21,0,0,0,0,20131119,85,109,22,24,31,24,24,194,24,2013,0,1,1603,0
Minnesota,34,29,18,19,0,0,0,0,Washington,27,24,30,23,0,0,0,0,20131119,100,104,-7,-12,0,4,4,204,4,2013,0,1,931,0
Phoenix,25,37,26,16,0,0,0,0,Sacramento,33,21,28,25,0,0,0,0,20131119,104,107,8,-8,-6,3,3,211,3,2013,0,1,634,0
New York,24,19,20,23,0,0,0,0,Detroit,26,17,28,21,0,0,0,0,20131119,86,92,2,0,8,6,6,178,6,2013,0,1,480,0
Atlanta,25,20,23,20,0,0,0,0,Miami,24,24,30,26,0,0,0,0,20131119,88,104,-1,3,10,16,16,192,16,2013,0,1,605,0
Boston,25,23,22,23,0,0,0,0,San Antonio,22,26,32,24,0,0,0,0,20131120,93,104,-3,0,10,11,11,197,11,2013,0,2,1765,0
Sacramento,27,28,19,39,0,0,0,0,Phoenix,27,23,12,44,0,0,0,0,20131120,113,106,0,5,12,7,7,219,-7,2013,0,2,634,0
Toronto,25,30,38,15,0,0,0,0,Philadelphia,25,23,29,21,0,0,0,0,20131120,108,98,0,7,16,10,10,206,-10,2013,0,2,334,0
Indiana,14,23,21,31,14,0,0,0,New York,19,23,20,27,7,0,0,0,20131120,103,96,-5,-5,-4,0,7,199,-7,2013,1,2,643,0
LA Clippers,24,22,25,31,0,0,0,0,Minnesota,24,22,21,31,0,0,0,0,20131120,102,98,0,0,4,4,4,200,-4,2013,0,2,1521,0
Miami,25,29,36,30,0,0,0,0,Orlando,20,29,22,21,0,0,0,0,20131120,120,92,5,5,19,28,28,212,-28,2013,0,2,204,0
Memphis,16,18,25,16,13,0,0,0,Golden State,26,18,13,18,6,0,0,0,20131120,88,81,-10,-10,2,0,7,169,-7,2013,1,2,1798,0
Houston,40,28,33,19,0,0,0,0,Dallas,29,32,26,36,0,0,0,0,20131120,120,123,-11,-7,-14,3,3,243,3,2013,0,2,225,0
Washington,30,26,24,18,0,0,0,0,Cleveland,19,19,21,32,0,0,0,0,20131120,98,91,11,18,21,7,7,189,-7,2013,0,2,304,0
Brooklyn,29,21,20,21,0,0,0,0,Charlotte,30,23,30,12,0,0,0,0,20131120,91,95,1,3,13,4,4,186,4,2013,0,2,531,0
Detroit,13,33,18,21,0,0,0,0,Atlanta,15,28,23,27,0,0,0,0,20131120,85,93,2,-3,2,8,8,178,8,2013,0,2,597,0
Portland,23,30,17,21,0,0,0,0,Milwaukee,24,27,13,18,0,0,0,0,20131120,91,82,-1,2,6,9,9,173,-9,2013,0,2,1714,0
Utah,17,24,28,29,0,0,0,0,New Orleans,20,25,28,32,0,0,0,0,20131120,98,105,3,4,4,7,7,203,7,2013,0,2,1432,0
LA Clippers,22,21,29,19,0,0,0,0,Oklahoma City,28,23,30,24,0,0,0,0,20131121,91,105,6,8,9,14,14,196,14,2013,0,3,1178,0
Chicago,25,23,14,25,0,0,0,0,Denver,24,26,20,27,0,0,0,0,20131121,87,97,-1,2,8,10,10,184,10,2013,0,3,916,0
Milwaukee,20,33,20,29,5,0,0,0,Philadelphia,28,27,20,27,13,0,0,0,20131122,107,115,8,2,2,0,8,222,8,2013,1,4,692,0
Chicago,32,27,12,24,0,0,0,0,Portland,22,22,34,20,0,0,0,0,20131122,95,98,-10,-15,7,3,3,193,3,2013,0,4,1754,0
Cleveland,20,31,20,29,0,0,0,0,New Orleans,21,21,28,34,0,0,0,0,20131122,100,104,1,-9,-1,4,4,204,4,2013,0,4,924,0
Washington,27,11,32,18,0,0,0,0,Toronto,32,19,15,30,0,0,0,0,20131122,88,96,5,13,-4,8,8,184,8,2013,0,4,349,0
San Antonio,26,25,20,31,0,0,0,0,Memphis,21,16,28,21,0,0,0,0,20131122,102,86,5,14,6,16,16,188,-16,2013,0,4,631,0
Brooklyn,14,23,21,23,0,0,0,0,Minnesota,30,27,33,21,0,0,0,0,20131122,81,111,16,20,32,30,30,192,30,2013,0,4,1016,0
Atlanta,27,22,24,23,0,0,0,0,Detroit,22,22,24,21,0,0,0,0,20131122,96,89,5,5,5,7,7,185,-7,2013,0,4,597,0
Utah,18,16,30,29,0,0,0,0,Dallas,31,27,22,23,0,0,0,0,20131122,93,103,13,24,16,10,10,196,10,2013,0,4,998,0
Phoenix,27,28,19,24,0,0,0,0,Charlotte,24,20,19,28,0,0,0,0,20131122,98,91,3,11,11,7,7,189,-7,2013,0,4,1778,0
Indiana,22,20,25,30,0,0,0,0,Boston,25,25,8,24,0,0,0,0,20131122,97,82,-3,-8,9,15,15,179,-15,2013,0,4,805,0
Golden State,21,25,17,32,0,0,0,0,LA Lakers,22,33,20,27,0,0,0,0,20131122,95,102,1,9,12,7,7,197,7,2013,0,4,347,0
Orlando,20,35,22,22,0,0,0,0,Miami,16,23,32,30,0,0,0,0,20131123,99,101,-4,-16,-6,2,2,200,2,2013,0,5,204,0
New York,27,25,17,20,0,0,0,0,Washington,26,23,27,22,0,0,0,0,20131123,89,98,-1,-3,7,9,9,187,9,2013,0,5,204,0
Cleveland,21,11,35,29,0,0,0,0,San Antonio,30,35,31,30,0,0,0,0,20131123,96,126,9,33,29,30,30,222,30,2013,0,5,1256,0
Charlotte,25,21,28,22,0,0,0,0,Milwaukee,21,18,12,21,0,0,0,0,20131123,96,72,4,7,23,24,24,168,-24,2013,0,5,658,0
Sacramento,13,35,21,33,0,0,0,0,LA Clippers,29,28,18,28,0,0,0,0,20131123,102,103,16,9,6,1,1,205,1,2013,0,5,361,0
Philadelphia,22,30,14,32,0,0,0,0,Indiana,25,31,21,29,0,0,0,0,20131123,98,106,3,4,11,8,8,204,8,2013,0,5,582,0
Minnesota,18,24,32,27,0,0,0,0,Houston,25,30,27,30,0,0,0,0,20131123,101,112,7,13,8,11,11,213,11,2013,0,5,1057,0
Portland,23,26,32,32,0,0,0,0,Golden State,24,30,30,17,0,0,0,0,20131123,113,101,-1,-5,-3,12,12,214,-12,2013,0,5,535,0
Dallas,22,31,27,20,0,0,0,0,Denver,35,30,21,16,0,0,0,0,20131123,100,102,13,12,6,2,2,202,2,2013,0,5,661,0
Boston,25,24,15,30,0,0,0,0,Atlanta,24,29,21,13,0,0,0,0,20131123,94,87,1,-4,-10,7,7,181,-7,2013,0,5,935,0
Detroit,23,21,34,31,0,0,0,0,Brooklyn,19,32,15,31,0,0,0,0,20131124,109,97,4,-7,12,12,12,206,-12,2013,0,6,480,0
Chicago,24,28,21,9,0,0,0,0,LA Clippers,31,34,31,25,0,0,0,0,20131124,82,121,7,13,23,39,39,203,39,2013,0,6,1741,0
Sacramento,24,24,13,25,0,0,0,0,LA Lakers,29,26,18,27,0,0,0,0,20131124,86,100,5,7,12,14,14,186,14,2013,0,6,361,0
Utah,13,17,13,30,0,0,0,0,Oklahoma City,22,25,28,20,0,0,0,0,20131124,73,95,9,17,32,22,22,168,22,2013,0,6,861,0
Phoenix,31,22,27,24,0,0,0,0,Orlando,21,23,28,24,0,0,0,0,20131124,104,96,10,9,8,8,8,200,-8,2013,0,6,1842,0
Phoenix,21,26,24,21,0,0,0,0,Miami,24,26,29,28,0,0,0,0,20131125,92,107,3,3,8,15,15,199,15,2013,0,0,1978,0
New York,18,21,30,22,0,0,0,0,Portland,34,22,25,21,0,0,0,0,20131125,91,102,16,17,12,11,11,193,11,2013,0,0,2439,0
Houston,20,12,23,38,0,0,0,0,Memphis,24,20,19,23,0,0,0,0,20131125,93,86,-4,-12,-8,7,7,179,-7,2013,0,0,484,0
New Orleans,24,16,25,28,0,0,0,0,San Antonio,27,30,34,21,0,0,0,0,20131125,93,112,3,17,26,19,19,205,19,2013,0,0,506,0
Milwaukee,18,16,32,28,0,0,0,0,Detroit,38,27,27,21,0,0,0,0,20131125,94,113,20,31,26,19,19,207,19,2013,0,0,251,0
Denver,32,24,29,25,0,0,0,0,Dallas,27,24,26,19,0,0,0,0,20131125,110,96,5,5,8,14,14,206,-14,2013,0,0,661,0
Boston,14,33,21,28,0,0,0,0,Charlotte,21,17,28,20,0,0,0,0,20131125,96,86,-7,9,2,10,10,182,-10,2013,0,0,720,0
Minnesota,24,22,22,16,0,0,0,0,Indiana,28,20,25,25,0,0,0,0,20131125,84,98,4,2,5,14,14,182,14,2013,0,0,510,0
Chicago,18,14,24,22,5,0,0,0,Utah,23,17,24,14,11,0,0,0,20131125,83,89,5,8,8,0,6,172,6,2013,1,0,1256,0
LA Lakers,29,26,22,34,0,0,0,0,Washington,31,28,23,34,0,0,0,0,20131126,111,116,2,4,5,5,5,227,5,2013,0,1,2294,0
Brooklyn,26,29,26,21,0,0,0,0,Toronto,28,23,25,24,0,0,0,0,20131126,102,100,-2,4,5,2,2,202,-2,2013,0,1,341,0
Golden State,28,29,19,26,0,0,0,0,New Orleans,18,31,28,24,0,0,0,0,20131126,102,101,10,8,-1,1,1,203,-1,2013,0,1,1921,0
Orlando,26,23,36,24,0,0,0,0,Atlanta,25,28,20,19,0,0,0,0,20131126,109,92,1,-4,12,17,17,201,-17,2013,0,1,401,0
Portland,32,26,18,30,0,0,0,0,Phoenix,21,40,29,30,0,0,0,0,20131127,106,120,-11,3,14,14,14,226,14,2013,0,2,1005,0
Philadelphia,27,23,23,21,0,0,0,0,Orlando,33,22,22,28,0,0,0,0,20131127,94,105,6,5,4,11,11,199,11,2013,0,2,864,0
San Antonio,21,25,15,27,0,0,0,0,Oklahoma City,19,24,25,26,0,0,0,0,20131127,88,94,-2,-3,7,6,6,182,6,2013,0,2,421,0
Denver,28,36,26,27,0,0,0,0,Minnesota,27,28,28,27,0,0,0,0,20131127,117,110,1,9,7,7,7,227,-7,2013,0,2,698,0
New York,27,18,23,12,0,0,0,0,LA Clippers,29,20,25,19,0,0,0,0,20131127,80,93,2,4,6,13,13,173,13,2013,0,2,2445,0
Atlanta,19,26,22,17,0,0,0,0,Houston,30,26,21,36,0,0,0,0,20131127,84,113,11,11,10,29,29,197,29,2013,0,2,700,0
Washington,25,24,22,16,13,0,0,0,Milwaukee,23,25,20,19,5,0,0,0,20131127,100,92,2,1,3,0,8,192,-8,2013,1,2,634,0
Golden State,22,24,25,28,0,0,0,0,Dallas,28,27,27,21,0,0,0,0,20131127,99,103,6,9,11,4,4,202,4,2013,0,2,1480,0
Miami,22,27,21,25,0,0,0,0,Cleveland,28,14,18,24,0,0,0,0,20131127,95,84,-6,7,10,11,11,179,-11,2013,0,2,1089,0
Indiana,22,21,17,39,0,0,0,0,Charlotte,11,27,14,22,0,0,0,0,20131127,99,74,11,5,8,25,25,173,-25,2013,0,2,428,0
LA Lakers,34,20,23,22,0,0,0,0,Brooklyn,18,22,28,26,0,0,0,0,20131127,99,94,16,14,9,5,5,193,-5,2013,0,2,2445,0
Memphis,27,22,20,31,0,0,0,0,Boston,13,23,23,34,0,0,0,0,20131127,100,93,14,13,10,7,7,193,-7,2013,0,2,1134,0
Chicago,25,26,25,23,0,0,0,0,Detroit,29,24,15,11,0,0,0,0,20131127,99,79,-4,-2,8,20,20,178,-20,2013,0,2,238,0
Golden State,28,23,31,22,8,0,0,0,Oklahoma City,32,22,22,28,9,0,0,0,20131129,112,113,4,3,-6,0,1,225,1,2013,1,4,1386,0
Phoenix,31,31,33,17,0,0,0,0,Utah,33,18,27,23,0,0,0,0,20131129,112,101,-2,11,17,11,11,213,-11,2013,0,4,505,0
Miami,27,30,21,12,0,0,0,0,Toronto,22,21,27,13,0,0,0,0,20131129,90,83,5,14,8,7,7,173,-7,2013,0,4,1234,0
New Orleans,35,26,26,34,0,0,0,0,Philadelphia,30,25,22,28,0,0,0,0,20131129,121,105,5,6,10,16,16,226,-16,2013,0,4,1088,0
San Antonio,29,34,18,28,0,0,0,0,Orlando,24,21,25,21,0,0,0,0,20131129,109,91,5,18,11,18,18,200,-18,2013,0,4,1035,0
Washington,14,22,20,17,0,0,0,0,Indiana,28,15,26,24,0,0,0,0,20131129,73,93,14,7,13,20,20,166,20,2013,0,4,490,0
LA Clippers,23,27,23,21,10,0,0,0,Sacramento,24,21,27,22,4,0,0,0,20131129,104,98,-1,5,1,0,6,202,-6,2013,1,4,361,0
LA Lakers,31,25,21,29,0,0,0,0,Detroit,32,23,32,15,0,0,0,0,20131129,106,102,-1,1,-10,4,4,208,-4,2013,0,4,1979,0
New York,20,25,22,28,0,0,0,0,Denver,30,21,24,22,0,0,0,0,20131129,95,97,10,6,8,2,2,192,2,2013,0,4,1627,0
Milwaukee,20,21,18,17,0,0,0,0,Charlotte,24,27,20,21,0,0,0,0,20131129,76,92,4,10,12,16,16,168,16,2013,0,4,658,0
Brooklyn,17,23,22,33,0,0,0,0,Houston,33,33,26,22,0,0,0,0,20131129,95,114,16,26,30,19,19,209,19,2013,0,4,1417,0
Cleveland,10,29,19,28,0,0,0,0,Boston,28,27,24,24,0,0,0,0,20131129,86,103,18,16,21,17,17,189,17,2013,0,4,549,0
Dallas,28,25,22,12,0,0,0,0,Atlanta,23,16,25,24,0,0,0,0,20131129,87,88,-5,-14,-11,1,1,175,1,2013,0,4,719,0
Atlanta,20,24,26,31,0,0,0,0,Washington,28,26,25,29,0,0,0,0,20131130,101,108,8,10,9,7,7,209,7,2013,0,5,541,0
Houston,30,27,26,29,0,0,0,0,San Antonio,24,22,34,26,0,0,0,0,20131130,112,106,6,11,3,6,6,218,-6,2013,0,5,189,0
Utah,28,21,29,34,0,0,0,0,Phoenix,23,30,24,27,0,0,0,0,20131130,112,104,5,-4,1,8,8,216,-8,2013,0,5,505,0
Brooklyn,24,24,25,24,0,0,0,0,Memphis,19,18,28,23,0,0,0,0,20131130,97,88,5,11,8,9,9,185,-9,2013,0,5,953,0
Minnesota,29,25,30,28,0,0,0,0,Dallas,24,23,30,29,0,0,0,0,20131130,112,106,5,7,7,6,6,218,-6,2013,0,5,863,0
Chicago,25,26,15,27,0,0,0,0,Cleveland,27,29,21,20,0,0,0,0,20131130,93,97,2,5,11,4,4,190,4,2013,0,5,308,0
Boston,27,14,22,22,0,0,0,0,Milwaukee,19,28,23,22,0,0,0,0,20131130,85,92,-8,6,7,7,7,177,7,2013,0,5,855,0
Minnesota,32,26,25,20,0,0,0,0,Oklahoma City,26,29,23,35,0,0,0,0,20131201,103,113,-6,-3,-5,10,10,216,10,2013,0,6,694,0
Golden State,24,32,34,25,0,0,0,0,Sacramento,26,27,27,33,0,0,0,0,20131201,115,113,-2,3,10,2,2,228,-2,2013,0,6,75,0
Denver,25,22,29,36,0,0,0,0,Toronto,31,14,27,26,0,0,0,0,20131201,112,98,-6,2,4,14,14,210,-14,2013,0,6,1341,0
New Orleans,16,28,32,27,0,0,0,0,New York,20,29,25,25,0,0,0,0,20131201,103,99,-4,-5,2,4,4,202,-4,2013,0,6,1168,0
Indiana,29,24,31,21,0,0,0,0,LA Clippers,22,25,27,26,0,0,0,0,20131201,105,100,7,6,10,5,5,205,-5,2013,0,6,1805,0
Portland,32,21,41,20,0,0,0,0,LA Lakers,24,26,24,34,0,0,0,0,20131201,114,108,8,3,20,6,6,222,-6,2013,0,6,826,0
Philadelphia,25,21,36,18,0,0,0,0,Detroit,40,30,24,21,0,0,0,0,20131201,100,115,15,24,12,15,15,215,15,2013,0,6,441,0
Charlotte,21,27,25,25,0,0,0,0,Miami,24,23,14,38,0,0,0,0,20131201,98,99,3,-1,-12,1,1,197,1,2013,0,6,654,0
New Orleans,24,26,27,26,6,13,9,0,Chicago,21,35,24,23,6,13,6,0,20131202,131,128,3,-6,-3,0,3,259,-3,2013,3,0,832,0
Indiana,23,23,26,30,0,0,0,0,Portland,20,25,27,34,0,0,0,0,20131202,102,106,-3,-1,0,4,4,208,4,2013,0,0,1880,0
Atlanta,23,26,22,29,0,0,0,0,San Antonio,25,25,23,29,0,0,0,0,20131202,100,102,2,1,2,2,2,202,2,2013,0,0,881,0
Houston,23,27,24,29,0,0,0,0,Utah,36,17,29,27,0,0,0,0,20131202,103,109,13,3,8,6,6,212,6,2013,0,0,1199,0
Orlando,22,19,20,19,0,0,0,0,Washington,22,30,23,23,0,0,0,0,20131202,80,98,0,11,14,18,18,178,18,2013,0,0,757,0
Detroit,28,26,28,25,0,0,0,0,Miami,18,25,25,29,0,0,0,0,20131203,107,97,10,11,14,10,10,204,-10,2013,0,1,1155,0
Oklahoma City,19,31,28,19,0,0,0,0,Sacramento,31,16,18,30,0,0,0,0,20131203,97,95,-12,3,13,2,2,192,-2,2013,0,1,1336,0
Phoenix,19,35,20,17,0,0,0,0,Memphis,23,23,36,28,0,0,0,0,20131203,91,110,4,-8,8,19,19,201,19,2013,0,1,1260,0
Orlando,34,23,23,24,14,7,0,0,Philadelphia,29,29,27,19,14,8,0,0,20131203,125,126,-5,1,5,0,1,251,1,2013,2,1,864,0
Charlotte,18,24,25,15,0,0,0,0,Dallas,22,17,21,29,0,0,0,0,20131203,82,89,4,-3,-7,7,7,171,7,2013,0,1,928,0
Milwaukee,23,18,22,37,0,0,0,0,Boston,28,20,21,39,0,0,0,0,20131203,100,108,5,7,6,8,8,208,8,2013,0,1,855,0
Toronto,36,29,23,15,0,0,0,0,Golden State,19,29,22,42,0,0,0,0,20131203,103,112,-17,-17,-18,9,9,215,9,2013,0,1,2263,0
Denver,27,31,31,22,0,0,0,0,Brooklyn,29,21,15,22,0,0,0,0,20131203,111,87,-2,8,24,24,24,198,-24,2013,0,1,1627,0
LA Clippers,21,23,26,27,0,0,0,0,Atlanta,29,26,24,28,0,0,0,0,20131204,97,107,8,11,9,10,10,204,10,2013,0,2,1932,0
Denver,24,28,21,15,0,0,0,0,Cleveland,31,25,23,19,0,0,0,0,20131204,88,98,7,4,6,10,10,186,10,2013,0,2,1223,0
Phoenix,25,26,22,24,0,0,0,0,Houston,20,20,21,27,0,0,0,0,20131204,97,88,5,11,12,9,9,185,-9,2013,0,2,1014,0
Detroit,26,19,35,25,0,0,0,0,Milwaukee,19,31,17,31,0,0,0,0,20131204,105,98,7,-5,13,7,7,203,-7,2013,0,2,251,0
Dallas,27,25,23,25,0,0,0,0,New Orleans,24,29,24,20,0,0,0,0,20131204,100,97,3,-1,-2,3,3,197,-3,2013,0,2,442,0
Oklahoma City,27,32,21,24,0,0,0,0,Portland,25,23,35,28,0,0,0,0,20131204,104,111,-2,-11,3,7,7,215,7,2013,0,2,1484,0
Indiana,17,30,21,27,0,0,0,0,Utah,23,25,19,19,0,0,0,0,20131204,95,86,-6,-1,1,9,9,181,-9,2013,0,2,1353,0
Miami,20,24,19,24,0,0,0,0,Chicago,29,29,27,22,0,0,0,0,20131205,87,107,9,14,22,20,20,194,20,2013,0,3,1189,0
LA Clippers,18,22,24,37,0,0,0,0,Memphis,20,22,11,28,0,0,0,0,20131205,101,81,-2,-2,11,20,20,182,-20,2013,0,3,1599,0
New York,29,21,34,29,0,0,0,0,Brooklyn,23,20,16,24,0,0,0,0,20131205,113,83,6,7,25,30,30,196,-30,2013,0,3,0,0
Cleveland,20,23,21,25,0,0,0,0,Atlanta,37,26,19,26,0,0,0,0,20131206,89,108,17,20,18,19,19,197,19,2013,0,4,555,0
Philadelphia,33,18,21,16,0,0,0,0,Charlotte,36,26,22,21,0,0,0,0,20131206,88,105,3,11,12,17,17,193,17,2013,0,4,450,0
Golden State,12,25,29,17,0,0,0,0,Houston,31,30,26,18,0,0,0,0,20131206,83,105,19,24,21,22,22,188,22,2013,0,4,1642,0
Oklahoma City,24,34,22,29,0,0,0,0,New Orleans,26,26,16,27,0,0,0,0,20131206,109,95,-2,6,12,14,14,204,-14,2013,0,4,576,0
Orlando,31,23,15,14,0,0,0,0,New York,28,31,30,32,0,0,0,0,20131206,83,121,-3,5,20,38,38,204,38,2013,0,4,939,0
Toronto,27,23,24,23,0,0,0,0,Phoenix,27,25,29,25,0,0,0,0,20131206,97,106,0,2,7,9,9,203,9,2013,0,4,1885,0
Utah,22,34,13,29,0,0,0,0,Portland,39,28,40,23,0,0,0,0,20131206,98,130,17,11,38,32,32,228,32,2013,0,4,634,0
LA Lakers,28,24,29,25,0,0,0,0,Sacramento,30,25,32,13,0,0,0,0,20131206,106,100,-2,-3,-6,6,6,206,-6,2013,0,4,361,0
Milwaukee,34,22,22,24,7,0,0,0,Washington,30,13,31,28,3,0,0,0,20131206,109,105,4,13,4,0,4,214,-4,2013,1,4,634,0
Denver,15,29,33,21,0,0,0,0,Boston,39,25,23,19,0,0,0,0,20131206,98,106,24,20,10,8,8,204,8,2013,0,4,1765,0
Denver,25,24,28,26,0,0,0,0,Philadelphia,27,26,24,15,0,0,0,0,20131207,103,92,-2,-4,0,11,11,195,-11,2013,0,5,1574,0
Sacramento,23,24,27,23,15,0,0,0,Utah,24,26,20,27,5,0,0,0,20131207,112,102,-1,-3,4,0,10,214,-10,2013,1,5,532,0
Indiana,20,32,35,24,0,0,0,0,San Antonio,28,20,17,35,0,0,0,0,20131207,111,100,-8,4,22,11,11,211,-11,2013,0,5,999,0
Dallas,28,27,24,29,0,0,0,0,Portland,30,23,23,30,0,0,0,0,20131207,108,106,-2,2,3,2,2,214,-2,2013,0,5,1630,0
Brooklyn,20,19,26,25,0,0,0,0,Milwaukee,18,22,19,23,0,0,0,0,20131207,90,82,2,-1,6,8,8,172,-8,2013,0,5,732,0
Golden State,29,20,28,31,0,0,0,0,Memphis,19,24,17,22,0,0,0,0,20131207,108,82,10,6,17,26,26,190,-26,2013,0,5,1798,0
LA Clippers,23,26,17,16,0,0,0,0,Cleveland,29,21,17,21,0,0,0,0,20131207,82,88,6,1,1,6,6,170,6,2013,0,5,2044,0
Detroit,25,22,24,21,0,0,0,0,Chicago,24,23,9,19,0,0,0,0,20131207,92,75,1,0,15,17,17,167,-17,2013,0,5,238,0
Miami,24,31,21,27,0,0,0,0,Minnesota,25,17,18,22,0,0,0,0,20131207,103,82,-1,13,16,21,21,185,-21,2013,0,5,1513,0
Miami,29,30,32,19,0,0,0,0,Detroit,21,32,17,25,0,0,0,0,20131208,110,95,8,6,21,15,15,205,-15,2013,0,6,1155,0
Orlando,18,20,23,27,0,0,0,0,Houston,28,24,31,15,0,0,0,0,20131208,88,98,10,14,22,10,10,186,10,2013,0,6,847,0
Toronto,30,21,22,33,0,0,0,0,LA Lakers,20,27,21,26,0,0,0,0,20131208,106,94,10,4,5,12,12,200,-12,2013,0,6,2170,0
Boston,34,24,34,22,0,0,0,0,New York,11,20,25,17,0,0,0,0,20131208,114,73,23,27,36,41,41,187,-41,2013,0,6,190,0
Indiana,18,19,32,25,0,0,0,0,Oklahoma City,28,28,34,28,0,0,0,0,20131208,94,118,10,19,21,24,24,212,24,2013,0,6,688,0
Denver,18,22,18,17,0,0,0,0,Washington,22,23,15,14,0,0,0,0,20131209,75,74,-4,-5,-2,1,1,149,-1,2013,0,0,1489,0
Dallas,23,24,26,24,0,0,0,0,Sacramento,34,23,35,20,0,0,0,0,20131209,97,112,11,10,19,15,15,209,15,2013,0,0,1437,0
Portland,22,29,26,28,0,0,0,0,Utah,22,23,19,30,0,0,0,0,20131209,105,94,0,6,13,11,11,199,-11,2013,0,0,634,0
Orlando,16,14,30,25,0,0,0,0,Memphis,23,28,22,21,0,0,0,0,20131209,85,94,7,21,13,9,9,179,9,2013,0,0,683,0
Golden State,21,20,36,34,0,0,0,0,Charlotte,27,26,30,32,0,0,0,0,20131209,111,115,6,12,6,4,4,226,4,2013,0,0,2296,0
LA Clippers,23,21,32,18,0,0,0,0,Philadelphia,17,19,24,23,0,0,0,0,20131209,94,83,6,8,16,11,11,177,-11,2013,0,0,2388,0
Oklahoma City,21,27,28,25,0,0,0,0,Atlanta,21,18,29,24,0,0,0,0,20131210,101,92,0,9,8,9,9,193,-9,2013,0,1,755,0
Boston,20,27,25,24,0,0,0,0,Brooklyn,31,25,29,19,0,0,0,0,20131210,96,104,11,9,13,8,8,200,8,2013,0,1,190,0
Milwaukee,20,15,20,23,0,0,0,0,Chicago,14,28,15,17,0,0,0,0,20131210,78,74,6,-7,-2,4,4,152,-4,2013,0,1,83,0
New York,19,26,20,29,0,0,0,0,Cleveland,31,17,33,28,0,0,0,0,20131210,94,109,12,3,16,15,15,203,15,2013,0,1,403,0
Minnesota,33,31,32,25,0,0,0,0,Detroit,32,19,26,17,0,0,0,0,20131210,121,94,1,13,19,27,27,215,-27,2013,0,1,542,0
Miami,30,17,17,20,0,0,0,0,Indiana,19,21,28,22,0,0,0,0,20131210,84,90,-11,-7,4,6,6,174,6,2013,0,1,1026,0
Phoenix,26,30,23,35,0,0,0,0,LA Lakers,21,30,23,34,0,0,0,0,20131210,114,108,5,5,5,6,6,222,-6,2013,0,1,356,0
San Antonio,24,35,30,27,0,0,0,0,Toronto,36,17,21,29,0,0,0,0,20131210,116,103,-12,6,15,13,13,219,-13,2013,0,1,1438,0
Detroit,28,23,23,22,10,0,0,0,New Orleans,29,28,26,13,15,0,0,0,20131211,106,111,1,6,9,0,5,217,5,2013,1,2,939,0
Utah,26,32,38,26,0,0,0,0,Sacramento,23,23,26,29,0,0,0,0,20131211,122,101,3,12,24,21,21,223,-21,2013,0,2,532,0
Chicago,17,15,22,24,0,0,0,0,New York,15,31,22,15,0,0,0,0,20131211,78,83,-2,14,14,5,5,161,5,2013,0,2,711,0
Philadelphia,39,22,20,18,0,0,0,0,Minnesota,20,28,30,28,0,0,0,0,20131211,99,106,-19,-13,-3,7,7,205,7,2013,0,2,983,0
San Antonio,32,31,29,17,0,0,0,0,Milwaukee,16,24,14,23,0,0,0,0,20131211,109,77,16,23,38,32,32,186,-32,2013,0,2,1108,0
Oklahoma City,25,32,32,27,0,0,0,0,Memphis,22,20,31,27,0,0,0,0,20131211,116,100,3,15,16,16,16,216,-16,2013,0,2,421,0
Dallas,23,32,17,21,0,0,0,0,Golden State,16,28,22,29,0,0,0,0,20131211,93,95,-7,-11,-6,2,2,188,2,2013,0,2,1480,0
Orlando,16,27,24,25,0,0,0,0,Charlotte,18,24,20,21,0,0,0,0,20131211,92,83,-2,1,5,9,9,175,-9,2013,0,2,463,0
LA Clippers,20,19,27,30,0,0,0,0,Boston,23,22,19,24,0,0,0,0,20131211,96,88,-3,-6,2,8,8,184,-8,2013,0,2,2590,0
LA Clippers,25,19,18,31,0,0,0,0,Brooklyn,20,36,27,19,0,0,0,0,20131212,93,102,-5,12,21,9,9,195,9,2013,0,3,2445,0
Houston,20,24,32,28,0,0,0,0,Portland,21,22,33,35,0,0,0,0,20131212,104,111,1,-1,0,7,7,215,7,2013,0,3,1833,0
Philadelphia,21,27,28,24,0,0,0,0,Toronto,36,20,27,25,0,0,0,0,20131213,100,108,15,8,7,8,8,208,8,2013,0,4,334,0
Minnesota,30,24,35,21,0,0,0,0,San Antonio,27,35,18,37,0,0,0,0,20131213,110,117,-3,8,-9,7,7,227,7,2013,0,4,1112,0
Sacramento,34,27,21,25,0,0,0,0,Phoenix,28,30,27,31,0,0,0,0,20131213,107,116,-6,-3,3,9,9,223,9,2013,0,4,634,0
Cleveland,19,31,23,36,0,0,0,0,Orlando,28,23,25,24,0,0,0,0,20131213,109,100,-9,-1,-3,9,9,209,-9,2013,0,4,895,0
LA Lakers,28,23,23,23,0,0,0,0,Oklahoma City,38,28,28,28,0,0,0,0,20131213,97,122,10,15,20,25,25,219,25,2013,0,4,1178,0
Memphis,34,20,11,33,0,0,0,0,New Orleans,26,29,27,22,0,0,0,0,20131213,98,104,-8,1,17,6,6,202,6,2013,0,4,358,0
Houston,30,28,24,34,0,0,0,0,Golden State,29,22,22,39,0,0,0,0,20131213,116,112,1,7,9,4,4,228,-4,2013,0,4,1642,0
Charlotte,25,30,21,18,0,0,0,0,Indiana,27,29,23,20,0,0,0,0,20131213,94,99,2,1,3,5,5,193,5,2013,0,4,428,0
Brooklyn,24,20,24,31,0,0,0,0,Detroit,23,38,25,17,0,0,0,0,20131213,99,103,-1,17,18,4,4,202,4,2013,0,4,480,0
Utah,33,20,20,30,0,0,0,0,Denver,28,16,31,18,0,0,0,0,20131213,103,93,5,9,-2,10,10,196,-10,2013,0,4,370,0
New York,26,22,25,13,0,0,0,0,Boston,29,25,14,22,0,0,0,0,20131213,86,90,3,6,-5,4,4,176,4,2013,0,4,190,0
Washington,19,27,15,25,13,0,0,0,Atlanta,21,27,23,15,15,0,0,0,20131213,99,101,2,2,10,0,2,200,2,2013,1,4,541,0
Chicago,26,21,15,29,0,0,0,0,Milwaukee,18,33,18,21,0,0,0,0,20131213,91,90,8,-4,-7,1,1,181,-1,2013,0,4,83,0
Portland,32,39,40,28,0,0,0,0,Philadelphia,34,30,15,26,0,0,0,0,20131214,139,105,-2,7,32,34,34,244,-34,2013,0,5,2405,0
LA Clippers,34,25,30,24,0,0,0,0,Washington,28,18,31,20,0,0,0,0,20131214,113,97,6,13,12,16,16,210,-16,2013,0,5,2294,0
Atlanta,22,26,29,29,0,0,0,0,New York,26,31,24,30,0,0,0,0,20131214,106,111,4,9,4,5,5,217,5,2013,0,5,745,0
San Antonio,23,32,25,20,0,0,0,0,Utah,17,23,26,18,0,0,0,0,20131214,100,84,6,15,14,16,16,184,-16,2013,0,5,1087,0
Milwaukee,26,15,20,32,0,0,0,0,Dallas,38,21,34,13,0,0,0,0,20131214,93,106,12,18,32,13,13,199,13,2013,0,5,857,0
Toronto,24,27,22,26,0,0,0,0,Chicago,21,20,25,11,0,0,0,0,20131214,99,77,3,10,7,22,22,176,-22,2013,0,5,436,0
LA Lakers,22,22,20,24,0,0,0,0,Charlotte,23,20,25,17,0,0,0,0,20131214,88,85,-1,1,-4,3,3,173,-3,2013,0,5,2115,0
Cleveland,29,23,28,27,0,0,0,0,Miami,35,33,16,30,0,0,0,0,20131214,107,114,6,16,4,7,7,221,7,2013,0,5,1089,0
New Orleans,27,25,16,25,0,0,0,0,Denver,24,28,23,27,0,0,0,0,20131215,93,102,-3,0,7,9,9,195,9,2013,0,6,1079,0
Portland,29,21,23,26,12,0,0,0,Detroit,22,29,33,15,10,0,0,0,20131215,111,109,7,-1,-11,0,2,220,-2,2013,1,6,1964,0
Minnesota,28,28,21,24,0,0,0,0,Memphis,17,29,27,20,0,0,0,0,20131215,101,93,11,10,4,8,8,194,-8,2013,0,6,700,0
Orlando,22,27,22,27,0,0,0,0,Oklahoma City,28,28,27,18,0,0,0,0,20131215,98,101,6,7,12,3,3,199,3,2013,0,6,1057,0
Golden State,27,26,27,22,0,0,0,0,Phoenix,33,26,22,25,0,0,0,0,20131215,102,106,6,6,1,4,4,208,4,2013,0,6,652,0
Houston,28,21,22,20,0,0,0,0,Sacramento,28,29,24,25,0,0,0,0,20131215,91,106,0,8,10,15,15,197,15,2013,0,6,1606,0
Washington,26,27,22,27,0,0,0,0,New York,21,21,35,24,0,0,0,0,20131216,102,101,5,11,-2,1,1,203,-1,2013,0,0,204,0
Utah,20,30,21,23,0,0,0,0,Miami,26,21,36,34,0,0,0,0,20131216,94,117,6,-3,12,23,23,211,23,2013,0,0,2086,0
San Antonio,28,21,21,22,0,0,0,0,LA Clippers,21,34,23,37,0,0,0,0,20131216,92,115,-7,6,8,23,23,207,23,2013,0,0,1201,0
Detroit,31,25,23,22,0,0,0,0,Indiana,28,21,24,23,0,0,0,0,20131216,101,96,3,7,6,5,5,197,-5,2013,0,0,240,0
Orlando,21,22,24,16,0,0,0,0,Chicago,14,21,24,23,0,0,0,0,20131216,83,82,7,8,8,1,1,165,-1,2013,0,0,984,0
Minnesota,21,29,19,28,0,0,0,0,Boston,29,22,23,27,0,0,0,0,20131216,97,101,8,1,5,4,4,198,4,2013,0,0,1120,0
LA Lakers,28,26,19,27,0,0,0,0,Atlanta,20,27,35,32,0,0,0,0,20131216,100,114,-8,-7,9,14,14,214,14,2013,0,0,1932,0
Philadelphia,22,26,25,21,0,0,0,0,Brooklyn,32,26,42,30,0,0,0,0,20131216,94,130,10,10,27,36,36,224,36,2013,0,0,80,0
Sacramento,22,21,29,15,0,0,0,0,Charlotte,35,21,22,17,0,0,0,0,20131217,87,95,13,13,6,8,8,182,8,2013,0,1,2239,0
Portland,26,29,37,27,0,0,0,0,Cleveland,28,31,29,28,0,0,0,0,20131217,119,116,-2,-4,4,3,3,235,-3,2013,0,1,2049,0
Oklahoma City,29,23,23,30,0,0,0,0,Denver,24,20,21,28,0,0,0,0,20131217,105,93,5,8,10,12,12,198,-12,2013,0,1,503,0
New Orleans,19,20,26,28,0,0,0,0,Golden State,26,31,31,16,0,0,0,0,20131217,93,104,7,18,23,11,11,197,11,2013,0,1,1921,0
LA Lakers,34,18,15,29,0,0,0,0,Memphis,24,23,20,25,0,0,0,0,20131217,96,92,10,5,0,4,4,188,-4,2013,0,1,1599,0
Portland,22,21,35,31,0,0,0,0,Minnesota,31,38,29,22,0,0,0,0,20131218,109,120,9,26,20,11,11,229,11,2013,0,2,1423,0
Charlotte,18,19,33,25,9,0,0,0,Toronto,15,32,23,25,7,0,0,0,20131218,104,102,3,-10,0,0,2,206,-2,2013,1,2,585,0
San Antonio,29,30,28,21,0,0,0,0,Phoenix,34,24,23,20,0,0,0,0,20131218,108,101,-5,1,6,7,7,209,-7,2013,0,2,846,0
Utah,27,22,19,18,0,0,0,0,Orlando,20,19,23,20,0,0,0,0,20131218,86,82,7,10,6,4,4,168,-4,2013,0,2,1915,0
Indiana,26,26,24,18,0,0,0,0,Miami,22,19,30,26,0,0,0,0,20131218,94,97,-4,-11,-5,3,3,191,3,2013,0,2,1026,0
New York,24,21,23,19,7,13,0,0,Milwaukee,22,22,22,21,7,7,0,0,20131218,107,101,2,1,2,0,6,208,-6,2013,2,2,732,0
Chicago,16,30,20,28,0,0,0,0,Houston,24,33,26,26,0,0,0,0,20131218,94,109,8,11,17,15,15,203,15,2013,0,2,939,0
New Orleans,22,23,20,30,0,0,0,0,LA Clippers,27,25,26,30,0,0,0,0,20131218,95,108,5,7,13,13,13,203,13,2013,0,2,1669,0
Memphis,21,18,27,25,0,0,0,0,Dallas,27,25,26,27,0,0,0,0,20131218,91,105,6,13,12,14,14,196,14,2013,0,2,419,0
Washington,30,29,26,28,0,0,0,0,Brooklyn,28,25,24,30,0,0,0,0,20131218,113,107,2,6,8,6,6,220,-6,2013,0,2,204,0
Detroit,23,29,28,27,0,0,0,0,Boston,42,21,18,25,0,0,0,0,20131218,107,106,-19,-11,-1,1,1,213,-1,2013,0,2,611,0
Sacramento,26,28,33,20,0,0,0,0,Atlanta,28,25,32,39,0,0,0,0,20131218,107,124,2,-1,-2,17,17,231,17,2013,0,2,2082,0
San Antonio,18,35,29,22,0,0,0,0,Golden State,23,28,23,28,0,0,0,0,20131219,104,102,-5,2,8,2,2,206,-2,2013,0,3,1487,0
Chicago,24,28,20,23,0,0,0,0,Oklahoma City,35,20,29,23,0,0,0,0,20131219,95,107,11,3,12,12,12,202,12,2013,0,3,690,0
Brooklyn,31,26,26,25,12,0,0,0,Philadelphia,29,31,22,26,13,0,0,0,20131220,120,121,-2,3,-1,0,1,241,1,2013,1,4,80,0
Sacramento,36,25,21,21,0,0,0,0,Miami,33,34,31,24,0,0,0,0,20131220,103,122,-3,6,16,19,19,225,19,2013,0,4,2547,0
Minnesota,26,27,23,15,0,0,0,0,LA Lakers,35,16,30,23,0,0,0,0,20131220,91,104,9,-2,5,13,13,195,13,2013,0,4,1521,0
Houston,20,25,20,16,0,0,0,0,Indiana,25,31,31,27,0,0,0,0,20131220,81,114,5,11,22,33,33,195,33,2013,0,4,865,0
Toronto,22,27,29,23,8,0,0,0,Dallas,33,19,29,20,7,0,0,0,20131220,109,108,-11,-3,-3,0,1,217,-1,2013,1,4,1201,0
Phoenix,20,28,24,31,0,0,0,0,Denver,28,34,20,17,0,0,0,0,20131220,103,99,-8,-14,-10,4,4,202,-4,2013,0,4,585,0
Milwaukee,26,21,23,26,15,0,0,0,Cleveland,25,22,23,26,18,0,0,0,20131220,111,114,-1,0,0,0,3,225,3,2013,1,4,334,0
Utah,16,18,24,27,0,0,0,0,Atlanta,30,25,30,33,0,0,0,0,20131220,85,118,14,21,27,33,33,203,33,2013,0,4,1580,0
Charlotte,22,22,31,41,0,0,0,0,Detroit,31,28,30,17,0,0,0,0,20131220,116,106,-9,-15,-14,10,10,222,-10,2013,0,4,504,0
Memphis,25,25,22,23,0,0,0,0,New York,22,18,21,26,0,0,0,0,20131221,95,87,3,10,11,8,8,182,-8,2013,0,5,953,0
Oklahoma City,21,40,24,28,0,0,0,0,San Antonio,21,29,26,24,0,0,0,0,20131221,113,100,0,11,9,13,13,213,-13,2013,0,5,421,0
Dallas,25,33,24,26,0,0,0,0,Phoenix,38,25,28,32,0,0,0,0,20131221,108,123,13,5,9,15,15,231,15,2013,0,5,884,0
Sacramento,25,31,19,30,0,0,0,0,Orlando,31,27,19,23,0,0,0,0,20131221,105,100,-6,-2,-2,5,5,205,-5,2013,0,5,2390,0
Philadelphia,23,26,23,34,0,0,0,0,Milwaukee,29,30,26,31,0,0,0,0,20131221,106,116,6,10,13,10,10,222,10,2013,0,5,692,0
New Orleans,26,27,25,29,0,0,0,0,Portland,21,31,31,27,0,0,0,0,20131221,107,110,-5,-1,5,3,3,217,3,2013,0,5,2059,0
LA Lakers,26,16,15,26,0,0,0,0,Golden State,27,19,26,30,0,0,0,0,20131221,83,102,1,4,15,19,19,185,19,2013,0,5,347,0
Houston,33,28,25,28,0,0,0,0,Detroit,24,29,18,26,0,0,0,0,20131221,114,97,9,8,15,17,17,211,-17,2013,0,5,1105,0
Cleveland,26,17,22,19,0,0,0,0,Chicago,33,27,21,19,0,0,0,0,20131221,84,100,7,17,16,16,16,184,16,2013,0,5,308,0
Utah,17,25,28,18,0,0,0,0,Charlotte,21,25,20,19,0,0,0,0,20131221,88,85,-4,-4,4,3,3,173,-3,2013,0,5,1723,0
Washington,14,30,30,32,0,0,0,0,Boston,30,21,25,23,0,0,0,0,20131221,106,99,-16,-7,-2,7,7,205,-7,2013,0,5,394,0
Denver,18,25,17,31,0,0,0,0,LA Clippers,28,28,23,33,0,0,0,0,20131221,91,112,10,13,19,21,21,203,21,2013,0,5,830,0
Boston,17,20,21,21,0,0,0,0,Indiana,20,32,28,26,0,0,0,0,20131222,79,106,3,15,22,27,27,185,27,2013,0,6,805,0
Minnesota,24,30,31,21,10,0,0,0,LA Clippers,24,32,27,23,14,0,0,0,20131222,116,120,0,2,-2,0,4,236,4,2013,1,6,1521,0
Toronto,25,37,13,29,0,0,0,0,Oklahoma City,21,35,28,14,0,0,0,0,20131222,104,98,4,6,-9,6,6,202,-6,2013,0,6,1114,0
Toronto,26,23,23,27,0,0,0,0,San Antonio,25,30,23,34,0,0,0,0,20131223,99,112,-1,6,6,13,13,211,13,2013,0,0,1438,0
New Orleans,28,24,25,36,0,0,0,0,Sacramento,27,25,25,23,0,0,0,0,20131223,113,100,1,0,0,13,13,213,-13,2013,0,0,1879,0
LA Lakers,24,27,17,22,0,0,0,0,Phoenix,28,36,26,27,0,0,0,0,20131223,90,117,4,13,22,27,27,207,27,2013,0,0,356,0
Atlanta,23,31,30,27,8,0,0,0,Miami,33,17,27,34,10,0,0,0,20131223,119,121,10,-4,-7,0,2,240,2,2013,1,0,605,0
Utah,21,27,23,23,0,0,0,0,Memphis,27,26,24,27,0,0,0,0,20131223,94,104,6,5,6,10,10,198,10,2013,0,0,1247,0
New York,29,36,19,19,0,0,0,0,Orlando,27,14,35,22,0,0,0,0,20131223,103,98,2,24,8,5,5,201,-5,2013,0,0,939,0
Golden State,30,17,17,25,0,0,0,0,Denver,22,21,23,15,0,0,0,0,20131223,89,81,8,4,-2,8,8,170,-8,2013,0,0,947,0
Detroit,28,30,31,26,0,0,0,0,Cleveland,18,22,24,28,0,0,0,0,20131223,115,92,10,18,25,23,23,207,-23,2013,0,0,90,0
Milwaukee,33,21,24,23,9,0,0,0,Charlotte,17,35,26,23,10,0,0,0,20131223,110,111,-16,-2,0,0,1,221,1,2013,1,0,658,0
Indiana,19,26,30,28,0,0,0,0,Brooklyn,17,22,19,28,0,0,0,0,20131223,103,86,2,6,17,17,17,189,-17,2013,0,0,643,0
Dallas,20,30,36,25,0,0,0,0,Houston,26,31,21,26,0,0,0,0,20131223,111,104,-6,-7,8,7,7,215,-7,2013,0,0,225,0
Houston,40,20,23,28,0,0,0,0,San Antonio,25,26,24,23,0,0,0,0,20131225,111,98,15,9,8,13,13,209,-13,2013,0,2,189,0
Miami,21,30,25,25,0,0,0,0,LA Lakers,27,19,28,21,0,0,0,0,20131225,101,95,-6,5,2,6,6,196,-6,2013,0,2,2335,0
Oklahoma City,35,25,27,36,0,0,0,0,New York,29,17,21,27,0,0,0,0,20131225,123,94,6,14,20,29,29,217,-29,2013,0,2,1324,0
Chicago,21,20,36,18,0,0,0,0,Brooklyn,23,15,20,20,0,0,0,0,20131225,95,78,-2,3,19,17,17,173,-17,2013,0,2,711,0
LA Clippers,30,23,25,25,0,0,0,0,Golden State,22,29,24,30,0,0,0,0,20131225,103,105,-8,-2,-3,2,2,208,2,2013,0,2,347,0
Atlanta,26,24,26,19,13,19,0,0,Cleveland,27,21,24,23,13,17,0,0,20131226,127,125,-1,2,4,0,2,252,-2,2013,2,3,555,0
San Antonio,27,31,26,32,0,0,0,0,Dallas,20,31,26,30,0,0,0,0,20131226,116,107,7,7,7,9,9,223,-9,2013,0,3,252,0
Memphis,23,30,19,20,0,0,0,0,Houston,26,19,21,34,0,0,0,0,20131226,92,100,3,-8,-6,8,8,192,8,2013,0,3,484,0
LA Clippers,14,32,27,28,11,0,0,0,Portland,19,28,29,25,15,0,0,0,20131226,112,116,5,1,3,0,4,228,4,2013,1,3,826,0
Detroit,21,27,18,26,0,0,0,0,Orlando,26,29,30,24,0,0,0,0,20131227,92,109,5,7,19,17,17,201,17,2013,0,4,957,0
LA Lakers,23,29,29,22,0,0,0,0,Utah,25,30,28,22,0,0,0,0,20131227,103,105,2,3,2,2,2,208,2,2013,0,4,579,0
Miami,32,23,18,16,14,0,0,0,Sacramento,19,26,29,15,19,0,0,0,20131227,103,108,-13,-10,1,0,5,211,5,2013,1,4,2547,0
Denver,25,20,21,23,0,0,0,0,New Orleans,34,24,23,24,0,0,0,0,20131227,89,105,9,13,15,16,16,194,16,2013,0,4,1079,0
Toronto,18,22,26,29,0,0,0,0,New York,25,24,22,12,0,0,0,0,20131227,95,83,-7,-9,-5,12,12,178,-12,2013,0,4,341,0
Phoenix,22,18,24,22,0,0,0,0,Golden State,28,31,26,30,0,0,0,0,20131227,86,115,6,19,21,29,29,201,29,2013,0,4,652,0
Oklahoma City,21,21,20,27,0,0,0,0,Charlotte,20,16,24,25,0,0,0,0,20131227,89,85,1,6,2,4,4,174,-4,2013,0,4,938,0
Milwaukee,18,19,23,33,0,0,0,0,Brooklyn,31,17,28,28,0,0,0,0,20131227,93,104,13,11,16,11,11,197,11,2013,0,4,732,0
Washington,23,24,27,24,0,0,0,0,Minnesota,22,39,27,32,0,0,0,0,20131227,98,120,-1,14,14,22,22,218,22,2013,0,4,931,0
Minnesota,34,30,39,14,0,0,0,0,Milwaukee,28,27,21,19,0,0,0,0,20131228,117,95,6,9,27,22,22,212,-22,2013,0,5,298,0
Detroit,23,18,21,20,0,0,0,0,Washington,31,31,24,20,0,0,0,0,20131228,82,106,8,21,24,24,24,188,24,2013,0,5,394,0
New York,22,22,27,29,0,0,0,0,Toronto,26,31,28,30,0,0,0,0,20131228,100,115,4,13,14,15,15,215,15,2013,0,5,341,0
Miami,30,28,25,25,0,0,0,0,Portland,34,28,26,19,0,0,0,0,20131228,108,107,-4,-4,-5,1,1,215,-1,2013,0,5,2704,0
Philadelphia,27,32,22,20,0,0,0,0,Phoenix,36,24,28,27,0,0,0,0,20131228,101,115,9,1,7,14,14,216,14,2013,0,5,2078,0
Denver,29,27,16,27,0,0,0,0,Memphis,27,28,30,35,0,0,0,0,20131228,99,120,-2,-1,13,21,21,219,21,2013,0,5,877,0
Brooklyn,27,29,20,15,0,0,0,0,Indiana,29,29,28,19,0,0,0,0,20131228,91,105,2,2,10,14,14,196,14,2013,0,5,643,0
New Orleans,22,30,21,25,0,0,0,0,Houston,31,21,22,33,0,0,0,0,20131228,98,107,9,0,1,9,9,205,9,2013,0,5,317,0
Dallas,30,31,25,19,0,0,0,0,Chicago,19,15,22,27,0,0,0,0,20131228,105,83,11,27,30,22,22,188,-22,2013,0,5,802,0
Cleveland,22,22,22,34,0,0,0,0,Boston,24,35,26,18,0,0,0,0,20131228,100,103,2,15,19,3,3,203,3,2013,0,5,549,0
Charlotte,22,28,27,24,15,0,0,0,Atlanta,25,20,26,30,17,0,0,0,20131228,116,118,3,-5,-6,0,2,234,2,2013,1,5,226,0
Utah,20,23,22,25,0,0,0,0,LA Clippers,17,25,26,30,0,0,0,0,20131228,90,98,-3,-1,3,8,8,188,8,2013,0,5,579,0
Atlanta,20,29,27,26,0,0,0,0,Orlando,26,30,23,30,0,0,0,0,20131229,102,109,6,7,3,7,7,211,7,2013,0,6,401,0
Golden State,26,29,27,17,9,0,0,0,Cleveland,35,29,20,15,5,0,0,0,20131229,108,104,-9,-9,-2,0,4,212,-4,2013,1,6,2161,0
Philadelphia,20,32,34,25,0,0,0,0,LA Lakers,22,30,25,27,0,0,0,0,20131229,111,104,-2,0,9,7,7,215,-7,2013,0,6,2388,0
Houston,14,30,26,16,0,0,0,0,Oklahoma City,26,30,34,27,0,0,0,0,20131229,86,117,12,12,20,31,31,203,31,2013,0,6,413,0
Sacramento,23,26,38,17,0,0,0,0,San Antonio,27,30,24,31,0,0,0,0,20131229,104,112,4,8,-6,8,8,216,8,2013,0,6,1456,0
Portland,21,28,33,26,0,0,0,0,New Orleans,26,30,33,21,0,0,0,0,20131230,108,110,5,7,7,2,2,218,2,2013,0,0,2059,0
Charlotte,21,13,19,27,0,0,0,0,Utah,21,21,21,20,0,0,0,0,20131230,80,83,0,8,10,3,3,163,3,2013,0,0,1723,0
Dallas,29,33,19,19,0,0,0,0,Minnesota,23,20,38,17,0,0,0,0,20131230,100,98,6,19,0,2,2,198,-2,2013,0,0,863,0
Washington,33,20,25,28,0,0,0,0,Detroit,32,31,24,12,0,0,0,0,20131230,106,99,1,-10,-9,7,7,205,-7,2013,0,0,394,0
Phoenix,30,31,27,19,0,0,0,0,LA Clippers,24,16,19,29,0,0,0,0,20131230,107,88,6,21,29,19,19,195,-19,2013,0,0,356,0
Miami,29,17,26,25,0,0,0,0,Denver,30,25,22,17,0,0,0,0,20131230,97,94,-1,-9,-5,3,3,191,-3,2013,0,0,1724,0
Chicago,17,29,25,24,0,0,0,0,Memphis,22,22,20,27,0,0,0,0,20131230,95,91,-5,2,7,4,4,186,-4,2013,0,0,480,0
Brooklyn,20,16,32,24,0,0,0,0,San Antonio,30,29,39,15,0,0,0,0,20131231,92,113,10,23,30,21,21,205,21,2013,0,1,1581,0
Portland,24,18,29,27,0,0,0,0,Oklahoma City,30,24,24,16,0,0,0,0,20131231,98,94,-6,-12,-7,4,4,192,-4,2013,0,1,1484,0
Milwaukee,23,19,32,20,0,0,0,0,LA Lakers,12,21,27,19,0,0,0,0,20131231,94,79,11,9,14,15,15,173,-15,2013,0,1,1741,0
Golden State,26,32,16,20,0,0,0,0,Orlando,15,20,24,22,0,0,0,0,20131231,94,81,11,23,15,13,13,175,-13,2013,0,1,2437,0
Sacramento,29,29,22,30,0,0,0,0,Houston,24,28,34,20,0,0,0,0,20131231,110,106,5,6,-6,4,4,216,-4,2013,0,1,1606,0
Toronto,21,15,21,28,0,0,0,0,Chicago,16,26,20,17,0,0,0,0,20131231,85,79,5,-6,-5,6,6,164,-6,2013,0,1,436,0
Atlanta,20,19,23,30,0,0,0,0,Boston,23,21,23,24,0,0,0,0,20131231,92,91,-3,-5,-5,1,1,183,-1,2013,0,1,935,0
Cleveland,25,19,22,10,0,0,0,0,Indiana,23,18,24,26,0,0,0,0,20131231,76,91,-2,-3,-1,15,15,167,15,2013,0,1,262,0
Philadelphia,24,44,27,19,0,0,0,0,Denver,30,26,25,21,0,0,0,0,20140101,114,102,-6,12,14,12,12,216,-12,2013,0,2,1574,0
Charlotte,27,29,13,16,0,0,0,0,LA Clippers,25,31,25,31,0,0,0,0,20140101,85,112,-2,0,12,27,27,197,27,2013,0,2,2115,0
New Orleans,28,19,26,39,0,0,0,0,Minnesota,33,28,36,27,0,0,0,0,20140101,112,124,5,14,24,12,12,236,12,2013,0,2,1052,0
Indiana,18,26,19,19,0,0,0,0,Toronto,26,14,26,29,0,0,0,0,20140101,82,95,8,-4,3,13,13,177,13,2013,0,2,438,0
Dallas,25,14,20,28,0,0,0,0,Washington,20,22,19,17,0,0,0,0,20140101,87,78,5,-3,-2,9,9,165,-9,2013,0,2,1181,0
Charlotte,21,28,28,27,0,0,0,0,Portland,39,31,30,34,0,0,0,0,20140102,104,134,18,21,23,30,30,238,30,2013,0,3,2284,0
New York,26,26,29,24,0,0,0,0,San Antonio,25,22,28,26,0,0,0,0,20140102,105,101,1,5,6,4,4,206,-4,2013,0,3,1581,0
Philadelphia,30,31,31,21,0,0,0,0,Sacramento,25,26,26,27,0,0,0,0,20140102,113,104,5,10,15,9,9,217,-9,2013,0,3,2451,0
Memphis,22,31,16,30,0,0,0,0,Phoenix,26,15,32,18,0,0,0,0,20140102,99,91,-4,12,-4,8,8,190,-8,2013,0,3,1260,0
Milwaukee,20,22,19,26,0,0,0,0,Utah,20,31,23,22,0,0,0,0,20140102,87,96,0,9,13,9,9,183,9,2013,0,3,1239,0
Golden State,38,27,31,27,0,0,0,0,Miami,33,28,26,27,0,0,0,0,20140102,123,114,5,4,9,9,9,237,-9,2013,0,3,2590,0
Orlando,23,16,23,17,2,0,0,0,Cleveland,19,22,16,22,8,0,0,0,20140102,81,87,-4,2,-5,0,6,168,6,2013,1,3,895,0
Boston,21,24,17,20,0,0,0,0,Chicago,24,24,22,24,0,0,0,0,20140102,82,94,3,3,8,12,12,176,12,2013,0,3,849,0
Brooklyn,29,15,22,29,0,0,0,0,Oklahoma City,26,33,18,16,0,0,0,0,20140102,95,93,3,-15,-11,2,2,188,-2,2013,0,3,1324,0
Toronto,26,22,36,17,0,0,0,0,Washington,17,28,16,27,0,0,0,0,20140103,101,88,9,3,23,13,13,189,-13,2013,0,4,349,0
Utah,12,28,27,32,0,0,0,0,LA Lakers,30,22,31,27,0,0,0,0,20140103,99,110,18,12,16,11,11,209,11,2013,0,4,579,0
New York,24,23,34,19,0,0,0,0,Houston,20,28,25,29,0,0,0,0,20140103,100,102,-4,1,-8,2,2,202,2,2013,0,4,1417,0
New Orleans,22,27,24,22,0,0,0,0,Boston,17,26,29,20,0,0,0,0,20140103,95,92,5,6,1,3,3,187,-3,2013,0,4,1358,0
LA Clippers,33,34,22,30,0,0,0,0,Dallas,39,31,17,25,0,0,0,0,20140103,119,112,-6,-3,2,7,7,231,-7,2013,0,4,1237,0
Golden State,24,22,18,37,0,0,0,0,Atlanta,21,25,26,28,0,0,0,0,20140103,101,100,3,0,-8,1,1,201,-1,2013,0,4,2135,0
Memphis,23,25,27,33,0,0,0,0,Denver,28,30,19,34,0,0,0,0,20140103,108,111,5,10,2,3,3,219,3,2013,0,4,877,0
Cleveland,17,21,27,17,0,0,0,0,Brooklyn,22,29,16,22,0,0,0,0,20140104,82,89,5,13,2,7,7,171,7,2013,0,5,403,0
Atlanta,18,27,19,20,0,0,0,0,Chicago,26,24,17,24,0,0,0,0,20140104,84,91,8,5,3,7,7,175,7,2013,0,5,587,0
New Orleans,27,22,12,21,0,0,0,0,Indiana,15,29,30,25,0,0,0,0,20140104,82,99,-12,-5,13,17,17,181,17,2013,0,5,713,0
Oklahoma City,26,23,28,38,0,0,0,0,Minnesota,30,25,32,24,0,0,0,0,20140104,115,111,-4,-6,-10,4,4,226,-4,2013,0,5,694,0
Miami,30,18,33,29,0,0,0,0,Orlando,24,22,24,24,0,0,0,0,20140104,110,94,6,2,11,16,16,204,-16,2013,0,5,204,0
Milwaukee,26,23,29,22,0,0,0,0,Phoenix,28,32,27,29,0,0,0,0,20140104,100,116,2,11,9,16,16,216,16,2013,0,5,1462,0
Philadelphia,32,20,17,32,0,0,0,0,Portland,19,31,26,23,0,0,0,0,20140104,101,99,13,2,-7,2,2,200,-2,2013,0,5,2405,0
Charlotte,32,33,24,24,0,0,0,0,Sacramento,27,25,30,21,0,0,0,0,20140104,113,103,5,13,7,10,10,216,-10,2013,0,5,2239,0
LA Clippers,17,18,35,22,0,0,0,0,San Antonio,37,33,18,28,0,0,0,0,20140104,92,116,20,35,18,24,24,208,24,2013,0,5,1201,0
Golden State,28,30,34,20,0,0,0,0,Washington,36,22,15,23,0,0,0,0,20140105,112,96,-8,0,19,16,16,208,-16,2013,0,6,2435,0
Boston,26,30,22,18,0,0,0,0,Oklahoma City,34,32,26,27,0,0,0,0,20140105,96,119,8,10,14,23,23,215,23,2013,0,6,1492,0
Toronto,29,22,33,13,0,0,0,0,Miami,29,23,27,23,0,0,0,0,20140105,97,102,0,1,-5,5,5,199,5,2013,0,6,1234,0
New York,29,23,15,25,0,0,0,0,Dallas,17,18,22,23,0,0,0,0,20140105,92,80,12,17,10,12,12,172,-12,2013,0,6,1370,0
Memphis,28,23,28,33,0,0,0,0,Detroit,27,29,11,17,0,0,0,0,20140105,112,84,1,-5,12,28,28,196,-28,2013,0,6,622,0
Indiana,22,22,23,15,0,0,0,0,Cleveland,18,17,23,20,0,0,0,0,20140105,82,78,4,9,9,4,4,160,-4,2013,0,6,262,0
Denver,26,34,33,44,0,0,0,0,LA Lakers,29,32,22,32,0,0,0,0,20140105,137,115,-3,-1,10,22,22,252,-22,2013,0,6,830,0
Atlanta,21,31,15,19,0,0,0,0,Brooklyn,27,19,26,19,0,0,0,0,20140106,86,91,6,-6,5,5,5,177,5,2013,0,0,745,0
Orlando,18,16,21,26,0,0,0,0,LA Clippers,36,24,25,16,0,0,0,0,20140106,81,101,18,26,30,20,20,182,20,2013,0,0,2197,0
Minnesota,32,38,35,21,0,0,0,0,Philadelphia,29,25,20,21,0,0,0,0,20140106,126,95,3,16,31,31,31,221,-31,2013,0,0,983,0
New Orleans,24,25,21,18,0,0,0,0,Miami,25,18,32,32,0,0,0,0,20140107,88,107,1,-6,5,19,19,195,19,2013,0,1,668,0
Oklahoma City,28,19,27,27,0,0,0,0,Utah,30,29,31,22,0,0,0,0,20140107,101,112,2,12,16,11,11,213,11,2013,0,1,861,0
Portland,35,25,13,46,0,0,0,0,Sacramento,24,31,25,43,0,0,0,0,20140107,119,123,-11,-5,7,4,4,242,4,2013,0,1,483,0
Detroit,21,20,17,27,0,0,0,0,New York,24,17,32,16,0,0,0,0,20140107,85,89,3,0,15,4,4,174,4,2013,0,1,480,0
Golden State,28,22,29,22,0,0,0,0,Milwaukee,30,18,20,12,0,0,0,0,20140107,101,80,-2,2,11,21,21,181,-21,2013,0,1,1838,0
San Antonio,25,28,21,24,12,0,0,0,Memphis,22,19,23,34,10,0,0,0,20140107,110,108,3,12,10,0,2,218,-2,2013,1,1,631,0
Washington,24,19,23,31,0,0,0,0,Charlotte,21,18,16,28,0,0,0,0,20140107,97,83,3,4,11,14,14,180,-14,2013,0,1,329,0
Boston,23,22,33,20,0,0,0,0,Denver,31,37,35,26,0,0,0,0,20140107,98,129,8,23,25,31,31,227,31,2013,0,1,1765,0
LA Lakers,31,22,24,20,0,0,0,0,Dallas,33,27,25,25,0,0,0,0,20140107,97,110,2,7,8,13,13,207,13,2013,0,1,1237,0
Philadelphia,20,21,25,27,0,0,0,0,Cleveland,36,28,27,20,0,0,0,0,20140107,93,111,16,23,25,18,18,204,18,2013,0,1,358,0
Phoenix,25,21,17,24,0,0,0,0,Chicago,27,22,21,22,0,0,0,0,20140107,87,92,2,3,7,5,5,179,5,2013,0,1,1450,0
Toronto,15,21,22,21,0,0,0,0,Indiana,22,22,27,15,0,0,0,0,20140107,79,86,7,8,13,7,7,165,7,2013,0,1,438,0
Detroit,25,29,20,17,0,0,0,0,Toronto,26,24,34,28,0,0,0,0,20140108,91,112,1,-4,10,21,21,203,21,2013,0,2,205,0
Dallas,16,22,24,28,0,0,0,0,San Antonio,25,20,37,30,0,0,0,0,20140108,90,112,9,7,20,22,22,202,22,2013,0,2,252,0
Orlando,24,27,24,19,0,0,0,0,Portland,24,21,26,39,0,0,0,0,20140108,94,110,0,-6,-4,16,16,204,16,2013,0,2,2525,0
Washington,28,33,26,15,0,0,0,0,New Orleans,28,16,22,30,0,0,0,0,20140108,102,96,0,17,21,6,6,198,-6,2013,0,2,964,0
Boston,23,32,27,23,0,0,0,0,LA Clippers,32,27,29,23,0,0,0,0,20140108,105,111,9,4,6,6,6,216,6,2013,0,2,2590,0
LA Lakers,28,29,15,27,0,0,0,0,Houston,24,28,33,28,0,0,0,0,20140108,99,113,-4,-5,13,14,14,212,14,2013,0,2,1371,0
Golden State,32,20,24,22,0,0,0,0,Brooklyn,22,37,16,27,0,0,0,0,20140108,98,102,-10,7,-1,4,4,200,4,2013,0,2,2565,0
Indiana,12,20,34,21,0,0,0,0,Atlanta,25,24,30,18,0,0,0,0,20140108,87,97,13,17,13,10,10,184,10,2013,0,2,427,0
Phoenix,27,26,19,32,0,0,0,0,Minnesota,23,24,30,26,0,0,0,0,20140108,104,103,4,6,-5,1,1,207,-1,2013,0,2,1278,0
Miami,27,21,23,21,0,0,0,0,New York,21,22,32,27,0,0,0,0,20140109,92,102,-6,-5,4,10,10,194,10,2013,0,3,1091,0
Oklahoma City,26,25,15,22,0,0,0,0,Denver,27,33,29,12,0,0,0,0,20140109,88,101,1,9,23,13,13,189,13,2013,0,3,503,0
Orlando,24,16,24,19,0,0,0,0,Sacramento,18,28,30,27,0,0,0,0,20140110,83,103,-6,6,12,20,20,186,20,2013,0,4,2390,0
Detroit,28,27,29,30,0,0,0,0,Philadelphia,36,27,18,23,0,0,0,0,20140110,114,104,-8,-8,3,10,10,218,-10,2013,0,4,441,0
Charlotte,28,20,22,22,0,0,0,0,Minnesota,29,39,27,24,0,0,0,0,20140110,92,119,1,20,25,27,27,211,27,2013,0,4,938,0
Cleveland,26,20,39,28,0,0,0,0,Utah,26,23,21,32,0,0,0,0,20140110,113,102,0,-3,15,11,11,215,-11,2013,0,4,1564,0
Chicago,20,27,22,12,0,0,0,0,Milwaukee,27,18,14,13,0,0,0,0,20140110,81,72,-7,2,10,9,9,153,-9,2013,0,4,83,0
Dallas,31,31,22,23,0,0,0,0,New Orleans,24,25,16,25,0,0,0,0,20140110,107,90,7,13,19,17,17,197,-17,2013,0,4,442,0
LA Lakers,25,27,8,27,0,0,0,0,LA Clippers,43,27,31,22,0,0,0,0,20140110,87,123,18,18,41,36,36,210,36,2013,0,4,0,0
Washington,18,19,14,15,0,0,0,0,Indiana,18,27,20,28,0,0,0,0,20140110,66,93,0,8,14,27,27,159,27,2013,0,4,490,0
Phoenix,29,26,19,25,0,0,0,0,Memphis,25,23,26,30,0,0,0,0,20140110,99,104,-4,-7,0,5,5,203,5,2013,0,4,1260,0
Boston,21,28,18,30,0,0,0,0,Golden State,24,23,25,27,0,0,0,0,20140110,97,99,3,-2,5,2,2,196,2,2013,0,4,2692,0
Miami,32,13,19,25,4,2,0,0,Brooklyn,33,20,23,13,4,11,0,0,20140110,95,104,1,8,12,0,9,199,9,2013,2,4,1091,0
Houston,18,23,19,20,0,0,0,0,Atlanta,10,29,26,18,0,0,0,0,20140110,80,83,-8,-2,5,3,3,163,3,2013,0,4,700,0
Houston,29,34,31,20,0,0,0,0,Washington,29,17,33,28,0,0,0,0,20140111,114,107,0,17,15,7,7,221,-7,2013,0,5,1217,0
Brooklyn,18,24,22,16,0,0,0,0,Toronto,24,23,21,28,0,0,0,0,20140111,80,96,6,5,4,16,16,176,16,2013,0,5,341,0
Boston,32,28,26,18,0,0,0,0,Portland,27,31,32,22,0,0,0,0,20140111,104,112,-5,-2,4,8,8,216,8,2013,0,5,2532,0
New York,20,32,32,18,0,0,0,0,Philadelphia,28,12,28,24,0,0,0,0,20140111,102,92,-8,12,16,10,10,194,-10,2013,0,5,80,0
Milwaukee,10,25,27,23,0,0,0,0,Oklahoma City,14,24,39,24,0,0,0,0,20140111,85,101,4,3,15,16,16,186,16,2013,0,5,732,0
Phoenix,21,30,28,29,0,0,0,0,Detroit,35,29,25,21,0,0,0,0,20140111,108,110,14,13,10,2,2,218,2,2013,0,5,1687,0
Orlando,25,22,19,28,0,0,0,0,Denver,34,35,23,28,0,0,0,0,20140111,94,120,9,22,26,26,26,214,26,2013,0,5,1548,0
New Orleans,22,15,40,30,0,0,0,0,Dallas,17,25,42,26,0,0,0,0,20140111,107,110,-5,5,7,3,3,217,3,2013,0,5,442,0
Charlotte,17,25,28,27,0,0,0,0,Chicago,24,28,18,33,0,0,0,0,20140111,97,103,7,10,0,6,6,200,6,2013,0,5,586,0
Atlanta,18,23,31,29,0,0,0,0,Memphis,21,27,29,31,0,0,0,0,20140112,101,108,3,7,5,7,7,209,7,2013,0,6,336,0
Cleveland,32,18,11,19,0,0,0,0,Sacramento,30,29,30,35,0,0,0,0,20140112,80,124,-2,9,28,44,44,204,44,2013,0,6,2096,0
Minnesota,21,28,22,15,0,0,0,0,San Antonio,28,24,29,23,0,0,0,0,20140112,86,104,7,3,10,18,18,190,18,2013,0,6,1112,0
Milwaukee,24,26,23,21,0,0,0,0,Toronto,38,20,30,28,0,0,0,0,20140113,94,116,14,8,15,22,22,210,22,2013,0,0,429,0
Phoenix,21,22,25,24,4,0,0,0,New York,28,24,23,17,6,0,0,0,20140113,96,98,7,9,7,0,2,194,2,2013,1,0,2139,0
San Antonio,24,27,25,25,0,0,0,0,New Orleans,28,24,21,22,0,0,0,0,20140113,101,95,-4,-1,3,6,6,196,-6,2013,0,0,506,0
Denver,31,22,24,26,0,0,0,0,Utah,35,32,26,25,0,0,0,0,20140113,103,118,4,14,16,15,15,221,15,2013,0,0,370,0
Washington,26,30,22,24,0,0,0,0,Chicago,19,24,25,20,0,0,0,0,20140113,102,88,7,13,10,14,14,190,-14,2013,0,0,594,0
Houston,19,33,32,20,0,0,0,0,Boston,27,16,22,27,0,0,0,0,20140113,104,92,-8,9,19,12,12,196,-12,2013,0,0,1603,0
Orlando,20,21,25,22,0,0,0,0,Dallas,28,31,25,23,0,0,0,0,20140113,88,107,8,18,18,19,19,195,19,2013,0,0,961,0
New York,24,22,27,25,0,0,0,0,Charlotte,27,28,23,30,0,0,0,0,20140114,98,108,3,9,5,10,10,206,10,2013,0,1,531,0
Sacramento,20,25,29,18,0,0,0,0,Indiana,25,34,27,30,0,0,0,0,20140114,92,116,5,14,12,24,24,208,24,2013,0,1,1882,0
Cleveland,28,29,31,32,0,0,0,0,LA Lakers,23,40,22,33,0,0,0,0,20140114,120,118,5,-6,3,2,2,238,-2,2013,0,1,2044,0
Oklahoma City,16,31,20,20,0,0,0,0,Memphis,24,19,29,18,0,0,0,0,20140114,87,90,8,-4,5,3,3,177,3,2013,0,1,421,0
Miami,18,30,29,20,0,0,0,0,Washington,43,26,17,28,0,0,0,0,20140115,97,114,25,21,9,17,17,211,17,2013,0,2,924,0
Utah,25,20,24,36,0,0,0,0,San Antonio,28,22,31,28,0,0,0,0,20140115,105,109,3,5,12,4,4,214,4,2013,0,2,1087,0
Cleveland,27,23,25,21,0,0,0,0,Portland,26,28,23,31,0,0,0,0,20140115,96,108,-1,4,2,12,12,204,12,2013,0,2,2049,0
LA Lakers,27,31,24,32,0,0,0,0,Phoenix,26,28,34,33,0,0,0,0,20140115,114,121,-1,-4,6,7,7,235,7,2013,0,2,356,0
Charlotte,27,18,23,24,0,0,0,0,Philadelphia,24,29,19,23,0,0,0,0,20140115,92,95,-3,8,4,3,3,187,3,2013,0,2,450,0
Chicago,26,20,27,28,10,8,9,0,Orlando,20,29,31,21,10,8,6,0,20140115,128,125,6,-3,-7,0,3,253,-3,2013,3,2,984,0
Sacramento,24,34,25,28,0,0,0,0,Minnesota,23,24,26,35,0,0,0,0,20140115,111,108,1,11,10,3,3,219,-3,2013,0,2,1511,0
Memphis,20,22,16,24,0,0,0,0,Milwaukee,10,25,25,17,0,0,0,0,20140115,82,77,10,7,-2,5,5,159,-5,2013,0,2,557,0
Dallas,32,30,36,29,0,0,0,0,LA Clippers,30,42,28,29,0,0,0,0,20140115,127,129,-2,10,2,2,2,256,2,2013,0,2,1237,0
Denver,35,30,26,32,0,0,0,0,Golden State,32,26,24,34,0,0,0,0,20140115,123,116,3,7,9,7,7,239,-7,2013,0,2,947,0
Toronto,25,16,15,27,0,0,0,0,Boston,23,22,28,15,0,0,0,0,20140115,83,88,-2,4,17,5,5,171,5,2013,0,2,430,0
Houston,19,26,29,29,0,0,0,0,New Orleans,30,26,25,19,0,0,0,0,20140115,103,100,-11,-11,-7,3,3,203,-3,2013,0,2,317,0
Brooklyn,31,34,34,28,0,0,0,0,Atlanta,27,26,21,36,0,0,0,0,20140116,127,110,4,12,25,17,17,237,-17,2013,0,3,745,0
Oklahoma City,36,23,24,21,0,0,0,0,Houston,32,41,10,9,0,0,0,0,20140116,104,92,4,-14,0,12,12,196,-12,2013,0,3,413,0
New York,31,17,21,20,0,0,0,0,Indiana,30,33,24,30,0,0,0,0,20140116,89,117,-1,15,18,28,28,206,28,2013,0,3,643,0
Miami,34,24,21,22,0,0,0,0,Philadelphia,24,17,20,25,0,0,0,0,20140117,101,86,10,17,18,15,15,187,-15,2013,0,4,1021,0
Chicago,27,23,24,19,0,0,0,0,Washington,30,24,20,22,0,0,0,0,20140117,93,96,3,4,0,3,3,189,3,2013,0,4,594,0
Portland,27,27,23,32,0,0,0,0,San Antonio,27,22,29,22,0,0,0,0,20140117,109,100,0,5,-1,9,9,209,-9,2013,0,4,1718,0
Dallas,36,22,26,26,0,0,0,0,Phoenix,30,26,19,32,0,0,0,0,20140117,110,107,6,2,9,3,3,217,-3,2013,0,4,884,0
Charlotte,30,22,26,33,0,0,0,0,Orlando,18,35,21,27,0,0,0,0,20140117,111,101,12,-1,4,10,10,212,-10,2013,0,4,463,0
Minnesota,15,25,21,28,0,0,0,0,Toronto,22,22,25,25,0,0,0,0,20140117,89,94,7,4,8,5,5,183,5,2013,0,4,691,0
LA Clippers,23,27,26,33,0,0,0,0,New York,27,23,17,28,0,0,0,0,20140117,109,95,-4,0,9,14,14,204,-14,2013,0,4,2445,0
Sacramento,21,21,29,19,0,0,0,0,Memphis,20,24,28,19,0,0,0,0,20140117,90,91,-1,2,1,1,1,181,1,2013,0,4,1745,0
Utah,27,31,31,21,0,0,0,0,Detroit,25,20,20,24,0,0,0,0,20140117,110,89,2,13,24,21,21,199,-21,2013,0,4,1488,0
Cleveland,26,42,19,30,0,0,0,0,Denver,29,28,23,29,0,0,0,0,20140117,117,109,-3,11,7,8,8,226,-8,2013,0,4,1223,0
LA Lakers,25,27,24,31,0,0,0,0,Boston,23,35,24,22,0,0,0,0,20140117,107,104,2,-6,-6,3,3,211,-3,2013,0,4,2590,0
Golden State,32,33,26,30,0,0,0,0,Oklahoma City,39,32,30,26,0,0,0,0,20140117,121,127,7,6,10,6,6,248,6,2013,0,4,1386,0
Miami,27,26,22,15,14,0,0,0,Charlotte,29,31,16,14,6,0,0,0,20140118,104,96,-2,-7,-1,0,8,200,-8,2013,1,5,654,0
Philadelphia,19,12,20,27,0,0,0,0,Chicago,24,27,27,25,0,0,0,0,20140118,78,103,5,20,27,25,25,181,25,2013,0,5,664,0
Portland,35,36,33,23,0,0,0,0,Dallas,23,29,18,41,0,0,0,0,20140118,127,111,12,19,34,16,16,238,-16,2013,0,5,1630,0
Milwaukee,23,29,26,26,0,0,0,0,Houston,29,33,29,23,0,0,0,0,20140118,104,114,6,10,13,10,10,218,10,2013,0,5,1005,0
LA Clippers,18,23,27,24,0,0,0,0,Indiana,28,29,21,28,0,0,0,0,20140118,92,106,10,16,10,14,14,198,14,2013,0,5,1805,0
Utah,14,9,22,27,0,0,0,0,Minnesota,23,28,28,19,0,0,0,0,20140118,72,98,9,28,34,26,26,170,26,2013,0,5,984,0
Golden State,24,28,26,19,0,0,0,0,New Orleans,29,25,18,15,0,0,0,0,20140118,97,87,-5,-2,6,10,10,184,-10,2013,0,5,1921,0
Detroit,22,24,33,25,0,0,0,0,Washington,29,25,22,22,0,0,0,0,20140118,104,98,-7,-8,3,6,6,202,-6,2013,0,5,394,0
LA Lakers,29,25,28,30,0,0,0,0,Toronto,36,22,23,25,0,0,0,0,20140119,112,106,-7,-4,1,6,6,218,-6,2013,0,6,2170,0
Milwaukee,16,22,22,22,0,0,0,0,San Antonio,29,24,31,26,0,0,0,0,20140119,82,110,13,15,24,28,28,192,28,2013,0,6,1108,0
Boston,26,20,18,27,0,0,0,0,Orlando,18,35,13,27,0,0,0,0,20140119,91,93,-8,7,2,2,2,184,2,2013,0,6,1115,0
Sacramento,30,22,22,19,0,0,0,0,Oklahoma City,28,29,32,19,0,0,0,0,20140119,93,108,-2,5,15,15,15,201,15,2013,0,6,1336,0
Denver,25,31,23,24,0,0,0,0,Phoenix,34,28,22,33,0,0,0,0,20140119,103,117,9,6,5,14,14,220,14,2013,0,6,585,0
Miami,31,39,22,22,0,0,0,0,Atlanta,34,37,26,24,0,0,0,0,20140120,114,121,3,1,5,7,7,235,7,2013,0,0,605,0
Toronto,11,25,24,35,0,0,0,0,Charlotte,26,29,23,22,0,0,0,0,20140120,95,100,15,19,18,5,5,195,5,2013,0,0,585,0
LA Lakers,26,26,20,21,7,0,0,0,Chicago,31,18,20,24,9,0,0,0,20140120,100,102,5,-3,-3,0,2,202,2,2013,1,0,1741,0
Dallas,30,29,20,23,0,0,0,0,Cleveland,23,14,29,31,0,0,0,0,20140120,102,97,7,22,13,5,5,199,-5,2013,0,0,1024,0
LA Clippers,26,38,30,18,0,0,0,0,Detroit,28,25,25,25,0,0,0,0,20140120,112,103,-2,11,16,9,9,215,-9,2013,0,0,1979,0
Indiana,35,18,24,25,0,0,0,0,Golden State,21,19,29,25,0,0,0,0,20140120,102,94,14,13,8,8,8,196,-8,2013,0,0,1944,0
Portland,28,28,35,22,0,0,0,0,Houston,37,34,35,20,0,0,0,0,20140120,113,126,9,15,15,13,13,239,13,2013,0,0,1833,0
New Orleans,25,16,27,27,0,0,0,0,Memphis,20,20,29,23,0,0,0,0,20140120,95,92,5,1,-1,3,3,187,-3,2013,0,0,358,0
Brooklyn,27,25,19,32,0,0,0,0,New York,16,22,17,25,0,0,0,0,20140120,103,80,11,14,16,23,23,183,-23,2013,0,0,0,0
Philadelphia,23,28,22,26,0,0,0,0,Washington,29,32,25,21,0,0,0,0,20140120,99,107,6,10,13,8,8,206,8,2013,0,0,123,0
Minnesota,34,20,30,28,0,0,0,0,Utah,16,23,23,35,0,0,0,0,20140121,112,97,18,15,22,15,15,209,-15,2013,0,1,984,0
Portland,27,25,23,22,0,0,0,0,Oklahoma City,21,30,26,28,0,0,0,0,20140121,97,105,-6,-1,2,8,8,202,8,2013,0,1,1484,0
Orlando,21,21,14,34,0,0,0,0,Brooklyn,27,19,27,28,0,0,0,0,20140121,90,101,6,4,17,11,11,191,11,2013,0,1,939,0
Boston,15,25,27,19,0,0,0,0,Miami,29,22,20,22,0,0,0,0,20140121,86,93,14,11,4,7,7,179,7,2013,0,1,1257,0
Sacramento,38,26,27,23,0,0,0,0,New Orleans,20,36,14,27,0,0,0,0,20140121,114,97,18,8,21,17,17,211,-17,2013,0,1,1879,0
LA Clippers,25,24,21,21,0,0,0,0,Charlotte,26,22,24,23,0,0,0,0,20140122,91,95,1,-1,2,4,4,186,4,2013,0,2,2115,0
Chicago,23,20,28,27,0,0,0,0,Cleveland,17,27,18,25,0,0,0,0,20140122,98,87,6,-1,9,11,11,185,-11,2013,0,2,308,0
Sacramento,22,22,29,25,0,0,0,0,Houston,29,26,33,31,0,0,0,0,20140122,98,119,7,11,15,21,21,217,21,2013,0,2,1606,0
Detroit,28,28,29,16,0,0,0,0,Milwaukee,25,25,31,23,0,0,0,0,20140122,101,104,-3,-6,-4,3,3,205,3,2013,0,2,251,0
Philadelphia,33,28,23,26,0,0,0,0,New York,26,30,24,26,0,0,0,0,20140122,110,106,7,5,4,4,4,216,-4,2013,0,2,80,0
Atlanta,29,31,28,24,0,0,0,0,Orlando,21,35,24,29,0,0,0,0,20140122,112,109,8,4,8,3,3,221,-3,2013,0,2,401,0
Indiana,29,20,30,21,0,0,0,0,Phoenix,30,32,34,28,0,0,0,0,20140122,100,124,1,13,17,24,24,224,24,2013,0,2,1496,0
Oklahoma City,30,25,21,35,0,0,0,0,San Antonio,24,29,22,30,0,0,0,0,20140122,111,105,6,2,1,6,6,216,-6,2013,0,2,421,0
Dallas,34,17,22,12,0,0,0,0,Toronto,15,31,22,25,0,0,0,0,20140122,85,93,-19,-5,-5,8,8,178,8,2013,0,2,1201,0
Boston,32,29,15,23,14,0,0,0,Washington,22,21,30,26,12,0,0,0,20140122,113,111,10,18,3,0,2,224,-2,2013,1,2,394,0
Denver,30,37,24,14,0,0,0,0,Portland,27,32,27,24,0,0,0,0,20140123,105,110,-3,-8,-5,5,5,215,5,2013,0,3,981,0
LA Lakers,27,19,29,27,0,0,0,0,Miami,30,27,28,24,0,0,0,0,20140123,102,109,3,11,10,7,7,211,7,2013,0,3,2335,0
Indiana,26,24,29,24,13,0,0,0,Sacramento,37,23,24,19,8,0,0,0,20140124,116,111,-11,-10,-5,0,5,227,-5,2013,1,4,1882,0
San Antonio,27,28,29,21,0,0,0,0,Atlanta,14,20,22,23,0,0,0,0,20140124,105,79,13,21,28,26,26,184,-26,2013,0,4,881,0
Oklahoma City,27,23,27,24,0,0,0,0,Boston,28,18,13,24,0,0,0,0,20140124,101,83,-1,4,18,18,18,184,-18,2013,0,4,1492,0
Dallas,21,25,24,36,0,0,0,0,Brooklyn,18,39,21,29,0,0,0,0,20140124,106,107,-3,11,8,1,1,213,1,2013,0,4,1370,0
LA Clippers,41,27,24,20,0,0,0,0,Chicago,26,29,25,15,0,0,0,0,20140124,112,95,15,13,12,17,17,207,-17,2013,0,4,1741,0
Milwaukee,23,14,18,23,0,0,0,0,Cleveland,24,22,25,22,0,0,0,0,20140124,78,93,1,9,16,15,15,171,15,2013,0,4,334,0
New Orleans,25,29,17,32,0,0,0,0,Detroit,26,22,32,21,0,0,0,0,20140124,103,101,-1,6,-9,2,2,204,-2,2013,0,4,939,0
Minnesota,36,27,28,30,0,0,0,0,Golden State,36,27,35,22,0,0,0,0,20140124,121,120,0,0,-7,1,1,241,-1,2013,0,4,1581,0
Memphis,21,23,20,24,0,0,0,0,Houston,20,15,29,23,0,0,0,0,20140124,88,87,1,9,0,1,1,175,-1,2013,0,4,484,0
Charlotte,21,25,20,30,0,0,0,0,New York,30,37,34,24,0,0,0,0,20140124,96,125,9,21,35,29,29,221,29,2013,0,4,531,0
LA Lakers,32,23,25,25,0,0,0,0,Orlando,28,25,38,23,0,0,0,0,20140124,105,114,-4,-2,11,9,9,219,9,2013,0,4,2197,0
Toronto,27,25,28,24,0,0,0,0,Philadelphia,28,25,25,17,0,0,0,0,20140124,104,95,-1,-1,2,9,9,199,-9,2013,0,4,334,0
Washington,30,21,31,19,0,0,0,0,Phoenix,29,28,19,19,0,0,0,0,20140124,101,95,1,-6,6,6,6,196,-6,2013,0,4,1977,0
LA Clippers,36,35,22,33,0,0,0,0,Toronto,37,28,28,25,0,0,0,0,20140125,126,118,-1,6,0,8,8,244,-8,2013,0,5,2170,0
Minnesota,29,28,24,23,0,0,0,0,Portland,27,38,22,28,0,0,0,0,20140125,104,115,-2,8,6,11,11,219,11,2013,0,5,1423,0
Washington,29,24,24,24,0,0,0,0,Utah,21,30,26,27,0,0,0,0,20140125,101,104,-8,-2,0,3,3,205,3,2013,0,5,1841,0
Oklahoma City,26,27,30,20,0,0,0,0,Philadelphia,26,18,27,20,0,0,0,0,20140125,103,91,0,9,12,12,12,194,-12,2013,0,5,1256,0
Chicago,22,17,18,32,0,0,0,0,Charlotte,24,15,16,32,0,0,0,0,20140125,89,87,-2,0,2,2,2,176,-2,2013,0,5,586,0
Houston,14,21,19,27,0,0,0,0,Memphis,16,30,25,28,0,0,0,0,20140125,81,99,2,11,17,18,18,180,18,2013,0,5,484,0
Indiana,18,18,40,20,0,0,0,0,Denver,22,33,31,23,0,0,0,0,20140125,96,109,4,19,10,13,13,205,13,2013,0,5,998,0
Atlanta,31,29,36,16,0,0,0,0,Milwaukee,25,20,19,23,0,0,0,0,20140125,112,87,6,15,32,25,25,199,-25,2013,0,5,669,0
Brooklyn,11,24,24,26,0,0,0,0,Boston,17,17,19,26,0,0,0,0,20140126,85,79,-6,1,6,6,6,164,-6,2013,0,6,190,0
Phoenix,22,21,25,31,0,0,0,0,Cleveland,29,32,6,23,0,0,0,0,20140126,99,90,-7,-18,1,9,9,189,-9,2013,0,6,1745,0
Detroit,25,21,35,25,0,0,0,0,Dallas,28,28,28,32,0,0,0,0,20140126,106,116,3,10,3,10,10,222,10,2013,0,6,999,0
Portland,22,33,12,21,0,0,0,0,Golden State,28,26,22,27,0,0,0,0,20140126,88,103,6,-1,9,15,15,191,15,2013,0,6,535,0
San Antonio,28,22,21,30,0,0,0,0,Miami,34,24,33,22,0,0,0,0,20140126,101,113,6,8,20,12,12,214,12,2013,0,6,1147,0
Orlando,21,23,25,23,0,0,0,0,New Orleans,27,27,21,25,0,0,0,0,20140126,92,100,6,10,6,8,8,192,8,2013,0,6,533,0
LA Lakers,25,22,34,22,0,0,0,0,New York,22,29,32,27,0,0,0,0,20140126,103,110,-3,4,2,7,7,213,7,2013,0,6,2445,0
Denver,30,35,30,30,0,0,0,0,Sacramento,31,28,34,24,0,0,0,0,20140126,125,117,-1,6,2,8,8,242,-8,2013,0,6,886,0
Sacramento,22,28,20,29,0,0,0,0,Utah,20,30,31,25,0,0,0,0,20140127,99,106,-2,0,11,7,7,205,7,2013,0,0,532,0
Phoenix,40,22,33,29,0,0,0,0,Philadelphia,26,28,28,31,0,0,0,0,20140127,124,113,14,8,13,11,11,237,-11,2013,0,0,2078,0
Atlanta,32,25,30,22,0,0,0,0,Oklahoma City,26,24,29,32,0,0,0,0,20140127,109,111,-6,-7,-8,2,2,220,2,2013,0,0,755,0
Minnesota,23,31,18,23,0,0,0,0,Chicago,20,26,19,21,0,0,0,0,20140127,95,86,3,8,7,9,9,181,-9,2013,0,0,355,0
Toronto,25,32,25,22,0,0,0,0,Brooklyn,26,30,25,22,0,0,0,0,20140127,104,103,-1,1,1,1,1,207,-1,2013,0,0,341,0
LA Clippers,32,32,20,30,0,0,0,0,Milwaukee,25,16,20,25,0,0,0,0,20140127,114,86,7,23,23,28,28,200,-28,2013,0,0,1741,0
New Orleans,26,30,27,17,0,0,0,0,Cleveland,29,15,21,24,0,0,0,0,20140128,100,89,-3,12,18,11,11,189,-11,2013,0,1,924,0
Orlando,22,21,17,27,0,0,0,0,Detroit,20,33,25,25,0,0,0,0,20140128,87,103,-2,10,18,16,16,190,16,2013,0,1,957,0
Washington,24,21,21,22,0,0,0,0,Golden State,22,27,16,20,0,0,0,0,20140128,88,85,2,-4,1,3,3,173,-3,2013,0,1,2435,0
San Antonio,28,18,18,26,0,0,0,0,Houston,20,19,33,25,0,0,0,0,20140128,90,97,-8,-7,8,7,7,187,7,2013,0,1,189,0
Indiana,22,27,30,25,0,0,0,0,LA Lakers,19,30,20,23,0,0,0,0,20140128,104,92,3,0,10,12,12,196,-12,2013,0,1,1805,0
Boston,15,22,22,29,0,0,0,0,New York,31,32,23,28,0,0,0,0,20140128,88,114,16,26,27,26,26,202,26,2013,0,1,190,0
Memphis,31,30,20,17,0,0,0,0,Portland,22,24,12,23,0,0,0,0,20140128,98,81,9,15,23,17,17,179,-17,2013,0,1,1845,0
New Orleans,16,19,27,15,0,0,0,0,Minnesota,23,24,20,21,0,0,0,0,20140129,77,88,7,12,5,11,11,165,11,2013,0,2,1052,0
Orlando,20,20,25,18,0,0,0,0,Toronto,33,22,25,18,0,0,0,0,20140129,83,98,13,15,15,15,15,181,15,2013,0,2,1048,0
Chicago,21,19,28,28,0,0,0,0,San Antonio,15,21,25,25,0,0,0,0,20140129,96,86,6,4,7,10,10,182,-10,2013,0,2,1050,0
Memphis,25,23,21,30,0,0,0,0,Sacramento,24,22,17,26,0,0,0,0,20140129,99,89,1,2,6,10,10,188,-10,2013,0,2,1745,0
Phoenix,28,34,29,35,0,0,0,0,Milwaukee,19,31,34,33,0,0,0,0,20140129,126,117,9,12,7,9,9,243,-9,2013,0,2,1462,0
Philadelphia,23,30,21,21,0,0,0,0,Boston,26,21,24,23,0,0,0,0,20140129,95,94,-3,6,3,1,1,189,-1,2013,0,2,270,0
Washington,31,20,23,29,0,0,0,0,LA Clippers,30,32,19,29,0,0,0,0,20140129,103,110,-1,11,7,7,7,213,7,2013,0,2,2294,0
Charlotte,32,21,22,26,0,0,0,0,Denver,21,31,23,23,0,0,0,0,20140129,101,98,11,1,0,3,3,199,-3,2013,0,2,1355,0
Houston,32,31,28,26,0,0,0,0,Dallas,30,27,28,30,0,0,0,0,20140129,117,115,2,6,6,2,2,232,-2,2013,0,2,225,0
Oklahoma City,21,34,36,21,0,0,0,0,Miami,30,20,25,20,0,0,0,0,20140129,112,95,-9,5,16,17,17,207,-17,2013,0,2,1225,0
LA Clippers,21,35,11,25,0,0,0,0,Golden State,32,32,26,21,0,0,0,0,20140130,92,111,11,8,23,19,19,203,19,2013,0,3,347,0
Phoenix,36,30,11,25,0,0,0,0,Indiana,19,30,25,20,0,0,0,0,20140130,102,94,17,17,3,8,8,196,-8,2013,0,3,1496,0
Cleveland,21,15,29,21,0,0,0,0,New York,38,22,21,36,0,0,0,0,20140130,86,117,17,24,16,31,31,203,31,2013,0,3,403,0
Golden State,23,18,25,29,0,0,0,0,Utah,21,27,23,19,0,0,0,0,20140131,95,90,2,-7,-5,5,5,185,-5,2013,0,4,599,0
Atlanta,27,37,38,23,0,0,0,0,Philadelphia,21,31,23,24,0,0,0,0,20140131,125,99,6,12,27,26,26,224,-26,2013,0,4,665,0
Milwaukee,20,26,18,38,0,0,0,0,Orlando,35,32,21,25,0,0,0,0,20140131,102,113,15,21,24,11,11,215,11,2013,0,4,1065,0
Memphis,30,20,16,28,0,0,0,0,Minnesota,22,15,30,23,0,0,0,0,20140131,94,90,8,13,-1,4,4,184,-4,2013,0,4,700,0
Toronto,29,31,26,14,0,0,0,0,Denver,25,28,17,20,0,0,0,0,20140131,100,90,4,7,16,10,10,190,-10,2013,0,4,1341,0
Sacramento,20,29,32,22,0,0,0,0,Dallas,24,30,21,32,0,0,0,0,20140131,103,107,4,5,-6,4,4,210,4,2013,0,4,1437,0
Oklahoma City,30,33,26,31,0,0,0,0,Brooklyn,16,19,24,36,0,0,0,0,20140131,120,95,14,28,30,25,25,215,-25,2013,0,4,1324,0
Charlotte,31,31,24,24,0,0,0,0,LA Lakers,27,22,25,26,0,0,0,0,20140131,110,100,4,13,12,10,10,210,-10,2013,0,4,2115,0
Miami,29,24,24,29,0,0,0,0,New York,22,24,25,20,0,0,0,0,20140201,106,91,7,7,6,15,15,197,-15,2013,0,5,1091,0
Oklahoma City,13,25,26,17,0,0,0,0,Washington,25,17,36,18,0,0,0,0,20140201,81,96,12,4,14,15,15,177,15,2013,0,5,1149,0
Sacramento,24,29,25,15,0,0,0,0,San Antonio,27,25,19,24,0,0,0,0,20140201,93,95,3,-1,-7,2,2,188,2,2013,0,5,1456,0
Toronto,19,21,34,29,0,0,0,0,Portland,31,26,26,23,0,0,0,0,20140201,103,106,12,17,9,3,3,209,3,2013,0,5,2108,0
Chicago,21,18,18,22,0,0,0,0,New Orleans,23,27,21,17,0,0,0,0,20140201,79,88,2,11,14,9,9,167,9,2013,0,5,832,0
Charlotte,27,14,22,32,0,0,0,0,Phoenix,32,27,31,15,0,0,0,0,20140201,95,105,5,18,27,10,10,200,10,2013,0,5,1778,0
Utah,21,21,23,22,0,0,0,0,LA Clippers,19,23,34,26,0,0,0,0,20140201,87,102,-2,0,11,15,15,189,15,2013,0,5,579,0
Minnesota,24,30,21,38,0,0,0,0,Atlanta,25,23,38,34,0,0,0,0,20140201,113,120,1,-6,11,7,7,233,7,2013,0,5,908,0
Philadelphia,22,27,21,26,0,0,0,0,Detroit,32,25,36,20,0,0,0,0,20140201,96,113,10,8,23,17,17,209,17,2013,0,5,441,0
Milwaukee,24,25,20,21,0,0,0,0,Memphis,17,26,24,32,0,0,0,0,20140201,90,99,-7,-6,-2,9,9,189,9,2013,0,5,557,0
Brooklyn,24,21,25,26,0,0,0,0,Indiana,25,21,26,25,0,0,0,0,20140201,96,97,1,1,2,1,1,193,1,2013,0,5,643,0
Cleveland,23,29,21,19,0,0,0,0,Houston,31,30,23,22,0,0,0,0,20140201,92,106,8,9,11,14,14,198,14,2013,0,5,1113,0
Orlando,19,26,19,25,0,0,0,0,Boston,27,27,17,25,0,0,0,0,20140202,89,96,8,9,7,7,7,185,7,2013,0,6,1115,0
Chicago,12,21,24,13,0,0,0,0,Sacramento,24,20,27,28,0,0,0,0,20140203,70,99,12,11,14,29,29,169,29,2013,0,0,1788,0
Portland,29,26,14,21,0,0,0,0,Washington,32,24,26,18,0,0,0,0,20140203,90,100,3,1,13,10,10,190,10,2013,0,0,2347,0
Toronto,24,31,16,23,0,0,0,0,Utah,27,17,18,17,0,0,0,0,20140203,94,79,-3,11,9,15,15,173,-15,2013,0,0,1664,0
Memphis,18,18,25,16,0,0,0,0,Oklahoma City,20,31,18,17,0,0,0,0,20140203,77,86,2,15,8,9,9,163,9,2013,0,0,421,0
New York,19,24,26,29,0,0,0,0,Milwaukee,18,32,25,26,0,0,0,0,20140203,98,101,-1,7,6,3,3,199,3,2013,0,0,732,0
San Antonio,25,17,22,38,0,0,0,0,New Orleans,27,27,22,19,0,0,0,0,20140203,102,95,-2,-12,-12,7,7,197,-7,2013,0,0,506,0
Orlando,22,28,13,16,0,0,0,0,Indiana,29,30,16,23,0,0,0,0,20140203,79,98,7,9,12,19,19,177,19,2013,0,0,822,0
LA Clippers,29,31,21,34,0,0,0,0,Denver,25,35,22,34,0,0,0,0,20140203,115,116,-4,0,1,1,1,231,1,2013,0,0,830,0
Cleveland,25,27,27,28,0,0,0,0,Dallas,27,32,35,30,0,0,0,0,20140203,107,124,2,7,15,17,17,231,17,2013,0,0,1024,0
Philadelphia,16,33,20,33,0,0,0,0,Brooklyn,24,30,30,24,0,0,0,0,20140203,102,108,8,5,15,6,6,210,6,2013,0,0,80,0
Detroit,29,28,23,16,0,0,0,0,Miami,32,31,21,18,0,0,0,0,20140203,96,102,3,6,4,6,6,198,6,2013,0,0,1155,0
Indiana,19,23,24,23,0,0,0,0,Atlanta,15,28,12,30,0,0,0,0,20140204,89,85,4,-1,11,4,4,174,-4,2013,0,1,427,0
Charlotte,26,25,21,19,0,0,0,0,Golden State,13,26,18,18,0,0,0,0,20140204,91,75,13,12,15,16,16,166,-16,2013,0,1,2296,0
LA Lakers,26,26,26,21,0,0,0,0,Minnesota,38,30,21,20,0,0,0,0,20140204,99,109,12,16,11,10,10,208,10,2013,0,1,1521,0
Chicago,21,23,25,32,0,0,0,0,Phoenix,13,20,30,29,0,0,0,0,20140204,101,92,8,11,6,9,9,193,-9,2013,0,1,1450,0
Minnesota,25,29,23,20,0,0,0,0,Oklahoma City,26,30,24,26,0,0,0,0,20140205,97,106,1,2,3,9,9,203,9,2013,0,2,694,0
Toronto,23,29,20,29,0,0,0,0,Sacramento,30,37,25,17,0,0,0,0,20140205,101,109,7,15,20,8,8,210,8,2013,0,2,2195,0
Boston,34,22,32,26,0,0,0,0,Philadelphia,23,24,35,26,0,0,0,0,20140205,114,108,11,9,6,6,6,222,-6,2013,0,2,270,0
Detroit,26,17,31,24,0,0,0,0,Orlando,26,31,31,24,0,0,0,0,20140205,98,112,0,14,14,14,14,210,14,2013,0,2,957,0
San Antonio,25,23,34,17,16,10,0,0,Washington,33,29,21,16,16,3,0,0,20140205,125,118,-8,-14,-1,0,7,243,-7,2013,2,2,1385,0
Portland,26,21,30,17,0,0,0,0,New York,23,23,22,22,0,0,0,0,20140205,94,90,3,1,9,4,4,184,-4,2013,0,2,2439,0
Dallas,21,31,26,32,0,0,0,0,Memphis,26,29,17,24,0,0,0,0,20140205,110,96,-5,-3,6,14,14,206,-14,2013,0,2,419,0
Miami,36,26,27,27,0,0,0,0,LA Clippers,24,31,20,37,0,0,0,0,20140205,116,112,12,7,14,4,4,228,-4,2013,0,2,2335,0
Phoenix,30,33,27,18,0,0,0,0,Houston,35,31,29,27,0,0,0,0,20140205,108,122,5,3,5,14,14,230,14,2013,0,2,1014,0
Milwaukee,24,28,20,28,0,0,0,0,Denver,30,21,33,26,0,0,0,0,20140205,100,110,6,-1,12,10,10,210,10,2013,0,2,912,0
LA Lakers,36,34,28,21,0,0,0,0,Cleveland,17,32,31,28,0,0,0,0,20140205,119,108,19,21,18,11,11,227,-11,2013,0,2,2044,0
Atlanta,24,27,24,25,0,0,0,0,New Orleans,28,19,24,34,0,0,0,0,20140205,100,105,4,-4,-4,5,5,205,5,2013,0,2,424,0
San Antonio,24,15,29,21,0,0,0,0,Brooklyn,17,23,35,28,0,0,0,0,20140206,89,103,-7,1,7,14,14,192,14,2013,0,3,1581,0
Chicago,29,17,22,19,0,0,0,0,Golden State,16,34,26,26,0,0,0,0,20140206,87,102,-13,4,8,15,15,189,15,2013,0,3,1853,0
Cleveland,32,35,26,22,0,0,0,0,Washington,38,25,22,28,0,0,0,0,20140207,115,113,-6,4,8,2,2,228,-2,2013,0,4,304,0
LA Lakers,26,35,26,25,0,0,0,0,Philadelphia,35,29,21,13,0,0,0,0,20140207,112,98,-9,-3,2,14,14,210,-14,2013,0,4,2388,0
Oklahoma City,36,29,23,14,0,0,0,0,Orlando,23,28,29,23,0,0,0,0,20140207,102,103,-13,-14,-8,1,1,205,1,2013,0,4,1057,0
Minnesota,26,21,24,20,0,0,0,0,New Orleans,25,17,19,37,0,0,0,0,20140207,91,98,-1,-5,-10,7,7,189,7,2013,0,4,1052,0
Denver,26,18,24,22,0,0,0,0,New York,20,30,33,34,0,0,0,0,20140207,90,117,-6,6,15,27,27,207,27,2013,0,4,1627,0
Portland,28,22,27,26,10,0,0,0,Indiana,16,29,26,32,15,0,0,0,20140207,113,118,-12,-5,-6,0,5,231,5,2013,1,4,1880,0
Brooklyn,17,27,29,22,0,0,0,0,Detroit,30,37,29,15,0,0,0,0,20140207,95,111,13,23,23,16,16,206,16,2013,0,4,480,0
Utah,23,20,24,14,0,0,0,0,Dallas,28,26,28,21,0,0,0,0,20140207,81,103,5,11,15,22,22,184,22,2013,0,4,998,0
Sacramento,29,17,23,20,0,0,0,0,Boston,21,28,22,28,0,0,0,0,20140207,89,99,-8,3,2,10,10,188,10,2013,0,4,2624,0
Toronto,22,29,32,22,0,0,0,0,LA Clippers,29,38,25,26,0,0,0,0,20140207,105,118,7,16,9,13,13,223,13,2013,0,4,2170,0
Memphis,27,10,24,18,0,0,0,0,Atlanta,29,14,11,22,0,0,0,0,20140208,79,76,-2,-6,7,3,3,155,-3,2013,0,5,336,0
San Antonio,21,20,28,35,0,0,0,0,Charlotte,25,17,28,30,0,0,0,0,20140208,104,100,-4,-1,-1,4,4,204,-4,2013,0,5,1103,0
Denver,29,32,25,23,0,0,0,0,Detroit,30,35,32,29,0,0,0,0,20140208,109,126,1,4,11,17,17,235,17,2013,0,5,1154,0
Houston,29,27,25,20,0,0,0,0,Milwaukee,26,19,24,26,0,0,0,0,20140208,101,95,3,11,12,6,6,196,-6,2013,0,5,1005,0
Portland,28,27,28,34,0,0,0,0,Minnesota,23,31,29,27,0,0,0,0,20140208,117,110,5,1,0,7,7,227,-7,2013,0,5,1423,0
Golden State,28,31,31,19,0,0,0,0,Phoenix,29,34,32,27,0,0,0,0,20140208,109,122,1,4,5,13,13,231,13,2013,0,5,652,0
Miami,20,30,16,23,0,0,0,0,Utah,32,20,16,26,0,0,0,0,20140208,89,94,12,2,2,5,5,183,5,2013,0,5,2086,0
New York,28,25,25,22,0,0,0,0,Oklahoma City,29,29,28,26,0,0,0,0,20140209,100,112,1,5,8,12,12,212,12,2013,0,6,1324,0
Sacramento,24,21,19,20,0,0,0,0,Washington,28,29,18,18,0,0,0,0,20140209,84,93,4,12,11,9,9,177,9,2013,0,6,2371,0
Indiana,31,21,22,18,0,0,0,0,Orlando,28,15,21,29,0,0,0,0,20140209,92,93,-3,-9,-10,1,1,185,1,2013,0,6,822,0
Chicago,34,18,25,15,0,0,0,0,LA Lakers,23,23,16,24,0,0,0,0,20140209,92,86,11,6,15,6,6,178,-6,2013,0,6,1741,0
New Orleans,14,14,32,21,0,0,0,0,Brooklyn,29,22,20,22,0,0,0,0,20140209,81,93,15,23,11,12,12,174,12,2013,0,6,1168,0
Memphis,18,15,25,20,5,0,0,0,Cleveland,22,20,17,19,13,0,0,0,20140209,83,91,4,9,1,0,8,174,8,2013,1,6,629,0
Dallas,17,27,28,30,0,0,0,0,Boston,16,22,18,35,0,0,0,0,20140209,102,91,1,6,16,11,11,193,-11,2013,0,6,1548,0
Philadelphia,15,15,21,27,0,0,0,0,LA Clippers,46,23,31,23,0,0,0,0,20140209,78,123,31,39,49,45,45,201,45,2013,0,6,2388,0
San Antonio,24,24,24,28,0,0,0,0,Detroit,25,34,33,17,0,0,0,0,20140210,100,109,1,11,20,9,9,209,9,2013,0,0,1238,0
Philadelphia,21,12,19,28,0,0,0,0,Golden State,29,37,32,25,0,0,0,0,20140210,80,123,8,33,46,43,43,203,43,2013,0,0,2516,0
Denver,20,20,16,24,0,0,0,0,Indiana,31,30,24,34,0,0,0,0,20140210,80,119,11,21,29,39,39,199,39,2013,0,0,998,0
Boston,26,23,21,32,0,0,0,0,Milwaukee,24,22,22,18,0,0,0,0,20140210,102,86,2,3,2,16,16,188,-16,2013,0,0,855,0
Houston,34,33,15,25,0,0,0,0,Minnesota,28,30,20,11,0,0,0,0,20140210,107,89,6,9,4,18,18,196,-18,2013,0,0,1057,0
New Orleans,20,29,21,31,0,0,0,0,Toronto,31,18,33,26,0,0,0,0,20140210,101,108,11,0,12,7,7,209,7,2013,0,0,1112,0
Oklahoma City,19,26,35,18,0,0,0,0,Portland,25,30,25,15,0,0,0,0,20140211,98,95,-6,-10,0,3,3,193,-3,2013,0,1,1484,0
Miami,22,21,28,32,0,0,0,0,Phoenix,25,21,28,23,0,0,0,0,20140211,103,97,-3,-3,-3,6,6,200,-6,2013,0,1,1978,0
Washington,23,16,31,19,0,0,0,0,Memphis,24,28,27,13,0,0,0,0,20140211,89,92,1,13,9,3,3,181,3,2013,0,1,762,0
Sacramento,23,20,25,31,0,0,0,0,Cleveland,30,25,25,29,0,0,0,0,20140211,99,109,7,12,12,10,10,208,10,2013,0,1,2096,0
Atlanta,17,22,31,15,0,0,0,0,Chicago,33,25,22,20,0,0,0,0,20140211,85,100,16,19,10,15,15,185,15,2013,0,1,587,0
Dallas,26,18,21,24,0,0,0,0,Charlotte,28,30,31,25,0,0,0,0,20140211,89,114,2,14,24,25,25,203,25,2013,0,1,928,0
Utah,16,32,20,28,0,0,0,0,LA Lakers,27,10,23,19,0,0,0,0,20140211,96,79,-11,11,8,17,17,175,-17,2013,0,1,579,0
New Orleans,25,21,37,19,0,0,0,0,Milwaukee,19,30,27,22,0,0,0,0,20140212,102,98,6,-3,7,4,4,200,-4,2013,0,2,911,0
Philadelphia,22,26,21,31,0,0,0,0,Utah,31,25,22,27,0,0,0,0,20140212,100,105,9,8,9,5,5,205,5,2013,0,2,1920,0
Memphis,24,18,22,22,0,0,0,0,Orlando,17,17,27,20,0,0,0,0,20140212,86,81,7,8,3,5,5,167,-5,2013,0,2,683,0
Denver,19,22,23,26,0,0,0,0,Minnesota,31,30,28,28,0,0,0,0,20140212,90,117,12,20,25,27,27,207,27,2013,0,2,698,0
Portland,30,31,34,22,0,0,0,0,LA Clippers,31,30,31,30,0,0,0,0,20140212,117,122,1,0,-3,5,5,239,5,2013,0,2,826,0
Atlanta,24,20,21,18,0,0,0,0,Toronto,19,26,33,26,0,0,0,0,20140212,83,104,-5,1,13,21,21,187,21,2013,0,2,733,0
Washington,26,28,36,22,0,0,0,0,Houston,38,25,30,20,0,0,0,0,20140212,112,113,12,9,3,1,1,225,1,2013,0,2,1217,0
Dallas,19,25,16,21,0,0,0,0,Indiana,19,23,20,11,0,0,0,0,20140212,81,73,0,2,-2,8,8,154,-8,2013,0,2,763,0
San Antonio,25,23,23,33,0,0,0,0,Boston,19,25,22,26,0,0,0,0,20140212,104,92,6,4,5,12,12,196,-12,2013,0,2,1765,0
Charlotte,29,15,19,26,0,0,0,0,Brooklyn,30,20,35,20,0,0,0,0,20140212,89,105,1,6,22,16,16,194,16,2013,0,2,531,0
Sacramento,22,26,24,21,13,0,0,0,New York,33,21,20,19,8,0,0,0,20140212,106,101,-11,-6,-2,0,5,207,-5,2013,1,2,2499,0
Cleveland,22,18,19,34,0,0,0,0,Detroit,28,23,15,23,0,0,0,0,20140212,93,89,-6,-11,-7,4,4,182,-4,2013,0,2,90,0
Miami,28,29,27,27,0,0,0,0,Golden State,20,26,36,28,0,0,0,0,20140212,111,110,8,11,2,1,1,221,-1,2013,0,2,2590,0
Brooklyn,19,22,20,15,0,0,0,0,Chicago,29,20,20,23,0,0,0,0,20140213,76,92,10,8,8,16,16,168,16,2013,0,3,711,0
Oklahoma City,17,28,27,35,0,0,0,0,LA Lakers,24,30,28,21,0,0,0,0,20140213,107,103,-7,-9,-10,4,4,210,-4,2013,0,3,1178,0
Toronto,27,28,29,19,0,0,0,0,Washington,27,22,21,23,0,0,0,0,20140218,103,93,0,6,14,10,10,196,-10,2013,0,1,349,0
Cleveland,31,33,21,29,0,0,0,0,Philadelphia,25,18,19,23,0,0,0,0,20140218,114,85,6,21,23,29,29,199,-29,2013,0,1,358,0
Orlando,22,25,32,21,0,0,0,0,Milwaukee,25,28,28,23,0,0,0,0,20140218,100,104,3,6,2,4,4,204,4,2013,0,1,1065,0
San Antonio,24,32,26,31,0,0,0,0,LA Clippers,26,25,25,27,0,0,0,0,20140218,113,103,-2,5,6,10,10,216,-10,2013,0,1,1201,0
New York,17,20,27,29,0,0,0,0,Memphis,22,28,16,32,0,0,0,0,20140218,93,98,5,13,2,5,5,191,5,2013,0,1,953,0
Charlotte,32,22,25,29,0,0,0,0,Detroit,21,22,24,29,0,0,0,0,20140218,108,96,11,11,12,12,12,204,-12,2013,0,1,504,0
Phoenix,31,21,24,23,13,0,0,0,Denver,25,26,26,22,8,0,0,0,20140218,112,107,6,1,-1,0,5,219,-5,2013,1,1,585,0
Miami,30,30,24,33,0,0,0,0,Dallas,28,26,31,21,0,0,0,0,20140218,117,106,2,6,-1,11,11,223,-11,2013,0,1,1110,0
Atlanta,23,26,26,23,0,0,0,0,Indiana,35,22,30,21,0,0,0,0,20140218,98,108,12,8,12,10,10,206,10,2013,0,1,427,0
Brooklyn,21,27,27,30,0,0,0,0,Utah,28,28,18,25,0,0,0,0,20140219,105,99,-7,-8,1,6,6,204,-6,2013,0,2,1967,0
Washington,31,27,33,23,0,0,0,0,Atlanta,14,33,36,14,0,0,0,0,20140219,114,97,17,11,8,17,17,211,-17,2013,0,2,541,0
Detroit,21,26,25,26,0,0,0,0,Charlotte,28,25,33,30,0,0,0,0,20140219,98,116,7,6,14,18,18,214,18,2013,0,2,504,0
Orlando,11,25,32,25,0,0,0,0,Cleveland,26,29,17,29,0,0,0,0,20140219,93,101,15,19,4,8,8,194,8,2013,0,2,895,0
Houston,32,32,40,30,0,0,0,0,LA Lakers,22,21,32,33,0,0,0,0,20140219,134,108,10,21,29,26,26,242,-26,2013,0,2,1371,0
Indiana,18,21,33,19,0,0,0,0,Minnesota,30,22,30,22,0,0,0,0,20140219,91,104,12,13,10,13,13,195,13,2013,0,2,510,0
New York,23,30,25,20,0,0,0,0,New Orleans,24,23,23,21,0,0,0,0,20140219,98,91,-1,6,8,7,7,189,-7,2013,0,2,1168,0
Boston,21,29,21,23,0,0,0,0,Phoenix,29,23,24,24,0,0,0,0,20140219,94,100,8,2,5,6,6,194,6,2013,0,2,2295,0
San Antonio,18,33,28,32,0,0,0,0,Portland,24,28,29,28,0,0,0,0,20140219,111,109,-6,-1,-2,2,2,220,-2,2013,0,2,1718,0
Golden State,30,29,16,26,0,0,0,0,Sacramento,26,24,26,16,0,0,0,0,20140219,101,92,4,9,-1,9,9,193,-9,2013,0,2,75,0
Chicago,31,17,22,24,0,0,0,0,Toronto,21,20,21,30,0,0,0,0,20140219,94,92,10,7,8,2,2,186,-2,2013,0,2,436,0
Miami,34,20,22,27,0,0,0,0,Oklahoma City,17,30,18,16,0,0,0,0,20140220,103,81,17,7,11,22,22,184,-22,2013,0,3,1225,0
Houston,24,19,24,22,10,0,0,0,Golden State,20,27,24,18,13,0,0,0,20140220,99,102,-4,4,4,0,3,201,3,2013,1,3,1642,0
Denver,31,19,28,23,0,0,0,0,Milwaukee,22,20,25,23,0,0,0,0,20140220,101,90,9,8,11,11,11,191,-11,2013,0,3,912,0
Utah,15,24,34,21,0,0,0,0,Portland,16,27,21,38,0,0,0,0,20140221,94,102,1,4,-9,8,8,196,8,2013,0,4,634,0
New Orleans,17,15,27,28,0,0,0,0,Charlotte,25,18,25,22,0,0,0,0,20140221,87,90,8,11,9,3,3,177,3,2013,0,4,648,0
Denver,19,27,23,20,0,0,0,0,Chicago,32,37,25,23,0,0,0,0,20140221,89,117,13,23,25,28,28,206,28,2013,0,4,916,0
Atlanta,22,41,20,24,0,0,0,0,Detroit,19,33,34,29,0,0,0,0,20140221,107,115,-3,-11,3,8,8,222,8,2013,0,4,597,0
Boston,28,18,28,18,0,0,0,0,LA Lakers,19,25,19,38,0,0,0,0,20140221,92,101,-9,-2,-11,9,9,193,9,2013,0,4,2590,0
LA Clippers,27,23,18,28,0,0,0,0,Memphis,21,32,20,29,0,0,0,0,20140221,96,102,-6,3,5,6,6,198,6,2013,0,4,1599,0
New York,30,30,26,20,7,8,0,0,Orlando,31,22,26,27,7,16,0,0,20140221,121,129,1,-7,-7,0,8,250,8,2013,2,4,939,0
Dallas,41,28,32,23,0,0,0,0,Philadelphia,23,39,27,23,0,0,0,0,20140221,124,112,18,7,12,12,12,236,-12,2013,0,4,1297,0
San Antonio,23,12,22,28,0,0,0,0,Phoenix,19,28,27,32,0,0,0,0,20140221,85,106,-4,12,17,21,21,191,21,2013,0,4,846,0
Cleveland,22,22,21,26,0,0,0,0,Toronto,16,23,37,22,0,0,0,0,20140221,91,98,-6,-5,11,7,7,189,7,2013,0,4,187,0
Minnesota,26,33,35,27,0,0,0,0,Utah,21,28,32,23,0,0,0,0,20140222,121,104,5,10,13,17,17,225,-17,2013,0,5,984,0
Boston,16,27,27,28,0,0,0,0,Sacramento,23,28,26,28,0,0,0,0,20140222,98,105,7,8,7,7,7,203,7,2013,0,5,2624,0
Indiana,27,24,24,35,0,0,0,0,Milwaukee,18,21,29,32,0,0,0,0,20140222,110,100,9,12,7,10,10,210,-10,2013,0,5,243,0
New York,23,29,21,25,0,0,0,0,Atlanta,24,15,29,39,0,0,0,0,20140222,98,107,1,-13,-5,9,9,205,9,2013,0,5,745,0
Dallas,29,35,24,25,0,0,0,0,Detroit,27,27,28,20,0,0,0,0,20140222,113,102,2,10,6,11,11,215,-11,2013,0,5,999,0
Memphis,21,27,15,26,0,0,0,0,Charlotte,28,14,22,28,0,0,0,0,20140222,89,92,7,-6,1,3,3,181,3,2013,0,5,519,0
New Orleans,21,22,23,27,0,0,0,0,Washington,24,19,23,28,0,0,0,0,20140222,93,94,3,0,0,1,1,187,1,2013,0,5,964,0
Brooklyn,23,23,18,22,0,0,0,0,Golden State,28,21,19,25,0,0,0,0,20140222,86,93,5,3,4,7,7,179,7,2013,0,5,2565,0
Minnesota,34,26,20,17,0,0,0,0,Portland,26,26,32,24,0,0,0,0,20140223,97,108,-8,-8,4,11,11,205,11,2013,0,6,1423,0
Houston,30,30,23,32,0,0,0,0,Phoenix,16,40,37,19,0,0,0,0,20140223,115,112,14,4,-10,3,3,227,-3,2013,0,6,1014,0
Orlando,14,27,24,25,0,0,0,0,Toronto,19,25,36,25,0,0,0,0,20140223,90,105,5,3,15,15,15,195,15,2013,0,6,1048,0
LA Clippers,28,44,27,26,0,0,0,0,Oklahoma City,32,34,27,24,0,0,0,0,20140223,125,117,-4,6,6,8,8,242,-8,2013,0,6,1178,0
Brooklyn,33,30,23,22,0,0,0,0,LA Lakers,21,26,27,28,0,0,0,0,20140223,108,102,12,16,12,6,6,210,-6,2013,0,6,2445,0
Sacramento,27,21,39,22,0,0,0,0,Denver,27,25,18,25,0,0,0,0,20140223,109,95,0,-4,17,14,14,204,-14,2013,0,6,886,0
Washington,30,28,20,18,0,0,0,0,Cleveland,27,25,20,11,0,0,0,0,20140223,96,83,3,6,6,13,13,179,-13,2013,0,6,304,0
Chicago,24,16,12,27,0,0,0,0,Miami,20,20,25,28,0,0,0,0,20140223,79,93,-4,0,13,14,14,172,14,2013,0,6,1189,0
Golden State,33,30,18,23,0,0,0,0,Detroit,37,25,21,13,0,0,0,0,20140224,104,96,-4,1,-2,8,8,200,-8,2013,0,0,2087,0
LA Clippers,32,29,32,30,0,0,0,0,New Orleans,26,27,25,32,0,0,0,0,20140224,123,110,6,8,15,13,13,233,-13,2013,0,0,1669,0
Dallas,31,29,24,26,0,0,0,0,New York,21,38,23,26,0,0,0,0,20140224,110,108,10,1,2,2,2,218,-2,2013,0,0,1370,0
Milwaukee,30,43,33,24,0,0,0,0,Philadelphia,28,16,32,34,0,0,0,0,20140224,130,110,2,29,30,20,20,240,-20,2013,0,0,692,0
Boston,18,28,22,30,0,0,0,0,Utah,27,32,24,27,0,0,0,0,20140224,98,110,9,13,15,12,12,208,12,2013,0,0,2093,0
Toronto,23,24,21,31,0,0,0,0,Cleveland,17,24,28,24,0,0,0,0,20140225,99,93,6,6,-1,6,6,192,-6,2013,0,1,187,0
Chicago,20,34,26,27,0,0,0,0,Atlanta,30,21,24,28,0,0,0,0,20140225,107,103,-10,3,5,4,4,210,-4,2013,0,1,587,0
Portland,32,20,30,18,0,0,0,0,Denver,21,24,24,26,0,0,0,0,20140225,100,95,11,7,13,5,5,195,-5,2013,0,1,981,0
LA Lakers,23,31,16,28,0,0,0,0,Indiana,30,27,34,27,0,0,0,0,20140225,98,118,7,3,21,20,20,216,20,2013,0,1,1805,0
Minnesota,34,21,20,35,0,0,0,0,Phoenix,28,29,24,20,0,0,0,0,20140225,110,101,6,-2,-6,9,9,211,-9,2013,0,1,1278,0
Houston,42,27,35,25,0,0,0,0,Sacramento,17,34,26,26,0,0,0,0,20140225,129,103,25,18,27,26,26,232,-26,2013,0,1,1606,0
Orlando,31,22,27,26,0,0,0,0,Washington,35,27,31,22,0,0,0,0,20140225,106,115,4,9,13,9,9,221,9,2013,0,1,757,0
Brooklyn,20,14,25,21,0,0,0,0,Portland,29,29,24,42,0,0,0,0,20140226,80,124,9,24,23,44,44,204,44,2013,0,2,2439,0
Orlando,19,21,27,34,0,0,0,0,Philadelphia,22,22,23,23,0,0,0,0,20140226,101,90,-3,-4,0,11,11,191,-11,2013,0,2,864,0
Detroit,26,27,28,29,0,0,0,0,San Antonio,28,29,33,30,0,0,0,0,20140226,110,120,2,4,9,10,10,230,10,2013,0,2,1238,0
Cleveland,26,25,21,42,0,0,0,0,Oklahoma City,27,25,24,28,0,0,0,0,20140226,114,104,-1,-1,-4,10,10,218,-10,2013,0,2,949,0
Phoenix,25,19,20,22,0,0,0,0,Utah,28,25,25,31,0,0,0,0,20140226,86,109,3,9,14,23,23,195,23,2013,0,2,505,0
Houston,22,26,25,20,0,0,0,0,LA Clippers,26,20,28,27,0,0,0,0,20140226,93,101,4,-2,1,8,8,194,8,2013,0,2,1371,0
New Orleans,27,16,24,22,0,0,0,0,Dallas,20,29,29,30,0,0,0,0,20140226,89,108,-7,6,11,19,19,197,19,2013,0,2,442,0
Golden State,24,21,14,24,0,0,0,0,Chicago,21,35,24,23,0,0,0,0,20140226,83,103,-3,11,21,20,20,186,20,2013,0,2,1853,0
Atlanta,27,29,23,25,0,0,0,0,Boston,25,33,23,34,0,0,0,0,20140226,104,115,-2,2,2,11,11,219,11,2013,0,2,935,0
LA Lakers,23,23,27,30,0,0,0,0,Memphis,31,34,17,26,0,0,0,0,20140226,103,108,8,19,9,5,5,211,5,2013,0,2,1599,0
Washington,21,36,26,23,8,4,16,0,Toronto,27,27,24,28,8,4,11,0,20140227,134,129,-6,3,5,0,5,263,-5,2013,3,3,349,0
New York,22,28,14,18,0,0,0,0,Miami,28,27,32,21,0,0,0,0,20140227,82,108,6,5,23,26,26,190,26,2013,0,3,1091,0
Milwaukee,15,35,16,30,0,0,0,0,Indiana,30,20,23,28,0,0,0,0,20140227,96,101,15,0,7,5,5,197,5,2013,0,3,243,0
Brooklyn,29,30,30,23,0,0,0,0,Denver,8,28,20,33,0,0,0,0,20140227,112,89,21,23,33,23,23,201,-23,2013,0,3,1627,0
Utah,27,14,19,19,0,0,0,0,Cleveland,20,19,30,30,0,0,0,0,20140228,79,99,-7,-2,9,20,20,178,20,2013,0,4,1564,0
Chicago,20,31,22,27,0,0,0,0,Dallas,32,22,22,15,0,0,0,0,20140228,100,91,-12,-3,-3,9,9,191,-9,2013,0,4,802,0
Sacramento,31,34,34,23,0,0,0,0,LA Lakers,27,27,41,31,0,0,0,0,20140228,122,126,-4,-11,-4,4,4,248,4,2013,0,4,361,0
Golden State,38,35,26,27,0,0,0,0,New York,27,25,28,23,0,0,0,0,20140228,126,103,11,21,19,23,23,229,-23,2013,0,4,2565,0
Memphis,22,20,29,36,0,0,0,0,Oklahoma City,29,28,30,26,0,0,0,0,20140228,107,113,7,15,16,6,6,220,6,2013,0,4,421,0
New Orleans,28,26,27,23,0,0,0,0,Phoenix,30,26,25,35,0,0,0,0,20140228,104,116,2,2,0,12,12,220,12,2013,0,4,1312,0
Charlotte,25,20,20,17,0,0,0,0,San Antonio,14,27,25,26,0,0,0,0,20140228,82,92,-11,-4,1,10,10,174,10,2013,0,4,1103,0
Minnesota,30,23,31,24,0,0,0,0,Sacramento,31,25,14,27,0,0,0,0,20140301,108,97,-1,-3,14,11,11,205,-11,2013,0,5,1511,0
Denver,24,24,25,23,0,0,0,0,Portland,32,24,28,18,0,0,0,0,20140301,96,102,8,8,11,6,6,198,6,2013,0,5,981,0
Washington,41,33,23,25,0,0,0,0,Philadelphia,28,34,21,20,0,0,0,0,20140301,122,103,13,12,14,19,19,225,-19,2013,0,5,123,0
Orlando,30,23,20,25,0,0,0,0,Miami,32,29,28,23,0,0,0,0,20140301,98,112,2,8,16,14,14,210,14,2013,0,5,204,0
Brooklyn,31,24,22,30,0,0,0,0,Milwaukee,29,24,19,26,0,0,0,0,20140301,107,98,2,2,5,9,9,205,-9,2013,0,5,732,0
New Orleans,17,19,20,20,0,0,0,0,LA Clippers,30,21,28,29,0,0,0,0,20140301,76,108,13,15,23,32,32,184,32,2013,0,5,1669,0
Detroit,20,26,34,30,0,0,0,0,Houston,41,28,26,23,0,0,0,0,20140301,110,118,21,23,15,8,8,228,8,2013,0,5,1105,0
Indiana,28,27,21,26,0,0,0,0,Boston,27,21,30,19,0,0,0,0,20140301,102,97,1,7,-2,5,5,199,-5,2013,0,5,805,0
Cleveland,30,35,15,16,0,0,0,0,Memphis,22,32,33,23,0,0,0,0,20140301,96,110,-8,-11,7,14,14,206,14,2013,0,5,629,0
New York,16,32,20,22,0,0,0,0,Chicago,37,22,21,29,0,0,0,0,20140302,90,109,21,11,12,19,19,199,19,2013,0,6,711,0
Utah,20,26,24,21,0,0,0,0,Indiana,21,24,30,19,0,0,0,0,20140302,91,94,1,-1,5,3,3,185,3,2013,0,6,1353,0
Charlotte,25,30,26,18,0,0,0,0,Oklahoma City,31,30,24,31,0,0,0,0,20140302,99,116,6,6,4,17,17,215,17,2013,0,6,938,0
Philadelphia,27,19,23,12,0,0,0,0,Orlando,28,15,23,26,0,0,0,0,20140302,81,92,1,-3,-3,11,11,173,11,2013,0,6,864,0
Atlanta,37,28,30,25,0,0,0,0,Phoenix,40,39,23,27,0,0,0,0,20140302,120,129,3,14,7,9,9,249,9,2013,0,6,1588,0
Dallas,22,25,23,36,0,0,0,0,San Antonio,25,23,30,34,0,0,0,0,20140302,106,112,3,1,8,6,6,218,6,2013,0,6,252,0
Golden State,28,22,28,20,0,0,0,0,Toronto,25,30,20,29,0,0,0,0,20140302,98,104,-3,5,-3,6,6,202,6,2013,0,6,2263,0
Utah,21,27,19,21,0,0,0,0,Milwaukee,30,25,40,19,0,0,0,0,20140303,88,114,9,7,28,26,26,202,26,2013,0,0,1239,0
Memphis,20,30,29,31,0,0,0,0,Washington,20,25,19,40,0,0,0,0,20140303,110,104,0,5,15,6,6,214,-6,2013,0,0,762,0
New Orleans,18,20,21,30,0,0,0,0,Sacramento,23,17,28,28,0,0,0,0,20140303,89,96,5,2,9,7,7,185,7,2013,0,0,1879,0
LA Lakers,33,30,24,20,0,0,0,0,Portland,20,36,28,22,0,0,0,0,20140303,107,106,13,7,3,1,1,213,-1,2013,0,0,826,0
Charlotte,26,28,25,28,0,0,0,0,Miami,29,31,38,26,0,0,0,0,20140303,107,124,3,6,19,17,17,231,17,2013,0,0,654,0
Minnesota,40,26,32,34,0,0,0,0,Denver,25,24,34,45,0,0,0,0,20140303,132,128,15,17,15,4,4,260,-4,2013,0,0,698,0
Chicago,18,24,17,21,0,0,0,0,Brooklyn,27,23,26,20,0,0,0,0,20140303,80,96,9,8,17,16,16,176,16,2013,0,0,711,0
New York,28,16,20,21,0,0,0,0,Detroit,20,19,30,27,0,0,0,0,20140303,85,96,-8,-5,5,11,11,181,11,2013,0,0,480,0
San Antonio,13,37,35,37,0,0,0,0,Cleveland,23,17,28,33,0,0,0,0,20140304,122,101,-10,10,17,21,21,223,-21,2013,0,1,1256,0
Miami,32,20,21,30,0,0,0,0,Houston,39,14,30,23,0,0,0,0,20140304,103,106,7,1,10,3,3,209,3,2013,0,1,966,0
Golden State,25,23,25,25,0,0,0,0,Indiana,21,21,28,26,0,0,0,0,20140304,98,96,4,6,3,2,2,194,-2,2013,0,1,1944,0
New Orleans,35,32,28,37,0,0,0,0,LA Lakers,23,28,34,40,0,0,0,0,20140304,132,125,12,16,10,7,7,257,-7,2013,0,1,1669,0
Philadelphia,23,22,31,16,0,0,0,0,Oklahoma City,37,24,37,27,0,0,0,0,20140304,92,125,14,16,22,33,33,217,33,2013,0,1,1256,0
LA Clippers,24,20,37,23,0,0,0,0,Phoenix,25,30,18,23,0,0,0,0,20140304,104,96,-1,-11,8,8,8,200,-8,2013,0,1,356,0
Atlanta,19,19,17,23,0,0,0,0,Portland,29,27,23,23,0,0,0,0,20140305,78,102,10,18,24,24,24,180,24,2013,0,2,2168,0
Houston,19,22,34,26,0,0,0,0,Orlando,32,16,17,24,0,0,0,0,20140305,101,89,-13,-7,10,12,12,190,-12,2013,0,2,847,0
New York,38,28,22,30,0,0,0,0,Minnesota,24,31,31,20,0,0,0,0,20140305,118,106,14,11,2,12,12,224,-12,2013,0,2,1016,0
Sacramento,28,33,34,21,0,0,0,0,Milwaukee,26,22,26,28,0,0,0,0,20140305,116,102,2,13,21,14,14,218,-14,2013,0,2,1771,0
Golden State,30,31,23,24,0,0,0,0,Boston,22,18,14,34,0,0,0,0,20140305,108,88,8,21,30,20,20,196,-20,2013,0,2,2692,0
Dallas,34,17,22,37,0,0,0,0,Denver,41,27,11,36,0,0,0,0,20140305,110,115,7,17,6,5,5,225,5,2013,0,2,661,0
Indiana,8,30,19,30,0,0,0,0,Charlotte,28,19,26,36,0,0,0,0,20140305,87,109,20,9,16,22,22,196,22,2013,0,2,428,0
Memphis,19,25,16,34,0,0,0,0,Brooklyn,30,24,33,16,0,0,0,0,20140305,94,103,11,10,27,9,9,197,9,2013,0,2,953,0
Utah,23,21,27,20,0,0,0,0,Washington,28,26,25,25,0,0,0,0,20140305,91,104,5,10,8,13,13,195,13,2013,0,2,1841,0
Chicago,19,33,19,34,0,0,0,0,Detroit,25,22,23,24,0,0,0,0,20140305,105,94,-6,5,1,11,11,199,-11,2013,0,2,238,0
Oklahoma City,41,24,33,24,0,0,0,0,Phoenix,32,29,40,27,0,0,0,0,20140306,122,128,-9,-4,3,6,6,250,6,2013,0,3,840,0
Miami,22,29,23,13,0,0,0,0,San Antonio,37,25,20,29,0,0,0,0,20140306,87,111,15,11,8,24,24,198,24,2013,0,3,1147,0
LA Clippers,29,44,36,33,0,0,0,0,LA Lakers,27,13,20,34,0,0,0,0,20140306,142,94,2,33,49,48,48,236,-48,2013,0,3,0,0
Sacramento,19,25,19,24,0,0,0,0,Toronto,29,22,29,19,0,0,0,0,20140307,87,99,10,7,17,12,12,186,12,2013,0,4,2195,0
Utah,22,19,19,21,0,0,0,0,New York,39,21,24,24,0,0,0,0,20140307,81,108,17,19,24,27,27,189,27,2013,0,4,1967,0
Milwaukee,25,24,28,27,0,0,0,0,New Orleans,22,29,27,34,0,0,0,0,20140307,104,112,-3,2,1,8,8,216,8,2013,0,4,911,0
Detroit,21,24,24,32,0,0,0,0,Minnesota,39,27,31,17,0,0,0,0,20140307,101,114,18,21,28,13,13,215,13,2013,0,4,542,0
Indiana,16,27,16,27,0,0,0,0,Houston,27,23,38,24,0,0,0,0,20140307,86,112,11,7,29,26,26,198,26,2013,0,4,865,0
Portland,10,28,36,24,0,0,0,0,Dallas,33,24,18,28,0,0,0,0,20140307,98,103,23,19,1,5,5,201,5,2013,0,4,1630,0
LA Lakers,35,31,25,35,0,0,0,0,Denver,42,35,33,24,0,0,0,0,20140307,126,134,7,11,19,8,8,260,8,2013,0,4,830,0
Brooklyn,20,21,29,14,0,0,0,0,Boston,26,27,25,13,0,0,0,0,20140307,84,91,6,12,8,7,7,175,7,2013,0,4,190,0
Atlanta,31,21,25,20,0,0,0,0,Golden State,32,34,19,26,0,0,0,0,20140307,97,111,1,14,8,14,14,208,14,2013,0,4,2135,0
Memphis,15,20,30,20,0,0,0,0,Chicago,12,27,24,14,0,0,0,0,20140307,85,77,3,-4,2,8,8,162,-8,2013,0,4,480,0
Cleveland,25,25,24,18,0,0,0,0,Charlotte,32,23,21,25,0,0,0,0,20140307,92,101,7,5,2,9,9,193,9,2013,0,4,435,0
New York,23,35,19,30,0,0,0,0,Cleveland,19,31,26,21,0,0,0,0,20140308,107,97,4,8,1,10,10,204,-10,2013,0,5,403,0
Atlanta,32,26,20,30,0,0,0,0,LA Clippers,25,32,31,21,0,0,0,0,20140308,108,109,-7,-1,10,1,1,217,1,2013,0,5,1932,0
Charlotte,21,23,17,28,0,0,0,0,Memphis,25,27,27,32,0,0,0,0,20140308,89,111,4,8,18,22,22,200,22,2013,0,5,519,0
Washington,36,39,10,29,0,0,0,0,Milwaukee,27,26,21,33,0,0,0,0,20140308,114,107,9,22,11,7,7,221,-7,2013,0,5,634,0
Utah,24,26,25,29,0,0,0,0,Philadelphia,22,30,18,22,0,0,0,0,20140308,104,92,2,-2,5,12,12,196,-12,2013,0,5,1920,0
Orlando,27,34,22,29,0,0,0,0,San Antonio,31,28,29,33,0,0,0,0,20140308,112,121,4,-2,5,9,9,233,9,2013,0,5,1035,0
Denver,29,25,19,21,13,0,0,0,New Orleans,17,26,30,21,17,0,0,0,20140309,107,111,-12,-11,0,0,4,218,4,2013,1,6,1079,0
Toronto,33,20,30,28,0,0,0,0,Minnesota,33,19,24,28,0,0,0,0,20140309,111,104,0,1,7,7,7,215,-7,2013,0,6,691,0
Oklahoma City,35,21,19,35,0,0,0,0,LA Lakers,26,25,36,27,0,0,0,0,20140309,110,114,-9,-5,12,4,4,224,4,2013,0,6,1178,0
Portland,30,24,31,21,7,0,0,0,Houston,28,19,26,33,12,0,0,0,20140309,113,118,-2,-7,-12,0,5,231,5,2013,1,6,1833,0
Sacramento,19,21,25,24,0,0,0,0,Brooklyn,28,21,28,27,0,0,0,0,20140309,89,104,9,9,12,15,15,193,15,2013,0,6,2499,0
Indiana,18,27,26,23,0,0,0,0,Dallas,30,18,28,29,0,0,0,0,20140309,94,105,12,3,5,11,11,199,11,2013,0,6,763,0
Miami,19,24,24,19,2,0,0,0,Chicago,21,16,22,27,9,0,0,0,20140309,88,95,2,-6,-8,0,7,183,7,2013,1,6,1189,0
Phoenix,29,32,17,29,0,0,0,0,Golden State,22,34,38,19,0,0,0,0,20140309,107,113,-7,-5,16,6,6,220,6,2013,0,6,652,0
Detroit,22,27,35,27,0,0,0,0,Boston,26,31,38,23,0,0,0,0,20140309,111,118,4,8,11,7,7,229,7,2013,0,6,611,0
Orlando,24,27,20,27,0,0,0,0,Milwaukee,13,32,23,37,0,0,0,0,20140310,98,105,-11,-6,-3,7,7,203,7,2013,0,0,1065,0
Atlanta,28,31,19,34,0,0,0,0,Utah,22,22,36,30,0,0,0,0,20140310,112,110,6,15,-2,2,2,222,-2,2013,0,0,1580,0
Philadelphia,31,30,24,25,0,0,0,0,New York,26,35,30,32,0,0,0,0,20140310,110,123,-5,0,6,13,13,233,13,2013,0,0,80,0
Phoenix,23,22,31,29,0,0,0,0,LA Clippers,34,28,28,22,0,0,0,0,20140310,105,112,11,17,14,7,7,217,7,2013,0,0,356,0
Denver,22,23,23,30,0,0,0,0,Charlotte,25,26,28,26,0,0,0,0,20140310,98,105,3,6,11,7,7,203,7,2013,0,0,1355,0
Toronto,30,21,22,24,0,0,0,0,Brooklyn,19,31,28,23,0,0,0,0,20140310,97,101,-11,-1,5,4,4,198,4,2013,0,0,341,0
Washington,23,22,28,17,0,0,0,0,Miami,31,22,20,26,0,0,0,0,20140310,90,99,8,8,0,9,9,189,9,2013,0,0,924,0
San Antonio,38,23,29,14,0,0,0,0,Chicago,14,19,33,30,0,0,0,0,20140311,104,96,24,28,24,8,8,200,-8,2013,0,1,1050,0
Sacramento,31,23,11,24,0,0,0,0,Detroit,28,24,20,27,0,0,0,0,20140311,89,99,-3,-2,7,10,10,188,10,2013,0,1,2020,0
Dallas,22,22,13,28,0,0,0,0,Golden State,29,26,24,29,0,0,0,0,20140311,85,108,7,11,22,23,23,193,23,2013,0,1,1480,0
Boston,20,20,21,22,0,0,0,0,Indiana,24,25,20,25,0,0,0,0,20140311,83,94,4,9,8,11,11,177,11,2013,0,1,805,0
Portland,23,24,22,30,0,0,0,0,Memphis,22,32,24,31,0,0,0,0,20140311,99,109,-1,7,9,10,10,208,10,2013,0,1,1845,0
Milwaukee,33,28,23,17,0,0,0,0,Minnesota,28,27,31,26,0,0,0,0,20140311,101,112,-5,-6,2,11,11,213,11,2013,0,1,298,0
Houston,24,17,26,31,0,0,0,0,Oklahoma City,26,30,21,29,0,0,0,0,20140311,98,106,2,15,10,8,8,204,8,2013,0,1,413,0
Dallas,23,32,25,28,0,0,0,0,Utah,25,28,25,23,0,0,0,0,20140312,108,101,-2,2,2,7,7,209,-7,2013,0,2,998,0
Detroit,21,24,24,18,0,0,0,0,Toronto,29,23,22,27,0,0,0,0,20140312,87,101,8,7,5,14,14,188,14,2013,0,2,205,0
Portland,24,16,24,26,0,0,0,0,San Antonio,30,26,17,30,0,0,0,0,20140312,90,103,6,16,9,13,13,193,13,2013,0,2,1718,0
Cleveland,37,23,22,28,0,0,0,0,Phoenix,24,23,30,24,0,0,0,0,20140312,110,101,13,13,5,9,9,211,-9,2013,0,2,1745,0
Sacramento,28,30,32,25,0,0,0,0,Philadelphia,24,30,22,22,0,0,0,0,20140312,115,98,4,4,14,17,17,213,-17,2013,0,2,2451,0
New York,36,32,17,31,0,0,0,0,Boston,24,24,27,17,0,0,0,0,20140312,116,92,12,20,10,24,24,208,-24,2013,0,2,190,0
Memphis,28,20,19,23,0,0,0,0,New Orleans,26,31,17,14,0,0,0,0,20140312,90,88,2,-9,-7,2,2,178,-2,2013,0,2,358,0
Brooklyn,22,20,31,23,0,0,0,0,Miami,22,20,29,24,0,0,0,0,20140312,96,95,0,0,2,1,1,191,-1,2013,0,2,1091,0
Golden State,29,27,23,19,0,0,0,0,LA Clippers,29,25,30,27,0,0,0,0,20140312,98,111,0,-2,5,13,13,209,13,2013,0,2,347,0
Charlotte,22,26,21,29,0,0,0,0,Washington,27,19,20,19,0,0,0,0,20140312,98,85,-5,2,3,13,13,183,-13,2013,0,2,329,0
Denver,23,29,33,35,0,0,0,0,Orlando,27,23,24,38,0,0,0,0,20140312,120,112,-4,2,11,8,8,232,-8,2013,0,2,1548,0
Houston,20,22,16,29,0,0,0,0,Chicago,25,25,35,26,0,0,0,0,20140313,87,111,5,8,27,24,24,198,24,2013,0,3,939,0
LA Lakers,19,27,31,25,0,0,0,0,Oklahoma City,33,27,41,30,0,0,0,0,20140313,102,131,14,14,24,29,29,233,29,2013,0,3,1178,0
Milwaukee,30,23,14,30,0,0,0,0,Atlanta,23,24,21,34,0,0,0,0,20140313,97,102,-7,-6,1,5,5,199,5,2013,0,3,669,0
LA Clippers,22,21,34,19,0,0,0,0,Utah,33,18,21,15,0,0,0,0,20140314,96,87,-11,-8,5,9,9,183,-9,2013,0,4,579,0
Memphis,24,20,23,19,0,0,0,0,Toronto,19,28,24,28,0,0,0,0,20140314,86,99,-5,3,4,13,13,185,13,2013,0,4,815,0
Indiana,27,25,26,23,0,0,0,0,Philadelphia,20,25,21,28,0,0,0,0,20140314,101,94,7,7,12,7,7,195,-7,2013,0,4,582,0
LA Lakers,14,20,26,25,0,0,0,0,San Antonio,29,32,28,30,0,0,0,0,20140314,85,119,15,27,29,34,34,204,34,2013,0,4,1201,0
Washington,27,17,23,20,18,0,0,0,Orlando,21,20,25,21,14,0,0,0,20140314,105,101,6,3,1,0,4,206,-4,2013,1,4,757,0
Minnesota,33,20,22,18,0,0,0,0,Charlotte,33,32,23,17,0,0,0,0,20140314,93,105,0,12,13,12,12,198,12,2013,0,4,938,0
Denver,20,38,27,26,0,0,0,0,Miami,30,23,18,36,0,0,0,0,20140314,111,107,-10,5,14,4,4,218,-4,2013,0,4,1724,0
Phoenix,29,17,18,23,0,0,0,0,Boston,22,22,16,20,0,0,0,0,20140314,87,80,7,2,4,7,7,167,-7,2013,0,4,2295,0
Portland,29,24,27,31,0,0,0,0,New Orleans,26,29,26,22,0,0,0,0,20140314,111,103,3,-2,-1,8,8,214,-8,2013,0,4,2059,0
Cleveland,16,36,32,19,0,0,0,0,Golden State,32,21,18,23,0,0,0,0,20140314,103,94,-16,-1,13,9,9,197,-9,2013,0,4,2161,0
Denver,15,22,34,21,0,0,0,0,Atlanta,28,25,24,20,0,0,0,0,20140315,92,97,13,16,6,5,5,189,5,2013,0,5,1209,0
Sacramento,23,20,20,24,0,0,0,0,Chicago,23,25,16,30,0,0,0,0,20140315,87,94,0,5,1,7,7,181,7,2013,0,5,1788,0
Indiana,20,21,32,27,12,0,0,0,Detroit,29,31,19,21,4,0,0,0,20140315,112,104,-9,-19,-6,0,8,216,-8,2013,1,5,240,0
Milwaukee,23,19,24,28,0,0,0,0,New York,30,30,28,27,0,0,0,0,20140315,94,115,7,18,22,21,21,209,21,2013,0,5,732,0
Memphis,22,23,29,29,0,0,0,0,Philadelphia,21,15,21,20,0,0,0,0,20140315,103,77,1,9,17,26,26,180,-26,2013,0,5,878,0
Brooklyn,26,31,22,15,0,0,0,0,Washington,19,29,24,29,0,0,0,0,20140315,94,101,-7,-9,-7,7,7,195,7,2013,0,5,204,0
Dallas,29,30,32,18,0,0,0,0,Oklahoma City,23,25,22,16,0,0,0,0,20140316,109,86,6,11,21,23,23,195,-23,2013,0,6,189,0
Phoenix,37,24,35,25,0,0,0,0,Toronto,35,24,31,23,0,0,0,0,20140316,121,113,2,2,6,8,8,234,-8,2013,0,6,1885,0
Utah,23,30,23,28,0,0,0,0,San Antonio,26,35,30,31,0,0,0,0,20140316,104,122,3,8,15,18,18,226,18,2013,0,6,1087,0
Golden State,23,21,33,36,0,0,0,0,Portland,24,31,30,27,0,0,0,0,20140316,113,112,-1,-11,-8,1,1,225,-1,2013,0,6,535,0
Charlotte,23,23,30,25,0,0,0,0,Milwaukee,28,22,24,18,0,0,0,0,20140316,101,92,-5,-4,2,9,9,193,-9,2013,0,6,658,0
Sacramento,29,25,20,28,0,0,0,0,Minnesota,32,21,24,27,0,0,0,0,20140316,102,104,3,-1,3,2,2,206,2,2013,0,6,1511,0
Houston,28,26,27,23,0,0,0,0,Miami,32,25,22,34,0,0,0,0,20140316,104,113,4,3,-2,9,9,217,9,2013,0,6,966,0
Cleveland,18,20,21,21,0,0,0,0,LA Clippers,27,25,24,26,0,0,0,0,20140316,80,102,9,14,17,22,22,182,22,2013,0,6,2044,0
Boston,25,39,20,28,8,0,0,0,New Orleans,27,30,27,28,9,0,0,0,20140316,120,121,2,-7,0,0,1,241,1,2013,1,6,1358,0
LA Clippers,25,28,30,17,0,0,0,0,Denver,23,33,27,27,0,0,0,0,20140317,100,110,-2,3,0,10,10,210,10,2013,0,0,830,0
Philadelphia,24,26,17,23,0,0,0,0,Indiana,21,37,17,24,0,0,0,0,20140317,90,99,-3,8,8,9,9,189,9,2013,0,0,582,0
Boston,22,21,18,28,0,0,0,0,Dallas,26,24,14,30,0,0,0,0,20140317,89,94,4,7,3,5,5,183,5,2013,0,0,1548,0
Utah,20,21,28,17,0,0,0,0,Houston,28,32,32,32,0,0,0,0,20140317,86,124,8,19,23,38,38,210,38,2013,0,0,1199,0
Atlanta,22,24,30,21,0,0,0,0,Charlotte,28,24,16,15,0,0,0,0,20140317,97,83,-6,-6,8,14,14,180,-14,2013,0,0,226,0
Phoenix,20,29,23,23,0,0,0,0,Brooklyn,30,32,28,18,0,0,0,0,20140317,95,108,10,13,18,13,13,203,13,2013,0,0,2139,0
Oklahoma City,23,24,27,23,0,0,0,0,Chicago,21,24,22,18,0,0,0,0,20140317,97,85,2,2,7,12,12,182,-12,2013,0,0,690,0
Washington,19,27,27,27,11,0,0,0,Sacramento,30,17,23,30,17,0,0,0,20140318,111,117,11,1,-3,0,6,228,6,2013,1,1,2371,0
Milwaukee,29,18,25,26,17,0,0,0,Portland,26,26,23,23,22,0,0,0,20140318,115,120,-3,5,3,0,5,235,5,2013,1,1,1714,0
Toronto,26,23,29,28,7,0,0,0,Atlanta,17,32,31,26,12,0,0,0,20140318,113,118,-9,0,2,0,5,231,5,2013,1,1,733,0
Miami,37,22,20,21,0,0,0,0,Cleveland,25,29,25,17,0,0,0,0,20140318,100,96,12,5,0,4,4,196,-4,2013,0,1,1089,0
Orlando,27,20,19,23,0,0,0,0,Golden State,30,27,30,16,0,0,0,0,20140318,89,103,3,10,21,14,14,192,14,2013,0,1,2437,0
Orlando,25,27,24,17,0,0,0,0,Phoenix,25,27,30,27,0,0,0,0,20140319,93,109,0,0,6,16,16,202,16,2013,0,2,1842,0
Indiana,14,21,27,24,0,0,0,0,New York,21,26,20,25,0,0,0,0,20140319,86,92,7,12,5,6,6,178,6,2013,0,2,643,0
Toronto,24,32,25,26,0,0,0,0,New Orleans,32,25,28,15,0,0,0,0,20140319,107,100,-8,-1,-4,7,7,207,-7,2013,0,2,1112,0
Utah,19,13,31,23,0,0,0,0,Memphis,30,18,26,22,0,0,0,0,20140319,86,96,11,16,11,10,10,182,10,2013,0,2,1247,0
Chicago,28,24,23,27,0,0,0,0,Philadelphia,26,19,24,25,0,0,0,0,20140319,102,94,2,7,6,8,8,196,-8,2013,0,2,664,0
Detroit,28,33,23,25,0,0,0,0,Denver,27,27,31,33,0,0,0,0,20140319,109,118,-1,-7,1,9,9,227,9,2013,0,2,1154,0
Minnesota,37,29,28,19,10,0,0,0,Dallas,24,35,28,26,9,0,0,0,20140319,123,122,13,7,7,0,1,245,-1,2013,1,2,863,0
Charlotte,21,25,24,29,0,0,0,0,Brooklyn,26,28,21,29,0,0,0,0,20140319,99,104,5,8,5,5,5,203,5,2013,0,2,531,0
Miami,34,25,19,18,0,0,0,0,Boston,22,31,27,21,0,0,0,0,20140319,96,101,-12,-6,2,5,5,197,5,2013,0,2,1257,0
San Antonio,35,23,34,33,0,0,0,0,LA Lakers,29,28,30,22,0,0,0,0,20140319,125,109,6,1,5,16,16,234,-16,2013,0,2,1201,0
Oklahoma City,21,35,29,17,0,0,0,0,Cleveland,25,21,22,27,0,0,0,0,20140320,102,95,-4,10,17,7,7,197,-7,2013,0,3,949,0
Milwaukee,21,30,24,35,0,0,0,0,Golden State,29,24,29,33,0,0,0,0,20140320,110,115,8,2,7,5,5,225,5,2013,0,3,1838,0
Minnesota,33,21,28,24,0,0,0,0,Houston,27,37,34,31,0,0,0,0,20140320,106,129,-6,10,16,23,23,235,23,2013,0,3,1057,0
Washington,28,23,22,30,0,0,0,0,Portland,23,30,33,30,0,0,0,0,20140320,103,116,-5,2,13,13,13,219,13,2013,0,3,2347,0
Memphis,22,21,25,18,0,0,0,0,Miami,15,30,23,23,0,0,0,0,20140321,86,91,-7,2,0,5,5,177,5,2013,0,4,873,0
San Antonio,24,23,22,30,0,0,0,0,Sacramento,23,14,20,22,0,0,0,0,20140321,99,79,1,10,12,20,20,178,-20,2013,0,4,1456,0
Detroit,27,23,21,21,0,0,0,0,Phoenix,26,25,22,25,0,0,0,0,20140321,92,98,-1,1,2,6,6,190,6,2013,0,4,1687,0
New York,21,20,31,21,0,0,0,0,Philadelphia,24,12,29,27,0,0,0,0,20140321,93,92,-3,5,7,1,1,185,-1,2013,0,4,80,0
Oklahoma City,22,20,30,24,11,12,0,0,Toronto,20,26,25,25,11,11,0,0,20140321,119,118,2,-4,1,0,1,237,-1,2013,2,4,1114,0
Washington,33,25,30,29,0,0,0,0,LA Lakers,21,26,34,26,0,0,0,0,20140321,117,107,12,11,7,10,10,224,-10,2013,0,4,2294,0
Denver,29,24,25,28,0,0,0,0,Dallas,26,35,29,32,0,0,0,0,20140321,106,122,-3,8,12,16,16,228,16,2013,0,4,661,0
New Orleans,20,24,25,42,0,0,0,0,Atlanta,16,28,27,34,0,0,0,0,20140321,111,105,4,0,-2,6,6,216,-6,2013,0,4,424,0
Chicago,23,20,19,17,0,0,0,0,Indiana,19,25,31,16,0,0,0,0,20140321,79,91,-4,1,13,12,12,170,12,2013,0,4,163,0
Boston,28,26,22,22,0,0,0,0,Brooklyn,34,30,28,22,0,0,0,0,20140321,98,114,6,10,16,16,16,212,16,2013,0,4,190,0
Orlando,16,27,18,27,0,0,0,0,Utah,27,22,17,23,0,0,0,0,20140322,88,89,11,6,5,1,1,177,1,2013,0,5,1915,0
Portland,22,24,27,21,0,0,0,0,Charlotte,33,36,29,26,0,0,0,0,20140322,94,124,11,23,25,30,30,218,30,2013,0,5,2284,0
Philadelphia,25,13,21,22,0,0,0,0,Chicago,20,21,24,26,0,0,0,0,20140322,81,91,-5,3,6,10,10,172,10,2013,0,5,664,0
Houston,39,28,34,17,0,0,0,0,Cleveland,31,24,24,32,0,0,0,0,20140322,118,111,8,12,22,7,7,229,-7,2013,0,5,1113,0
San Antonio,32,18,26,23,0,0,0,0,Golden State,22,25,22,21,0,0,0,0,20140322,99,90,10,3,7,9,9,189,-9,2013,0,5,1487,0
Detroit,26,29,15,33,0,0,0,0,LA Clippers,36,20,24,32,0,0,0,0,20140322,103,112,10,1,10,9,9,215,9,2013,0,5,1979,0
Indiana,17,13,19,22,0,0,0,0,Memphis,19,24,21,18,0,0,0,0,20140322,71,82,2,13,15,11,11,153,11,2013,0,5,383,0
Miami,22,21,29,23,0,0,0,0,New Orleans,22,23,31,29,0,0,0,0,20140322,95,105,0,2,4,10,10,200,10,2013,0,5,668,0
Atlanta,25,24,22,15,0,0,0,0,Toronto,16,26,18,36,0,0,0,0,20140323,86,96,-9,-7,-11,10,10,182,10,2013,0,6,733,0
Milwaukee,16,28,26,37,0,0,0,0,Sacramento,39,31,34,20,0,0,0,0,20140323,107,124,23,26,34,17,17,231,17,2013,0,6,1771,0
Cleveland,27,19,31,29,0,0,0,0,New York,34,27,23,16,0,0,0,0,20140323,106,100,-7,-15,-7,6,6,206,-6,2013,0,6,403,0
Washington,29,20,24,29,0,0,0,0,Denver,21,26,30,28,0,0,0,0,20140323,102,105,-8,-2,4,3,3,207,3,2013,0,6,1489,0
Orlando,24,24,25,21,0,0,0,0,LA Lakers,29,26,20,28,0,0,0,0,20140323,94,103,5,7,2,9,9,197,9,2013,0,6,2197,0
Brooklyn,15,26,24,26,16,0,0,0,Dallas,29,19,24,19,13,0,0,0,20140323,107,104,-14,-7,-7,0,3,211,-3,2013,1,6,1370,0
Phoenix,27,35,31,34,0,0,0,0,Minnesota,41,32,30,17,0,0,0,0,20140323,127,120,-14,-11,-10,7,7,247,-7,2013,0,6,1278,0
Portland,25,17,19,30,0,0,0,0,Miami,22,24,26,21,0,0,0,0,20140324,91,93,-3,4,11,2,2,184,2,2013,0,0,2704,0
Philadelphia,24,20,24,23,0,0,0,0,San Antonio,31,29,29,24,0,0,0,0,20140324,91,113,7,16,21,22,22,204,22,2013,0,0,1505,0
Denver,24,34,15,23,0,0,0,0,Oklahoma City,41,31,18,27,0,0,0,0,20140324,96,117,17,14,17,21,21,213,21,2013,0,0,503,0
Brooklyn,26,32,18,22,6,0,0,0,New Orleans,20,22,31,25,11,0,0,0,20140324,104,109,-6,-16,-3,0,5,213,5,2013,1,0,1168,0
Detroit,26,34,26,28,0,0,0,0,Utah,23,17,29,25,0,0,0,0,20140324,114,94,3,20,17,20,20,208,-20,2013,0,0,1488,0
Minnesota,15,24,29,24,0,0,0,0,Memphis,30,27,24,28,0,0,0,0,20140324,92,109,15,18,13,17,17,201,17,2013,0,0,700,0
Indiana,19,15,22,21,0,0,0,0,Chicago,15,18,31,25,0,0,0,0,20140324,77,89,-4,-1,8,12,12,166,12,2013,0,0,163,0
Houston,25,29,24,22,0,0,0,0,Charlotte,24,26,18,21,0,0,0,0,20140324,100,89,1,4,10,11,11,189,-11,2013,0,0,925,0
Phoenix,25,17,35,25,0,0,0,0,Atlanta,23,22,23,27,0,0,0,0,20140324,102,95,2,-3,9,7,7,197,-7,2013,0,0,1588,0
Milwaukee,25,27,22,24,0,0,0,0,LA Clippers,35,22,22,27,0,0,0,0,20140324,98,106,10,5,5,8,8,204,8,2013,0,0,1741,0
Toronto,17,28,36,19,0,0,0,0,Cleveland,26,33,29,14,0,0,0,0,20140325,100,102,9,14,7,2,2,202,2,2013,0,1,187,0
Oklahoma City,24,36,29,22,8,0,0,0,Dallas,28,31,25,27,17,0,0,0,20140325,119,128,4,-1,-5,0,9,247,9,2013,1,1,189,0
New York,22,20,31,23,0,0,0,0,LA Lakers,14,36,51,26,0,0,0,0,20140325,96,127,-8,8,28,31,31,223,31,2013,0,1,2445,0
Portland,26,16,23,20,0,0,0,0,Orlando,23,27,29,16,0,0,0,0,20140325,85,95,-3,8,14,10,10,180,10,2013,0,1,2525,0
Phoenix,25,29,25,20,0,0,0,0,Washington,23,21,25,24,0,0,0,0,20140326,99,93,2,10,10,6,6,192,-6,2013,0,2,1977,0
Memphis,17,23,22,29,0,0,0,0,Utah,25,25,21,16,0,0,0,0,20140326,91,87,-8,-10,-9,4,4,178,-4,2013,0,2,1247,0
Denver,28,15,24,36,0,0,0,0,San Antonio,34,29,21,24,0,0,0,0,20140326,103,108,6,20,17,5,5,211,5,2013,0,2,802,0
New York,31,32,23,21,0,0,0,0,Sacramento,28,20,24,27,0,0,0,0,20140326,107,99,3,15,14,8,8,206,-8,2013,0,2,2499,0
LA Clippers,27,25,23,21,0,0,0,0,New Orleans,29,26,21,22,0,0,0,0,20140326,96,98,2,3,1,2,2,194,2,2013,0,2,1669,0
Miami,17,28,23,15,0,0,0,0,Indiana,23,21,19,21,0,0,0,0,20140326,83,84,6,-1,-5,1,1,167,1,2013,0,2,1026,0
Cleveland,24,26,16,31,0,0,0,0,Detroit,33,18,31,14,0,0,0,0,20140326,97,96,-9,-1,-16,1,1,193,-1,2013,0,2,90,0
Brooklyn,28,31,19,27,6,0,0,0,Charlotte,24,34,25,22,11,0,0,0,20140326,111,116,-4,-1,5,0,5,227,5,2013,1,2,531,0
Toronto,31,24,22,22,0,0,0,0,Boston,22,24,16,28,0,0,0,0,20140326,99,90,9,9,15,9,9,189,-9,2013,0,2,430,0
Atlanta,19,22,20,22,0,0,0,0,Minnesota,20,28,27,32,0,0,0,0,20140326,83,107,1,7,14,24,24,190,24,2013,0,2,908,0
LA Lakers,30,23,27,25,0,0,0,0,Milwaukee,26,29,32,21,0,0,0,0,20140327,105,108,-4,2,7,3,3,213,3,2013,0,3,1741,0
Portland,22,31,25,22,0,0,0,0,Atlanta,16,21,27,21,0,0,0,0,20140327,100,85,6,16,14,15,15,185,-15,2013,0,3,2168,0
LA Clippers,29,29,23,28,0,0,0,0,Dallas,29,31,21,22,0,0,0,0,20140327,109,103,0,-2,0,6,6,212,-6,2013,0,3,1237,0
Philadelphia,28,21,31,18,0,0,0,0,Houston,35,28,37,20,0,0,0,0,20140327,98,120,7,14,20,22,22,218,22,2013,0,3,1339,0
Indiana,21,16,19,22,0,0,0,0,Washington,24,20,30,17,0,0,0,0,20140328,78,91,3,7,18,13,13,169,13,2013,0,4,490,0
Sacramento,15,23,13,30,0,0,0,0,Oklahoma City,32,22,28,12,0,0,0,0,20140328,81,94,17,16,31,13,13,175,13,2013,0,4,1336,0
Boston,26,27,20,30,0,0,0,0,Toronto,32,24,29,20,0,0,0,0,20140328,103,105,6,3,12,2,2,208,2,2013,0,4,430,0
New York,26,14,26,22,0,0,0,0,Phoenix,34,28,26,24,0,0,0,0,20140328,88,112,8,22,22,24,24,200,24,2013,0,4,2139,0
Utah,22,16,28,29,0,0,0,0,New Orleans,20,23,29,30,0,0,0,0,20140328,95,102,-2,5,6,7,7,197,7,2013,0,4,1432,0
Charlotte,30,20,31,16,8,0,0,0,Orlando,16,25,33,23,13,0,0,0,20140328,105,110,-14,-9,-7,0,5,215,5,2013,1,4,463,0
Memphis,27,25,24,17,0,0,0,0,Golden State,30,23,26,21,0,0,0,0,20140328,93,100,3,1,3,7,7,193,7,2013,0,4,1798,0
Miami,28,29,35,18,0,0,0,0,Detroit,23,19,18,18,0,0,0,0,20140328,110,78,5,15,32,32,32,188,-32,2013,0,4,1155,0
San Antonio,31,31,35,36,0,0,0,0,Denver,23,20,31,28,0,0,0,0,20140328,133,102,8,19,23,31,31,235,-31,2013,0,4,802,0
Portland,19,28,26,18,0,0,0,0,Chicago,16,20,22,16,0,0,0,0,20140328,91,74,3,11,15,17,17,165,-17,2013,0,4,1754,0
Cleveland,29,21,27,20,0,0,0,0,Brooklyn,29,32,24,23,0,0,0,0,20140328,97,108,0,11,8,11,11,205,11,2013,0,4,403,0
LA Lakers,24,19,34,30,0,0,0,0,Minnesota,41,33,37,32,0,0,0,0,20140328,107,143,17,31,34,36,36,250,36,2013,0,4,1521,0
New Orleans,15,20,24,21,0,0,0,0,San Antonio,28,24,18,26,0,0,0,0,20140329,80,96,13,17,11,16,16,176,16,2013,0,5,506,0
Detroit,23,28,17,30,0,0,0,0,Philadelphia,33,37,28,25,0,0,0,0,20140329,98,123,10,19,30,25,25,221,25,2013,0,5,441,0
Atlanta,27,25,19,26,0,0,0,0,Washington,28,22,25,26,0,0,0,0,20140329,97,101,1,-2,4,4,4,198,4,2013,0,5,541,0
LA Clippers,23,38,27,30,0,0,0,0,Houston,33,25,26,23,0,0,0,0,20140329,118,107,-10,3,4,11,11,225,-11,2013,0,5,1371,0
Sacramento,19,23,28,30,0,0,0,0,Dallas,26,28,18,31,0,0,0,0,20140329,100,103,7,12,2,3,3,203,3,2013,0,5,1437,0
Miami,21,25,19,23,0,0,0,0,Milwaukee,12,17,17,21,0,0,0,0,20140329,88,67,9,17,19,21,21,155,-21,2013,0,5,1269,0
Chicago,25,26,27,29,0,0,0,0,Boston,26,24,27,25,0,0,0,0,20140330,107,102,-1,1,1,5,5,209,-5,2013,0,6,849,0
Minnesota,27,27,28,17,0,0,0,0,Brooklyn,30,29,26,29,0,0,0,0,20140330,99,114,3,5,3,15,15,213,15,2013,0,6,1016,0
Indiana,20,16,22,18,0,0,0,0,Cleveland,25,24,24,17,0,0,0,0,20140330,76,90,5,13,15,14,14,166,14,2013,0,6,262,0
New York,22,34,18,15,0,0,0,0,Golden State,32,12,22,18,0,0,0,0,20140330,89,84,-10,12,8,5,5,173,-5,2013,0,6,2565,0
Phoenix,15,28,31,25,0,0,0,0,LA Lakers,26,35,28,26,0,0,0,0,20140330,99,115,11,18,15,16,16,214,16,2013,0,6,356,0
Utah,9,31,37,19,0,0,0,0,Oklahoma City,26,33,33,24,0,0,0,0,20140330,96,116,17,19,15,20,20,212,20,2013,0,6,861,0
Toronto,27,30,16,25,0,0,0,0,Orlando,22,16,26,29,0,0,0,0,20140330,98,93,5,19,9,5,5,191,-5,2013,0,6,1048,0
Memphis,23,22,25,28,0,0,0,0,Portland,25,32,29,19,0,0,0,0,20140330,98,105,2,12,16,7,7,203,7,2013,0,6,1845,0
Toronto,23,28,14,18,0,0,0,0,Miami,24,30,20,19,0,0,0,0,20140331,83,93,1,3,9,10,10,176,10,2013,0,0,1234,0
New York,21,27,31,13,0,0,0,0,Utah,27,22,20,14,0,0,0,0,20140331,92,83,-6,-1,10,9,9,175,-9,2013,0,0,1967,0
Sacramento,29,24,27,22,0,0,0,0,New Orleans,22,33,21,21,0,0,0,0,20140331,102,97,7,-2,4,5,5,199,-5,2013,0,0,1879,0
San Antonio,25,23,21,34,0,0,0,0,Indiana,15,20,24,18,0,0,0,0,20140331,103,77,10,13,10,26,26,180,-26,2013,0,0,999,0
LA Clippers,26,28,34,26,0,0,0,0,Minnesota,22,29,15,38,0,0,0,0,20140331,114,104,4,3,22,10,10,218,-10,2013,0,0,1521,0
Memphis,25,22,28,19,0,0,0,0,Denver,16,29,23,24,0,0,0,0,20140331,94,92,9,2,7,2,2,186,-2,2013,0,0,877,0
Boston,24,26,20,10,0,0,0,0,Chicago,25,23,23,23,0,0,0,0,20140331,80,94,1,-2,1,14,14,174,14,2013,0,0,849,0
Washington,20,40,20,14,0,0,0,0,Charlotte,25,19,26,30,0,0,0,0,20140331,94,100,5,-16,-10,6,6,194,6,2013,0,0,329,0
Philadelphia,31,22,20,22,0,0,0,0,Atlanta,18,25,32,28,0,0,0,0,20140331,95,103,-13,-10,2,8,8,198,8,2013,0,0,665,0
Milwaukee,30,31,21,29,0,0,0,0,Detroit,34,18,29,35,0,0,0,0,20140331,111,116,4,-9,-1,5,5,227,5,2013,0,0,251,0
Houston,24,27,28,17,0,0,0,0,Brooklyn,29,25,29,22,0,0,0,0,20140401,96,105,5,3,4,9,9,201,9,2013,0,1,1417,0
Golden State,30,23,32,23,14,0,0,0,Dallas,21,41,19,27,12,0,0,0,20140401,122,120,9,-9,4,0,2,242,-2,2013,1,1,1480,0
Portland,29,34,28,33,0,0,0,0,LA Lakers,27,34,22,29,0,0,0,0,20140401,124,112,2,2,8,12,12,236,-12,2013,0,1,826,0
Boston,21,25,16,30,0,0,0,0,Washington,29,28,32,29,0,0,0,0,20140402,92,118,8,11,27,26,26,210,26,2013,0,2,394,0
Houston,25,25,30,23,0,0,0,0,Toronto,23,32,35,17,0,0,0,0,20140402,103,107,-2,5,10,4,4,210,4,2013,0,2,1299,0
Golden State,18,24,25,23,0,0,0,0,San Antonio,31,26,30,24,0,0,0,0,20140402,90,111,13,15,20,21,21,201,21,2013,0,2,1487,0
LA Lakers,23,29,24,26,0,0,0,0,Sacramento,24,36,27,20,0,0,0,0,20140402,102,107,1,8,11,5,5,209,5,2013,0,2,361,0
LA Clippers,30,30,18,34,0,0,0,0,Phoenix,25,37,29,17,0,0,0,0,20140402,112,108,5,-2,-13,4,4,220,-4,2013,0,2,356,0
Charlotte,31,32,25,35,0,0,0,0,Philadelphia,19,19,25,30,0,0,0,0,20140402,123,93,12,25,25,30,30,216,-30,2013,0,2,450,0
Cleveland,35,35,24,25,0,0,0,0,Orlando,27,20,21,30,0,0,0,0,20140402,119,98,8,23,26,21,21,217,-21,2013,0,2,895,0
Memphis,20,21,20,27,0,0,0,0,Minnesota,20,28,29,25,0,0,0,0,20140402,88,102,0,7,16,14,14,190,14,2013,0,2,700,0
Milwaukee,19,19,19,20,0,0,0,0,Miami,33,23,21,19,0,0,0,0,20140402,77,96,14,18,20,19,19,173,19,2013,0,2,1269,0
Detroit,27,19,28,20,0,0,0,0,Indiana,28,22,23,28,0,0,0,0,20140402,94,101,1,4,-1,7,7,195,7,2013,0,2,240,0
New Orleans,26,27,28,26,0,0,0,0,Denver,40,31,34,32,0,0,0,0,20140402,107,137,14,18,24,30,30,244,30,2013,0,2,1079,0
Chicago,31,26,21,27,0,0,0,0,Atlanta,31,18,23,20,0,0,0,0,20140402,105,92,0,8,6,13,13,197,-13,2013,0,2,587,0
Brooklyn,20,18,23,20,0,0,0,0,New York,29,34,19,28,0,0,0,0,20140402,81,110,9,25,21,29,29,191,29,2013,0,2,0,0
Dallas,32,26,28,27,0,0,0,0,LA Clippers,26,30,25,26,0,0,0,0,20140403,113,107,6,2,5,6,6,220,-6,2013,0,3,1237,0
San Antonio,24,27,20,23,0,0,0,0,Oklahoma City,22,26,32,26,0,0,0,0,20140403,94,106,-2,-3,9,12,12,200,12,2013,0,3,421,0
Denver,18,29,18,27,0,0,0,0,Memphis,24,19,26,31,0,0,0,0,20140404,92,100,6,-4,4,8,8,192,8,2013,0,4,877,0
New Orleans,23,22,20,31,0,0,0,0,Utah,25,18,30,27,0,0,0,0,20140404,96,100,2,-2,8,4,4,196,4,2013,0,4,1432,0
Indiana,28,18,29,19,0,0,0,0,Toronto,27,27,21,27,0,0,0,0,20140404,94,102,-1,8,0,8,8,196,8,2013,0,4,438,0
Phoenix,28,23,28,30,0,0,0,0,Portland,26,28,26,13,0,0,0,0,20140404,109,93,2,-3,-1,16,16,202,-16,2013,0,4,1005,0
Washington,27,12,25,26,0,0,0,0,New York,21,22,24,22,0,0,0,0,20140404,90,89,6,-4,-3,1,1,179,-1,2013,0,4,204,0
Minnesota,24,28,25,20,12,13,0,0,Miami,29,23,23,22,12,12,0,0,20140404,122,121,-5,0,2,0,1,243,-1,2013,2,4,1513,0
Dallas,27,25,30,25,0,0,0,0,LA Lakers,23,31,24,17,0,0,0,0,20140404,107,95,4,-2,4,12,12,202,-12,2013,0,4,1237,0
Orlando,19,17,24,20,0,0,0,0,Charlotte,20,33,19,19,0,0,0,0,20140404,80,91,1,17,12,11,11,171,11,2013,0,4,463,0
Sacramento,14,13,23,19,0,0,0,0,Golden State,25,34,25,18,0,0,0,0,20140404,69,102,11,32,34,33,33,171,33,2013,0,4,75,0
Cleveland,23,26,24,25,0,0,0,0,Atlanta,39,22,29,27,0,0,0,0,20140404,98,117,16,12,17,19,19,215,19,2013,0,4,555,0
Philadelphia,23,26,27,35,0,0,0,0,Boston,17,34,20,31,0,0,0,0,20140404,111,102,6,-2,5,9,9,213,-9,2013,0,4,270,0
Oklahoma City,23,22,39,23,0,0,0,0,Houston,27,23,32,29,0,0,0,0,20140404,107,111,4,5,-2,4,4,218,4,2013,0,4,413,0
Milwaukee,15,20,27,28,0,0,0,0,Chicago,27,24,31,20,0,0,0,0,20140404,90,102,12,16,20,12,12,192,12,2013,0,4,83,0
Detroit,22,23,24,35,0,0,0,0,Brooklyn,22,35,34,25,0,0,0,0,20140404,104,116,0,12,22,12,12,220,12,2013,0,4,480,0
Chicago,28,24,24,20,0,0,0,0,Washington,16,10,35,17,0,0,0,0,20140405,96,78,12,26,15,18,18,174,-18,2013,0,5,594,0
Charlotte,17,23,22,20,14,0,0,0,Cleveland,21,12,33,16,12,0,0,0,20140405,96,94,-4,7,-4,0,2,190,-2,2013,1,5,435,0
Boston,32,33,30,16,0,0,0,0,Detroit,29,26,30,30,0,0,0,0,20140405,111,115,-3,-10,-10,4,4,226,4,2013,0,5,611,0
Toronto,28,19,28,27,0,0,0,0,Milwaukee,22,34,20,22,0,0,0,0,20140405,102,98,6,-9,-1,4,4,200,-4,2013,0,5,429,0
Minnesota,26,22,29,15,0,0,0,0,Orlando,25,21,26,28,0,0,0,0,20140405,92,100,-1,-2,-5,8,8,192,8,2013,0,5,1309,0
Brooklyn,27,30,24,24,0,0,0,0,Philadelphia,21,21,27,32,0,0,0,0,20140405,105,101,6,15,12,4,4,206,-4,2013,0,5,80,0
Memphis,10,28,29,25,0,0,0,0,San Antonio,26,28,27,31,0,0,0,0,20140406,92,112,16,16,14,20,20,204,20,2013,0,6,631,0
Dallas,29,16,23,25,0,0,0,0,Sacramento,24,24,17,26,0,0,0,0,20140406,93,91,5,-3,3,2,2,184,-2,2013,0,6,1437,0
New Orleans,25,30,14,25,0,0,0,0,Portland,25,23,29,23,0,0,0,0,20140406,94,100,0,-7,8,6,6,194,6,2013,0,6,2059,0
Oklahoma City,25,28,38,24,0,0,0,0,Phoenix,28,34,32,28,0,0,0,0,20140406,115,122,3,9,3,7,7,237,7,2013,0,6,840,0
Denver,27,25,36,29,8,0,0,0,Houston,22,47,19,29,13,0,0,0,20140406,125,130,-5,17,0,0,5,255,5,2013,1,6,878,0
LA Lakers,22,27,23,25,0,0,0,0,LA Clippers,25,32,37,26,0,0,0,0,20140406,97,120,3,8,22,23,23,217,23,2013,0,6,0,0
Atlanta,33,22,24,28,0,0,0,0,Indiana,11,12,36,29,0,0,0,0,20140406,107,88,22,32,20,19,19,195,-19,2013,0,6,427,0
Utah,22,30,21,29,0,0,0,0,Golden State,35,31,35,29,0,0,0,0,20140406,102,130,13,14,28,28,28,232,28,2013,0,6,599,0
New York,26,24,14,27,0,0,0,0,Miami,25,23,25,29,0,0,0,0,20140406,91,102,-1,-2,9,11,11,193,11,2013,0,6,1091,0
San Antonio,19,15,29,28,0,0,0,0,Minnesota,27,27,31,25,0,0,0,0,20140408,91,110,8,20,22,19,19,201,19,2013,0,1,1112,0
Oklahoma City,30,31,24,22,0,0,0,0,Sacramento,27,22,28,15,0,0,0,0,20140408,107,92,3,12,8,15,15,199,-15,2013,0,1,1336,0
Dallas,39,22,20,14,0,0,0,0,Utah,25,21,19,18,0,0,0,0,20140408,95,83,14,15,16,12,12,178,-12,2013,0,1,998,0
Brooklyn,26,18,18,26,0,0,0,0,Miami,14,29,22,22,0,0,0,0,20140408,88,87,12,1,-3,1,1,175,-1,2013,0,1,1091,0
Detroit,35,23,23,21,0,0,0,0,Atlanta,27,25,26,17,0,0,0,0,20140408,102,95,8,6,3,7,7,197,-7,2013,0,1,597,0
Houston,35,31,49,30,0,0,0,0,LA Lakers,26,35,29,40,0,0,0,0,20140408,145,130,9,5,25,15,15,275,-15,2013,0,1,1371,0
Charlotte,32,22,17,16,7,0,0,0,Washington,18,23,25,21,1,0,0,0,20140409,94,88,14,13,5,0,6,182,-6,2013,1,2,329,0
Philadelphia,28,32,29,25,0,0,0,0,Toronto,34,34,30,27,0,0,0,0,20140409,114,125,6,8,9,11,11,239,11,2013,0,2,334,0
Sacramento,20,26,25,28,0,0,0,0,Portland,27,29,23,21,0,0,0,0,20140409,99,100,7,10,8,1,1,199,1,2013,0,2,483,0
Phoenix,23,24,24,23,0,0,0,0,New Orleans,14,32,18,24,0,0,0,0,20140409,94,88,9,1,7,6,6,182,-6,2013,0,2,1312,0
Chicago,26,22,27,27,0,0,0,0,Minnesota,25,28,17,17,0,0,0,0,20140409,102,87,1,-5,5,15,15,189,-15,2013,0,2,355,0
Brooklyn,22,21,35,33,0,0,0,0,Orlando,20,35,28,32,0,0,0,0,20140409,111,115,-2,12,5,4,4,226,4,2013,0,2,939,0
Miami,32,26,22,22,0,0,0,0,Memphis,31,23,26,27,0,0,0,0,20140409,102,107,-1,-4,0,5,5,209,5,2013,0,2,873,0
Oklahoma City,29,30,26,22,0,0,0,0,LA Clippers,22,32,19,28,0,0,0,0,20140409,107,101,7,5,12,6,6,208,-6,2013,0,2,1178,0
Houston,18,40,30,28,0,0,0,0,Denver,30,38,37,18,0,0,0,0,20140409,116,123,12,10,17,7,7,239,7,2013,0,2,878,0
Detroit,18,19,33,30,0,0,0,0,Cleveland,31,38,29,24,0,0,0,0,20140409,100,122,13,32,28,22,22,222,22,2013,0,2,90,0
Boston,23,28,26,20,0,0,0,0,Atlanta,32,24,14,35,0,0,0,0,20140409,97,105,9,5,-7,8,8,202,8,2013,0,2,935,0
Indiana,25,28,19,32,0,0,0,0,Milwaukee,25,25,17,35,0,0,0,0,20140409,104,102,0,3,5,2,2,206,-2,2013,0,2,243,0
San Antonio,30,19,34,26,0,0,0,0,Dallas,22,29,21,28,0,0,0,0,20140410,109,100,8,-2,11,9,9,209,-9,2013,0,3,252,0
Denver,15,28,30,27,0,0,0,0,Golden State,28,25,22,24,0,0,0,0,20140410,100,99,-13,-10,-2,1,1,199,-1,2013,0,3,947,0
Houston,32,31,21,26,0,0,0,0,Minnesota,39,20,23,30,0,0,0,0,20140411,110,112,7,-4,-2,2,2,222,2,2013,0,4,1057,0
Portland,23,30,23,35,0,0,0,0,Utah,31,20,25,23,0,0,0,0,20140411,111,99,-8,2,0,12,12,210,-12,2013,0,4,634,0
New York,24,21,33,30,0,0,0,0,Toronto,26,21,30,23,0,0,0,0,20140411,108,100,-2,-2,1,8,8,208,-8,2013,0,4,341,0
Washington,17,28,22,29,0,0,0,0,Orlando,29,22,19,16,0,0,0,0,20140411,96,86,-12,-6,-3,10,10,182,-10,2013,0,4,757,0
New Orleans,23,24,15,32,0,0,0,0,Oklahoma City,30,30,27,29,0,0,0,0,20140411,94,116,7,13,25,22,22,210,22,2013,0,4,576,0
Cleveland,32,37,18,29,0,0,0,0,Milwaukee,37,25,30,27,0,0,0,0,20140411,116,119,5,-7,5,3,3,235,3,2013,0,4,334,0
Phoenix,37,25,19,23,0,0,0,0,San Antonio,24,25,37,26,0,0,0,0,20140411,104,112,-13,-13,5,8,8,216,8,2013,0,4,846,0
Philadelphia,24,23,17,31,0,0,0,0,Memphis,30,27,30,30,0,0,0,0,20140411,95,117,6,10,23,22,22,212,22,2013,0,4,878,0
Golden State,26,32,25,29,0,0,0,0,LA Lakers,26,17,26,26,0,0,0,0,20140411,112,95,0,15,14,17,17,207,-17,2013,0,4,347,0
Detroit,28,28,24,18,0,0,0,0,Chicago,17,21,32,36,0,0,0,0,20140411,98,106,-11,-18,-10,8,8,204,8,2013,0,4,238,0
Indiana,25,17,20,24,0,0,0,0,Miami,23,22,31,22,0,0,0,0,20140411,86,98,-2,3,14,12,12,184,12,2013,0,4,1026,0
Atlanta,16,39,19,19,0,0,0,0,Brooklyn,23,24,26,15,0,0,0,0,20140411,93,88,-7,8,1,5,5,181,-5,2013,0,4,745,0
Charlotte,29,26,20,28,0,0,0,0,Boston,28,29,27,22,0,0,0,0,20140411,103,106,-1,2,9,3,3,209,3,2013,0,4,720,0
Milwaukee,26,26,22,17,0,0,0,0,Washington,27,28,32,17,0,0,0,0,20140412,91,104,1,3,13,13,13,195,13,2013,0,5,634,0
New Orleans,20,39,23,22,0,0,0,0,Houston,22,24,26,39,0,0,0,0,20140412,104,111,2,-13,-10,7,7,215,7,2013,0,5,317,0
Utah,23,21,21,29,0,0,0,0,Denver,18,16,30,37,0,0,0,0,20140412,94,101,-5,-10,-1,7,7,195,7,2013,0,5,370,0
Sacramento,26,21,32,22,0,0,0,0,LA Clippers,27,29,29,32,0,0,0,0,20140412,101,117,1,9,6,16,16,218,16,2013,0,5,361,0
Boston,28,32,29,22,0,0,0,0,Cleveland,18,24,16,41,0,0,0,0,20140412,111,99,10,18,31,12,12,210,-12,2013,0,5,549,0
Philadelphia,24,35,19,27,0,0,0,0,Charlotte,26,30,31,24,0,0,0,0,20140412,105,111,2,-3,9,6,6,216,6,2013,0,5,450,0
Miami,23,26,13,23,0,0,0,0,Atlanta,28,21,20,29,0,0,0,0,20140412,85,98,5,0,7,13,13,183,13,2013,0,5,605,0
Phoenix,26,31,21,20,0,0,0,0,Dallas,27,19,29,26,0,0,0,0,20140412,98,101,1,-11,-3,3,3,199,3,2013,0,5,884,0
Orlando,28,21,21,18,0,0,0,0,Brooklyn,25,21,33,18,0,0,0,0,20140413,88,97,-3,-3,9,9,9,185,9,2013,0,6,939,0
Toronto,42,21,24,29,0,0,0,0,Detroit,26,23,37,21,0,0,0,0,20140413,116,107,16,14,1,9,9,223,-9,2013,0,6,205,0
Oklahoma City,21,24,21,31,0,0,0,0,Indiana,22,25,27,28,0,0,0,0,20140413,97,102,1,2,8,5,5,199,5,2013,0,6,688,0
Memphis,23,30,34,15,0,0,0,0,LA Lakers,27,25,17,21,0,0,0,0,20140413,102,90,-4,1,18,12,12,192,-12,2013,0,6,1599,0
Chicago,22,17,25,25,0,0,0,0,New York,19,26,32,23,0,0,0,0,20140413,89,100,-3,6,13,11,11,189,11,2013,0,6,711,0
Golden State,19,33,23,30,12,0,0,0,Portland,23,21,32,29,14,0,0,0,20140413,117,119,4,-8,1,0,2,236,2,2013,1,6,535,0
Minnesota,28,24,24,27,0,0,0,0,Sacramento,30,17,28,31,0,0,0,0,20140413,103,106,2,-5,-1,3,3,209,3,2013,0,6,1511,0
Milwaukee,19,27,23,31,0,0,0,0,Toronto,32,27,25,26,0,0,0,0,20140414,100,110,13,13,15,10,10,210,10,2013,0,0,429,0
Miami,26,22,17,28,0,0,0,0,Washington,27,43,28,16,0,0,0,0,20140414,93,114,1,22,33,21,21,207,21,2013,0,0,924,0
LA Lakers,23,34,29,33,0,0,0,0,Utah,30,21,35,18,0,0,0,0,20140414,119,104,-7,6,0,15,15,223,-15,2013,0,0,579,0
Memphis,24,22,21,30,0,0,0,0,Phoenix,14,28,25,24,0,0,0,0,20140414,97,91,10,4,0,6,6,188,-6,2013,0,0,1260,0
Boston,33,17,34,24,0,0,0,0,Philadelphia,33,34,19,27,0,0,0,0,20140414,108,113,0,17,2,5,5,221,5,2013,0,0,270,0
San Antonio,21,22,25,30,0,0,0,0,Houston,30,20,26,28,0,0,0,0,20140414,98,104,9,7,8,6,6,202,6,2013,0,0,189,0
Minnesota,42,22,28,28,0,0,0,0,Golden State,28,34,35,33,0,0,0,0,20140414,120,130,-14,-2,5,10,10,250,10,2013,0,0,1581,0
Orlando,21,23,26,25,0,0,0,0,Chicago,26,31,24,27,0,0,0,0,20140414,95,108,5,13,11,13,13,203,13,2013,0,0,984,0
Charlotte,26,18,21,30,0,0,0,0,Atlanta,24,26,30,13,0,0,0,0,20140414,95,93,2,-6,-15,2,2,188,-2,2013,0,0,226,0
Oklahoma City,21,25,23,20,0,0,0,0,New Orleans,23,22,25,31,0,0,0,0,20140414,89,101,2,-1,1,12,12,190,12,2013,0,0,576,0
New York,29,26,28,26,0,0,0,0,Brooklyn,18,25,24,31,0,0,0,0,20140415,109,98,11,12,16,11,11,207,-11,2013,0,1,0,0
Denver,26,20,34,25,0,0,0,0,LA Clippers,38,25,25,29,0,0,0,0,20140415,105,117,12,17,8,12,12,222,12,2013,0,1,830,0
Atlanta,29,29,24,29,0,0,0,0,Milwaukee,39,24,20,20,0,0,0,0,20140416,111,103,-10,-5,-1,8,8,214,-8,2013,0,2,669,0
Phoenix,21,26,24,33,0,0,0,0,Sacramento,24,23,27,25,0,0,0,0,20140416,104,99,-3,0,-3,5,5,203,-5,2013,0,2,634,0
LA Clippers,29,23,33,19,0,0,0,0,Portland,37,31,14,28,0,0,0,0,20140416,104,110,8,16,-3,6,6,214,6,2013,0,2,826,0
Indiana,25,21,29,26,0,0,0,0,Orlando,20,20,22,24,0,0,0,0,20140416,101,86,5,6,13,15,15,187,-15,2013,0,2,822,0
Detroit,30,25,32,24,0,0,0,0,Oklahoma City,28,26,25,33,0,0,0,0,20140416,111,112,-2,-1,-8,1,1,223,1,2013,0,2,909,0
Toronto,28,29,17,18,0,0,0,0,New York,21,23,30,21,0,0,0,0,20140416,92,95,-7,-13,0,3,3,187,3,2013,0,2,341,0
Houston,30,20,28,22,0,0,0,0,New Orleans,28,25,27,25,0,0,0,0,20140416,100,105,-2,3,2,5,5,205,5,2013,0,2,317,0
Dallas,24,29,20,20,12,0,0,0,Memphis,29,22,24,18,13,0,0,0,20140416,105,106,5,-2,2,0,1,211,1,2013,1,2,419,0
Philadelphia,29,26,29,16,0,0,0,0,Miami,27,24,15,21,0,0,0,0,20140416,100,87,2,4,18,13,13,187,-13,2013,0,2,1021,0
LA Lakers,33,18,35,27,0,0,0,0,San Antonio,23,28,24,25,0,0,0,0,20140416,113,100,10,0,11,13,13,213,-13,2013,0,2,1201,0
Golden State,36,30,22,28,0,0,0,0,Denver,27,25,28,32,0,0,0,0,20140416,116,112,9,14,8,4,4,228,-4,2013,0,2,947,0
Brooklyn,21,28,15,21,0,0,0,0,Cleveland,33,18,30,33,0,0,0,0,20140416,85,114,12,2,17,29,29,199,29,2013,0,2,403,0
Chicago,21,18,21,20,6,0,0,0,Charlotte,16,27,16,21,11,0,0,0,20140416,86,91,-5,4,-1,0,5,177,5,2013,1,2,586,0
Washington,38,30,23,27,0,0,0,0,Boston,24,32,19,27,0,0,0,0,20140416,118,102,14,12,16,16,16,220,-16,2013,0,2,394,0
Utah,31,20,29,27,12,17,0,0,Minnesota,17,31,22,37,12,11,0,0,20140416,136,130,14,3,10,0,6,266,-6,2013,2,2,984,0
Memphis,16,18,31,21,0,0,0,0,Oklahoma City,29,27,13,31,0,0,0,0,20140419,86,100,13,22,4,14,14,186,14,2013,0,5,421,1
Brooklyn,29,21,17,27,0,0,0,0,Toronto,21,25,16,25,0,0,0,0,20140419,94,87,8,4,5,7,7,181,-7,2013,0,5,341,1
Atlanta,28,22,30,21,0,0,0,0,Indiana,22,28,16,27,0,0,0,0,20140419,101,93,6,0,14,8,8,194,-8,2013,0,5,427,1
Golden State,24,28,35,22,0,0,0,0,LA Clippers,29,23,27,26,0,0,0,0,20140419,109,105,-5,0,8,4,4,214,-4,2013,0,5,347,1
Charlotte,23,19,23,23,0,0,0,0,Miami,19,30,23,27,0,0,0,0,20140420,88,99,-4,7,7,11,11,187,11,2013,0,6,654,1
Dallas,12,32,21,20,0,0,0,0,San Antonio,21,22,22,25,0,0,0,0,20140420,85,90,9,-1,0,5,5,175,5,2013,0,6,252,1
Washington,24,24,24,30,0,0,0,0,Chicago,22,32,21,18,0,0,0,0,20140420,102,93,2,-6,-3,9,9,195,-9,2013,0,6,594,1
Portland,27,21,25,33,16,0,0,0,Houston,20,29,30,27,14,0,0,0,20140420,122,120,7,-1,-6,0,2,242,-2,2013,1,6,1833,1
Golden State,20,21,32,25,0,0,0,0,LA Clippers,31,36,38,33,0,0,0,0,20140421,98,138,11,26,32,40,40,236,40,2013,0,0,347,1
Memphis,24,22,22,31,12,0,0,0,Oklahoma City,16,27,22,34,6,0,0,0,20140421,111,105,8,3,3,0,6,216,-6,2013,1,0,421,1
Washington,31,25,14,21,10,0,0,0,Chicago,20,29,26,16,8,0,0,0,20140422,101,99,11,7,-5,0,2,200,-2,2013,1,1,594,1
Atlanta,26,26,13,20,0,0,0,0,Indiana,21,27,31,22,0,0,0,0,20140422,85,101,-5,-4,14,16,16,186,16,2013,0,1,427,1
Brooklyn,19,20,27,29,0,0,0,0,Toronto,21,24,19,36,0,0,0,0,20140422,95,100,2,6,-2,5,5,195,5,2013,0,1,341,1
Portland,23,30,30,29,0,0,0,0,Houston,31,22,24,28,0,0,0,0,20140423,112,105,-8,0,6,7,7,217,-7,2013,0,2,1833,1
Charlotte,19,28,25,25,0,0,0,0,Miami,29,28,22,22,0,0,0,0,20140423,97,101,10,10,7,4,4,198,4,2013,0,2,654,1
Dallas,24,32,32,25,0,0,0,0,San Antonio,23,28,24,17,0,0,0,0,20140423,113,92,1,5,13,21,21,205,-21,2013,0,2,252,1
Indiana,24,14,20,27,0,0,0,0,Atlanta,24,15,28,31,0,0,0,0,20140424,85,98,0,1,9,13,13,183,13,2013,0,3,427,1
LA Clippers,24,22,29,23,0,0,0,0,Golden State,21,22,21,32,0,0,0,0,20140424,98,96,3,3,11,2,2,194,-2,2013,0,3,347,1
Oklahoma City,18,18,25,24,10,0,0,0,Memphis,24,20,27,14,13,0,0,0,20140424,95,98,6,8,10,0,3,193,3,2013,1,3,421,1
Chicago,28,20,24,28,0,0,0,0,Washington,30,21,18,28,0,0,0,0,20140425,100,97,-2,-3,3,3,3,197,-3,2013,0,4,594,1
Houston,35,19,27,29,11,0,0,0,Portland,24,31,23,32,6,0,0,0,20140425,121,116,11,-1,3,0,5,237,-5,2013,1,4,1833,1
Toronto,23,22,21,32,0,0,0,0,Brooklyn,19,30,28,25,0,0,0,0,20140425,98,102,-4,4,11,4,4,200,4,2013,0,4,341,1
Indiana,29,13,24,25,0,0,0,0,Atlanta,22,26,17,23,0,0,0,0,20140426,91,88,7,-6,1,3,3,179,-3,2013,0,5,427,1
Miami,23,35,28,12,0,0,0,0,Charlotte,27,19,19,20,0,0,0,0,20140426,98,85,-4,12,21,13,13,183,-13,2013,0,5,654,1
San Antonio,34,20,20,34,0,0,0,0,Dallas,27,32,18,32,0,0,0,0,20140426,108,109,-7,5,3,1,1,217,1,2013,0,5,252,1
Oklahoma City,15,27,22,16,12,0,0,0,Memphis,18,17,17,28,9,0,0,0,20140426,92,89,-3,7,12,0,3,181,-3,2013,1,5,421,1
Toronto,35,16,16,20,0,0,0,0,Brooklyn,22,22,23,12,0,0,0,0,20140427,87,79,13,7,0,8,8,166,-8,2013,0,6,341,1
LA Clippers,24,24,23,26,0,0,0,0,Golden State,39,27,23,29,0,0,0,0,20140427,97,118,15,18,18,21,21,215,21,2013,0,6,347,1
Houston,29,32,23,22,14,0,0,0,Portland,23,28,28,27,17,0,0,0,20140427,120,123,-6,-10,-5,0,3,243,3,2013,1,6,1833,1
Chicago,18,22,22,27,0,0,0,0,Washington,28,27,27,16,0,0,0,0,20140427,89,98,10,15,20,9,9,187,9,2013,0,6,594,1
Atlanta,20,41,26,20,0,0,0,0,Indiana,21,19,27,30,0,0,0,0,20140428,107,97,-1,21,20,10,10,204,-10,2013,0,0,427,1
Miami,26,26,32,25,0,0,0,0,Charlotte,27,27,17,27,0,0,0,0,20140428,109,98,-1,-2,13,11,11,207,-11,2013,0,0,654,1
San Antonio,18,32,23,20,0,0,0,0,Dallas,23,13,29,24,0,0,0,0,20140428,93,89,-5,14,8,4,4,182,-4,2013,0,0,252,1
Memphis,30,25,21,14,10,0,0,0,Oklahoma City,25,18,27,20,9,0,0,0,20140429,100,99,5,12,6,0,1,199,-1,2013,1,1,421,1
Golden State,21,29,22,31,0,0,0,0,LA Clippers,31,24,22,36,0,0,0,0,20140429,103,113,10,5,5,10,10,216,10,2013,0,1,347,1
Washington,23,18,20,14,0,0,0,0,Chicago,15,26,11,17,0,0,0,0,20140429,75,69,8,0,9,6,6,144,-6,2013,0,1,594,1
Portland,27,21,29,21,0,0,0,0,Houston,30,26,26,26,0,0,0,0,20140430,98,108,3,8,5,10,10,206,10,2013,0,2,1833,1
Dallas,26,23,22,32,0,0,0,0,San Antonio,27,31,21,30,0,0,0,0,20140430,103,109,1,9,8,6,6,212,6,2013,0,2,252,1
Brooklyn,25,19,25,44,0,0,0,0,Toronto,28,34,29,24,0,0,0,0,20140430,113,115,3,18,22,2,2,228,2,2013,0,2,341,1
Indiana,20,24,20,31,0,0,0,0,Atlanta,22,17,28,21,0,0,0,0,20140501,95,88,-2,5,-3,7,7,183,-7,2013,0,3,427,1
LA Clippers,25,26,16,32,0,0,0,0,Golden State,25,23,22,30,0,0,0,0,20140501,99,100,0,-3,3,1,1,199,1,2013,0,3,347,1
Oklahoma City,25,31,26,22,0,0,0,0,Memphis,17,24,20,23,0,0,0,0,20140501,104,84,8,15,21,20,20,188,-20,2013,0,3,421,1
Toronto,19,22,18,24,0,0,0,0,Brooklyn,34,26,19,18,0,0,0,0,20140502,83,97,15,19,20,14,14,180,14,2013,0,4,341,1
San Antonio,26,26,29,30,0,0,0,0,Dallas,34,24,18,37,0,0,0,0,20140502,111,113,8,6,-5,2,2,224,2,2013,0,4,252,1
Houston,29,29,21,19,0,0,0,0,Portland,28,28,22,21,0,0,0,0,20140502,98,99,-1,-2,-1,1,1,197,1,2013,0,4,1833,1
Atlanta,23,13,27,17,0,0,0,0,Indiana,24,23,24,21,0,0,0,0,20140503,80,92,1,11,8,12,12,172,12,2013,0,5,427,1
Golden State,32,32,20,37,0,0,0,0,LA Clippers,22,34,31,39,0,0,0,0,20140503,121,126,-10,-8,3,5,5,247,5,2013,0,5,347,1
Memphis,36,22,23,28,0,0,0,0,Oklahoma City,27,34,33,26,0,0,0,0,20140503,109,120,-9,3,13,11,11,229,11,2013,0,5,421,1
Brooklyn,26,35,20,23,0,0,0,0,Toronto,28,25,20,30,0,0,0,0,20140504,104,103,-2,8,8,1,1,207,-1,2013,0,6,341,1
Dallas,23,23,22,28,0,0,0,0,San Antonio,35,33,26,25,0,0,0,0,20140504,96,119,12,22,26,23,23,215,23,2013,0,6,252,1
Washington,28,28,13,33,0,0,0,0,Indiana,15,28,19,34,0,0,0,0,20140505,102,96,13,13,7,6,6,198,-6,2013,0,0,490,1
LA Clippers,39,30,35,18,0,0,0,0,Oklahoma City,25,27,26,27,0,0,0,0,20140505,122,105,14,17,26,17,17,227,-17,2013,0,0,1178,1
Brooklyn,20,23,23,20,0,0,0,0,Miami,22,24,33,28,0,0,0,0,20140506,86,107,2,3,13,21,21,193,21,2013,0,1,1091,1
Portland,16,23,26,27,0,0,0,0,San Antonio,29,36,25,26,0,0,0,0,20140506,92,116,13,26,25,24,24,208,24,2013,0,1,1718,1
Washington,23,22,19,18,0,0,0,0,Indiana,23,20,25,18,0,0,0,0,20140507,82,86,0,-2,4,4,4,168,4,2013,0,2,490,1
LA Clippers,28,28,21,24,0,0,0,0,Oklahoma City,37,24,33,18,0,0,0,0,20140507,101,112,9,5,17,11,11,213,11,2013,0,2,1178,1
Brooklyn,21,25,21,15,0,0,0,0,Miami,15,30,24,25,0,0,0,0,20140508,82,94,-6,-1,2,12,12,176,12,2013,0,3,1091,1
Portland,26,25,20,26,0,0,0,0,San Antonio,29,41,17,27,0,0,0,0,20140508,97,114,3,19,16,17,17,211,17,2013,0,3,1718,1
Oklahoma City,29,32,25,32,0,0,0,0,LA Clippers,33,30,27,22,0,0,0,0,20140509,118,112,-4,-2,-4,6,6,230,-6,2013,0,4,1178,1
Indiana,17,17,26,25,0,0,0,0,Washington,17,16,12,18,0,0,0,0,20140509,85,63,0,1,15,22,22,148,-22,2013,0,4,490,1
Miami,30,19,14,27,0,0,0,0,Brooklyn,29,22,26,27,0,0,0,0,20140510,90,104,-1,2,14,14,14,194,14,2013,0,5,1091,1
San Antonio,28,32,23,35,0,0,0,0,Portland,18,22,29,34,0,0,0,0,20140510,118,103,10,20,14,15,15,221,-15,2013,0,5,1718,1
Oklahoma City,32,25,18,24,0,0,0,0,LA Clippers,15,31,17,38,0,0,0,0,20140511,99,101,-17,-11,-12,2,2,200,2,2013,0,6,1178,1
Indiana,27,11,33,24,0,0,0,0,Washington,26,29,17,20,0,0,0,0,20140511,95,92,1,-17,-1,3,3,187,-3,2013,0,6,490,1
San Antonio,24,24,20,24,0,0,0,0,Portland,29,21,35,18,0,0,0,0,20140512,92,103,5,2,17,11,11,195,11,2013,0,0,1718,1
Miami,27,29,23,23,0,0,0,0,Brooklyn,22,27,27,20,0,0,0,0,20140512,102,96,5,7,3,6,6,198,-6,2013,0,0,1091,1
Washington,25,20,31,26,0,0,0,0,Indiana,19,19,14,27,0,0,0,0,20140513,102,79,6,7,24,23,23,181,-23,2013,0,1,490,1
LA Clippers,34,24,28,18,0,0,0,0,Oklahoma City,25,27,28,25,0,0,0,0,20140513,104,105,-9,-6,-6,1,1,209,1,2013,0,1,1178,1
Brooklyn,22,27,26,19,0,0,0,0,Miami,23,19,24,30,0,0,0,0,20140514,94,96,1,-7,-9,2,2,190,2,2013,0,2,1091,1
Portland,19,25,19,19,0,0,0,0,San Antonio,19,32,26,27,0,0,0,0,20140514,82,104,0,7,14,22,22,186,22,2013,0,2,1718,1
Oklahoma City,16,26,30,32,0,0,0,0,LA Clippers,30,20,22,26,0,0,0,0,20140515,104,98,-14,-8,0,6,6,202,-6,2013,0,3,1178,1
Indiana,29,23,19,22,0,0,0,0,Washington,23,17,23,17,0,0,0,0,20140515,93,80,6,12,8,13,13,173,-13,2013,0,3,490,1
Miami,24,21,25,26,0,0,0,0,Indiana,30,25,28,24,0,0,0,0,20140518,96,107,6,10,13,11,11,203,11,2013,0,6,1026,1
Oklahoma City,27,32,23,23,0,0,0,0,San Antonio,30,37,22,33,0,0,0,0,20140519,105,122,3,8,7,17,17,227,17,2013,0,0,421,1
Miami,20,21,21,25,0,0,0,0,Indiana,21,16,26,20,0,0,0,0,20140520,87,83,-1,4,-1,4,4,170,-4,2013,0,1,1026,1
Oklahoma City,26,18,18,15,0,0,0,0,San Antonio,24,34,33,21,0,0,0,0,20140521,77,112,-2,14,29,35,35,189,35,2013,0,2,421,1
Indiana,21,21,22,23,0,0,0,0,Miami,14,24,33,28,0,0,0,0,20140524,87,99,-7,-4,7,12,12,186,12,2013,0,5,1026,1
San Antonio,29,24,23,21,0,0,0,0,Oklahoma City,28,29,26,23,0,0,0,0,20140525,97,106,-1,4,7,9,9,203,9,2013,0,6,421,1
Indiana,19,25,20,26,0,0,0,0,Miami,27,22,31,22,0,0,0,0,20140526,90,102,8,5,16,12,12,192,12,2013,0,0,1026,1
San Antonio,20,23,24,25,0,0,0,0,Oklahoma City,26,32,25,22,0,0,0,0,20140527,92,105,6,15,16,13,13,197,13,2013,0,1,421,1
Miami,16,26,15,33,0,0,0,0,Indiana,22,11,31,29,0,0,0,0,20140528,90,93,6,-9,7,3,3,183,3,2013,0,2,1026,1
Oklahoma City,32,23,19,15,0,0,0,0,San Antonio,32,33,29,23,0,0,0,0,20140529,89,117,0,10,20,28,28,206,28,2013,0,3,421,1
Indiana,13,21,24,34,0,0,0,0,Miami,24,36,31,26,0,0,0,0,20140530,92,117,11,26,33,25,25,209,25,2013,0,4,1026,1
San Antonio,20,22,37,22,11,0,0,0,Oklahoma City,23,26,20,32,6,0,0,0,20140531,112,107,-3,-7,10,0,5,219,-5,2013,1,5,421,1
Miami,20,29,29,17,0,0,0,0,San Antonio,26,28,20,36,0,0,0,0,20140605,95,110,6,5,-4,15,15,205,15,2013,0,3,1147,1
Miami,19,24,34,21,0,0,0,0,San Antonio,26,17,35,18,0,0,0,0,20140608,98,96,-7,0,-1,2,2,194,-2,2013,0,6,1147,1
San Antonio,41,30,15,25,0,0,0,0,Miami,25,25,25,17,0,0,0,0,20140610,111,92,16,21,11,19,19,203,-19,2013,0,1,1147,1
San Antonio,26,29,26,26,0,0,0,0,Miami,17,19,21,29,0,0,0,0,20140612,107,86,9,19,24,21,21,193,-21,2013,0,3,1147,1
Miami,29,11,18,29,0,0,0,0,San Antonio,22,25,30,27,0,0,0,0,20140615,87,104,-7,7,19,17,17,191,17,2013,0,6,1147,1
Houston,31,31,23,23,0,0,0,0,LA Lakers,19,26,24,21,0,0,0,0,20141028,108,90,12,17,16,18,18,198,-18,2014,0,1,1371,0
Orlando,25,16,23,20,0,0,0,0,New Orleans,24,24,30,23,0,0,0,0,20141028,84,101,-1,7,14,17,17,185,17,2014,0,1,533,0
Dallas,24,29,20,27,0,0,0,0,San Antonio,26,19,31,25,0,0,0,0,20141028,100,101,2,-8,3,1,1,201,1,2014,0,1,252,0
Houston,27,31,17,29,0,0,0,0,Utah,27,23,22,21,0,0,0,0,20141029,104,93,0,8,3,11,11,197,-11,2014,0,2,1199,0
Atlanta,22,30,19,31,0,0,0,0,Toronto,24,36,26,23,0,0,0,0,20141029,102,109,2,8,15,7,7,211,7,2014,0,2,733,0
Golden State,25,22,26,22,0,0,0,0,Sacramento,23,26,14,14,0,0,0,0,20141029,95,77,2,-2,10,18,18,172,-18,2014,0,2,75,0
Oklahoma City,34,20,23,12,0,0,0,0,Portland,29,20,26,31,0,0,0,0,20141029,89,106,-5,-5,-2,17,17,195,17,2014,0,2,1484,0
LA Lakers,19,31,23,26,0,0,0,0,Phoenix,33,26,39,21,0,0,0,0,20141029,99,119,14,9,25,20,20,218,20,2014,0,2,356,0
Chicago,24,29,31,20,0,0,0,0,New York,20,23,17,20,0,0,0,0,20141029,104,80,4,10,24,24,24,184,-24,2014,0,2,711,0
Brooklyn,23,18,31,33,0,0,0,0,Boston,32,35,34,20,0,0,0,0,20141029,105,121,9,26,29,16,16,226,16,2014,0,2,190,0
Minnesota,27,20,27,27,0,0,0,0,Memphis,25,28,28,24,0,0,0,0,20141029,101,105,-2,6,7,4,4,206,4,2014,0,2,700,0
Philadelphia,24,27,22,18,0,0,0,0,Indiana,26,22,30,25,0,0,0,0,20141029,91,103,2,-3,5,12,12,194,12,2014,0,2,582,0
Detroit,21,19,23,16,0,0,0,0,Denver,23,19,23,24,0,0,0,0,20141029,79,89,2,2,2,10,10,168,10,2014,0,2,1154,0
Milwaukee,24,33,26,17,6,0,0,0,Charlotte,25,21,22,32,8,0,0,0,20141029,106,108,1,-11,-15,0,2,214,2,2014,1,2,658,0
Washington,28,24,18,25,0,0,0,0,Miami,22,31,19,35,0,0,0,0,20141029,95,107,-6,1,2,12,12,202,12,2014,0,2,924,0
New York,18,24,25,28,0,0,0,0,Cleveland,25,19,20,26,0,0,0,0,20141030,95,90,-7,-2,3,5,5,185,-5,2014,0,3,403,0
Utah,20,24,29,29,0,0,0,0,Dallas,36,33,24,27,0,0,0,0,20141030,102,120,16,25,20,18,18,222,18,2014,0,3,998,0
Oklahoma City,28,13,21,28,0,0,0,0,LA Clippers,22,24,24,23,0,0,0,0,20141030,90,93,-6,5,8,3,3,183,3,2014,0,3,1178,0
Detroit,21,23,21,26,0,0,0,0,Minnesota,21,24,30,22,0,0,0,0,20141030,91,97,0,1,10,6,6,188,6,2014,0,3,542,0
Washington,28,26,28,23,0,0,0,0,Orlando,23,28,15,32,0,0,0,0,20141030,105,98,5,3,16,7,7,203,-7,2014,0,3,757,0
Portland,24,24,23,23,0,0,0,0,Sacramento,26,22,23,32,0,0,0,0,20141031,94,103,2,0,0,9,9,197,9,2014,0,4,483,0
San Antonio,24,21,26,18,0,0,0,0,Phoenix,11,25,31,27,0,0,0,0,20141031,89,94,-13,-9,-4,5,5,183,5,2014,0,4,846,0
Philadelphia,24,23,27,7,0,0,0,0,Milwaukee,24,22,27,20,0,0,0,0,20141031,81,93,0,-1,-1,12,12,174,12,2014,0,4,692,0
Cleveland,28,30,20,20,16,0,0,0,Chicago,27,25,17,29,10,0,0,0,20141031,114,108,1,6,9,0,6,222,-6,2014,1,4,308,0
Memphis,23,22,33,19,0,0,0,0,Indiana,19,34,14,22,0,0,0,0,20141031,97,89,4,-8,11,8,8,186,-8,2014,0,4,383,0
LA Clippers,31,31,24,32,0,0,0,0,LA Lakers,22,34,34,21,0,0,0,0,20141031,118,111,9,6,-4,7,7,229,-7,2014,0,4,0,0
Denver,17,16,23,35,0,0,0,0,Oklahoma City,29,26,21,26,0,0,0,0,20141101,91,102,12,22,20,11,11,193,11,2014,0,5,503,0
Milwaukee,17,27,24,29,0,0,0,0,Washington,29,20,34,25,0,0,0,0,20141101,97,108,12,5,15,11,11,205,11,2014,0,5,634,0
Phoenix,22,33,20,16,0,0,0,0,Utah,33,26,30,29,0,0,0,0,20141101,91,118,11,4,14,27,27,209,27,2014,0,5,505,0
Miami,32,28,27,27,0,0,0,0,Philadelphia,30,24,29,13,0,0,0,0,20141101,114,96,2,6,4,18,18,210,-18,2014,0,5,1021,0
Toronto,29,20,38,21,0,0,0,0,Orlando,26,26,26,17,0,0,0,0,20141101,108,95,3,-3,9,13,13,203,-13,2014,0,5,1048,0
Dallas,32,34,20,23,0,0,0,0,New Orleans,26,26,37,15,0,0,0,0,20141101,109,104,6,14,-3,5,5,213,-5,2014,0,5,442,0
Boston,22,16,24,28,0,0,0,0,Houston,37,20,24,23,0,0,0,0,20141101,90,104,15,19,19,14,14,194,14,2014,0,5,1603,0
Chicago,27,36,22,21,0,0,0,0,Minnesota,25,24,32,24,0,0,0,0,20141101,106,105,2,14,4,1,1,211,-1,2014,0,5,355,0
LA Lakers,35,20,31,18,0,0,0,0,Golden State,29,32,32,34,0,0,0,0,20141101,104,127,-6,6,7,23,23,231,23,2014,0,5,347,0
Brooklyn,33,26,22,21,0,0,0,0,Detroit,25,22,28,15,0,0,0,0,20141101,102,90,8,12,6,12,12,192,-12,2014,0,5,480,0
Memphis,23,13,15,20,0,0,0,0,Charlotte,15,15,16,23,0,0,0,0,20141101,71,69,8,6,5,2,2,140,-2,2014,0,5,519,0
Indiana,18,26,19,29,0,0,0,0,Atlanta,27,24,19,32,0,0,0,0,20141101,92,102,9,7,7,10,10,194,10,2014,0,5,427,0
Sacramento,25,20,25,28,0,0,0,0,LA Clippers,19,32,23,18,0,0,0,0,20141102,98,92,6,-6,-4,6,6,190,-6,2014,0,6,361,0
Toronto,26,28,23,25,0,0,0,0,Miami,31,33,23,20,0,0,0,0,20141102,102,107,5,10,10,5,5,209,5,2014,0,6,1234,0
Charlotte,21,29,30,13,0,0,0,0,New York,29,23,27,17,0,0,0,0,20141102,93,96,8,2,-1,3,3,189,3,2014,0,6,531,0
Golden State,30,21,17,27,0,0,0,0,Portland,22,26,20,22,0,0,0,0,20141102,95,90,8,3,0,5,5,185,-5,2014,0,6,535,0
New Orleans,13,20,23,25,0,0,0,0,Memphis,20,20,24,29,0,0,0,0,20141103,81,93,7,7,8,12,12,174,12,2014,0,0,358,0
Utah,20,23,27,31,0,0,0,0,LA Clippers,26,30,17,34,0,0,0,0,20141103,101,107,6,13,3,6,6,208,6,2014,0,0,579,0
Houston,32,23,24,25,0,0,0,0,Philadelphia,19,35,20,19,0,0,0,0,20141103,104,93,13,1,5,11,11,197,-11,2014,0,0,1339,0
Boston,19,22,38,34,0,0,0,0,Dallas,40,27,24,27,0,0,0,0,20141103,113,118,21,26,12,5,5,231,5,2014,0,0,1548,0
Oklahoma City,19,21,22,23,0,0,0,0,Brooklyn,32,27,26,31,0,0,0,0,20141103,85,116,13,19,23,31,31,201,31,2014,0,0,1324,0
Sacramento,19,32,28,31,0,0,0,0,Denver,22,24,31,28,0,0,0,0,20141103,110,105,-3,5,2,5,5,215,-5,2014,0,0,886,0
Orlando,28,24,17,21,0,0,0,0,Chicago,24,30,15,29,0,0,0,0,20141104,90,98,-4,2,0,8,8,188,8,2014,0,1,984,0
Milwaukee,22,21,26,18,0,0,0,0,Indiana,19,19,23,20,0,0,0,0,20141104,87,81,3,5,8,6,6,168,-6,2014,0,1,243,0
Phoenix,26,32,21,33,0,0,0,0,LA Lakers,24,22,29,31,0,0,0,0,20141104,112,106,2,12,4,6,6,218,-6,2014,0,1,356,0
Houston,30,27,26,25,0,0,0,0,Miami,31,24,22,14,0,0,0,0,20141104,108,91,-1,2,6,17,17,199,-17,2014,0,1,966,0
Charlotte,21,27,17,26,0,0,0,0,New Orleans,26,21,26,27,0,0,0,0,20141104,91,100,5,-1,8,9,9,191,9,2014,0,1,648,0
Washington,17,23,32,26,0,0,0,0,New York,23,22,15,23,0,0,0,0,20141104,98,83,-6,-5,12,15,15,181,-15,2014,0,1,204,0
Cleveland,34,16,19,13,0,0,0,0,Portland,31,24,21,25,0,0,0,0,20141104,82,101,-3,5,7,19,19,183,19,2014,0,1,2049,0
Oklahoma City,30,22,18,18,0,0,0,0,Toronto,23,28,22,27,0,0,0,0,20141104,88,100,-7,-1,3,12,12,188,12,2014,0,1,1114,0
Atlanta,15,24,23,30,0,0,0,0,San Antonio,27,22,19,26,0,0,0,0,20141105,92,94,12,10,6,2,2,186,2,2014,0,2,881,0
Miami,17,27,18,27,0,0,0,0,Charlotte,24,22,26,24,0,0,0,0,20141105,89,96,7,2,10,7,7,185,7,2014,0,2,654,0
Indiana,24,17,20,23,10,0,0,0,Washington,24,22,20,18,12,0,0,0,20141105,94,96,0,5,5,0,2,190,2,2014,1,2,490,0
Denver,19,35,18,37,0,0,0,0,Sacramento,40,28,37,26,0,0,0,0,20141105,109,131,21,14,33,22,22,240,22,2014,0,2,886,0
Cleveland,23,25,27,25,0,0,0,0,Utah,32,27,17,26,0,0,0,0,20141105,100,102,9,11,1,2,2,202,2,2014,0,2,1564,0
Memphis,26,20,30,26,0,0,0,0,Phoenix,27,25,19,20,0,0,0,0,20141105,102,91,-1,-6,5,11,11,193,-11,2014,0,2,1260,0
Minnesota,24,23,25,26,0,0,0,0,Brooklyn,21,27,18,25,0,0,0,0,20141105,98,91,3,-1,6,7,7,189,-7,2014,0,2,1016,0
Chicago,23,26,23,23,0,0,0,0,Milwaukee,21,32,17,16,0,0,0,0,20141105,95,86,2,-4,2,9,9,181,-9,2014,0,2,83,0
LA Clippers,20,22,33,29,0,0,0,0,Golden State,30,35,37,19,0,0,0,0,20141105,104,121,10,23,27,17,17,225,17,2014,0,2,347,0
New York,20,17,22,36,0,0,0,0,Detroit,25,24,26,23,0,0,0,0,20141105,95,98,5,12,16,3,3,193,3,2014,0,2,480,0
Toronto,23,31,34,22,0,0,0,0,Boston,35,22,29,21,0,0,0,0,20141105,110,107,-12,-3,2,3,3,217,-3,2014,0,2,430,0
Orlando,26,26,23,16,0,0,0,0,Philadelphia,28,24,23,14,0,0,0,0,20141105,91,89,-2,0,0,2,2,180,-2,2014,0,2,864,0
San Antonio,15,14,26,26,0,0,0,0,Houston,18,27,36,17,0,0,0,0,20141106,81,98,3,16,26,17,17,179,17,2014,0,3,189,0
Dallas,24,26,18,19,0,0,0,0,Portland,20,26,35,27,0,0,0,0,20141106,87,108,-4,-4,13,21,21,195,21,2014,0,3,1630,0
Washington,18,17,23,26,0,0,0,0,Toronto,28,31,23,21,0,0,0,0,20141107,84,103,10,24,24,19,19,187,19,2014,0,4,349,0
Sacramento,25,30,22,22,7,8,0,0,Phoenix,36,22,30,11,7,6,0,0,20141107,114,112,-11,-3,-11,0,2,226,-2,2014,2,4,634,0
Chicago,33,24,35,26,0,0,0,0,Philadelphia,28,29,19,39,0,0,0,0,20141107,118,115,5,0,16,3,3,233,-3,2014,0,4,664,0
Minnesota,27,25,25,17,9,0,0,0,Orlando,26,21,27,20,18,0,0,0,20141107,103,112,-1,-5,-3,0,9,215,9,2014,1,4,1309,0
Memphis,22,27,17,25,0,0,0,0,Oklahoma City,19,21,22,27,0,0,0,0,20141107,91,89,3,9,4,2,2,180,-2,2014,0,4,421,0
Atlanta,29,21,28,19,13,9,0,0,Charlotte,22,25,23,27,13,12,0,0,20141107,119,122,-7,-3,-8,0,3,241,3,2014,2,4,226,0
Cleveland,38,20,27,25,0,0,0,0,Denver,20,25,26,30,0,0,0,0,20141107,110,101,18,13,14,9,9,211,-9,2014,0,4,1223,0
New York,20,22,26,31,0,0,0,0,Brooklyn,30,25,31,24,0,0,0,0,20141107,99,110,10,13,18,11,11,209,11,2014,0,4,0,0
Indiana,26,26,23,23,0,0,0,0,Boston,30,25,18,28,0,0,0,0,20141107,98,101,4,3,-2,3,3,199,3,2014,0,4,805,0
Dallas,24,28,26,27,0,0,0,0,Utah,17,27,18,20,0,0,0,0,20141107,105,82,7,8,16,23,23,187,-23,2014,0,4,998,0
Milwaukee,21,23,28,23,0,0,0,0,Detroit,27,24,25,22,0,0,0,0,20141107,95,98,6,7,4,3,3,193,3,2014,0,4,251,0
Memphis,23,28,21,20,0,0,0,0,Milwaukee,21,23,22,27,0,0,0,0,20141108,92,93,-2,-7,-6,1,1,185,1,2014,0,5,557,0
Minnesota,13,28,28,23,0,0,0,0,Miami,29,24,27,22,0,0,0,0,20141108,92,102,16,12,11,10,10,194,10,2014,0,5,1513,0
New Orleans,30,25,26,19,0,0,0,0,San Antonio,23,30,18,28,0,0,0,0,20141108,100,99,7,2,10,1,1,199,-1,2014,0,5,506,0
Washington,32,22,19,24,0,0,0,0,Indiana,14,21,30,25,0,0,0,0,20141108,97,90,18,19,8,7,7,187,-7,2014,0,5,490,0
Golden State,25,23,28,22,0,0,0,0,Houston,29,27,13,18,0,0,0,0,20141108,98,87,-4,-8,7,11,11,185,-11,2014,0,5,1642,0
Boston,20,36,27,23,0,0,0,0,Chicago,25,16,26,34,0,0,0,0,20141108,106,101,-5,15,16,5,5,207,-5,2014,0,5,849,0
New York,32,29,13,22,0,0,0,0,Atlanta,20,28,27,28,0,0,0,0,20141108,96,103,-12,-13,1,7,7,199,7,2014,0,5,745,0
Portland,38,24,17,23,0,0,0,0,LA Clippers,33,20,26,27,0,0,0,0,20141108,102,106,-5,-9,0,4,4,208,4,2014,0,5,826,0
Orlando,23,29,25,19,0,0,0,0,Brooklyn,24,26,31,23,0,0,0,0,20141109,96,104,1,-2,4,8,8,200,8,2014,0,6,939,0
Miami,29,26,28,22,0,0,0,0,Dallas,20,24,23,29,0,0,0,0,20141109,105,96,9,11,16,9,9,201,-9,2014,0,6,1110,0
Utah,27,25,22,23,0,0,0,0,Detroit,21,31,27,17,0,0,0,0,20141109,97,96,6,0,-5,1,1,193,-1,2014,0,6,1488,0
Charlotte,25,26,13,28,0,0,0,0,LA Lakers,18,24,34,31,0,0,0,0,20141109,92,107,-7,-9,12,15,15,199,15,2014,0,6,2115,0
Sacramento,17,22,26,28,0,0,0,0,Oklahoma City,24,28,15,34,0,0,0,0,20141109,93,101,7,13,2,8,8,194,8,2014,0,6,1336,0
Golden State,30,28,21,16,0,0,0,0,Phoenix,28,19,24,36,0,0,0,0,20141109,95,107,-2,-11,-8,12,12,202,12,2014,0,6,652,0
Denver,27,29,17,27,0,0,0,0,Portland,36,28,21,31,0,0,0,0,20141109,100,116,9,8,12,16,16,216,16,2014,0,6,981,0
Philadelphia,20,25,18,25,0,0,0,0,Toronto,33,27,28,32,0,0,0,0,20141109,88,120,13,15,25,32,32,208,32,2014,0,6,334,0
Utah,20,21,28,17,0,0,0,0,Indiana,17,30,25,25,0,0,0,0,20141110,86,97,-3,6,3,11,11,183,11,2014,0,0,1353,0
Atlanta,17,21,26,27,0,0,0,0,New York,16,22,21,26,0,0,0,0,20141110,91,85,1,0,5,6,6,176,-6,2014,0,0,745,0
San Antonio,14,25,25,25,0,0,0,0,LA Clippers,20,22,28,15,0,0,0,0,20141110,89,85,-6,-3,-6,4,4,174,-4,2014,0,0,1201,0
Detroit,21,23,26,21,0,0,0,0,Chicago,27,33,18,24,0,0,0,0,20141110,91,102,6,16,8,11,11,193,11,2014,0,0,238,0
New Orleans,28,28,23,32,0,0,0,0,Cleveland,24,27,34,33,0,0,0,0,20141110,111,118,-4,-5,6,7,7,229,7,2014,0,0,924,0
Orlando,32,28,23,17,0,0,0,0,Toronto,24,27,21,32,0,0,0,0,20141111,100,104,-8,-9,-11,4,4,204,4,2014,0,1,1048,0
Sacramento,32,25,15,26,0,0,0,0,Dallas,14,34,30,28,0,0,0,0,20141111,98,106,-18,-9,6,8,8,204,8,2014,0,1,1437,0
San Antonio,29,21,32,31,0,0,0,0,Golden State,26,18,26,30,0,0,0,0,20141111,113,100,3,6,12,13,13,213,-13,2014,0,1,1487,0
LA Lakers,21,31,23,27,0,0,0,0,Memphis,25,31,27,24,0,0,0,0,20141111,102,107,4,4,8,5,5,209,5,2014,0,1,1599,0
Oklahoma City,22,16,26,14,0,0,0,0,Milwaukee,15,26,28,16,0,0,0,0,20141111,78,85,-7,3,5,7,7,163,7,2014,0,1,732,0
Charlotte,35,29,21,15,0,0,0,0,Portland,21,30,24,27,0,0,0,0,20141111,100,102,-14,-13,-10,2,2,202,2,2014,0,1,2284,0
Brooklyn,29,34,21,20,0,0,0,0,Phoenix,17,32,29,34,0,0,0,0,20141112,104,112,-12,-14,-6,8,8,216,8,2014,0,2,2139,0
Portland,39,45,27,19,0,0,0,0,Denver,28,22,28,35,0,0,0,0,20141112,130,113,11,34,33,17,17,243,-17,2014,0,2,981,0
Orlando,31,25,18,23,0,0,0,0,New York,27,23,26,19,0,0,0,0,20141112,97,95,4,6,-2,2,2,192,-2,2014,0,2,939,0
Detroit,34,25,26,18,0,0,0,0,Washington,24,33,25,25,0,0,0,0,20141112,103,107,-10,-2,-3,4,4,210,4,2014,0,2,394,0
LA Lakers,25,23,24,30,0,0,0,0,New Orleans,23,28,34,24,0,0,0,0,20141112,102,109,-2,3,13,7,7,211,7,2014,0,2,1669,0
Utah,32,22,34,9,0,0,0,0,Atlanta,32,25,25,18,0,0,0,0,20141112,97,100,0,3,-6,3,3,197,3,2014,0,2,1580,0
Indiana,24,17,22,18,0,0,0,0,Miami,26,16,16,17,0,0,0,0,20141112,81,75,-2,-1,5,6,6,156,-6,2014,0,2,1026,0
Oklahoma City,15,27,34,33,0,0,0,0,Boston,24,27,21,22,0,0,0,0,20141112,109,94,-9,-9,4,15,15,203,-15,2014,0,2,1492,0
Houston,28,25,31,29,0,0,0,0,Minnesota,26,23,21,31,0,0,0,0,20141112,113,101,2,4,14,12,12,214,-12,2014,0,2,1057,0
Philadelphia,10,19,24,17,0,0,0,0,Dallas,38,35,22,28,0,0,0,0,20141113,70,123,28,44,42,53,53,193,53,2014,0,3,1297,0
Brooklyn,36,19,20,24,0,0,0,0,Golden State,32,34,21,20,0,0,0,0,20141113,99,107,-4,11,12,8,8,206,8,2014,0,3,2565,0
Sacramento,38,24,29,19,0,0,0,0,Memphis,16,30,30,35,0,0,0,0,20141113,110,111,-22,-16,-15,1,1,221,1,2014,0,3,1745,0
Chicago,25,20,35,20,0,0,0,0,Toronto,24,28,14,27,0,0,0,0,20141113,100,93,1,-7,14,7,7,193,-7,2014,0,3,436,0
Milwaukee,30,19,19,17,0,0,0,0,Orlando,25,27,28,21,0,0,0,0,20141114,85,101,-5,3,12,16,16,186,16,2014,0,4,1065,0
Detroit,21,21,25,15,14,0,0,0,Oklahoma City,30,18,18,16,7,0,0,0,20141114,96,89,-9,-6,1,0,7,185,-7,2014,1,4,909,0
Utah,31,17,27,27,0,0,0,0,New York,23,24,25,28,0,0,0,0,20141114,102,100,8,1,3,2,2,202,-2,2014,0,4,1967,0
Minnesota,19,25,28,19,0,0,0,0,New Orleans,43,37,38,21,0,0,0,0,20141114,91,139,24,36,46,48,48,230,48,2014,0,4,1052,0
Cleveland,25,34,25,38,0,0,0,0,Boston,31,28,42,20,0,0,0,0,20141114,122,121,-6,0,-17,1,1,243,-1,2014,0,4,549,0
Denver,30,34,28,16,0,0,0,0,Indiana,27,19,21,20,0,0,0,0,20141114,108,87,3,18,25,21,21,195,-21,2014,0,4,998,0
Philadelphia,28,19,21,19,0,0,0,0,Houston,19,28,16,25,0,0,0,0,20141114,87,88,-9,0,-5,1,1,175,1,2014,0,4,1339,0
Miami,23,29,27,24,0,0,0,0,Atlanta,35,27,24,28,0,0,0,0,20141114,103,114,12,10,7,11,11,217,11,2014,0,4,605,0
Charlotte,14,33,27,29,0,0,0,0,Phoenix,28,19,28,20,0,0,0,0,20141114,103,95,-14,0,-1,8,8,198,-8,2014,0,4,1778,0
San Antonio,29,18,21,25,0,0,0,0,LA Lakers,22,13,22,23,0,0,0,0,20141114,93,80,7,12,11,13,13,173,-13,2014,0,4,1201,0
Utah,25,24,23,21,0,0,0,0,Toronto,23,23,30,35,0,0,0,0,20141115,93,111,-2,-3,4,18,18,204,18,2014,0,5,1664,0
San Antonio,24,14,28,25,0,0,0,0,Sacramento,23,22,25,24,0,0,0,0,20141115,91,94,-1,7,4,3,3,185,3,2014,0,5,1456,0
Brooklyn,15,24,27,21,0,0,0,0,Portland,24,26,30,17,0,0,0,0,20141115,87,97,9,11,14,10,10,184,10,2014,0,5,2439,0
Orlando,17,21,24,31,0,0,0,0,Washington,24,24,21,29,0,0,0,0,20141115,93,98,7,10,7,5,5,191,5,2014,0,5,757,0
Detroit,16,34,14,24,0,0,0,0,Memphis,25,26,18,26,0,0,0,0,20141115,88,95,9,1,5,7,7,183,7,2014,0,5,622,0
Phoenix,23,31,20,33,0,0,0,0,LA Clippers,27,27,42,24,0,0,0,0,20141115,107,120,4,0,22,13,13,227,13,2014,0,5,356,0
Charlotte,23,23,22,19,0,0,0,0,Golden State,28,39,29,16,0,0,0,0,20141115,87,112,5,21,28,25,25,199,25,2014,0,5,2296,0
Minnesota,22,22,38,35,0,0,0,0,Dallas,28,35,38,30,0,0,0,0,20141115,117,131,6,19,19,14,14,248,14,2014,0,5,863,0
Atlanta,25,18,26,25,0,0,0,0,Cleveland,41,30,30,26,0,0,0,0,20141115,94,127,16,28,32,33,33,221,33,2014,0,5,555,0
Indiana,23,23,23,30,0,0,0,0,Chicago,20,22,23,25,0,0,0,0,20141115,99,90,3,4,4,9,9,189,-9,2014,0,5,163,0
Golden State,34,40,41,21,0,0,0,0,LA Lakers,23,32,24,36,0,0,0,0,20141116,136,115,11,19,36,21,21,251,-21,2014,0,6,347,0
Milwaukee,19,19,26,27,0,0,0,0,Miami,23,23,13,25,0,0,0,0,20141116,91,84,-4,-8,5,7,7,175,-7,2014,0,6,1269,0
Denver,31,8,35,19,0,0,0,0,New York,31,31,24,23,0,0,0,0,20141116,93,109,0,23,12,16,16,202,16,2014,0,6,1627,0
Houston,24,18,9,18,0,0,0,0,Oklahoma City,19,14,18,14,0,0,0,0,20141116,69,65,5,9,0,4,4,134,-4,2014,0,6,413,0
Philadelphia,13,21,23,18,0,0,0,0,San Antonio,30,16,27,27,0,0,0,0,20141117,75,100,17,12,16,25,25,175,25,2014,0,0,1505,0
New Orleans,21,28,31,13,0,0,0,0,Portland,22,20,26,34,0,0,0,0,20141117,93,102,1,-7,-12,9,9,195,9,2014,0,0,2059,0
Houston,18,24,24,27,0,0,0,0,Memphis,34,31,32,22,0,0,0,0,20141117,93,119,16,23,31,26,26,212,26,2014,0,0,484,0
Chicago,21,27,31,26,0,0,0,0,LA Clippers,18,32,14,25,0,0,0,0,20141117,105,89,3,-2,15,16,16,194,-16,2014,0,0,1741,0
Orlando,28,21,29,29,0,0,0,0,Detroit,28,24,24,17,0,0,0,0,20141117,107,93,0,-3,2,14,14,200,-14,2014,0,0,957,0
Denver,24,29,28,25,0,0,0,0,Cleveland,26,26,23,22,0,0,0,0,20141117,106,97,-2,1,6,9,9,203,-9,2014,0,0,1223,0
Dallas,32,35,21,19,0,0,0,0,Charlotte,24,19,18,19,0,0,0,0,20141117,107,80,8,24,27,27,27,187,-27,2014,0,0,928,0
Miami,19,19,32,25,0,0,0,0,Brooklyn,21,22,21,19,0,0,0,0,20141117,95,83,-2,-5,6,12,12,178,-12,2014,0,0,1091,0
Phoenix,33,27,29,29,0,0,0,0,Boston,31,23,34,26,0,0,0,0,20141117,118,114,2,6,1,4,4,232,-4,2014,0,0,2295,0
LA Lakers,31,36,24,23,0,0,0,0,Atlanta,20,32,31,26,0,0,0,0,20141118,114,109,11,15,8,5,5,223,-5,2014,0,1,1932,0
New York,30,19,31,33,0,0,0,0,Milwaukee,30,36,29,22,0,0,0,0,20141118,113,117,0,17,15,4,4,230,4,2014,0,1,732,0
New Orleans,20,25,31,30,0,0,0,0,Sacramento,27,27,15,31,0,0,0,0,20141118,106,100,-7,-9,7,6,6,206,-6,2014,0,1,1879,0
Oklahoma City,23,19,17,22,0,0,0,0,Utah,14,26,32,26,0,0,0,0,20141118,81,98,-9,-2,13,17,17,179,17,2014,0,1,861,0
Dallas,23,31,22,29,0,0,0,0,Washington,29,24,20,29,0,0,0,0,20141119,105,102,-6,1,3,3,3,207,-3,2014,0,2,1181,0
Memphis,20,28,27,17,0,0,0,0,Toronto,22,20,27,27,0,0,0,0,20141119,92,96,2,-6,-6,4,4,188,4,2014,0,2,815,0
Boston,22,24,27,28,0,0,0,0,Philadelphia,27,19,22,22,0,0,0,0,20141119,101,90,-5,0,5,11,11,191,-11,2014,0,2,270,0
LA Clippers,26,30,28,30,0,0,0,0,Orlando,23,25,20,22,0,0,0,0,20141119,114,90,3,8,16,24,24,204,-24,2014,0,2,2197,0
New York,25,26,22,26,0,0,0,0,Minnesota,27,37,29,22,0,0,0,0,20141119,99,115,2,13,20,16,16,214,16,2014,0,2,1016,0
Phoenix,21,23,21,23,0,0,0,0,Detroit,19,24,21,22,0,0,0,0,20141119,88,86,2,1,1,2,2,174,-2,2014,0,2,1687,0
LA Lakers,21,28,21,28,0,0,0,0,Houston,23,28,24,17,0,0,0,0,20141119,98,92,-2,-2,-5,6,6,190,-6,2014,0,2,1371,0
Oklahoma City,26,23,25,26,0,0,0,0,Denver,27,27,34,19,0,0,0,0,20141119,100,107,1,5,14,7,7,207,7,2014,0,2,503,0
San Antonio,23,21,28,20,0,0,0,0,Cleveland,20,27,22,21,0,0,0,0,20141119,92,90,3,-3,3,2,2,182,-2,2014,0,2,1256,0
Milwaukee,22,19,28,26,10,7,10,0,Brooklyn,24,25,23,23,10,7,6,0,20141119,122,118,-2,-8,-3,0,4,240,-4,2014,3,2,732,0
Charlotte,28,21,17,20,0,0,0,0,Indiana,20,23,22,23,0,0,0,0,20141119,86,88,-8,-6,-1,2,2,174,2,2014,0,2,428,0
LA Clippers,39,19,30,22,0,0,0,0,Miami,15,25,26,27,0,0,0,0,20141120,110,93,24,18,22,17,17,203,-17,2014,0,3,2335,0
Chicago,29,18,21,20,0,0,0,0,Sacramento,22,30,28,23,0,0,0,0,20141120,88,103,-7,5,12,15,15,191,15,2014,0,3,1788,0
Cleveland,21,21,23,13,0,0,0,0,Washington,26,29,25,11,0,0,0,0,20141121,78,91,5,13,15,13,13,169,13,2014,0,4,304,0
Milwaukee,27,18,12,25,0,0,0,0,Toronto,37,34,30,23,0,0,0,0,20141121,82,124,10,26,44,42,42,206,42,2014,0,4,429,0
Chicago,21,22,22,22,0,0,0,0,Portland,32,29,28,16,0,0,0,0,20141121,87,105,11,18,24,18,18,192,18,2014,0,4,1754,0
Phoenix,26,41,25,30,0,0,0,0,Philadelphia,27,17,23,29,0,0,0,0,20141121,122,96,-1,23,25,26,26,218,-26,2014,0,4,2078,0
Brooklyn,21,28,22,23,0,0,0,0,Oklahoma City,27,26,21,18,0,0,0,0,20141121,94,92,-6,-4,-3,2,2,186,-2,2014,0,4,1324,0
San Antonio,29,30,32,30,0,0,0,0,Minnesota,26,22,14,30,0,0,0,0,20141121,121,92,3,11,29,29,29,213,-29,2014,0,4,1112,0
New Orleans,26,23,24,24,0,0,0,0,Denver,31,28,27,31,0,0,0,0,20141121,97,117,5,10,13,20,20,214,20,2014,0,4,1079,0
Utah,13,19,25,31,0,0,0,0,Golden State,28,26,31,16,0,0,0,0,20141121,88,101,15,22,28,13,13,189,13,2014,0,4,599,0
LA Lakers,27,32,24,23,0,0,0,0,Dallas,38,30,42,30,0,0,0,0,20141121,106,140,11,9,27,34,34,246,34,2014,0,4,1237,0
Orlando,26,14,24,41,0,0,0,0,Charlotte,27,24,28,21,0,0,0,0,20141121,105,100,-1,-11,-15,5,5,205,-5,2014,0,4,463,0
Detroit,25,15,24,25,0,0,0,0,Atlanta,29,21,24,25,0,0,0,0,20141121,89,99,4,10,10,10,10,188,10,2014,0,4,597,0
Boston,16,25,29,30,0,0,0,0,Memphis,25,30,27,35,0,0,0,0,20141121,100,117,9,14,12,17,17,217,17,2014,0,4,1134,0
Philadelphia,13,26,15,29,0,0,0,0,New York,25,21,25,20,0,0,0,0,20141122,83,91,12,7,17,8,8,174,8,2014,0,5,80,0
Miami,22,27,19,31,0,0,0,0,Orlando,18,28,21,25,0,0,0,0,20141122,99,92,4,3,1,7,7,191,-7,2014,0,5,204,0
Sacramento,21,27,36,29,0,0,0,0,Minnesota,24,28,25,24,0,0,0,0,20141122,113,101,-3,-4,7,12,12,214,-12,2014,0,5,1511,0
Brooklyn,18,18,28,23,0,0,0,0,San Antonio,25,26,28,20,0,0,0,0,20141122,87,99,7,15,15,12,12,186,12,2014,0,5,1581,0
Phoenix,30,25,25,26,0,0,0,0,Indiana,27,21,16,19,0,0,0,0,20141122,106,83,3,7,16,23,23,189,-23,2014,0,5,1496,0
Dallas,29,22,17,24,0,0,0,0,Houston,29,31,17,18,0,0,0,0,20141122,92,95,0,9,9,3,3,187,3,2014,0,5,225,0
Toronto,21,35,29,25,0,0,0,0,Cleveland,34,20,17,22,0,0,0,0,20141122,110,93,-13,2,14,17,17,203,-17,2014,0,5,187,0
Washington,21,26,27,37,0,0,0,0,Milwaukee,28,24,18,30,0,0,0,0,20141122,111,100,-7,-5,4,11,11,211,-11,2014,0,5,634,0
New Orleans,25,32,20,29,0,0,0,0,Utah,23,17,32,22,0,0,0,0,20141122,106,94,2,17,5,12,12,200,-12,2014,0,5,1432,0
Golden State,28,24,18,21,0,0,0,0,Oklahoma City,20,27,19,20,0,0,0,0,20141123,91,86,8,5,4,5,5,177,-5,2014,0,6,1386,0
Charlotte,22,22,28,21,0,0,0,0,Miami,23,30,14,27,0,0,0,0,20141123,93,94,1,9,-5,1,1,187,1,2014,0,6,654,0
Denver,21,20,31,14,15,0,0,0,LA Lakers,19,20,36,11,8,0,0,0,20141123,101,94,2,2,-3,0,7,195,-7,2014,1,6,830,0
LA Clippers,21,19,32,19,0,0,0,0,Memphis,26,27,35,19,0,0,0,0,20141123,91,107,5,13,16,16,16,198,16,2014,0,6,1599,0
Portland,21,23,28,22,0,0,0,0,Boston,23,26,23,16,0,0,0,0,20141123,94,88,-2,-5,0,6,6,182,-6,2014,0,6,2532,0
LA Clippers,31,25,22,35,0,0,0,0,Charlotte,23,30,17,22,0,0,0,0,20141124,113,92,8,3,8,21,21,205,-21,2014,0,0,2115,0
Orlando,16,22,20,16,0,0,0,0,Cleveland,26,30,25,25,0,0,0,0,20141124,74,106,10,18,23,32,32,180,32,2014,0,0,895,0
Indiana,25,30,30,26,0,0,0,0,Dallas,24,26,28,22,0,0,0,0,20141124,111,100,1,5,7,11,11,211,-11,2014,0,0,763,0
New York,26,20,23,17,0,0,0,0,Houston,27,24,18,22,0,0,0,0,20141124,86,91,1,5,0,5,5,177,5,2014,0,0,1417,0
Portland,24,26,39,25,0,0,0,0,Philadelphia,20,32,28,24,0,0,0,0,20141124,114,104,4,-2,9,10,10,218,-10,2014,0,0,2405,0
Phoenix,26,22,18,34,0,0,0,0,Toronto,29,25,27,23,0,0,0,0,20141124,100,104,3,6,15,4,4,204,4,2014,0,0,1885,0
Chicago,30,26,22,19,0,0,0,0,Utah,14,27,36,18,0,0,0,0,20141124,97,95,16,15,1,2,2,192,-2,2014,0,0,1256,0
Atlanta,22,19,27,38,0,0,0,0,Washington,19,20,28,35,0,0,0,0,20141125,106,102,3,2,1,4,4,208,-4,2014,0,1,541,0
Sacramento,27,22,26,24,0,0,0,0,New Orleans,16,33,21,19,0,0,0,0,20141125,99,89,11,0,5,10,10,188,-10,2014,0,1,1879,0
Chicago,21,28,27,33,0,0,0,0,Denver,31,25,30,28,0,0,0,0,20141125,109,114,10,7,10,5,5,223,5,2014,0,1,916,0
Golden State,30,31,30,23,0,0,0,0,Miami,36,26,24,11,0,0,0,0,20141125,114,97,-6,-1,5,17,17,211,-17,2014,0,1,2590,0
Detroit,31,17,19,19,0,0,0,0,Milwaukee,26,23,30,19,0,0,0,0,20141125,86,98,-5,1,12,12,12,184,12,2014,0,1,251,0
Utah,29,19,14,20,0,0,0,0,Oklahoma City,31,25,18,23,0,0,0,0,20141126,82,97,2,8,12,15,15,179,15,2014,0,2,861,0
Indiana,27,28,21,24,0,0,0,0,San Antonio,25,25,27,29,0,0,0,0,20141126,100,106,-2,-5,1,6,6,206,6,2014,0,2,999,0
Denver,30,34,22,26,0,0,0,0,Phoenix,34,30,29,27,0,0,0,0,20141126,112,120,4,0,7,8,8,232,8,2014,0,2,585,0
Brooklyn,32,17,23,27,0,0,0,0,Philadelphia,19,22,26,24,0,0,0,0,20141126,99,91,13,8,5,8,8,190,-8,2014,0,2,80,0
Golden State,31,34,27,19,0,0,0,0,Orlando,27,25,13,31,0,0,0,0,20141126,111,96,4,13,27,15,15,207,-15,2014,0,2,2437,0
Milwaukee,26,25,21,31,0,0,0,0,Minnesota,24,23,23,16,0,0,0,0,20141126,103,86,2,4,2,17,17,189,-17,2014,0,2,298,0
Washington,18,28,21,20,0,0,0,0,Cleveland,31,27,23,32,0,0,0,0,20141126,87,113,13,12,14,26,26,200,26,2014,0,2,304,0
Sacramento,19,31,23,16,0,0,0,0,Houston,37,20,20,25,0,0,0,0,20141126,89,102,18,7,4,13,13,191,13,2014,0,2,1606,0
LA Clippers,25,23,24,32,0,0,0,0,Detroit,27,24,22,25,0,0,0,0,20141126,104,98,-2,-3,-1,6,6,202,-6,2014,0,2,1979,0
New York,24,18,31,22,7,0,0,0,Dallas,19,27,25,24,14,0,0,0,20141126,102,109,-5,4,-2,0,7,211,7,2014,1,2,1370,0
Portland,28,17,34,26,0,0,0,0,Charlotte,26,30,20,21,0,0,0,0,20141126,105,97,2,-11,3,8,8,202,-8,2014,0,2,2284,0
Toronto,34,30,27,35,0,0,0,0,Atlanta,24,37,27,27,0,0,0,0,20141126,126,115,10,3,3,11,11,241,-11,2014,0,2,733,0
Memphis,21,25,34,19,0,0,0,0,LA Lakers,26,25,23,19,0,0,0,0,20141126,99,93,-5,-5,6,6,6,192,-6,2014,0,2,1599,0
Minnesota,23,31,39,27,0,0,0,0,LA Lakers,30,28,38,23,0,0,0,0,20141128,120,119,-7,-4,-3,1,1,239,-1,2014,0,4,1521,0
Dallas,26,22,23,35,0,0,0,0,Toronto,21,22,21,38,0,0,0,0,20141128,106,102,5,5,7,4,4,208,-4,2014,0,4,1201,0
Sacramento,22,29,29,24,0,0,0,0,San Antonio,26,35,27,24,0,0,0,0,20141128,104,112,4,10,8,8,8,216,8,2014,0,4,1456,0
Memphis,23,29,31,29,0,0,0,0,Portland,25,18,27,29,0,0,0,0,20141128,112,99,-2,9,13,13,13,211,-13,2014,0,4,1845,0
New York,13,20,17,28,0,0,0,0,Oklahoma City,30,29,23,23,0,0,0,0,20141128,78,105,17,26,32,27,27,183,27,2014,0,4,1324,0
Orlando,20,25,14,24,0,0,0,0,Indiana,26,21,25,26,0,0,0,0,20141128,83,98,6,2,13,15,15,181,15,2014,0,4,822,0
New Orleans,15,13,23,40,0,0,0,0,Atlanta,19,22,21,38,0,0,0,0,20141128,91,100,4,13,11,9,9,191,9,2014,0,4,424,0
Milwaukee,25,28,21,30,0,0,0,0,Detroit,29,16,24,19,0,0,0,0,20141128,104,88,-4,8,5,16,16,192,-16,2014,0,4,251,0
Phoenix,22,25,23,27,0,0,0,0,Denver,33,33,33,23,0,0,0,0,20141128,97,122,11,19,29,25,25,219,25,2014,0,4,585,0
Golden State,28,21,25,32,0,0,0,0,Charlotte,24,31,25,21,0,0,0,0,20141128,106,101,4,-6,-6,5,5,207,-5,2014,0,4,2296,0
Chicago,24,30,31,24,0,0,0,0,Boston,35,25,31,11,0,0,0,0,20141128,109,102,-11,-6,-6,7,7,211,-7,2014,0,4,849,0
LA Clippers,26,30,29,17,0,0,0,0,Houston,24,20,28,13,0,0,0,0,20141128,102,85,2,12,13,17,17,187,-17,2014,0,4,1371,0
LA Clippers,35,27,28,22,0,0,0,0,Utah,18,32,26,20,0,0,0,0,20141129,112,96,17,12,14,16,16,208,-16,2014,0,5,579,0
Dallas,28,30,32,20,0,0,0,0,Philadelphia,26,25,35,17,0,0,0,0,20141129,110,103,2,7,4,7,7,213,-7,2014,0,5,1297,0
New Orleans,18,18,21,23,0,0,0,0,Washington,23,17,25,18,0,0,0,0,20141129,80,83,5,4,8,3,3,163,3,2014,0,5,964,0
Indiana,21,28,22,26,0,0,0,0,Cleveland,29,23,35,22,0,0,0,0,20141129,97,109,8,3,16,12,12,206,12,2014,0,5,262,0
Charlotte,17,11,23,24,0,0,0,0,Atlanta,28,36,20,21,0,0,0,0,20141129,75,105,11,36,33,30,30,180,30,2014,0,5,226,0
Houston,28,25,32,32,0,0,0,0,Milwaukee,23,23,26,31,0,0,0,0,20141129,117,103,5,7,13,14,14,220,-14,2014,0,5,1005,0
San Antonio,25,20,33,33,0,0,0,0,Boston,22,27,24,16,0,0,0,0,20141130,111,89,3,-4,5,22,22,200,-22,2014,0,6,1765,0
Chicago,25,22,29,26,0,0,0,0,Brooklyn,22,20,21,21,0,0,0,0,20141130,102,84,3,5,13,18,18,186,-18,2014,0,6,711,0
Golden State,21,32,29,22,0,0,0,0,Detroit,24,16,31,22,0,0,0,0,20141130,104,93,-3,13,11,11,11,197,-11,2014,0,6,2087,0
Toronto,24,25,31,29,13,0,0,0,LA Lakers,27,31,23,28,20,0,0,0,20141130,122,129,3,9,1,0,7,251,7,2014,1,6,2170,0
Miami,21,21,21,23,0,0,0,0,New York,17,17,25,20,0,0,0,0,20141130,86,79,4,8,4,7,7,165,-7,2014,0,6,1091,0
Orlando,27,25,17,24,0,0,0,0,Phoenix,23,16,19,32,0,0,0,0,20141130,93,90,4,13,11,3,3,183,-3,2014,0,6,1842,0
Minnesota,26,14,21,32,0,0,0,0,Portland,22,26,27,32,0,0,0,0,20141130,93,107,-4,8,14,14,14,200,14,2014,0,6,1423,0
Memphis,28,30,16,23,0,0,0,0,Sacramento,20,22,23,20,0,0,0,0,20141130,97,85,8,16,9,12,12,182,-12,2014,0,6,1745,0
Miami,22,27,17,20,0,0,0,0,Washington,30,34,17,26,0,0,0,0,20141201,86,107,8,15,15,21,21,193,21,2014,0,0,924,0
Denver,26,36,21,20,0,0,0,0,Utah,23,20,34,24,0,0,0,0,20141201,103,101,3,19,6,2,2,204,-2,2014,0,0,370,0
Minnesota,34,16,18,33,0,0,0,0,LA Clippers,31,34,36,26,0,0,0,0,20141201,101,127,-3,15,33,26,26,228,26,2014,0,0,1521,0
San Antonio,27,34,23,25,0,0,0,0,Philadelphia,20,26,27,30,0,0,0,0,20141201,109,103,7,15,11,6,6,212,-6,2014,0,0,1505,0
Boston,42,24,19,20,0,0,0,0,Atlanta,30,20,30,29,0,0,0,0,20141202,105,109,-12,-16,-5,4,4,214,4,2014,0,1,935,0
Dallas,25,34,21,28,13,11,0,0,Chicago,26,21,27,34,13,8,0,0,20141202,132,129,-1,12,6,0,3,261,-3,2014,2,1,802,0
Milwaukee,23,31,25,29,0,0,0,0,Cleveland,30,22,27,32,0,0,0,0,20141202,108,111,7,-2,0,3,3,219,3,2014,0,1,334,0
Portland,23,27,28,27,0,0,0,0,Denver,31,25,29,18,0,0,0,0,20141202,105,103,-8,-6,-7,2,2,208,-2,2014,0,1,981,0
LA Lakers,19,27,35,25,0,0,0,0,Detroit,19,26,20,31,0,0,0,0,20141202,106,96,0,1,16,10,10,202,-10,2014,0,1,1979,0
Orlando,25,21,29,22,0,0,0,0,Golden State,24,32,17,25,0,0,0,0,20141202,97,98,-1,10,-2,1,1,195,1,2014,0,1,2437,0
Oklahoma City,26,26,22,30,0,0,0,0,New Orleans,29,40,16,27,0,0,0,0,20141202,104,112,3,17,11,8,8,216,8,2014,0,1,576,0
Brooklyn,27,22,28,21,0,0,0,0,New York,18,27,19,29,0,0,0,0,20141202,98,93,9,4,13,5,5,191,-5,2014,0,1,0,0
Indiana,28,28,23,20,0,0,0,0,Phoenix,26,28,29,33,0,0,0,0,20141202,99,116,-2,-2,4,17,17,215,17,2014,0,1,1496,0
Toronto,31,26,35,25,0,0,0,0,Sacramento,22,33,28,26,0,0,0,0,20141202,117,109,9,2,9,8,8,226,-8,2014,0,1,2195,0
LA Lakers,33,19,17,26,0,0,0,0,Washington,27,27,24,33,0,0,0,0,20141203,95,111,-6,2,9,16,16,206,16,2014,0,2,2294,0
Toronto,31,38,28,26,0,0,0,0,Utah,24,29,29,22,0,0,0,0,20141203,123,104,7,16,15,19,19,227,-19,2014,0,2,1664,0
Philadelphia,23,9,25,28,0,0,0,0,Minnesota,13,21,22,21,0,0,0,0,20141203,85,77,10,-2,1,8,8,162,-8,2014,0,2,983,0
Dallas,29,28,23,27,0,0,0,0,Milwaukee,31,33,14,27,0,0,0,0,20141203,107,105,-2,-7,2,2,2,212,-2,2014,0,2,857,0
Atlanta,27,28,33,24,0,0,0,0,Miami,18,29,25,30,0,0,0,0,20141203,112,102,9,8,16,10,10,214,-10,2014,0,2,605,0
Memphis,28,18,22,28,0,0,0,0,Houston,34,24,36,11,0,0,0,0,20141203,96,105,6,12,26,9,9,201,9,2014,0,2,484,0
Chicago,26,19,27,30,0,0,0,0,Charlotte,24,16,31,24,0,0,0,0,20141203,102,95,2,5,1,7,7,197,-7,2014,0,2,586,0
Detroit,23,20,15,30,14,0,0,0,Boston,21,21,19,27,21,0,0,0,20141203,102,109,-2,-1,3,0,7,211,7,2014,1,2,611,0
Orlando,23,21,18,24,0,0,0,0,LA Clippers,31,26,27,30,0,0,0,0,20141203,86,114,8,13,22,28,28,200,28,2014,0,2,2197,0
San Antonio,19,23,16,30,5,0,0,0,Brooklyn,19,21,28,20,7,0,0,0,20141203,93,95,0,-2,10,0,2,188,2,2014,1,2,1581,0
New Orleans,28,12,26,19,0,0,0,0,Golden State,22,31,27,32,0,0,0,0,20141204,85,112,-6,13,14,27,27,197,27,2014,0,3,1921,0
Cleveland,25,25,18,22,0,0,0,0,New York,24,29,20,14,0,0,0,0,20141204,90,87,1,-3,-5,3,3,177,-3,2014,0,3,403,0
Indiana,14,19,26,23,0,0,0,0,Portland,16,22,24,26,0,0,0,0,20141204,82,88,2,5,3,6,6,170,6,2014,0,3,1880,0
Cleveland,30,21,25,29,0,0,0,0,Toronto,21,23,20,27,0,0,0,0,20141205,105,91,9,7,12,14,14,196,-14,2014,0,4,187,0
Orlando,24,29,18,27,0,0,0,0,Utah,21,20,23,29,0,0,0,0,20141205,98,93,3,12,7,5,5,191,-5,2014,0,4,1915,0
Atlanta,16,36,26,20,0,0,0,0,Brooklyn,18,13,24,20,0,0,0,0,20141205,98,75,-2,21,23,23,23,173,-23,2014,0,4,745,0
Indiana,20,25,27,24,5,0,0,0,Sacramento,34,22,24,16,6,0,0,0,20141205,101,102,14,11,8,0,1,203,1,2014,1,4,1882,0
Denver,28,18,23,20,0,0,0,0,Washington,30,35,25,29,0,0,0,0,20141205,89,119,2,19,21,30,30,208,30,2014,0,4,1489,0
Oklahoma City,31,26,25,21,0,0,0,0,Philadelphia,24,23,20,24,0,0,0,0,20141205,103,91,7,10,15,12,12,194,-12,2014,0,4,1256,0
LA Lakers,20,28,22,26,0,0,0,0,Boston,30,23,33,27,0,0,0,0,20141205,96,113,10,5,16,17,17,209,17,2014,0,4,2590,0
Miami,30,20,21,14,0,0,0,0,Milwaukee,25,29,26,29,0,0,0,0,20141205,85,109,-5,4,9,24,24,194,24,2014,0,4,1269,0
San Antonio,25,33,20,29,0,0,0,0,Memphis,14,32,22,33,0,0,0,0,20141205,107,101,11,12,10,6,6,208,-6,2014,0,4,631,0
Phoenix,40,29,24,25,0,0,0,0,Dallas,27,30,29,20,0,0,0,0,20141205,118,106,13,12,7,12,12,224,-12,2014,0,4,884,0
New York,21,24,24,33,0,0,0,0,Charlotte,31,26,28,18,0,0,0,0,20141205,102,103,10,12,16,1,1,205,1,2014,0,4,531,0
Houston,33,22,28,22,9,0,0,0,Minnesota,24,33,17,31,7,0,0,0,20141205,114,112,9,-2,9,0,2,226,-2,2014,1,4,1057,0
Minnesota,23,28,25,25,0,0,0,0,San Antonio,31,37,28,27,0,0,0,0,20141206,101,123,8,17,20,22,22,224,22,2014,0,5,1112,0
Orlando,27,25,25,28,0,0,0,0,Sacramento,27,22,17,30,0,0,0,0,20141206,105,96,0,3,11,9,9,201,-9,2014,0,5,2390,0
New Orleans,18,36,24,22,0,0,0,0,LA Clippers,34,20,39,27,0,0,0,0,20141206,100,120,16,0,15,20,20,220,20,2014,0,5,1669,0
Philadelphia,30,24,23,23,8,0,0,0,Detroit,28,23,31,18,1,0,0,0,20141206,108,101,2,3,-5,0,7,209,-7,2014,1,5,441,0
Golden State,28,33,18,33,0,0,0,0,Chicago,22,27,31,22,0,0,0,0,20141206,112,102,6,12,-1,10,10,214,-10,2014,0,5,1853,0
Phoenix,18,23,26,28,0,0,0,0,Houston,35,25,20,20,0,0,0,0,20141206,95,100,17,19,13,5,5,195,5,2014,0,5,1014,0
Miami,26,22,27,12,0,0,0,0,Memphis,28,27,27,21,0,0,0,0,20141207,87,103,2,7,7,16,16,190,16,2014,0,6,873,0
Denver,21,15,30,18,0,0,0,0,Atlanta,32,25,20,19,0,0,0,0,20141207,84,96,11,21,11,12,12,180,12,2014,0,6,1209,0
Washington,15,21,23,34,0,0,0,0,Boston,24,29,24,24,0,0,0,0,20141207,93,101,9,17,18,8,8,194,8,2014,0,6,394,0
Milwaukee,21,25,25,31,0,0,0,0,Dallas,32,27,31,35,0,0,0,0,20141207,102,125,11,13,19,23,23,227,23,2014,0,6,857,0
Oklahoma City,25,23,29,19,0,0,0,0,Detroit,33,22,20,19,0,0,0,0,20141207,96,94,-8,-7,2,2,2,190,-2,2014,0,6,909,0
New Orleans,22,28,29,25,0,0,0,0,LA Lakers,16,24,19,28,0,0,0,0,20141207,104,87,6,10,20,17,17,191,-17,2014,0,6,1669,0
Portland,25,28,30,20,0,0,0,0,New York,20,30,25,24,0,0,0,0,20141207,103,99,5,3,8,4,4,202,-4,2014,0,6,2439,0
Denver,30,22,29,21,5,0,0,0,Toronto,35,27,20,20,10,0,0,0,20141208,107,112,5,10,1,0,5,219,5,2014,1,0,1341,0
Boston,29,16,31,34,11,11,0,0,Washington,30,28,34,18,11,12,0,0,20141208,132,133,1,13,16,0,1,265,1,2014,2,0,394,0
Utah,31,18,19,24,0,0,0,0,Sacramento,23,32,13,33,0,0,0,0,20141208,92,101,-8,6,0,9,9,193,9,2014,0,0,532,0
Phoenix,28,29,23,32,8,0,0,0,LA Clippers,28,32,29,23,9,0,0,0,20141208,120,121,0,3,9,0,1,241,1,2014,1,0,356,0
Golden State,25,23,31,23,0,0,0,0,Minnesota,20,19,24,23,0,0,0,0,20141208,102,86,5,9,16,16,16,188,-16,2014,0,0,1581,0
Atlanta,28,32,25,23,0,0,0,0,Indiana,18,25,21,28,0,0,0,0,20141208,108,92,10,17,21,16,16,200,-16,2014,0,0,427,0
Cleveland,22,28,35,25,0,0,0,0,Brooklyn,25,24,18,21,0,0,0,0,20141208,110,88,-3,1,18,22,22,198,-22,2014,0,0,403,0
Toronto,33,30,25,13,0,0,0,0,Cleveland,26,29,26,24,0,0,0,0,20141209,101,105,-7,-8,-7,4,4,206,4,2014,0,1,187,0
Portland,33,22,21,22,0,0,0,0,Detroit,22,24,16,24,0,0,0,0,20141209,98,86,11,9,14,12,12,184,-12,2014,0,1,1964,0
Sacramento,29,26,26,14,0,0,0,0,LA Lakers,24,22,32,20,0,0,0,0,20141209,95,98,-5,-9,-3,3,3,193,3,2014,0,1,361,0
Dallas,37,25,17,26,0,0,0,0,Memphis,34,22,36,22,0,0,0,0,20141209,105,114,-3,-6,13,9,9,219,9,2014,0,1,419,0
New York,27,25,21,20,0,0,0,0,New Orleans,28,26,23,27,0,0,0,0,20141209,93,104,1,2,4,11,11,197,11,2014,0,1,1168,0
Milwaukee,31,21,26,23,0,0,0,0,Oklahoma City,26,35,26,27,0,0,0,0,20141209,101,114,-5,9,9,13,13,215,13,2014,0,1,732,0
Miami,28,18,27,30,0,0,0,0,Phoenix,25,26,21,25,0,0,0,0,20141209,103,97,3,-5,1,6,6,200,-6,2014,0,1,1978,0
San Antonio,22,21,29,24,0,0,0,0,Utah,21,23,34,22,0,0,0,0,20141209,96,100,-1,1,6,4,4,196,4,2014,0,1,1087,0
New York,26,26,21,22,0,0,0,0,San Antonio,29,27,38,15,0,0,0,0,20141210,95,109,3,4,21,14,14,204,14,2014,0,2,1581,0
Washington,26,19,22,24,0,0,0,0,Orlando,21,23,31,14,0,0,0,0,20141210,91,89,5,1,-8,2,2,180,-2,2014,0,2,757,0
Portland,16,20,15,31,0,0,0,0,Minnesota,20,24,22,24,0,0,0,0,20141210,82,90,4,8,15,8,8,172,8,2014,0,2,1423,0
LA Clippers,33,21,28,21,0,0,0,0,Indiana,25,24,16,31,0,0,0,0,20141210,103,96,8,5,17,7,7,199,-7,2014,0,2,1805,0
Houston,30,16,30,17,0,0,0,0,Golden State,23,23,27,32,0,0,0,0,20141210,93,105,-7,0,-3,12,12,198,12,2014,0,2,1642,0
New Orleans,15,36,27,29,0,0,0,0,Dallas,25,22,30,35,0,0,0,0,20141210,107,112,10,-4,-1,5,5,219,5,2014,0,2,442,0
Boston,16,29,21,21,0,0,0,0,Charlotte,22,18,33,23,0,0,0,0,20141210,87,96,6,-5,7,9,9,183,9,2014,0,2,720,0
Brooklyn,25,26,17,12,0,0,0,0,Chicago,20,31,26,28,0,0,0,0,20141210,80,105,-5,0,9,25,25,185,25,2014,0,2,711,0
Philadelphia,21,17,20,21,0,0,0,0,Atlanta,25,22,21,27,0,0,0,0,20141210,79,95,4,9,10,16,16,174,16,2014,0,2,665,0
Miami,21,27,14,20,0,0,0,0,Denver,22,26,31,23,0,0,0,0,20141210,82,102,1,0,17,20,20,184,20,2014,0,2,1724,0
Cleveland,26,21,19,28,0,0,0,0,Oklahoma City,18,29,31,25,0,0,0,0,20141211,94,103,-8,0,12,9,9,197,9,2014,0,3,949,0
Houston,16,20,25,34,18,0,0,0,Sacramento,26,20,23,26,14,0,0,0,20141211,113,109,-10,-10,-8,0,4,222,-4,2014,1,3,1606,0
Detroit,28,27,20,30,0,0,0,0,Phoenix,28,24,24,27,0,0,0,0,20141212,105,103,0,3,-1,2,2,208,-2,2014,0,4,1687,0
LA Clippers,21,21,25,29,0,0,0,0,Washington,30,27,23,24,0,0,0,0,20141212,96,104,9,15,13,8,8,200,8,2014,0,4,2294,0
Miami,29,33,16,22,0,0,0,0,Utah,24,23,27,21,0,0,0,0,20141212,100,95,5,15,4,5,5,195,-5,2014,0,4,2086,0
Indiana,20,22,30,22,0,0,0,0,Toronto,28,25,27,26,0,0,0,0,20141212,94,106,8,11,8,12,12,200,12,2014,0,4,438,0
LA Lakers,25,29,32,15,11,0,0,0,San Antonio,25,25,25,26,9,0,0,0,20141212,112,110,0,4,11,0,2,222,-2,2014,1,4,1201,0
Cleveland,33,26,17,38,0,0,0,0,New Orleans,33,31,25,30,0,0,0,0,20141212,114,119,0,5,13,5,5,233,5,2014,0,4,924,0
Portland,28,23,27,28,0,0,0,0,Chicago,24,35,23,33,0,0,0,0,20141212,106,115,-4,8,4,9,9,221,9,2014,0,4,1754,0
Charlotte,21,24,27,20,10,5,0,0,Memphis,26,21,22,23,10,11,0,0,20141212,107,113,5,2,-3,0,6,220,6,2014,2,4,519,0
Philadelphia,18,27,15,10,0,0,0,0,Brooklyn,22,22,19,25,0,0,0,0,20141212,70,88,4,-1,3,18,18,158,18,2014,0,4,80,0
New York,26,25,24,26,0,0,0,0,Boston,19,27,23,26,0,0,0,0,20141212,101,95,7,5,6,6,6,196,-6,2014,0,4,190,0
Orlando,26,14,24,17,0,0,0,0,Atlanta,29,11,24,23,0,0,0,0,20141212,81,87,3,0,0,6,6,168,6,2014,0,4,401,0
Oklahoma City,39,31,23,18,0,0,0,0,Minnesota,21,28,28,15,0,0,0,0,20141212,111,92,18,21,16,19,19,203,-19,2014,0,4,694,0
Detroit,23,20,24,28,0,0,0,0,Sacramento,24,22,14,30,0,0,0,0,20141213,95,90,-1,-3,7,5,5,185,-5,2014,0,5,2020,0
Atlanta,23,25,24,27,0,0,0,0,Orlando,18,29,25,28,0,0,0,0,20141213,99,100,-5,-1,0,1,1,199,1,2014,0,5,401,0
LA Clippers,28,14,29,35,0,0,0,0,Milwaukee,26,25,21,39,0,0,0,0,20141213,106,111,-2,9,1,5,5,217,5,2014,0,5,1741,0
Memphis,21,22,25,41,11,0,0,0,Philadelphia,28,22,30,29,6,0,0,0,20141213,120,115,-7,-7,-12,0,5,235,-5,2014,1,5,878,0
Denver,31,17,25,23,0,0,0,0,Houston,21,33,26,28,0,0,0,0,20141213,96,108,-10,6,7,12,12,204,12,2014,0,5,878,0
Golden State,39,27,21,18,0,0,0,0,Dallas,18,26,24,30,0,0,0,0,20141213,105,98,21,22,19,7,7,203,-7,2014,0,5,1480,0
Brooklyn,32,20,33,29,0,0,0,0,Charlotte,17,25,17,28,0,0,0,0,20141213,114,87,15,10,26,27,27,201,-27,2014,0,5,531,0
Portland,22,36,24,13,0,0,0,0,Indiana,23,15,28,19,0,0,0,0,20141213,95,85,-1,20,16,10,10,180,-10,2014,0,5,1880,0
San Antonio,20,25,26,28,0,0,0,0,Denver,22,12,27,30,0,0,0,0,20141214,99,91,-2,11,10,8,8,190,-8,2014,0,6,802,0
Chicago,14,25,33,21,0,0,0,0,Miami,18,14,16,27,0,0,0,0,20141214,93,75,-4,7,24,18,18,168,-18,2014,0,6,1189,0
LA Lakers,22,27,22,29,0,0,0,0,Minnesota,19,25,25,25,0,0,0,0,20141214,100,94,3,5,2,6,6,194,-6,2014,0,6,1521,0
Golden State,28,32,29,22,17,0,0,0,New Orleans,31,20,38,22,11,0,0,0,20141214,128,122,-3,9,0,0,6,250,-6,2014,1,6,1921,0
Toronto,27,18,27,14,9,0,0,0,New York,27,19,21,19,4,0,0,0,20141214,95,90,0,-1,5,0,5,185,-5,2014,1,6,341,0
Phoenix,29,19,16,24,0,0,0,0,Oklahoma City,41,29,19,23,0,0,0,0,20141214,88,112,12,22,25,24,24,200,24,2014,0,6,840,0
Utah,24,18,16,26,0,0,0,0,Washington,22,15,30,26,0,0,0,0,20141214,84,93,-2,-5,9,9,9,177,9,2014,0,6,1841,0
Milwaukee,14,30,23,29,0,0,0,0,Phoenix,26,27,19,22,0,0,0,0,20141215,96,94,-12,-9,-5,2,2,190,-2,2014,0,0,1462,0
Orlando,25,27,13,17,0,0,0,0,Toronto,28,16,27,24,0,0,0,0,20141215,82,95,3,-8,6,13,13,177,13,2014,0,0,1048,0
San Antonio,20,23,25,27,0,0,0,0,Portland,23,25,28,32,0,0,0,0,20141215,95,108,3,5,8,13,13,203,13,2014,0,0,1718,0
Detroit,27,17,19,28,0,0,0,0,LA Clippers,29,26,31,27,0,0,0,0,20141215,91,113,2,11,23,22,22,204,22,2014,0,0,1979,0
Charlotte,17,28,23,20,0,0,0,0,Cleveland,34,20,26,17,0,0,0,0,20141215,88,97,17,9,12,9,9,185,9,2014,0,0,435,0
LA Lakers,15,12,31,33,0,0,0,0,Indiana,34,26,29,21,0,0,0,0,20141215,91,110,19,33,31,19,19,201,19,2014,0,0,1805,0
Boston,30,27,31,17,0,0,0,0,Philadelphia,25,13,26,23,0,0,0,0,20141215,105,87,5,19,24,18,18,192,-18,2014,0,0,270,0
Chicago,22,22,20,22,0,0,0,0,Atlanta,28,22,23,20,0,0,0,0,20141215,86,93,6,6,9,7,7,179,7,2014,0,0,587,0
Miami,33,22,21,19,0,0,0,0,Brooklyn,25,20,21,25,0,0,0,0,20141216,95,91,8,10,10,4,4,186,-4,2014,0,1,1091,0
Golden State,30,19,20,29,0,0,0,0,Memphis,24,33,23,25,0,0,0,0,20141216,98,105,-6,8,11,7,7,203,7,2014,0,1,1798,0
Utah,26,30,33,22,0,0,0,0,New Orleans,20,33,25,41,0,0,0,0,20141216,111,119,-6,-3,-11,8,8,230,8,2014,0,1,1432,0
Dallas,36,18,27,26,0,0,0,0,New York,24,20,24,19,0,0,0,0,20141216,107,87,12,10,13,20,20,194,-20,2014,0,1,1370,0
Oklahoma City,34,27,20,23,0,0,0,0,Sacramento,20,34,17,21,0,0,0,0,20141216,104,92,14,7,10,12,12,196,-12,2014,0,1,1336,0
Minnesota,16,20,33,26,0,0,0,0,Washington,27,19,28,35,0,0,0,0,20141216,95,109,11,10,5,14,14,204,14,2014,0,1,931,0
Brooklyn,30,22,21,16,0,0,0,0,Toronto,22,31,23,29,0,0,0,0,20141217,89,105,-8,1,3,16,16,194,16,2014,0,2,341,0
Memphis,34,18,21,19,10,9,6,0,San Antonio,19,26,23,24,10,9,5,0,20141217,117,116,15,7,5,0,1,233,-1,2014,3,2,631,0
Milwaukee,25,16,29,27,0,0,0,0,Portland,18,25,25,36,0,0,0,0,20141217,97,104,-7,2,-2,7,7,201,7,2014,0,2,1714,0
Utah,33,22,22,28,0,0,0,0,Miami,16,25,18,28,0,0,0,0,20141217,105,87,17,14,18,18,18,192,-18,2014,0,2,2086,0
Indiana,27,24,21,28,0,0,0,0,LA Clippers,30,22,26,24,0,0,0,0,20141217,100,102,3,1,6,2,2,202,2,2014,0,2,1805,0
Dallas,32,21,30,34,0,0,0,0,Detroit,30,21,22,33,0,0,0,0,20141217,117,106,2,2,10,11,11,223,-11,2014,0,2,999,0
Houston,25,30,20,24,16,0,0,0,Denver,29,31,18,21,12,0,0,0,20141217,115,111,-4,-5,-3,0,4,226,-4,2014,1,2,878,0
Atlanta,26,39,30,32,0,0,0,0,Cleveland,34,26,15,23,0,0,0,0,20141217,127,98,-8,5,20,29,29,225,-29,2014,0,2,555,0
Phoenix,27,27,29,28,0,0,0,0,Charlotte,31,30,26,19,0,0,0,0,20141217,111,106,-4,-7,-4,5,5,217,-5,2014,0,2,1778,0
Orlando,28,25,20,19,0,0,0,0,Boston,29,27,22,31,0,0,0,0,20141217,92,109,1,3,5,17,17,201,17,2014,0,2,1115,0
New York,20,25,29,23,0,0,0,0,Chicago,30,22,21,30,0,0,0,0,20141218,97,103,10,7,-1,6,6,200,6,2014,0,3,711,0
Oklahoma City,40,23,26,20,0,0,0,0,Golden State,32,33,29,20,0,0,0,0,20141218,109,114,-8,2,5,5,5,223,5,2014,0,3,1386,0
New Orleans,21,25,19,34,0,0,0,0,Houston,22,17,29,22,0,0,0,0,20141218,99,90,-1,7,-3,9,9,189,-9,2014,0,3,317,0
Milwaukee,25,32,24,27,0,0,0,0,Sacramento,29,25,27,26,0,0,0,0,20141218,108,107,-4,3,0,1,1,215,-1,2014,0,3,1771,0
Charlotte,37,29,19,24,0,0,0,0,Philadelphia,26,20,26,19,0,0,0,0,20141219,109,91,11,20,13,18,18,200,-18,2014,0,4,450,0
Portland,17,27,25,28,7,8,17,0,San Antonio,20,26,28,23,7,8,7,0,20141219,129,119,-3,-2,-5,0,10,248,-10,2014,3,4,1718,0
Utah,29,20,32,20,0,0,0,0,Orlando,17,26,23,28,0,0,0,0,20141219,101,94,12,6,15,7,7,195,-7,2014,0,4,1915,0
Washington,29,25,22,29,0,0,0,0,Miami,25,30,24,24,0,0,0,0,20141219,105,103,4,-1,-3,2,2,208,-2,2014,0,4,924,0
Chicago,20,31,22,30,0,0,0,0,Memphis,22,21,23,31,0,0,0,0,20141219,103,97,-2,8,7,6,6,200,-6,2014,0,4,480,0
Brooklyn,33,16,22,20,0,0,0,0,Cleveland,26,28,20,21,0,0,0,0,20141219,91,95,-7,5,3,4,4,186,4,2014,0,4,403,0
Toronto,26,26,29,29,0,0,0,0,Detroit,31,21,18,30,0,0,0,0,20141219,110,100,-5,0,11,10,10,210,-10,2014,0,4,205,0
LA Clippers,20,23,31,32,0,0,0,0,Denver,29,30,12,38,0,0,0,0,20141219,106,109,9,16,-3,3,3,215,3,2014,0,4,830,0
Minnesota,24,24,29,21,0,0,0,0,Boston,27,26,30,31,0,0,0,0,20141219,98,114,3,5,6,16,16,212,16,2014,0,4,1120,0
Oklahoma City,20,32,30,22,0,0,0,0,LA Lakers,26,24,23,30,0,0,0,0,20141219,104,103,-6,2,9,1,1,207,-1,2014,0,4,1178,0
Phoenix,24,20,23,32,0,0,0,0,New York,21,26,21,22,0,0,0,0,20141220,99,90,3,-3,-1,9,9,189,-9,2014,0,5,2139,0
Milwaukee,24,28,31,19,0,0,0,0,LA Clippers,28,22,32,24,0,0,0,0,20141220,102,106,4,-2,-1,4,4,208,4,2014,0,5,1741,0
Atlanta,32,20,22,30,0,0,0,0,Houston,26,14,34,23,0,0,0,0,20141220,104,97,6,12,0,7,7,201,-7,2014,0,5,700,0
Portland,32,30,32,20,0,0,0,0,New Orleans,17,27,18,26,0,0,0,0,20141220,114,88,15,18,32,26,26,202,-26,2014,0,5,2059,0
San Antonio,25,22,30,16,0,0,0,0,Dallas,21,21,33,24,0,0,0,0,20141220,93,99,-4,-5,-2,6,6,192,6,2014,0,5,252,0
Utah,23,16,24,23,0,0,0,0,Charlotte,31,21,32,20,0,0,0,0,20141220,86,104,8,13,21,18,18,190,18,2014,0,5,1723,0
Indiana,21,12,22,18,0,0,0,0,Denver,15,17,23,21,0,0,0,0,20141220,73,76,-6,-1,0,3,3,149,3,2014,0,5,998,0
New York,25,26,24,33,0,0,0,0,Toronto,33,25,33,27,0,0,0,0,20141221,108,118,8,7,16,10,10,226,10,2014,0,6,341,0
Detroit,18,33,27,27,0,0,0,0,Brooklyn,28,25,30,27,0,0,0,0,20141221,105,110,10,2,5,5,5,215,5,2014,0,6,480,0
Memphis,19,22,29,21,0,0,0,0,Cleveland,22,30,25,28,0,0,0,0,20141221,91,105,3,11,7,14,14,196,14,2014,0,6,629,0
Boston,21,21,19,23,0,0,0,0,Miami,28,24,20,28,0,0,0,0,20141221,84,100,7,10,11,16,16,184,16,2014,0,6,1257,0
Indiana,20,32,23,25,0,0,0,0,Minnesota,17,21,30,28,0,0,0,0,20141221,100,96,3,14,7,4,4,196,-4,2014,0,6,510,0
New Orleans,25,28,23,25,0,0,0,0,Oklahoma City,28,20,33,18,0,0,0,0,20141221,101,99,-3,5,-5,2,2,200,-2,2014,0,6,576,0
Philadelphia,23,14,27,32,0,0,0,0,Orlando,20,22,18,28,0,0,0,0,20141221,96,88,3,-5,4,8,8,184,-8,2014,0,6,864,0
LA Lakers,23,37,20,21,0,0,0,0,Sacramento,26,26,29,27,0,0,0,0,20141221,101,108,3,-8,1,7,7,209,7,2014,0,6,361,0
Phoenix,22,28,29,25,0,0,0,0,Washington,23,27,21,21,0,0,0,0,20141221,104,92,-1,0,8,12,12,196,-12,2014,0,6,1977,0
Utah,19,25,26,27,0,0,0,0,Memphis,22,21,25,23,0,0,0,0,20141222,97,91,-3,1,2,6,6,188,-6,2014,0,0,1247,0
LA Clippers,33,27,30,28,0,0,0,0,San Antonio,35,37,23,30,0,0,0,0,20141222,118,125,2,12,5,7,7,243,7,2014,0,0,1201,0
Sacramento,20,30,26,32,0,0,0,0,Golden State,36,28,29,35,0,0,0,0,20141222,108,128,16,14,17,20,20,236,20,2014,0,0,75,0
Portland,33,20,23,19,0,0,0,0,Houston,37,36,23,14,0,0,0,0,20141222,95,110,4,20,20,15,15,205,15,2014,0,0,1833,0
Atlanta,25,27,30,23,0,0,0,0,Dallas,18,20,25,39,0,0,0,0,20141222,105,102,7,14,19,3,3,207,-3,2014,0,0,719,0
Denver,18,22,17,25,0,0,0,0,Charlotte,28,30,26,26,0,0,0,0,20141222,82,110,10,18,27,28,28,192,28,2014,0,0,1355,0
Toronto,33,33,17,37,0,0,0,0,Chicago,33,27,20,49,0,0,0,0,20141222,120,129,0,-6,-3,9,9,249,9,2014,0,0,436,0
Chicago,21,25,24,29,0,0,0,0,Washington,20,20,25,26,0,0,0,0,20141223,99,91,1,6,5,8,8,190,-8,2014,0,1,594,0
Dallas,26,19,29,41,0,0,0,0,Phoenix,25,28,36,35,0,0,0,0,20141223,115,124,-1,8,15,9,9,239,9,2014,0,1,884,0
Portland,19,35,19,25,17,0,0,0,Oklahoma City,26,17,30,25,13,0,0,0,20141223,115,111,-7,11,0,0,4,226,-4,2014,1,1,1484,0
Charlotte,28,26,34,20,0,0,0,0,Milwaukee,30,26,24,21,0,0,0,0,20141223,108,101,-2,-2,8,7,7,209,-7,2014,0,1,658,0
Philadelphia,19,23,31,18,0,0,0,0,Miami,32,25,21,9,0,0,0,0,20141223,91,87,-13,-15,-5,4,4,178,-4,2014,0,1,1021,0
Boston,9,21,30,35,0,0,0,0,Orlando,26,27,32,15,0,0,0,0,20141223,95,100,17,23,25,5,5,195,5,2014,0,1,1115,0
New Orleans,26,14,21,23,0,0,0,0,Indiana,24,20,26,26,0,0,0,0,20141223,84,96,-2,4,9,12,12,180,12,2014,0,1,713,0
Minnesota,26,30,23,25,0,0,0,0,Cleveland,27,37,32,29,0,0,0,0,20141223,104,125,1,8,17,21,21,229,21,2014,0,1,629,0
Denver,27,27,23,19,0,0,0,0,Brooklyn,30,28,18,26,0,0,0,0,20141223,96,102,3,4,-1,6,6,198,6,2014,0,1,1627,0
LA Clippers,25,32,26,21,0,0,0,0,Atlanta,31,19,31,26,0,0,0,0,20141223,104,107,6,-7,-2,3,3,211,3,2014,0,1,1932,0
Golden State,24,24,25,32,0,0,0,0,LA Lakers,34,29,32,20,0,0,0,0,20141223,105,115,10,15,22,10,10,220,10,2014,0,1,347,0
LA Lakers,24,23,30,16,0,0,0,0,Chicago,27,31,25,30,0,0,0,0,20141225,93,113,3,11,6,20,20,206,20,2014,0,3,1741,0
Golden State,20,22,28,16,0,0,0,0,LA Clippers,18,23,32,27,0,0,0,0,20141225,86,100,-2,-1,3,14,14,186,14,2014,0,3,347,0
Cleveland,27,22,25,17,0,0,0,0,Miami,30,32,15,24,0,0,0,0,20141225,91,101,3,13,3,10,10,192,10,2014,0,3,1089,0
Washington,34,26,24,18,0,0,0,0,New York,23,21,26,21,0,0,0,0,20141225,102,91,11,16,14,11,11,193,-11,2014,0,3,204,0
Oklahoma City,29,21,26,38,0,0,0,0,San Antonio,27,20,30,29,0,0,0,0,20141225,114,106,2,3,-1,8,8,220,-8,2014,0,3,421,0
San Antonio,24,20,20,26,0,0,0,0,New Orleans,20,28,22,27,0,0,0,0,20141226,90,97,-4,4,6,7,7,187,7,2014,0,4,506,0
Phoenix,28,31,35,21,0,0,0,0,Sacramento,21,35,34,16,0,0,0,0,20141226,115,106,7,3,4,9,9,221,-9,2014,0,4,634,0
Cleveland,27,22,22,27,0,0,0,0,Orlando,32,21,22,14,0,0,0,0,20141226,98,89,-5,-4,-4,9,9,187,-9,2014,0,4,895,0
Charlotte,24,16,16,19,0,0,0,0,Oklahoma City,33,26,22,17,0,0,0,0,20141226,75,98,9,19,25,23,23,173,23,2014,0,4,938,0
Houston,24,26,29,25,13,0,0,0,Memphis,31,26,24,23,7,0,0,0,20141226,117,111,-7,-7,-2,0,6,228,-6,2014,1,4,484,0
Philadelphia,24,27,23,19,0,0,0,0,Portland,27,34,27,26,0,0,0,0,20141226,93,114,3,10,14,21,21,207,21,2014,0,4,2405,0
Minnesota,27,20,27,28,0,0,0,0,Denver,26,27,26,27,0,0,0,0,20141226,102,106,-1,6,5,4,4,208,4,2014,0,4,698,0
LA Lakers,19,23,20,36,0,0,0,0,Dallas,26,22,24,30,0,0,0,0,20141226,98,102,7,6,10,4,4,200,4,2014,0,4,1237,0
Brooklyn,28,28,23,30,0,0,0,0,Boston,29,27,30,21,0,0,0,0,20141226,109,107,-1,0,-7,2,2,216,-2,2014,0,4,190,0
Indiana,26,27,29,27,0,0,0,0,Detroit,32,25,36,26,0,0,0,0,20141226,109,119,6,4,11,10,10,228,10,2014,0,4,240,0
Milwaukee,24,34,23,26,0,0,0,0,Atlanta,22,20,16,19,0,0,0,0,20141226,107,77,2,16,23,30,30,184,-30,2014,0,4,669,0
Boston,12,27,24,25,0,0,0,0,Washington,30,26,24,21,0,0,0,0,20141227,88,101,18,17,17,13,13,189,13,2014,0,5,394,0
Philadelphia,12,20,23,16,0,0,0,0,Utah,25,19,15,29,0,0,0,0,20141227,71,88,13,12,4,17,17,159,17,2014,0,5,1920,0
New York,27,31,22,37,12,0,0,0,Sacramento,38,29,22,28,18,0,0,0,20141227,129,135,11,9,9,0,6,264,6,2014,1,5,2499,0
Atlanta,21,18,27,24,0,0,0,0,Milwaukee,10,27,26,22,0,0,0,0,20141227,90,85,11,2,3,5,5,175,-5,2014,0,5,669,0
Memphis,27,30,15,31,0,0,0,0,Miami,16,25,28,26,0,0,0,0,20141227,103,95,11,16,3,8,8,198,-8,2014,0,5,873,0
Minnesota,23,25,19,30,0,0,0,0,Golden State,31,27,30,22,0,0,0,0,20141227,97,110,8,10,21,13,13,207,13,2014,0,5,1581,0
Orlando,22,30,29,21,0,0,0,0,Charlotte,18,24,26,26,0,0,0,0,20141227,102,94,4,10,13,8,8,196,-8,2014,0,5,463,0
New Orleans,25,20,26,29,0,0,0,0,Chicago,23,26,31,27,0,0,0,0,20141227,100,107,-2,4,9,7,7,207,7,2014,0,5,832,0
Indiana,22,28,29,31,0,0,0,0,Brooklyn,23,24,18,20,0,0,0,0,20141227,110,85,-1,3,14,25,25,195,-25,2014,0,5,643,0
Toronto,22,27,31,30,0,0,0,0,LA Clippers,26,23,29,20,0,0,0,0,20141227,110,98,-4,0,2,12,12,208,-12,2014,0,5,2170,0
New York,22,19,17,21,0,0,0,0,Portland,31,24,21,25,0,0,0,0,20141228,79,101,9,14,18,22,22,180,22,2014,0,6,2439,0
Houston,33,22,29,22,0,0,0,0,San Antonio,28,28,29,25,0,0,0,0,20141228,106,110,-5,1,1,4,4,216,4,2014,0,6,189,0
Phoenix,26,29,33,28,0,0,0,0,LA Lakers,28,28,25,26,0,0,0,0,20141228,116,107,-2,-1,7,9,9,223,-9,2014,0,6,356,0
Detroit,17,33,27,26,0,0,0,0,Cleveland,28,19,14,19,0,0,0,0,20141228,103,80,-11,3,16,23,23,183,-23,2014,0,6,90,0
Oklahoma City,26,32,30,19,0,0,0,0,Dallas,33,31,17,31,0,0,0,0,20141228,107,112,7,6,-7,5,5,219,5,2014,0,6,189,0
Toronto,27,33,28,28,0,0,0,0,Denver,24,30,33,15,0,0,0,0,20141228,116,102,3,6,1,14,14,218,-14,2014,0,6,1341,0
Sacramento,28,16,25,30,0,0,0,0,Brooklyn,27,30,25,25,0,0,0,0,20141229,99,107,-1,13,13,8,8,206,8,2014,0,0,2499,0
Milwaukee,25,24,19,15,21,0,0,0,Charlotte,18,14,29,22,11,0,0,0,20141229,104,94,7,17,7,0,10,198,-10,2014,1,0,658,0
Washington,24,22,32,26,0,0,0,0,Houston,27,18,22,36,0,0,0,0,20141229,104,103,-3,1,11,1,1,207,-1,2014,0,0,1217,0
Chicago,22,25,34,11,0,0,0,0,Indiana,17,18,30,25,0,0,0,0,20141229,92,90,5,12,16,2,2,182,-2,2014,0,0,163,0
Utah,18,26,33,20,0,0,0,0,LA Clippers,25,23,29,24,0,0,0,0,20141229,97,101,7,4,0,4,4,198,4,2014,0,0,579,0
Orlando,26,24,27,25,0,0,0,0,Miami,25,28,24,24,0,0,0,0,20141229,102,101,1,-3,0,1,1,203,-1,2014,0,0,204,0
Phoenix,25,28,26,27,0,0,0,0,New Orleans,31,24,26,29,0,0,0,0,20141230,106,110,6,2,2,4,4,216,4,2014,0,1,1312,0
Minnesota,27,17,28,22,0,0,0,0,Utah,21,24,27,28,0,0,0,0,20141230,94,100,-6,1,0,6,6,194,6,2014,0,1,984,0
Toronto,23,22,25,17,10,0,0,0,Portland,23,15,25,24,15,0,0,0,20141230,97,102,0,-7,-7,0,5,199,5,2014,1,1,2108,0
Detroit,20,34,26,29,0,0,0,0,Orlando,21,26,23,16,0,0,0,0,20141230,109,86,-1,7,10,23,23,195,-23,2014,0,1,957,0
San Antonio,20,18,25,24,0,0,0,0,Memphis,30,22,22,21,0,0,0,0,20141230,87,95,10,14,11,8,8,182,8,2014,0,1,631,0
Brooklyn,24,31,29,12,0,0,0,0,Chicago,31,14,24,13,0,0,0,0,20141230,96,82,-7,10,15,14,14,178,-14,2014,0,1,711,0
LA Lakers,33,29,21,28,0,0,0,0,Denver,29,17,25,32,0,0,0,0,20141230,111,103,4,16,12,8,8,214,-8,2014,0,1,830,0
Washington,24,21,19,23,0,0,0,0,Dallas,27,36,26,25,0,0,0,0,20141230,87,114,3,18,25,27,27,201,27,2014,0,1,1181,0
Philadelphia,17,17,29,23,0,0,0,0,Golden State,32,29,35,30,0,0,0,0,20141230,86,126,15,27,33,40,40,212,40,2014,0,1,2516,0
Cleveland,25,16,32,28,0,0,0,0,Atlanta,26,25,27,31,0,0,0,0,20141230,101,109,1,10,5,8,8,210,8,2014,0,1,555,0
New Orleans,14,14,32,24,9,0,0,0,San Antonio,17,21,24,22,11,0,0,0,20141231,93,95,3,10,2,0,2,188,2,2014,1,2,506,0
Phoenix,29,33,32,34,6,0,0,0,Oklahoma City,30,34,36,28,9,0,0,0,20141231,134,137,1,2,6,0,3,271,3,2014,1,2,840,0
Miami,24,27,19,25,0,0,0,0,Indiana,20,22,36,28,0,0,0,0,20141231,95,106,-4,-9,8,11,11,201,11,2014,0,2,1026,0
New York,21,19,18,20,0,0,0,0,LA Clippers,29,21,24,25,0,0,0,0,20141231,78,99,8,10,16,21,21,177,21,2014,0,2,2445,0
Milwaukee,31,21,19,25,0,0,0,0,Cleveland,18,29,7,26,0,0,0,0,20141231,96,80,13,5,17,16,16,176,-16,2014,0,2,334,0
Sacramento,19,20,22,23,0,0,0,0,Boston,23,26,28,29,0,0,0,0,20141231,84,106,4,10,16,22,22,190,22,2014,0,2,2624,0
Charlotte,25,20,23,15,0,0,0,0,Houston,23,24,29,26,0,0,0,0,20141231,83,102,-2,2,8,19,19,185,19,2014,0,2,925,0
Denver,23,30,21,27,0,0,0,0,Chicago,22,20,35,29,0,0,0,0,20150101,101,106,-1,-11,3,5,5,207,5,2014,0,3,916,0
Sacramento,37,23,24,26,0,0,0,0,Minnesota,29,29,22,27,0,0,0,0,20150101,110,107,8,2,4,3,3,217,-3,2014,0,3,1511,0
Washington,29,28,25,20,0,0,0,0,Oklahoma City,28,27,27,27,0,0,0,0,20150102,102,109,-1,-2,0,7,7,211,7,2014,0,4,1149,0
Atlanta,31,26,25,16,0,0,0,0,Utah,21,24,23,24,0,0,0,0,20150102,98,92,10,12,14,6,6,190,-6,2014,0,4,1580,0
Philadelphia,29,30,20,17,0,0,0,0,Phoenix,34,23,27,28,0,0,0,0,20150102,96,112,5,-2,5,16,16,208,16,2014,0,4,2078,0
Brooklyn,22,30,34,14,0,0,0,0,Orlando,25,15,21,37,0,0,0,0,20150102,100,98,-3,12,25,2,2,198,-2,2014,0,4,939,0
Detroit,24,33,25,15,0,0,0,0,New York,20,18,14,29,0,0,0,0,20150102,97,81,4,19,30,16,16,178,-16,2014,0,4,480,0
Dallas,31,28,33,27,0,0,0,0,Boston,17,29,18,37,0,0,0,0,20150102,119,101,14,13,28,18,18,220,-18,2014,0,4,1548,0
Indiana,23,23,20,28,0,0,0,0,Milwaukee,21,32,15,23,0,0,0,0,20150102,94,91,2,-7,-2,3,3,185,-3,2014,0,4,243,0
Memphis,22,25,33,29,0,0,0,0,LA Lakers,25,27,25,29,0,0,0,0,20150102,109,106,-3,-5,3,3,3,215,-3,2014,0,4,1599,0
Toronto,31,30,23,21,0,0,0,0,Golden State,40,26,31,29,0,0,0,0,20150102,105,126,9,5,13,21,21,231,21,2014,0,4,2263,0
Cleveland,16,24,32,19,0,0,0,0,Charlotte,25,21,18,23,0,0,0,0,20150102,91,87,-9,-6,8,4,4,178,-4,2014,0,4,435,0
Houston,20,22,18,23,0,0,0,0,New Orleans,29,30,30,22,0,0,0,0,20150102,83,111,9,17,29,28,28,194,28,2014,0,4,317,0
Charlotte,22,30,18,28,0,0,0,0,Orlando,20,9,25,36,0,0,0,0,20150103,98,90,2,23,16,8,8,188,-8,2014,0,5,463,0
Washington,35,23,19,15,0,0,0,0,San Antonio,31,27,20,23,0,0,0,0,20150103,92,101,-4,0,1,9,9,193,9,2014,0,5,1385,0
Atlanta,29,23,31,32,0,0,0,0,Portland,20,29,26,32,0,0,0,0,20150103,115,107,9,3,8,8,8,222,-8,2014,0,5,2168,0
Utah,20,27,30,24,0,0,0,0,Minnesota,21,20,20,28,0,0,0,0,20150103,101,89,-1,6,16,12,12,190,-12,2014,0,5,984,0
Boston,23,17,29,30,5,0,0,0,Chicago,17,29,23,30,10,0,0,0,20150103,104,109,-6,6,0,0,5,213,5,2014,1,5,849,0
Miami,27,22,11,19,0,0,0,0,Houston,23,38,33,21,0,0,0,0,20150103,79,115,-4,12,34,36,36,194,36,2014,0,5,966,0
Memphis,22,16,22,25,0,0,0,0,Denver,32,17,34,31,0,0,0,0,20150103,85,114,10,11,23,29,29,199,29,2014,0,5,877,0
Philadelphia,21,32,21,17,0,0,0,0,LA Clippers,34,28,26,39,0,0,0,0,20150103,91,127,13,9,14,36,36,218,36,2014,0,5,2388,0
Dallas,28,29,32,20,0,0,0,0,Cleveland,25,22,24,19,0,0,0,0,20150104,109,90,3,10,18,19,19,199,-19,2014,0,6,1024,0
Sacramento,22,24,32,17,0,0,0,0,Detroit,24,31,29,30,0,0,0,0,20150104,95,114,2,9,6,19,19,209,19,2014,0,6,2020,0
Indiana,28,20,21,18,0,0,0,0,LA Lakers,15,26,22,25,0,0,0,0,20150104,87,88,-13,-7,-6,1,1,175,1,2014,0,6,1805,0
Brooklyn,21,19,19,25,0,0,0,0,Miami,30,19,15,24,0,0,0,0,20150104,84,88,9,9,5,4,4,172,4,2014,0,6,1091,0
Milwaukee,22,23,31,19,0,0,0,0,New York,21,17,26,18,0,0,0,0,20150104,95,82,1,7,12,13,13,177,-13,2014,0,6,732,0
Toronto,19,34,23,33,0,0,0,0,Phoenix,27,43,28,27,0,0,0,0,20150104,109,125,8,17,22,16,16,234,16,2014,0,6,1885,0
Cleveland,20,30,18,24,0,0,0,0,Philadelphia,19,18,23,35,0,0,0,0,20150105,92,95,-1,-13,-8,3,3,187,3,2014,0,0,358,0
Washington,27,25,17,23,0,0,0,0,New Orleans,23,21,20,21,0,0,0,0,20150105,92,85,4,8,5,7,7,177,-7,2014,0,0,964,0
Denver,35,27,25,23,0,0,0,0,Minnesota,21,20,28,32,0,0,0,0,20150105,110,101,14,21,18,9,9,211,-9,2014,0,0,698,0
New York,14,22,26,21,0,0,0,0,Memphis,21,26,37,21,0,0,0,0,20150105,83,105,7,11,22,22,22,188,22,2014,0,0,953,0
Charlotte,24,26,29,25,0,0,0,0,Boston,16,20,26,33,0,0,0,0,20150105,104,95,8,14,17,9,9,199,-9,2014,0,0,720,0
Oklahoma City,25,20,20,26,0,0,0,0,Golden State,34,31,19,33,0,0,0,0,20150105,91,117,9,20,19,26,26,208,26,2014,0,0,1386,0
Houston,33,29,27,16,0,0,0,0,Chicago,34,28,21,31,0,0,0,0,20150105,105,114,1,0,-6,9,9,219,9,2014,0,0,939,0
Dallas,21,22,22,17,14,0,0,0,Brooklyn,35,14,16,17,6,0,0,0,20150105,96,88,-14,-6,0,0,8,184,-8,2014,1,0,1370,0
LA Lakers,23,22,28,21,0,0,0,0,Portland,24,23,23,28,0,0,0,0,20150105,94,98,1,2,-3,4,4,192,4,2014,0,0,826,0
Atlanta,21,23,33,30,0,0,0,0,LA Clippers,26,20,23,29,0,0,0,0,20150105,107,98,-5,-2,8,9,9,205,-9,2014,0,0,1932,0
Indiana,31,22,21,31,0,0,0,0,Utah,16,23,23,39,0,0,0,0,20150105,105,101,15,14,12,4,4,206,-4,2014,0,0,1353,0
Detroit,20,29,33,23,0,0,0,0,San Antonio,37,21,19,27,0,0,0,0,20150106,105,104,-17,-9,5,1,1,209,-1,2014,0,1,1238,0
Phoenix,15,28,28,31,0,0,0,0,Milwaukee,21,23,28,24,0,0,0,0,20150106,102,96,-6,-1,-1,6,6,198,-6,2014,0,1,1462,0
Phoenix,20,25,26,42,0,0,0,0,Minnesota,25,23,30,33,0,0,0,0,20150107,113,111,-5,-3,-7,2,2,224,-2,2014,0,2,1278,0
New York,21,20,26,24,0,0,0,0,Washington,30,23,24,24,0,0,0,0,20150107,91,101,9,12,10,10,10,192,10,2014,0,2,204,0
Oklahoma City,16,27,14,26,0,0,0,0,Sacramento,28,25,25,26,0,0,0,0,20150107,83,104,12,10,21,21,21,187,21,2014,0,2,1336,0
Milwaukee,27,26,24,20,0,0,0,0,Philadelphia,11,28,21,17,0,0,0,0,20150107,97,77,16,14,17,20,20,174,-20,2014,0,2,692,0
LA Lakers,24,24,15,26,0,0,0,0,LA Clippers,34,36,29,15,0,0,0,0,20150107,89,114,10,22,36,25,25,203,25,2014,0,2,0,0
Orlando,18,21,19,32,0,0,0,0,Denver,25,15,23,30,0,0,0,0,20150107,90,93,7,1,5,3,3,183,3,2014,0,2,1548,0
Indiana,28,22,26,26,0,0,0,0,Golden State,23,27,34,33,0,0,0,0,20150107,102,117,-5,0,8,15,15,219,15,2014,0,2,1944,0
Houston,26,23,24,32,0,0,0,0,Cleveland,23,25,26,19,0,0,0,0,20150107,105,93,3,1,-1,12,12,198,-12,2014,0,2,1113,0
New Orleans,27,21,22,24,0,0,0,0,Charlotte,20,21,26,31,0,0,0,0,20150107,94,98,-7,-7,-3,4,4,192,4,2014,0,2,648,0
Utah,22,14,27,34,0,0,0,0,Chicago,16,16,19,26,0,0,0,0,20150107,97,77,6,4,12,20,20,174,-20,2014,0,2,1256,0
Boston,19,21,29,20,0,0,0,0,Brooklyn,25,14,23,19,0,0,0,0,20150107,89,81,-6,1,7,8,8,170,-8,2014,0,2,190,0
Memphis,19,25,15,27,0,0,0,0,Atlanta,23,26,21,26,0,0,0,0,20150107,86,96,4,5,11,10,10,182,10,2014,0,2,336,0
Detroit,31,23,20,34,0,0,0,0,Dallas,26,23,19,27,0,0,0,0,20150107,108,95,5,5,6,13,13,203,-13,2014,0,2,999,0
Charlotte,31,19,25,28,0,0,0,0,Toronto,23,29,14,29,0,0,0,0,20150108,103,95,8,-2,9,8,8,198,-8,2014,0,3,585,0
Houston,27,29,37,27,0,0,0,0,New York,22,20,27,27,0,0,0,0,20150108,120,96,5,14,24,24,24,216,-24,2014,0,3,1417,0
Miami,23,25,16,19,0,0,0,0,Portland,18,25,33,23,0,0,0,0,20150108,83,99,-5,-5,12,16,16,182,16,2014,0,3,2704,0
Denver,30,24,36,28,0,0,0,0,Sacramento,27,33,15,33,0,0,0,0,20150109,118,108,3,-6,15,10,10,226,-10,2014,0,4,886,0
Utah,27,23,26,18,0,0,0,0,Oklahoma City,27,17,30,25,0,0,0,0,20150109,94,99,0,-6,-2,5,5,193,5,2014,0,4,861,0
Chicago,13,29,26,18,0,0,0,0,Washington,30,30,20,22,0,0,0,0,20150109,86,102,17,18,12,16,16,188,16,2014,0,4,594,0
Phoenix,18,25,26,26,0,0,0,0,San Antonio,29,20,10,41,0,0,0,0,20150109,95,100,11,6,-10,5,5,195,5,2014,0,4,846,0
Memphis,19,20,32,24,0,0,0,0,New Orleans,31,21,30,24,0,0,0,0,20150109,95,106,12,13,11,11,11,201,11,2014,0,4,358,0
Minnesota,22,16,20,26,0,0,0,0,Milwaukee,19,34,19,26,0,0,0,0,20150109,84,98,-3,15,14,14,14,182,14,2014,0,4,298,0
Orlando,20,25,22,17,0,0,0,0,LA Lakers,29,25,19,28,0,0,0,0,20150109,84,101,9,9,6,17,17,185,17,2014,0,4,2197,0
Boston,17,20,23,34,9,0,0,0,Indiana,25,21,19,29,13,0,0,0,20150109,103,107,8,9,5,0,4,210,4,2014,1,4,805,0
Cleveland,32,22,22,18,0,0,0,0,Golden State,30,30,24,28,0,0,0,0,20150109,94,112,-2,6,8,18,18,206,18,2014,0,4,2161,0
Atlanta,31,33,26,16,0,0,0,0,Detroit,22,23,30,28,0,0,0,0,20150109,106,103,9,19,15,3,3,209,-3,2014,0,4,597,0
Philadelphia,23,22,19,26,0,0,0,0,Brooklyn,32,14,25,17,0,0,0,0,20150109,90,88,-9,-1,-7,2,2,178,-2,2014,0,4,80,0
Boston,26,17,22,31,0,0,0,0,Toronto,19,28,35,27,0,0,0,0,20150110,96,109,-7,4,17,13,13,205,13,2014,0,5,430,0
Orlando,13,28,29,22,0,0,0,0,Portland,26,20,26,31,0,0,0,0,20150110,92,103,13,5,2,11,11,195,11,2014,0,5,2525,0
Charlotte,21,41,27,21,0,0,0,0,New York,18,13,13,38,0,0,0,0,20150110,110,82,3,31,45,28,28,192,-28,2014,0,5,531,0
San Antonio,27,31,26,24,0,0,0,0,Minnesota,18,25,21,29,0,0,0,0,20150110,108,93,9,15,20,15,15,201,-15,2014,0,5,1112,0
Indiana,21,28,21,22,0,0,0,0,Philadelphia,19,24,29,21,0,0,0,0,20150110,92,93,-2,-6,2,1,1,185,1,2014,0,5,582,0
Utah,23,14,20,25,0,0,0,0,Houston,23,23,32,19,0,0,0,0,20150110,82,97,0,9,21,15,15,179,15,2014,0,5,1199,0
Brooklyn,21,26,22,24,0,0,0,0,Detroit,22,25,27,24,0,0,0,0,20150110,93,98,1,0,5,5,5,191,5,2014,0,5,480,0
Milwaukee,19,20,23,25,0,0,0,0,Chicago,29,19,20,27,0,0,0,0,20150110,87,95,10,9,6,8,8,182,8,2014,0,5,83,0
Dallas,24,24,24,28,0,0,0,0,LA Clippers,30,26,32,32,0,0,0,0,20150110,100,120,6,8,16,20,20,220,20,2014,0,5,1237,0
Washington,22,28,27,12,0,0,0,0,Atlanta,34,21,32,33,0,0,0,0,20150111,89,120,12,5,10,31,31,209,31,2014,0,6,541,0
Miami,30,32,24,18,0,0,0,0,LA Clippers,29,24,23,14,0,0,0,0,20150111,104,90,1,9,10,14,14,194,-14,2014,0,6,2335,0
Portland,23,27,22,34,0,0,0,0,LA Lakers,20,25,24,25,0,0,0,0,20150111,106,94,3,5,3,12,12,200,-12,2014,0,6,826,0
Phoenix,15,26,25,35,7,2,0,0,Memphis,22,29,24,26,7,14,0,0,20150111,110,122,7,10,9,0,12,232,12,2014,2,6,1260,0
Cleveland,29,15,20,20,0,0,0,0,Sacramento,30,29,26,18,0,0,0,0,20150111,84,103,1,15,21,19,19,187,19,2014,0,6,2096,0
Orlando,29,34,30,28,0,0,0,0,Chicago,21,34,23,36,0,0,0,0,20150112,121,114,8,8,15,7,7,235,-7,2014,0,0,984,0
New Orleans,22,27,27,24,0,0,0,0,Boston,22,27,23,36,0,0,0,0,20150112,100,108,0,0,-4,8,8,208,8,2014,0,0,1358,0
Houston,37,23,26,27,0,0,0,0,Brooklyn,28,24,18,29,0,0,0,0,20150112,113,99,9,8,16,14,14,212,-14,2014,0,0,1417,0
Detroit,20,28,34,32,0,0,0,0,Toronto,32,28,23,28,0,0,0,0,20150112,114,111,-12,-12,-1,3,3,225,-3,2014,0,0,205,0
San Antonio,24,24,24,21,0,0,0,0,Washington,31,20,24,26,0,0,0,0,20150113,93,101,7,3,3,8,8,194,8,2014,0,1,1385,0
Dallas,29,31,20,19,9,0,0,0,Sacramento,33,30,20,16,5,0,0,0,20150113,108,104,-4,-3,-3,0,4,212,-4,2014,1,1,1437,0
Cleveland,24,27,28,21,0,0,0,0,Phoenix,31,28,26,22,0,0,0,0,20150113,100,107,7,8,6,7,7,207,7,2014,0,1,1745,0
Golden State,25,28,44,19,0,0,0,0,Utah,26,27,27,25,0,0,0,0,20150113,116,105,-1,0,17,11,11,221,-11,2014,0,1,599,0
Miami,22,22,17,17,0,0,0,0,LA Lakers,12,22,19,22,0,0,0,0,20150113,78,75,10,10,8,3,3,153,-3,2014,0,1,2335,0
Atlanta,25,24,25,31,0,0,0,0,Philadelphia,20,17,18,32,0,0,0,0,20150113,105,87,5,12,19,18,18,192,-18,2014,0,1,665,0
Minnesota,25,21,23,41,0,0,0,0,Indiana,21,31,23,26,0,0,0,0,20150113,110,101,4,-6,-6,9,9,211,-9,2014,0,1,510,0
Philadelphia,19,27,15,23,0,0,0,0,Toronto,34,16,21,29,0,0,0,0,20150114,84,100,15,4,10,16,16,184,16,2014,0,2,334,0
LA Clippers,27,23,22,28,0,0,0,0,Portland,21,28,23,22,0,0,0,0,20150114,100,94,6,1,0,6,6,194,-6,2014,0,2,826,0
Miami,18,20,25,26,0,0,0,0,Golden State,26,29,26,23,0,0,0,0,20150114,89,104,8,17,18,15,15,193,15,2014,0,2,2590,0
New Orleans,22,36,25,22,0,0,0,0,Detroit,18,18,30,28,0,0,0,0,20150114,105,94,4,22,17,11,11,199,-11,2014,0,2,939,0
Houston,19,33,33,28,0,0,0,0,Orlando,29,26,29,36,0,0,0,0,20150114,113,120,10,3,-1,7,7,233,7,2014,0,2,847,0
San Antonio,22,35,19,22,0,0,0,0,Charlotte,18,27,23,25,0,0,0,0,20150114,98,93,4,12,8,5,5,191,-5,2014,0,2,1103,0
Washington,26,18,32,29,0,0,0,0,Chicago,32,18,19,30,0,0,0,0,20150114,105,99,-6,-6,7,6,6,204,-6,2014,0,2,594,0
Memphis,32,19,31,21,0,0,0,0,Brooklyn,23,22,20,27,0,0,0,0,20150114,103,92,9,6,17,11,11,195,-11,2014,0,2,953,0
Atlanta,24,33,32,16,0,0,0,0,Boston,24,21,29,17,0,0,0,0,20150114,105,91,0,12,15,14,14,196,-14,2014,0,2,935,0
Dallas,24,26,28,29,0,0,0,0,Denver,28,31,31,24,0,0,0,0,20150114,107,114,4,9,12,7,7,221,7,2014,0,2,661,0
Oklahoma City,18,35,22,26,0,0,0,0,Houston,40,24,24,24,0,0,0,0,20150115,101,112,22,11,13,11,11,213,11,2014,0,3,413,0
Cleveland,30,27,22,30,0,0,0,0,LA Lakers,30,31,14,27,0,0,0,0,20150115,109,102,0,-4,4,7,7,211,-7,2014,0,3,2044,0
New York,13,24,19,23,0,0,0,0,Milwaukee,31,25,26,13,0,0,0,0,20150115,79,95,18,19,26,16,16,174,16,2014,0,3,732,0
Minnesota,27,29,19,24,0,0,0,0,Phoenix,32,27,27,24,0,0,0,0,20150116,99,110,5,3,11,11,11,209,11,2014,0,4,1278,0
LA Lakers,23,20,20,22,0,0,0,0,Utah,28,16,26,24,0,0,0,0,20150116,85,94,5,1,7,9,9,179,9,2014,0,4,579,0
Brooklyn,18,25,28,31,0,0,0,0,Washington,24,16,18,22,0,0,0,0,20150116,102,80,-6,3,13,22,22,182,-22,2014,0,4,204,0
Portland,28,24,27,17,0,0,0,0,San Antonio,35,25,31,19,0,0,0,0,20150116,96,110,7,8,12,14,14,206,14,2014,0,4,1718,0
Miami,26,26,23,20,0,0,0,0,Sacramento,22,22,17,22,0,0,0,0,20150116,95,83,4,8,14,12,12,178,-12,2014,0,4,2547,0
New Orleans,22,25,12,22,0,0,0,0,Philadelphia,33,17,23,23,0,0,0,0,20150116,81,96,11,3,14,15,15,177,15,2014,0,4,1088,0
Atlanta,24,28,33,25,0,0,0,0,Toronto,19,19,30,21,0,0,0,0,20150116,110,89,5,14,17,21,21,199,-21,2014,0,4,733,0
Golden State,35,25,31,24,0,0,0,0,Oklahoma City,33,36,29,29,0,0,0,0,20150116,115,127,-2,9,7,12,12,242,12,2014,0,4,1386,0
Cleveland,28,33,31,34,0,0,0,0,LA Clippers,33,31,31,26,0,0,0,0,20150116,126,121,-5,-3,-3,5,5,247,-5,2014,0,4,2044,0
Detroit,23,26,30,19,0,0,0,0,Indiana,19,32,25,20,0,0,0,0,20150116,98,96,4,-2,3,2,2,194,-2,2014,0,4,240,0
Denver,24,18,23,24,0,0,0,0,Dallas,29,20,24,24,0,0,0,0,20150116,89,97,5,7,8,8,8,186,8,2014,0,4,661,0
Chicago,22,33,33,31,0,0,0,0,Boston,24,34,28,17,0,0,0,0,20150116,119,103,-2,-3,2,16,16,222,-16,2014,0,4,849,0
Memphis,27,21,33,25,0,0,0,0,Orlando,28,21,25,22,0,0,0,0,20150116,106,96,-1,-1,7,10,10,202,-10,2014,0,4,683,0
Washington,23,27,27,22,0,0,0,0,Brooklyn,26,25,19,20,0,0,0,0,20150117,99,90,-3,-1,7,9,9,189,-9,2014,0,5,204,0
Atlanta,24,24,28,31,0,0,0,0,Chicago,16,23,28,32,0,0,0,0,20150117,107,99,8,9,9,8,8,206,-8,2014,0,5,587,0
Indiana,21,19,11,17,3,0,0,0,Charlotte,17,20,13,18,12,0,0,0,20150117,71,80,-4,-3,-1,0,9,151,9,2014,1,5,428,0
Minnesota,37,19,29,28,0,0,0,0,Denver,25,34,24,22,0,0,0,0,20150117,113,105,12,-3,2,8,8,218,-8,2014,0,5,698,0
Philadelphia,21,16,25,27,0,0,0,0,Detroit,31,25,25,26,0,0,0,0,20150117,89,107,10,19,19,18,18,196,18,2014,0,5,441,0
Golden State,31,33,38,29,0,0,0,0,Houston,31,28,21,26,0,0,0,0,20150117,131,106,0,5,22,25,25,237,-25,2014,0,5,1642,0
Portland,23,19,28,28,0,0,0,0,Memphis,30,30,18,24,0,0,0,0,20150117,98,102,7,18,8,4,4,200,4,2014,0,5,1845,0
LA Clippers,28,24,31,34,0,0,0,0,Sacramento,28,24,26,30,0,0,0,0,20150117,117,108,0,0,5,9,9,225,-9,2014,0,5,361,0
New Orleans,21,29,14,31,0,0,0,0,Toronto,14,22,35,22,0,0,0,0,20150118,95,93,7,14,-7,2,2,188,-2,2014,0,6,1112,0
Utah,15,12,20,22,0,0,0,0,San Antonio,23,20,23,23,0,0,0,0,20150118,69,89,8,16,19,20,20,158,20,2014,0,6,1087,0
Oklahoma City,37,42,24,24,0,0,0,0,Orlando,20,25,31,23,0,0,0,0,20150118,127,99,17,34,27,28,28,226,-28,2014,0,6,1057,0
Detroit,12,29,20,21,0,0,0,0,Atlanta,16,28,24,25,0,0,0,0,20150119,82,93,4,3,7,11,11,175,11,2014,0,0,597,0
Minnesota,20,13,19,28,0,0,0,0,Charlotte,23,27,33,22,0,0,0,0,20150119,80,105,3,17,31,25,25,185,25,2014,0,0,938,0
Chicago,19,20,23,32,0,0,0,0,Cleveland,24,30,30,24,0,0,0,0,20150119,94,108,5,15,22,14,14,202,14,2014,0,0,308,0
Denver,15,13,32,19,0,0,0,0,Golden State,25,30,34,33,0,0,0,0,20150119,79,122,10,27,29,43,43,201,43,2014,0,0,947,0
Indiana,21,24,23,30,0,0,0,0,Houston,29,26,34,21,0,0,0,0,20150119,98,110,8,10,21,12,12,208,12,2014,0,0,865,0
Boston,17,20,25,31,0,0,0,0,LA Clippers,23,24,27,28,0,0,0,0,20150119,93,102,6,10,12,9,9,195,9,2014,0,0,2590,0
Dallas,25,28,29,21,0,0,0,0,Memphis,16,30,29,20,0,0,0,0,20150119,103,95,9,7,7,8,8,198,-8,2014,0,0,419,0
Toronto,22,31,15,24,0,0,0,0,Milwaukee,25,19,18,27,0,0,0,0,20150119,92,89,-3,9,6,3,3,181,-3,2014,0,0,429,0
New Orleans,16,25,24,27,0,0,0,0,New York,22,31,25,21,0,0,0,0,20150119,92,99,6,12,13,7,7,191,7,2014,0,0,1168,0
LA Lakers,26,25,26,23,0,0,0,0,Phoenix,26,25,36,28,0,0,0,0,20150119,100,115,0,0,10,15,15,215,15,2014,0,0,356,0
Sacramento,31,25,19,19,0,0,0,0,Portland,23,28,16,31,0,0,0,0,20150119,94,98,-8,-5,-8,4,4,192,4,2014,0,0,483,0
Philadelphia,14,18,26,18,0,0,0,0,Washington,27,28,30,26,0,0,0,0,20150119,76,111,13,23,27,35,35,187,35,2014,0,0,123,0
San Antonio,20,31,29,29,0,0,0,0,Denver,20,28,28,23,0,0,0,0,20150120,109,99,0,3,4,10,10,208,-10,2014,0,1,802,0
Oklahoma City,24,25,23,22,0,0,0,0,Miami,27,23,17,19,0,0,0,0,20150120,94,86,-3,-1,5,8,8,180,-8,2014,0,1,1225,0
New York,18,31,25,24,0,0,0,0,Philadelphia,18,24,20,29,0,0,0,0,20150121,98,91,0,7,12,7,7,189,-7,2014,0,2,80,0
Portland,29,23,24,37,0,0,0,0,Phoenix,40,26,25,27,0,0,0,0,20150121,113,118,11,14,15,5,5,231,5,2014,0,2,1005,0
LA Lakers,20,24,24,12,0,0,0,0,New Orleans,22,21,26,27,0,0,0,0,20150121,80,96,2,-1,1,16,16,176,16,2014,0,2,1669,0
Oklahoma City,26,12,28,26,13,0,0,0,Washington,31,19,20,22,11,0,0,0,20150121,105,103,-5,-12,-4,0,2,208,-2,2014,1,2,1149,0
Brooklyn,36,26,20,21,0,0,0,0,Sacramento,24,22,23,31,0,0,0,0,20150121,103,100,12,16,13,3,3,203,-3,2014,0,2,2499,0
Toronto,16,22,23,25,0,0,0,0,Memphis,16,25,19,32,0,0,0,0,20150121,86,92,0,3,-1,6,6,178,6,2014,0,2,815,0
Orlando,24,24,36,34,0,0,0,0,Detroit,35,30,31,32,0,0,0,0,20150121,118,128,11,17,12,10,10,246,10,2014,0,2,957,0
Houston,29,13,36,35,0,0,0,0,Golden State,32,30,40,24,0,0,0,0,20150121,113,126,3,20,24,13,13,239,13,2014,0,2,1642,0
Indiana,21,20,23,27,0,0,0,0,Atlanta,25,27,36,22,0,0,0,0,20150121,91,110,4,11,24,19,19,201,19,2014,0,2,427,0
Miami,17,22,16,21,0,0,0,0,Charlotte,25,20,20,13,0,0,0,0,20150121,76,78,8,6,10,2,2,154,2,2014,0,2,654,0
Dallas,24,35,16,23,0,0,0,0,Minnesota,21,17,19,18,0,0,0,0,20150121,98,75,3,21,18,23,23,173,-23,2014,0,2,863,0
Utah,20,20,22,30,0,0,0,0,Cleveland,31,22,29,24,0,0,0,0,20150121,92,106,11,13,20,14,14,198,14,2014,0,2,1564,0
San Antonio,22,18,20,21,0,0,0,0,Chicago,21,25,31,27,0,0,0,0,20150122,81,104,-1,6,17,23,23,185,23,2014,0,3,1050,0
Brooklyn,23,14,19,28,0,0,0,0,LA Clippers,34,36,27,26,0,0,0,0,20150122,84,123,11,33,41,39,39,207,39,2014,0,3,2445,0
Utah,26,27,23,25,0,0,0,0,Milwaukee,16,31,32,20,0,0,0,0,20150122,101,99,10,6,-3,2,2,200,-2,2014,0,3,1239,0
Boston,23,21,23,23,0,0,0,0,Portland,19,23,30,17,0,0,0,0,20150122,90,89,4,2,-5,1,1,179,-1,2014,0,3,2532,0
LA Lakers,15,23,23,24,0,0,0,0,San Antonio,31,25,20,23,0,0,0,0,20150123,85,99,16,18,15,14,14,184,14,2014,0,4,1201,0
Houston,32,28,27,26,0,0,0,0,Phoenix,24,28,25,34,0,0,0,0,20150123,113,111,8,8,10,2,2,224,-2,2014,0,4,1014,0
Toronto,22,26,15,28,0,0,0,0,Philadelphia,30,11,21,24,0,0,0,0,20150123,91,86,-8,7,1,5,5,177,-5,2014,0,4,334,0
New Orleans,24,21,24,23,0,0,0,0,Minnesota,20,24,19,21,0,0,0,0,20150123,92,84,4,1,6,8,8,176,-8,2014,0,4,1052,0
Indiana,18,19,27,23,0,0,0,0,Miami,26,28,21,14,0,0,0,0,20150123,87,89,8,17,11,2,2,176,2,2014,0,4,1026,0
Orlando,26,24,28,28,0,0,0,0,New York,20,31,31,31,0,0,0,0,20150123,106,113,-6,1,4,7,7,219,7,2014,0,4,939,0
Boston,20,22,33,25,0,0,0,0,Denver,28,20,26,25,0,0,0,0,20150123,100,99,-8,-6,1,1,1,199,-1,2014,0,4,1765,0
Chicago,30,24,26,22,0,0,0,0,Dallas,21,30,24,23,0,0,0,0,20150123,102,98,9,3,5,4,4,200,-4,2014,0,4,802,0
Charlotte,13,27,23,27,0,0,0,0,Cleveland,33,42,28,26,0,0,0,0,20150123,90,129,20,35,40,39,39,219,39,2014,0,4,435,0
Oklahoma City,30,17,28,18,0,0,0,0,Atlanta,23,25,31,24,0,0,0,0,20150123,93,103,-7,1,4,10,10,196,10,2014,0,4,755,0
Sacramento,25,26,22,28,0,0,0,0,Golden State,34,22,41,29,0,0,0,0,20150123,101,126,9,5,24,25,25,227,25,2014,0,4,75,0
New York,23,14,17,17,0,0,0,0,Charlotte,16,20,21,19,0,0,0,0,20150124,71,76,-7,-1,3,5,5,147,5,2014,0,5,531,0
Philadelphia,21,20,20,22,0,0,0,0,Memphis,27,33,21,20,0,0,0,0,20150124,83,101,6,19,20,18,18,184,18,2014,0,5,878,0
Detroit,28,21,18,19,0,0,0,0,Milwaukee,23,40,28,10,0,0,0,0,20150124,86,101,-5,14,24,15,15,187,15,2014,0,5,251,0
Washington,32,23,15,26,0,0,0,0,Portland,20,25,24,34,0,0,0,0,20150124,96,103,-12,-10,-1,7,7,199,7,2014,0,5,2347,0
Brooklyn,21,16,22,14,0,0,0,0,Utah,25,33,23,27,0,0,0,0,20150124,73,108,4,21,22,35,35,181,35,2014,0,5,1967,0
Indiana,24,27,24,31,0,0,0,0,Orlando,27,22,33,17,0,0,0,0,20150125,106,99,-3,2,-7,7,7,205,-7,2014,0,6,822,0
Detroit,25,28,26,31,0,0,0,0,Toronto,26,32,31,25,0,0,0,0,20150125,110,114,1,5,10,4,4,224,4,2014,0,6,205,0
Milwaukee,24,31,12,28,0,0,0,0,San Antonio,21,26,22,32,0,0,0,0,20150125,95,101,-3,-8,2,6,6,196,6,2014,0,6,1108,0
LA Clippers,23,32,34,31,0,0,0,0,Phoenix,16,41,20,23,0,0,0,0,20150125,120,100,7,-2,12,20,20,220,-20,2014,0,6,356,0
Dallas,22,34,28,22,0,0,0,0,New Orleans,25,36,28,20,0,0,0,0,20150125,106,109,3,5,5,3,3,215,3,2014,0,6,442,0
Oklahoma City,26,23,29,20,0,0,0,0,Cleveland,20,37,26,25,0,0,0,0,20150125,98,108,-6,8,5,10,10,206,10,2014,0,6,949,0
Boston,23,26,28,34,0,0,0,0,Golden State,30,26,33,25,0,0,0,0,20150125,111,114,7,7,12,3,3,225,3,2014,0,6,2692,0
Houston,30,22,28,19,0,0,0,0,LA Lakers,15,21,24,27,0,0,0,0,20150125,99,87,15,16,20,12,12,186,-12,2014,0,6,1371,0
Miami,26,22,26,22,0,0,0,0,Chicago,20,18,24,22,0,0,0,0,20150125,96,84,6,10,12,12,12,180,-12,2014,0,6,1189,0
Minnesota,24,23,30,23,0,0,0,0,Atlanta,25,36,25,26,0,0,0,0,20150125,100,112,1,14,9,12,12,212,12,2014,0,6,908,0
Washington,28,31,24,22,12,0,0,0,Denver,26,33,25,21,10,0,0,0,20150125,117,115,2,0,-1,0,2,232,-2,2014,1,6,1489,0
Denver,31,16,30,21,0,0,0,0,LA Clippers,20,30,19,33,0,0,0,0,20150126,98,102,-11,3,-8,4,4,200,4,2014,0,0,830,0
Orlando,29,19,25,21,0,0,0,0,Memphis,34,33,22,14,0,0,0,0,20150126,94,103,5,19,16,9,9,197,9,2014,0,0,683,0
Philadelphia,19,24,19,12,0,0,0,0,New Orleans,30,22,33,14,0,0,0,0,20150126,74,99,11,9,23,25,25,173,25,2014,0,0,1088,0
Boston,17,38,16,28,0,0,0,0,Utah,17,14,35,24,0,0,0,0,20150126,99,90,0,24,5,9,9,189,-9,2014,0,0,2093,0
Minnesota,19,21,16,28,0,0,0,0,Oklahoma City,25,23,17,27,0,0,0,0,20150126,84,92,6,8,9,8,8,176,8,2014,0,0,694,0
Milwaukee,30,24,28,27,0,0,0,0,Miami,29,21,32,20,0,0,0,0,20150127,109,102,1,4,0,7,7,211,-7,2014,0,1,1269,0
Memphis,24,30,32,23,0,0,0,0,Dallas,24,20,28,18,0,0,0,0,20150127,109,90,0,10,14,19,19,199,-19,2014,0,1,419,0
Cleveland,17,30,28,28,0,0,0,0,Detroit,19,20,25,31,0,0,0,0,20150127,103,95,-2,8,11,8,8,198,-8,2014,0,1,90,0
Chicago,29,22,28,28,6,0,0,0,Golden State,35,21,25,26,4,0,0,0,20150127,113,111,-6,-5,-2,0,2,224,-2,2014,1,1,1853,0
Toronto,21,29,27,27,0,0,0,0,Indiana,28,16,24,23,0,0,0,0,20150127,104,91,-7,6,9,13,13,195,-13,2014,0,1,438,0
Washington,24,22,29,23,0,0,0,0,LA Lakers,31,26,19,16,0,0,0,0,20150127,98,92,-7,-11,-1,6,6,190,-6,2014,0,1,2294,0
Charlotte,19,19,26,22,0,0,0,0,San Antonio,27,28,14,26,0,0,0,0,20150128,86,95,8,17,5,9,9,181,9,2014,0,2,1103,0
Sacramento,22,32,22,26,0,0,0,0,Toronto,26,28,39,26,0,0,0,0,20150128,102,119,4,0,17,17,17,221,17,2014,0,2,2195,0
Washington,17,22,27,32,0,0,0,0,Phoenix,29,27,24,26,0,0,0,0,20150128,98,106,12,17,14,8,8,204,8,2014,0,2,1977,0
LA Clippers,24,25,19,26,0,0,0,0,Utah,26,24,22,17,0,0,0,0,20150128,94,89,-2,-1,-4,5,5,183,-5,2014,0,2,579,0
Detroit,16,21,18,14,0,0,0,0,Philadelphia,28,20,20,21,0,0,0,0,20150128,69,89,12,11,13,20,20,158,20,2014,0,2,441,0
Oklahoma City,19,26,22,25,0,0,0,0,New York,20,23,25,32,0,0,0,0,20150128,92,100,1,-2,1,8,8,192,8,2014,0,2,1324,0
Denver,28,21,21,23,0,0,0,0,New Orleans,17,22,31,15,0,0,0,0,20150128,93,85,11,10,0,8,8,178,-8,2014,0,2,1079,0
Boston,22,27,25,24,0,0,0,0,Minnesota,26,22,33,29,0,0,0,0,20150128,98,110,4,-1,7,12,12,208,12,2014,0,2,1120,0
Dallas,25,28,25,16,0,0,0,0,Houston,24,30,27,18,0,0,0,0,20150128,94,99,-1,1,3,5,5,193,5,2014,0,2,225,0
Portland,21,23,30,20,0,0,0,0,Cleveland,31,23,25,20,0,0,0,0,20150128,94,99,10,10,5,5,5,193,5,2014,0,2,2049,0
Brooklyn,27,26,28,21,0,0,0,0,Atlanta,30,34,25,24,0,0,0,0,20150128,102,113,3,11,8,11,11,215,11,2014,0,2,745,0
New York,29,20,12,21,0,0,0,0,Indiana,22,32,35,14,0,0,0,0,20150129,82,103,-7,5,28,21,21,185,21,2014,0,3,643,0
Chicago,19,29,28,22,8,12,0,0,LA Lakers,28,31,21,18,8,17,0,0,20150129,118,123,9,11,4,0,5,241,5,2014,2,3,1741,0
Denver,11,24,14,20,0,0,0,0,Memphis,26,24,24,25,0,0,0,0,20150129,69,99,15,15,25,30,30,168,30,2014,0,3,877,0
Milwaukee,28,31,37,19,0,0,0,0,Orlando,18,26,27,29,0,0,0,0,20150129,115,100,10,15,25,15,15,215,-15,2014,0,3,1065,0
Golden State,19,26,23,32,0,0,0,0,Utah,23,33,25,29,0,0,0,0,20150130,100,110,4,11,13,10,10,210,10,2014,0,4,599,0
Chicago,23,19,25,26,0,0,0,0,Phoenix,26,29,13,31,0,0,0,0,20150130,93,99,3,13,1,6,6,192,6,2014,0,4,1450,0
Minnesota,28,31,18,17,0,0,0,0,Philadelphia,26,35,17,25,0,0,0,0,20150130,94,103,-2,2,1,9,9,197,9,2014,0,4,983,0
LA Clippers,26,28,22,27,0,0,0,0,New Orleans,28,25,35,20,0,0,0,0,20150130,103,108,2,-1,12,5,5,211,5,2014,0,4,1669,0
Toronto,29,37,25,22,14,0,0,0,Brooklyn,23,31,28,31,9,0,0,0,20150130,127,122,6,12,9,0,5,249,-5,2014,1,4,341,0
Sacramento,20,24,21,25,0,0,0,0,Cleveland,30,25,31,15,0,0,0,0,20150130,90,101,10,11,21,11,11,191,11,2014,0,4,2096,0
Houston,29,31,9,24,0,0,0,0,Boston,21,21,22,23,0,0,0,0,20150130,93,87,8,18,5,6,6,180,-6,2014,0,4,1603,0
Portland,29,22,23,25,0,0,0,0,Atlanta,27,23,19,36,0,0,0,0,20150130,99,105,-2,-1,-5,6,6,204,6,2014,0,4,2168,0
Dallas,13,20,27,33,0,0,0,0,Miami,15,30,15,12,0,0,0,0,20150130,93,72,-2,-12,0,21,21,165,-21,2014,0,4,1110,0
Cleveland,30,22,24,30,0,0,0,0,Minnesota,21,28,30,11,0,0,0,0,20150131,106,90,9,3,-3,16,16,196,-16,2014,0,5,629,0
Toronto,33,32,29,15,11,0,0,0,Washington,30,20,28,31,7,0,0,0,20150131,120,116,3,15,16,0,4,236,-4,2014,1,5,349,0
LA Clippers,29,27,28,21,0,0,0,0,San Antonio,25,17,27,16,0,0,0,0,20150131,105,85,4,14,15,20,20,190,-20,2014,0,5,1201,0
Dallas,34,32,22,20,0,0,0,0,Orlando,17,24,29,23,0,0,0,0,20150131,108,93,17,25,18,15,15,201,-15,2014,0,5,961,0
Oklahoma City,20,20,22,12,0,0,0,0,Memphis,25,20,23,17,0,0,0,0,20150131,74,85,5,5,6,11,11,159,11,2014,0,5,421,0
Portland,15,27,23,23,0,0,0,0,Milwaukee,27,18,31,19,0,0,0,0,20150131,88,95,12,3,11,7,7,183,7,2014,0,5,1714,0
Phoenix,28,23,19,17,0,0,0,0,Golden State,23,29,26,28,0,0,0,0,20150131,87,106,-5,1,8,19,19,193,19,2014,0,5,652,0
Houston,27,19,23,32,0,0,0,0,Detroit,32,27,27,28,0,0,0,0,20150131,101,114,5,13,17,13,13,215,13,2014,0,5,1105,0
Charlotte,30,32,18,24,0,0,0,0,Denver,15,15,22,34,0,0,0,0,20150131,104,86,15,32,28,18,18,190,-18,2014,0,5,1355,0
Philadelphia,10,24,32,19,0,0,0,0,Atlanta,22,27,22,20,0,0,0,0,20150131,85,91,12,15,5,6,6,176,6,2014,0,5,665,0
Sacramento,34,30,15,20,0,0,0,0,Indiana,21,29,17,27,0,0,0,0,20150131,99,94,13,14,12,5,5,193,-5,2014,0,5,1882,0
Miami,25,19,17,22,0,0,0,0,Boston,15,16,28,16,0,0,0,0,20150201,83,75,10,13,2,8,8,158,-8,2014,0,6,1257,0
LA Lakers,19,20,18,23,0,0,0,0,New York,32,15,25,20,0,0,0,0,20150201,80,92,13,8,15,12,12,172,12,2014,0,6,2445,0
Memphis,25,24,28,25,0,0,0,0,Phoenix,23,21,28,29,0,0,0,0,20150202,102,101,2,5,5,1,1,203,-1,2014,0,0,1260,0
Charlotte,28,25,17,22,0,0,0,0,Washington,24,27,15,22,0,0,0,0,20150202,92,88,4,2,4,4,4,180,-4,2014,0,0,329,0
Milwaukee,23,24,26,9,0,0,0,0,Toronto,14,27,19,15,0,0,0,0,20150202,82,75,9,6,13,7,7,157,-7,2014,0,0,429,0
Orlando,22,28,17,30,0,0,0,0,Oklahoma City,29,32,21,22,0,0,0,0,20150202,97,104,7,11,15,7,7,201,7,2014,0,0,1057,0
Atlanta,22,20,32,26,0,0,0,0,New Orleans,32,23,33,27,0,0,0,0,20150202,100,115,10,13,14,15,15,215,15,2014,0,0,424,0
Minnesota,20,27,26,21,0,0,0,0,Dallas,30,24,27,19,0,0,0,0,20150202,94,100,10,7,8,6,6,194,6,2014,0,0,863,0
Philadelphia,15,20,30,19,0,0,0,0,Cleveland,24,23,22,28,0,0,0,0,20150202,84,97,9,12,4,13,13,181,13,2014,0,0,358,0
LA Clippers,22,14,36,28,0,0,0,0,Brooklyn,22,16,32,32,0,0,0,0,20150202,100,102,0,2,-2,2,2,202,2,2014,0,0,2445,0
Miami,12,27,28,24,0,0,0,0,Detroit,33,20,32,23,0,0,0,0,20150203,91,108,21,14,18,17,17,199,17,2014,0,1,1155,0
Boston,26,31,23,28,0,0,0,0,New York,19,25,28,25,0,0,0,0,20150203,108,97,7,13,8,11,11,205,-11,2014,0,1,190,0
Denver,28,12,28,30,0,0,0,0,Philadelphia,34,27,24,20,0,0,0,0,20150203,98,105,6,21,17,7,7,203,7,2014,0,1,1574,0
Utah,23,24,23,32,0,0,0,0,Portland,27,17,28,31,0,0,0,0,20150203,102,103,4,-3,2,1,1,205,1,2014,0,1,634,0
Golden State,29,34,31,27,0,0,0,0,Sacramento,22,20,38,16,0,0,0,0,20150203,121,96,7,21,14,25,25,217,-25,2014,0,1,75,0
Oklahoma City,31,20,26,25,0,0,0,0,New Orleans,29,28,19,15,0,0,0,0,20150204,102,91,2,-6,1,11,11,193,-11,2014,0,2,576,0
Miami,24,27,32,18,0,0,0,0,Minnesota,27,26,23,26,0,0,0,0,20150204,101,102,3,2,-7,1,1,203,1,2014,0,2,1513,0
Memphis,30,28,19,23,0,0,0,0,Utah,23,28,20,19,0,0,0,0,20150204,100,90,7,7,6,10,10,190,-10,2014,0,2,1247,0
Orlando,25,19,30,29,0,0,0,0,San Antonio,24,27,27,32,0,0,0,0,20150204,103,110,-1,7,4,7,7,213,7,2014,0,2,1035,0
LA Lakers,24,30,14,26,11,0,0,0,Milwaukee,26,20,28,20,19,0,0,0,20150204,105,113,2,-8,6,0,8,218,8,2014,1,2,1741,0
Brooklyn,22,27,27,33,0,0,0,0,Toronto,28,23,21,21,0,0,0,0,20150204,109,93,-6,-2,4,16,16,202,-16,2014,0,2,341,0
Chicago,27,21,22,20,0,0,0,0,Houston,27,30,18,26,0,0,0,0,20150204,90,101,0,9,5,11,11,191,11,2014,0,2,939,0
Dallas,42,20,36,16,0,0,0,0,Golden State,25,33,43,27,0,0,0,0,20150204,114,128,-17,-4,3,14,14,242,14,2014,0,2,1480,0
Denver,29,22,27,22,0,0,0,0,Boston,26,35,22,21,0,0,0,0,20150204,100,104,-3,10,5,4,4,204,4,2014,0,2,1765,0
Washington,18,28,28,22,0,0,0,0,Atlanta,29,30,18,28,0,0,0,0,20150204,96,105,11,13,3,9,9,201,9,2014,0,2,541,0
Detroit,26,23,27,33,0,0,0,0,Indiana,29,19,33,33,0,0,0,0,20150204,109,114,3,-1,5,5,5,223,5,2014,0,2,240,0
Dallas,23,37,23,18,0,0,0,0,Sacramento,23,20,17,18,0,0,0,0,20150205,101,78,0,17,23,23,23,179,-23,2014,0,3,1437,0
Phoenix,15,20,30,22,0,0,0,0,Portland,27,19,20,42,0,0,0,0,20150205,87,108,12,11,1,21,21,195,21,2014,0,3,1005,0
Washington,30,24,20,13,0,0,0,0,Charlotte,34,15,20,25,0,0,0,0,20150205,87,94,4,-5,-5,7,7,181,7,2014,0,3,329,0
LA Clippers,20,22,21,31,0,0,0,0,Cleveland,30,35,29,11,0,0,0,0,20150205,94,105,10,23,31,11,11,199,11,2014,0,3,2044,0
Miami,19,22,20,24,0,0,0,0,San Antonio,30,22,25,21,0,0,0,0,20150206,85,98,11,11,16,13,13,183,13,2014,0,4,1147,0
Utah,24,18,29,22,0,0,0,0,Phoenix,25,29,22,24,0,0,0,0,20150206,93,100,1,12,5,7,7,193,7,2014,0,4,505,0
LA Lakers,23,29,26,13,6,0,0,0,Orlando,26,12,31,22,12,0,0,0,20150206,97,103,3,-14,-9,0,6,200,6,2014,1,4,2197,0
New Orleans,29,24,30,33,0,0,0,0,Oklahoma City,33,23,25,32,0,0,0,0,20150206,116,113,-4,-3,2,3,3,229,-3,2014,0,4,576,0
Memphis,23,20,26,20,0,0,0,0,Minnesota,24,19,22,25,0,0,0,0,20150206,89,90,1,0,-4,1,1,179,1,2014,0,4,700,0
LA Clippers,34,25,20,28,0,0,0,0,Toronto,19,38,38,28,0,0,0,0,20150206,107,123,-15,-2,16,16,16,230,16,2014,0,4,2170,0
Milwaukee,23,33,26,29,0,0,0,0,Houston,36,32,28,21,0,0,0,0,20150206,111,117,13,12,14,6,6,228,6,2014,0,4,1005,0
Denver,21,21,20,26,0,0,0,0,Detroit,28,28,24,18,0,0,0,0,20150206,88,98,7,14,18,10,10,186,10,2014,0,4,1154,0
New York,21,24,25,18,0,0,0,0,Brooklyn,29,24,15,24,0,0,0,0,20150206,88,92,8,8,-2,4,4,180,4,2014,0,4,0,0
Philadelphia,15,27,27,27,0,0,0,0,Boston,29,31,15,32,0,0,0,0,20150206,96,107,14,18,6,11,11,203,11,2014,0,4,270,0
Golden State,25,27,33,31,0,0,0,0,Atlanta,21,31,37,35,0,0,0,0,20150206,116,124,-4,0,4,8,8,240,8,2014,0,4,2135,0
Cleveland,31,24,15,29,0,0,0,0,Indiana,27,20,20,36,0,0,0,0,20150206,99,103,-4,-8,-3,4,4,202,4,2014,0,4,262,0
Brooklyn,19,19,23,16,0,0,0,0,Washington,28,30,31,25,0,0,0,0,20150207,77,114,9,20,28,37,37,191,37,2014,0,5,204,0
Sacramento,15,24,22,29,0,0,0,0,Utah,25,24,26,27,0,0,0,0,20150207,90,102,10,10,14,12,12,192,12,2014,0,5,532,0
Charlotte,24,24,13,20,0,0,0,0,Philadelphia,23,19,28,19,0,0,0,0,20150207,81,89,-1,-6,9,8,8,170,8,2014,0,5,450,0
Chicago,18,30,33,26,0,0,0,0,New Orleans,20,19,17,16,0,0,0,0,20150207,107,72,-2,9,25,35,35,179,-35,2014,0,5,832,0
Boston,23,23,29,18,0,0,0,0,Milwaukee,23,30,27,16,0,0,0,0,20150207,93,96,0,7,5,3,3,189,3,2014,0,5,855,0
Portland,25,30,28,13,5,0,0,0,Dallas,24,26,20,26,15,0,0,0,20150207,101,111,-1,-5,-13,0,10,212,10,2014,1,5,1630,0
Golden State,32,32,27,15,0,0,0,0,New York,19,29,26,18,0,0,0,0,20150207,106,92,13,16,17,14,14,198,-14,2014,0,5,2565,0
LA Clippers,26,30,19,33,0,0,0,0,Oklahoma City,28,38,35,30,0,0,0,0,20150208,108,131,2,10,26,23,23,239,23,2014,0,6,1178,0
San Antonio,25,21,12,24,0,0,0,0,Toronto,28,17,19,23,0,0,0,0,20150208,82,87,3,-1,6,5,5,169,5,2014,0,6,1438,0
Phoenix,18,24,17,24,0,0,0,0,Sacramento,26,22,25,12,0,0,0,0,20150208,83,85,8,6,14,2,2,168,2,2014,0,6,634,0
Chicago,32,18,24,24,0,0,0,0,Orlando,16,29,29,23,0,0,0,0,20150208,98,97,16,5,0,1,1,195,-1,2014,0,6,984,0
Atlanta,16,27,23,22,0,0,0,0,Memphis,20,22,27,25,0,0,0,0,20150208,88,94,4,-1,3,6,6,182,6,2014,0,6,336,0
Minnesota,32,29,20,31,0,0,0,0,Detroit,24,27,22,28,0,0,0,0,20150208,112,101,8,10,8,11,11,213,-11,2014,0,6,542,0
LA Lakers,28,21,30,26,0,0,0,0,Cleveland,32,32,32,24,0,0,0,0,20150208,105,120,4,15,17,15,15,225,15,2014,0,6,2044,0
Indiana,20,19,36,28,0,0,0,0,Charlotte,32,24,27,19,0,0,0,0,20150208,103,102,-12,-17,-8,1,1,205,-1,2014,0,6,428,0
Portland,26,35,20,28,0,0,0,0,Houston,27,21,32,18,0,0,0,0,20150208,109,98,-1,13,1,11,11,207,-11,2014,0,6,1833,0
Utah,27,15,29,29,0,0,0,0,New Orleans,25,27,15,29,0,0,0,0,20150209,100,96,2,-10,4,4,4,196,-4,2014,0,0,1432,0
Orlando,16,19,19,26,0,0,0,0,Washington,24,19,31,22,0,0,0,0,20150209,80,96,8,8,20,16,16,176,16,2014,0,0,757,0
Golden State,20,26,21,22,0,0,0,0,Philadelphia,24,20,17,23,0,0,0,0,20150209,89,84,-4,2,6,5,5,173,-5,2014,0,0,2516,0
Brooklyn,30,22,16,29,0,0,0,0,Milwaukee,24,23,32,24,0,0,0,0,20150209,97,103,-6,-5,11,6,6,200,6,2014,0,0,732,0
Atlanta,32,25,29,31,0,0,0,0,Minnesota,30,23,19,33,0,0,0,0,20150209,117,105,2,4,14,12,12,222,-12,2014,0,0,908,0
San Antonio,30,17,18,30,0,0,0,0,Indiana,28,17,34,14,0,0,0,0,20150209,95,93,2,2,-14,2,2,188,-2,2014,0,0,999,0
Oklahoma City,38,35,33,18,0,0,0,0,Denver,18,41,33,22,0,0,0,0,20150209,124,114,20,14,14,10,10,238,-10,2014,0,0,503,0
LA Clippers,32,34,28,21,0,0,0,0,Dallas,31,22,27,18,0,0,0,0,20150209,115,98,1,13,14,17,17,213,-17,2014,0,0,1237,0
New York,32,24,18,21,0,0,0,0,Miami,23,29,25,32,0,0,0,0,20150209,95,109,-9,-4,3,14,14,204,14,2014,0,0,1091,0
Brooklyn,15,25,22,24,0,0,0,0,Memphis,32,20,23,20,0,0,0,0,20150210,86,95,17,12,13,9,9,181,9,2014,0,1,953,0
Sacramento,26,23,15,22,0,0,0,0,Chicago,30,27,27,20,0,0,0,0,20150210,86,104,4,8,20,18,18,190,18,2014,0,1,1788,0
Detroit,26,28,29,23,0,0,0,0,Charlotte,27,19,14,18,0,0,0,0,20150210,106,78,-1,8,23,28,28,184,-28,2014,0,1,504,0
Denver,24,21,26,35,0,0,0,0,LA Lakers,29,19,23,25,0,0,0,0,20150210,106,96,-5,-3,0,10,10,202,-10,2014,0,1,830,0
Houston,41,29,18,39,0,0,0,0,Phoenix,23,38,28,29,0,0,0,0,20150210,127,118,18,9,-1,9,9,245,-9,2014,0,1,1014,0
Memphis,26,22,21,20,0,0,0,0,Oklahoma City,35,31,19,20,0,0,0,0,20150211,89,105,9,18,16,16,16,194,16,2014,0,2,421,0
New York,24,23,13,23,0,0,0,0,Orlando,27,17,20,25,0,0,0,0,20150211,83,89,3,-3,4,6,6,172,6,2014,0,2,939,0
Indiana,32,25,32,17,0,0,0,0,New Orleans,18,17,25,33,0,0,0,0,20150211,106,93,14,22,29,13,13,199,-13,2014,0,2,713,0
Washington,25,22,29,17,0,0,0,0,Toronto,27,22,26,20,0,0,0,0,20150211,93,95,2,2,-1,2,2,188,2,2014,0,2,349,0
LA Lakers,24,22,19,21,0,0,0,0,Portland,32,22,34,14,0,0,0,0,20150211,86,102,8,8,23,16,16,188,16,2014,0,2,826,0
Golden State,28,28,17,21,0,0,0,0,Minnesota,25,21,21,24,0,0,0,0,20150211,94,91,3,10,6,3,3,185,-3,2014,0,2,1581,0
Sacramento,29,22,18,34,0,0,0,0,Milwaukee,29,31,27,24,0,0,0,0,20150211,103,111,0,9,18,8,8,214,8,2014,0,2,1771,0
Houston,26,30,23,16,0,0,0,0,LA Clippers,26,28,26,30,0,0,0,0,20150211,95,110,0,-2,1,15,15,205,15,2014,0,2,1371,0
San Antonio,20,28,34,22,0,0,0,0,Detroit,12,27,24,24,0,0,0,0,20150211,104,87,8,9,19,17,17,191,-17,2014,0,2,1238,0
Utah,9,28,20,25,0,0,0,0,Dallas,22,17,25,23,0,0,0,0,20150211,82,87,13,2,7,5,5,169,5,2014,0,2,998,0
Miami,23,25,21,24,0,0,0,0,Cleveland,38,21,26,28,0,0,0,0,20150211,93,113,15,11,16,20,20,206,20,2014,0,2,1089,0
Atlanta,23,26,23,16,0,0,0,0,Boston,13,21,27,28,0,0,0,0,20150211,88,89,-10,-15,-11,1,1,177,1,2014,0,2,935,0
Cleveland,26,22,29,21,0,0,0,0,Chicago,30,25,32,26,0,0,0,0,20150212,98,113,4,7,10,15,15,211,15,2014,0,3,308,0
San Antonio,24,31,33,27,0,0,0,0,LA Clippers,27,25,38,29,0,0,0,0,20150219,115,119,3,-3,2,4,4,234,4,2014,0,3,1201,0
Dallas,19,17,29,24,0,0,0,0,Oklahoma City,25,27,31,21,0,0,0,0,20150219,89,104,6,16,18,15,15,193,15,2014,0,3,189,0
Cleveland,35,30,29,33,0,0,0,0,Washington,26,25,20,18,0,0,0,0,20150220,127,89,9,14,23,38,38,216,-38,2014,0,4,304,0
Portland,24,19,16,17,0,0,0,0,Utah,18,21,26,27,0,0,0,0,20150220,76,92,-6,-4,6,16,16,168,16,2014,0,4,634,0
Boston,27,24,23,27,0,0,0,0,Sacramento,28,28,26,27,0,0,0,0,20150220,101,109,1,5,8,8,8,210,8,2014,0,4,2624,0
Indiana,23,35,29,19,0,0,0,0,Philadelphia,16,24,28,27,0,0,0,0,20150220,106,95,7,18,19,11,11,201,-11,2014,0,4,582,0
New Orleans,20,27,24,13,0,0,0,0,Orlando,19,24,30,22,0,0,0,0,20150220,84,95,-1,-4,2,11,11,179,11,2014,0,4,533,0
Miami,25,33,29,24,0,0,0,0,New York,26,22,20,19,0,0,0,0,20150220,111,87,-1,10,19,24,24,198,-24,2014,0,4,1091,0
San Antonio,29,26,13,31,0,0,0,0,Golden State,27,35,27,21,0,0,0,0,20150220,99,110,-2,7,21,11,11,209,11,2014,0,4,1487,0
Denver,21,23,21,16,0,0,0,0,Milwaukee,19,23,28,19,0,0,0,0,20150220,81,89,-2,-2,5,8,8,170,8,2014,0,4,912,0
Brooklyn,34,22,40,18,0,0,0,0,LA Lakers,32,25,20,28,0,0,0,0,20150220,114,105,2,-1,19,9,9,219,-9,2014,0,4,2445,0
Chicago,23,30,15,23,0,0,0,0,Detroit,22,23,32,23,0,0,0,0,20150220,91,100,-1,-8,9,9,9,191,9,2014,0,4,238,0
Houston,20,23,24,33,0,0,0,0,Dallas,24,30,33,24,0,0,0,0,20150220,100,111,4,11,20,11,11,211,11,2014,0,4,225,0
Toronto,26,23,28,28,0,0,0,0,Atlanta,26,19,13,22,0,0,0,0,20150220,105,80,0,4,19,25,25,185,-25,2014,0,4,733,0
Phoenix,24,18,35,32,0,0,0,0,Minnesota,26,26,28,31,0,0,0,0,20150220,109,111,2,10,3,2,2,220,2,2014,0,4,1278,0
New Orleans,25,27,33,20,0,0,0,0,Miami,14,28,23,26,0,0,0,0,20150221,105,91,11,10,20,14,14,196,-14,2014,0,5,668,0
Sacramento,29,18,18,34,0,0,0,0,LA Clippers,24,42,31,29,0,0,0,0,20150221,99,126,-5,19,32,27,27,225,27,2014,0,5,361,0
Toronto,18,18,17,23,0,0,0,0,Houston,20,20,28,30,0,0,0,0,20150221,76,98,2,4,15,22,22,174,22,2014,0,5,1299,0
Oklahoma City,28,31,27,24,0,0,0,0,Charlotte,30,26,27,20,0,0,0,0,20150221,110,103,-2,3,3,7,7,213,-7,2014,0,5,938,0
Phoenix,28,28,27,24,0,0,0,0,Chicago,33,19,29,31,0,0,0,0,20150221,107,112,5,-4,-2,5,5,219,5,2014,0,5,1450,0
Charlotte,16,19,21,25,0,0,0,0,Dallas,28,17,22,25,0,0,0,0,20150222,81,92,12,10,11,11,11,173,11,2014,0,6,928,0
Washington,22,30,19,18,0,0,0,0,Detroit,27,20,35,24,0,0,0,0,20150222,89,106,5,-5,11,17,17,195,17,2014,0,6,394,0
Golden State,38,19,21,20,0,0,0,0,Indiana,26,32,23,23,0,0,0,0,20150222,98,104,-12,1,3,6,6,202,6,2014,0,6,1944,0
Boston,32,26,20,28,5,0,0,0,LA Lakers,26,30,17,33,12,0,0,0,20150222,111,118,-6,-2,-5,0,7,229,7,2014,1,6,2590,0
Atlanta,22,26,18,31,0,0,0,0,Milwaukee,13,22,29,22,0,0,0,0,20150222,97,86,9,13,2,11,11,183,-11,2014,0,6,669,0
Cleveland,36,26,19,20,0,0,0,0,New York,17,21,17,28,0,0,0,0,20150222,101,83,19,24,26,18,18,184,-18,2014,0,6,403,0
Denver,18,24,27,25,0,0,0,0,Oklahoma City,36,31,31,21,0,0,0,0,20150222,94,119,18,25,29,25,25,213,25,2014,0,6,503,0
Philadelphia,23,24,22,29,0,0,0,0,Orlando,29,26,21,27,0,0,0,0,20150222,98,103,6,8,7,5,5,201,5,2014,0,6,864,0
Memphis,19,19,26,34,0,0,0,0,Portland,21,17,39,15,0,0,0,0,20150222,98,92,-2,0,-13,6,6,190,-6,2014,0,6,1845,0
San Antonio,22,18,24,17,0,0,0,0,Utah,28,19,26,17,0,0,0,0,20150223,81,90,6,7,9,9,9,171,9,2014,0,0,1087,0
Boston,26,41,22,26,0,0,0,0,Phoenix,21,29,29,31,0,0,0,0,20150223,115,110,5,17,10,5,5,225,-5,2014,0,0,2295,0
Toronto,28,28,18,23,0,0,0,0,New Orleans,17,27,23,33,0,0,0,0,20150223,97,100,-11,-12,-7,3,3,197,3,2014,0,0,1112,0
Philadelphia,31,29,19,29,0,0,0,0,Miami,32,29,30,28,0,0,0,0,20150223,108,119,1,1,12,11,11,227,11,2014,0,0,1021,0
Milwaukee,15,18,16,22,0,0,0,0,Chicago,21,27,16,23,0,0,0,0,20150223,71,87,6,15,15,16,16,158,16,2014,0,0,83,0
Minnesota,25,31,19,27,0,0,0,0,Houston,26,30,28,29,0,0,0,0,20150223,102,113,1,0,9,11,11,215,11,2014,0,0,1057,0
Brooklyn,26,28,31,25,0,0,0,0,Denver,23,22,24,13,0,0,0,0,20150223,110,82,3,9,16,28,28,192,-28,2014,0,0,1627,0
Memphis,21,17,28,24,0,0,0,0,LA Clippers,22,22,24,19,0,0,0,0,20150223,90,87,-1,-6,-2,3,3,177,-3,2014,0,0,1599,0
Golden State,30,24,32,28,0,0,0,0,Washington,28,23,32,24,0,0,0,0,20150224,114,107,2,3,3,7,7,221,-7,2014,0,1,2435,0
Toronto,29,26,22,15,0,0,0,0,Dallas,25,24,25,25,0,0,0,0,20150224,92,99,-4,-6,-3,7,7,191,7,2014,0,1,1201,0
Cleveland,30,23,24,25,0,0,0,0,Detroit,27,35,12,19,0,0,0,0,20150224,102,93,3,-9,3,9,9,195,-9,2014,0,1,90,0
Indiana,20,22,27,23,0,0,0,0,Oklahoma City,30,18,32,25,0,0,0,0,20150224,92,105,10,6,11,13,13,197,13,2014,0,1,688,0
Miami,17,19,25,24,8,0,0,0,Orlando,17,23,21,24,5,0,0,0,20150225,93,90,0,-4,0,0,3,183,-3,2014,1,2,204,0
Brooklyn,21,29,23,23,0,0,0,0,New Orleans,27,26,23,26,0,0,0,0,20150225,96,102,6,3,3,6,6,198,6,2014,0,2,1168,0
Memphis,25,27,25,13,0,0,0,0,Sacramento,32,30,14,26,0,0,0,0,20150225,90,102,7,10,-1,12,12,192,12,2014,0,2,1745,0
San Antonio,16,34,21,24,0,0,0,0,Portland,32,19,30,30,0,0,0,0,20150225,95,111,16,1,10,16,16,206,16,2014,0,2,1718,0
LA Lakers,21,24,24,31,0,0,0,0,Utah,29,22,27,19,0,0,0,0,20150225,100,97,-8,-6,-9,3,3,197,-3,2014,0,2,579,0
Washington,20,22,18,17,0,0,0,0,Minnesota,11,31,32,23,0,0,0,0,20150225,77,97,-9,0,14,20,20,174,20,2014,0,2,931,0
LA Clippers,26,34,25,20,0,0,0,0,Houston,27,35,22,26,0,0,0,0,20150225,105,110,1,2,-1,5,5,215,5,2014,0,2,1371,0
Phoenix,35,23,25,27,0,0,0,0,Denver,26,25,22,23,0,0,0,0,20150225,110,96,9,7,10,14,14,206,-14,2014,0,2,585,0
Charlotte,20,24,23,31,0,0,0,0,Chicago,20,24,21,21,0,0,0,0,20150225,98,86,0,0,2,12,12,184,-12,2014,0,2,586,0
New York,25,24,23,22,0,0,0,0,Boston,23,25,32,35,0,0,0,0,20150225,94,115,-2,-1,8,21,21,209,21,2014,0,2,190,0
Dallas,34,19,15,19,0,0,0,0,Atlanta,22,25,30,27,0,0,0,0,20150225,87,104,-12,-6,9,17,17,191,17,2014,0,2,719,0
Philadelphia,12,20,28,28,0,0,0,0,Milwaukee,29,32,21,22,0,0,0,0,20150225,88,104,17,29,22,16,16,192,16,2014,0,2,692,0
Golden State,33,23,22,21,0,0,0,0,Cleveland,32,29,29,20,0,0,0,0,20150226,99,110,-1,5,12,11,11,209,11,2014,0,3,2161,0
Oklahoma City,15,33,36,25,4,0,0,0,Phoenix,25,28,33,23,8,0,0,0,20150226,113,117,10,5,2,0,4,230,4,2014,1,3,840,0
Golden State,27,27,44,15,0,0,0,0,Toronto,11,20,26,32,0,0,0,0,20150227,113,89,16,23,41,24,24,202,-24,2014,0,4,2263,0
San Antonio,20,29,31,27,0,0,0,0,Sacramento,25,21,32,18,0,0,0,0,20150227,107,96,-5,3,2,11,11,203,-11,2014,0,4,1456,0
Oklahoma City,25,34,30,23,0,0,0,0,Portland,28,19,31,37,0,0,0,0,20150227,112,115,3,-12,-11,3,3,227,3,2014,0,4,1484,0
Washington,25,17,19,20,0,0,0,0,Philadelphia,28,19,16,26,0,0,0,0,20150227,81,89,3,5,2,8,8,170,8,2014,0,4,123,0
Miami,25,29,28,20,0,0,0,0,New Orleans,24,30,19,31,0,0,0,0,20150227,102,104,-1,0,-9,2,2,206,2,2014,0,4,668,0
LA Clippers,17,24,28,28,0,0,0,0,Memphis,16,25,21,17,0,0,0,0,20150227,97,79,1,0,7,18,18,176,-18,2014,0,4,1599,0
Milwaukee,18,29,25,21,0,0,0,0,LA Lakers,24,21,20,36,0,0,0,0,20150227,93,101,6,-2,-7,8,8,194,8,2014,0,4,1741,0
New York,23,18,25,29,10,16,0,0,Detroit,28,25,16,26,10,10,0,0,20150227,121,115,-5,-12,-3,0,6,236,-6,2014,2,4,480,0
Brooklyn,36,21,16,25,0,0,0,0,Houston,25,28,21,28,0,0,0,0,20150227,98,102,-11,-4,1,4,4,200,4,2014,0,4,1417,0
Utah,28,22,30,24,0,0,0,0,Denver,17,17,19,29,0,0,0,0,20150227,104,82,11,16,27,22,22,186,-22,2014,0,4,370,0
Minnesota,23,21,23,22,0,0,0,0,Chicago,27,24,22,23,0,0,0,0,20150227,89,96,4,7,6,7,7,185,7,2014,0,4,355,0
Charlotte,21,28,26,23,0,0,0,0,Boston,27,18,24,37,0,0,0,0,20150227,98,106,6,-4,-6,8,8,204,8,2014,0,4,720,0
Orlando,16,29,22,21,0,0,0,0,Atlanta,28,14,34,19,0,0,0,0,20150227,88,95,12,-3,9,7,7,183,7,2014,0,4,401,0
Cleveland,28,17,16,25,0,0,0,0,Indiana,19,32,23,19,0,0,0,0,20150227,86,93,-9,6,13,7,7,179,7,2014,0,4,262,0
San Antonio,24,27,24,26,0,0,0,0,Phoenix,13,11,17,33,0,0,0,0,20150228,101,74,11,27,34,27,27,175,-27,2014,0,5,846,0
Detroit,27,17,26,25,0,0,0,0,Washington,37,23,20,19,0,0,0,0,20150228,95,99,10,16,10,4,4,194,4,2014,0,5,394,0
Toronto,15,32,24,27,0,0,0,0,New York,22,28,25,28,0,0,0,0,20150228,98,103,7,3,4,5,5,201,5,2014,0,5,341,0
Milwaukee,18,22,15,20,0,0,0,0,Utah,26,21,11,24,0,0,0,0,20150228,75,82,8,7,3,7,7,157,7,2014,0,5,1239,0
Atlanta,17,26,21,29,0,0,0,0,Miami,12,21,20,38,0,0,0,0,20150228,93,91,5,10,11,2,2,184,-2,2014,0,5,605,0
Brooklyn,23,24,35,22,0,0,0,0,Dallas,26,25,21,22,0,0,0,0,20150228,104,94,-3,-4,10,10,10,198,-10,2014,0,5,1370,0
Memphis,18,30,24,29,0,0,0,0,Minnesota,24,22,24,27,0,0,0,0,20150228,101,97,-6,2,2,4,4,198,-4,2014,0,5,700,0
Golden State,25,24,26,31,0,0,0,0,Boston,38,27,21,15,0,0,0,0,20150301,106,101,-13,-16,-11,5,5,207,-5,2014,0,6,2692,0
LA Clippers,26,17,26,27,0,0,0,0,Chicago,18,23,28,17,0,0,0,0,20150301,96,86,8,2,0,10,10,182,-10,2014,0,6,1741,0
New Orleans,21,16,28,34,0,0,0,0,Denver,16,21,28,27,0,0,0,0,20150301,99,92,5,0,0,7,7,191,-7,2014,0,6,1079,0
Cleveland,26,21,27,24,5,0,0,0,Houston,29,21,32,16,7,0,0,0,20150301,103,105,3,3,8,0,2,208,2,2014,1,6,1113,0
Philadelphia,24,22,18,10,0,0,0,0,Indiana,27,32,14,21,0,0,0,0,20150301,74,94,3,13,9,20,20,168,20,2014,0,6,582,0
Oklahoma City,28,28,28,24,0,0,0,0,LA Lakers,19,29,24,29,0,0,0,0,20150301,108,101,9,8,12,7,7,209,-7,2014,0,6,1178,0
Charlotte,28,15,28,27,0,0,0,0,Orlando,22,20,18,23,0,0,0,0,20150301,98,83,6,1,11,15,15,181,-15,2014,0,6,463,0
Portland,34,30,21,25,0,0,0,0,Sacramento,23,27,25,24,0,0,0,0,20150301,110,99,11,14,10,11,11,209,-11,2014,0,6,483,0
Toronto,26,29,28,31,0,0,0,0,Philadelphia,22,27,27,27,0,0,0,0,20150302,114,103,4,6,7,11,11,217,-11,2014,0,0,334,0
Phoenix,24,24,26,24,0,0,0,0,Miami,23,39,23,30,0,0,0,0,20150302,98,115,-1,14,11,17,17,213,17,2014,0,0,1978,0
LA Clippers,36,22,28,24,0,0,0,0,Minnesota,23,37,27,18,0,0,0,0,20150302,110,105,13,-2,-1,5,5,215,-5,2014,0,0,1521,0
Golden State,23,28,29,28,0,0,0,0,Brooklyn,33,24,29,24,0,0,0,0,20150302,108,110,10,6,6,2,2,218,2,2014,0,0,2565,0
New Orleans,31,27,13,22,0,0,0,0,Dallas,32,23,25,22,0,0,0,0,20150302,93,102,1,-3,9,9,9,195,9,2014,0,0,442,0
Houston,31,28,22,15,0,0,0,0,Atlanta,22,23,27,32,0,0,0,0,20150303,96,104,-9,-14,-9,8,8,200,8,2014,0,1,700,0
Washington,22,22,23,25,0,0,0,0,Chicago,24,27,23,23,0,0,0,0,20150303,92,97,2,7,7,5,5,189,5,2014,0,1,594,0
LA Lakers,30,20,20,33,0,0,0,0,Charlotte,27,23,24,30,0,0,0,0,20150303,103,104,-3,0,4,1,1,207,1,2014,0,1,2115,0
Boston,16,20,17,26,0,0,0,0,Cleveland,29,32,34,15,0,0,0,0,20150303,79,110,13,25,42,31,31,189,31,2014,0,1,549,0
Milwaukee,29,22,19,25,0,0,0,0,Denver,29,26,21,30,0,0,0,0,20150303,95,106,0,4,6,11,11,201,11,2014,0,1,912,0
Utah,19,18,27,29,0,0,0,0,Memphis,20,18,23,21,0,0,0,0,20150303,93,82,-1,-1,3,11,11,175,-11,2014,0,1,1247,0
Sacramento,35,30,35,24,0,0,0,0,New York,19,20,29,18,0,0,0,0,20150303,124,86,16,26,32,38,38,210,-38,2014,0,1,2499,0
Detroit,24,22,17,22,0,0,0,0,New Orleans,17,25,23,23,0,0,0,0,20150304,85,88,-7,-4,2,3,3,173,3,2014,0,2,939,0
Cleveland,28,29,27,36,0,0,0,0,Toronto,25,18,31,38,0,0,0,0,20150304,120,112,3,14,10,8,8,232,-8,2014,0,2,187,0
Sacramento,27,11,23,24,0,0,0,0,San Antonio,26,28,31,27,0,0,0,0,20150304,85,112,-1,16,24,27,27,197,27,2014,0,2,1456,0
Phoenix,22,21,34,28,0,0,0,0,Orlando,25,27,17,31,0,0,0,0,20150304,105,100,-3,-9,8,5,5,205,-5,2014,0,2,1842,0
Philadelphia,34,25,31,20,8,0,0,0,Oklahoma City,37,19,28,26,13,0,0,0,20150304,118,123,3,-3,-6,0,5,241,5,2014,1,2,1256,0
Denver,26,34,17,23,0,0,0,0,Minnesota,27,16,22,20,0,0,0,0,20150304,100,85,-1,17,12,15,15,185,-15,2014,0,2,698,0
Portland,28,18,20,21,11,0,0,0,LA Clippers,24,24,20,19,6,0,0,0,20150304,98,93,4,-2,-2,0,5,191,-5,2014,1,2,826,0
New York,19,22,23,18,0,0,0,0,Indiana,30,35,23,17,0,0,0,0,20150304,82,105,11,24,24,23,23,187,23,2014,0,2,643,0
Memphis,24,30,25,23,0,0,0,0,Houston,31,28,20,21,0,0,0,0,20150304,102,100,-7,-5,0,2,2,202,-2,2014,0,2,484,0
Milwaukee,19,34,18,22,0,0,0,0,Golden State,25,28,19,30,0,0,0,0,20150304,93,102,6,0,1,9,9,195,9,2014,0,2,1838,0
Charlotte,35,21,32,27,0,0,0,0,Brooklyn,15,29,22,25,0,0,0,0,20150304,115,91,20,12,22,24,24,206,-24,2014,0,2,531,0
Utah,19,14,22,29,0,0,0,0,Boston,18,16,27,24,0,0,0,0,20150304,84,85,-1,1,6,1,1,169,1,2014,0,2,2093,0
LA Lakers,25,26,22,21,0,0,0,0,Miami,28,18,30,24,0,0,0,0,20150304,94,100,3,-5,3,6,6,194,6,2014,0,2,2335,0
Oklahoma City,30,20,29,26,0,0,0,0,Chicago,18,30,24,36,0,0,0,0,20150305,105,108,-12,-2,-7,3,3,213,3,2014,0,3,690,0
Dallas,23,13,21,18,0,0,0,0,Portland,17,23,31,23,0,0,0,0,20150305,75,94,-6,4,14,19,19,169,19,2014,0,3,1630,0
Dallas,24,16,24,25,0,0,0,0,Golden State,29,23,30,22,0,0,0,0,20150306,89,104,5,12,18,15,15,193,15,2014,0,4,1480,0
Utah,21,20,23,25,0,0,0,0,Philadelphia,24,18,13,28,0,0,0,0,20150306,89,83,-3,-1,9,6,6,172,-6,2014,0,4,1920,0
Sacramento,26,31,29,28,0,0,0,0,Orlando,35,33,24,27,0,0,0,0,20150306,114,119,9,11,6,5,5,233,5,2014,0,4,2390,0
Boston,27,20,24,33,0,0,0,0,New Orleans,25,22,21,30,0,0,0,0,20150306,104,98,2,0,3,6,6,202,-6,2014,0,4,1358,0
LA Lakers,16,30,25,19,0,0,0,0,Memphis,24,19,24,30,0,0,0,0,20150306,90,97,8,-3,-4,7,7,187,7,2014,0,4,1599,0
Phoenix,21,29,19,23,16,0,0,0,Brooklyn,21,25,34,12,8,0,0,0,20150306,108,100,0,4,-11,0,8,208,-8,2014,1,4,2139,0
Detroit,23,23,23,24,0,0,0,0,Houston,29,25,26,23,0,0,0,0,20150306,93,103,6,8,11,10,10,196,10,2014,0,4,1105,0
Toronto,24,18,29,23,0,0,0,0,Charlotte,25,28,24,26,0,0,0,0,20150306,94,103,1,11,6,9,9,197,9,2014,0,4,585,0
Denver,29,31,23,28,0,0,0,0,San Antonio,32,33,25,30,0,0,0,0,20150306,111,120,3,5,7,9,9,231,9,2014,0,4,802,0
Cleveland,19,24,36,18,0,0,0,0,Atlanta,36,17,28,25,0,0,0,0,20150306,97,106,17,10,2,9,9,203,9,2014,0,4,555,0
Chicago,20,22,24,18,0,0,0,0,Indiana,23,22,21,32,0,0,0,0,20150306,84,98,3,3,0,14,14,182,14,2014,0,4,163,0
Miami,18,21,34,24,0,0,0,0,Washington,40,27,21,11,0,0,0,0,20150306,97,99,22,28,15,2,2,196,2,2014,0,4,924,0
Indiana,22,16,22,32,0,0,0,0,New York,18,25,20,23,0,0,0,0,20150307,92,86,4,-5,-3,6,6,178,-6,2014,0,5,643,0
Atlanta,31,22,16,15,0,0,0,0,Philadelphia,20,27,25,20,0,0,0,0,20150307,84,92,-11,-6,3,8,8,176,8,2014,0,5,665,0
Memphis,25,25,17,22,0,0,0,0,New Orleans,18,20,33,24,0,0,0,0,20150307,89,95,-7,-12,4,6,6,184,6,2014,0,5,358,0
Portland,30,25,22,36,0,0,0,0,Minnesota,29,22,30,40,0,0,0,0,20150307,113,121,-1,-4,4,8,8,234,8,2014,0,5,1423,0
Sacramento,30,31,17,18,13,0,0,0,Miami,26,21,21,28,18,0,0,0,20150307,109,114,-4,-14,-10,0,5,223,5,2014,1,5,2547,0
Houston,25,30,33,26,0,0,0,0,Denver,28,20,25,27,0,0,0,0,20150307,114,100,-3,7,15,14,14,214,-14,2014,0,5,878,0
Phoenix,24,13,15,27,0,0,0,0,Cleveland,30,23,27,9,0,0,0,0,20150307,79,89,6,16,28,10,10,168,10,2014,0,5,1745,0
Washington,19,20,24,22,0,0,0,0,Milwaukee,30,21,14,26,0,0,0,0,20150307,85,91,11,12,2,6,6,176,6,2014,0,5,634,0
Chicago,19,20,38,28,0,0,0,0,San Antonio,25,32,30,29,0,0,0,0,20150308,105,116,6,18,10,11,11,221,11,2014,0,6,1050,0
Utah,21,21,24,29,0,0,0,0,Brooklyn,24,19,20,25,0,0,0,0,20150308,95,88,-3,-1,3,7,7,183,-7,2014,0,6,1967,0
Charlotte,27,27,24,30,0,0,0,0,Detroit,33,29,22,17,0,0,0,0,20150308,108,101,-6,-8,-6,7,7,209,-7,2014,0,6,504,0
LA Clippers,28,22,18,30,0,0,0,0,Golden State,29,28,30,19,0,0,0,0,20150308,98,106,1,7,19,8,8,204,8,2014,0,6,347,0
Dallas,25,19,31,25,0,0,0,0,LA Lakers,24,20,33,16,0,0,0,0,20150308,100,93,1,0,-2,7,7,193,-7,2014,0,6,1237,0
Toronto,26,35,18,25,0,0,0,0,Oklahoma City,31,27,28,22,0,0,0,0,20150308,104,108,5,-3,7,4,4,212,4,2014,0,6,1114,0
Boston,31,18,20,29,0,0,0,0,Orlando,17,26,26,34,0,0,0,0,20150308,98,103,-14,-6,0,5,5,201,5,2014,0,6,1115,0
Golden State,25,21,30,22,0,0,0,0,Phoenix,19,27,15,19,0,0,0,0,20150309,98,80,6,0,15,18,18,178,-18,2014,0,0,652,0
New Orleans,29,31,27,27,0,0,0,0,Milwaukee,26,24,34,19,0,0,0,0,20150309,114,103,3,10,3,11,11,217,-11,2014,0,0,911,0
Boston,24,19,30,27,0,0,0,0,Miami,19,21,24,26,0,0,0,0,20150309,100,90,5,3,9,10,10,190,-10,2014,0,0,1257,0
Minnesota,25,14,23,14,0,0,0,0,LA Clippers,25,23,26,15,0,0,0,0,20150309,76,89,0,9,12,13,13,165,13,2014,0,0,1521,0
Memphis,22,19,32,28,0,0,0,0,Chicago,22,17,26,26,0,0,0,0,20150309,101,91,0,2,8,10,10,192,-10,2014,0,0,480,0
Washington,36,20,21,18,0,0,0,0,Charlotte,21,25,14,9,0,0,0,0,20150309,95,69,15,10,17,26,26,164,-26,2014,0,0,329,0
Sacramento,20,34,28,23,0,0,0,0,Atlanta,33,43,29,25,0,0,0,0,20150309,105,130,13,22,23,25,25,235,25,2014,0,0,2082,0
New York,25,15,19,19,0,0,0,0,Denver,25,30,36,15,0,0,0,0,20150309,78,106,0,15,32,28,28,184,28,2014,0,0,1627,0
Toronto,17,24,30,36,0,0,0,0,San Antonio,28,33,24,32,0,0,0,0,20150310,107,117,11,20,14,10,10,224,10,2014,0,1,1438,0
Detroit,20,30,11,24,0,0,0,0,LA Lakers,25,24,18,26,0,0,0,0,20150310,85,93,5,-1,6,8,8,178,8,2014,0,1,1979,0
New York,20,15,30,17,0,0,0,0,Utah,24,19,22,22,0,0,0,0,20150310,82,87,4,8,0,5,5,169,5,2014,0,1,1967,0
Cleveland,26,41,32,28,0,0,0,0,Dallas,31,22,23,18,0,0,0,0,20150310,127,94,-5,14,23,33,33,221,-33,2014,0,1,1024,0
New Orleans,23,32,23,33,0,0,0,0,Brooklyn,27,19,15,30,0,0,0,0,20150310,111,91,-4,9,17,20,20,202,-20,2014,0,1,1168,0
Orlando,28,19,23,16,0,0,0,0,Indiana,26,33,27,32,0,0,0,0,20150310,86,118,-2,12,16,32,32,204,32,2014,0,1,822,0
Houston,29,24,21,26,0,0,0,0,Portland,26,28,26,25,0,0,0,0,20150311,100,105,-3,1,6,5,5,205,5,2014,0,2,1833,0
LA Clippers,36,29,35,20,0,0,0,0,Oklahoma City,30,27,28,23,0,0,0,0,20150311,120,108,6,8,15,12,12,228,-12,2014,0,2,1178,0
Minnesota,18,26,25,28,0,0,0,0,Phoenix,25,25,28,28,0,0,0,0,20150311,97,106,7,6,9,9,9,203,9,2014,0,2,1278,0
Chicago,22,29,21,20,12,0,0,0,Philadelphia,22,29,12,29,3,0,0,0,20150311,104,95,0,0,9,0,9,199,-9,2014,1,2,664,0
Orlando,31,26,15,19,0,0,0,0,Milwaukee,29,25,18,25,0,0,0,0,20150311,91,97,-2,-3,0,6,6,188,6,2014,0,2,1065,0
Atlanta,22,20,26,34,0,0,0,0,Denver,31,29,38,17,0,0,0,0,20150311,102,115,9,18,30,13,13,217,13,2014,0,2,1209,0
Detroit,25,26,25,22,0,0,0,0,Golden State,30,26,23,26,0,0,0,0,20150311,98,105,5,5,3,7,7,203,7,2014,0,2,2087,0
Memphis,18,21,24,29,0,0,0,0,Boston,23,16,25,31,0,0,0,0,20150311,92,95,5,0,1,3,3,187,3,2014,0,2,1134,0
Brooklyn,23,28,16,31,0,0,0,0,Miami,34,28,20,22,0,0,0,0,20150311,98,104,11,11,15,6,6,202,6,2014,0,2,1091,0
Sacramento,24,27,27,35,0,0,0,0,Charlotte,21,25,32,28,0,0,0,0,20150311,113,106,3,5,0,7,7,219,-7,2014,0,2,2239,0
Milwaukee,31,22,21,22,7,0,0,0,Indiana,19,32,31,14,13,0,0,0,20150312,103,109,-12,-2,8,0,6,212,6,2014,1,3,243,0
New York,25,35,20,21,0,0,0,0,LA Lakers,28,26,20,20,0,0,0,0,20150312,101,94,-3,6,6,7,7,195,-7,2014,0,3,2445,0
Cleveland,30,32,17,31,18,0,0,0,San Antonio,31,33,20,26,15,0,0,0,20150312,128,125,-1,-2,-5,0,3,253,-3,2014,1,3,1256,0
Houston,23,20,22,26,0,0,0,0,Utah,28,25,29,27,0,0,0,0,20150312,91,109,5,10,17,18,18,200,18,2014,0,3,1199,0
Memphis,33,14,24,16,0,0,0,0,Washington,26,34,29,18,0,0,0,0,20150312,87,107,-7,13,18,20,20,194,20,2014,0,3,762,0
Miami,18,23,22,29,0,0,0,0,Toronto,21,29,28,24,0,0,0,0,20150313,92,102,3,9,15,10,10,194,10,2014,0,4,1234,0
Detroit,24,22,32,21,0,0,0,0,Portland,35,29,31,23,0,0,0,0,20150313,99,118,11,18,17,19,19,217,19,2014,0,4,1964,0
Sacramento,22,42,18,25,0,0,0,0,Philadelphia,29,22,37,26,0,0,0,0,20150313,107,114,7,-13,6,7,7,221,7,2014,0,4,2451,0
Minnesota,26,23,23,27,0,0,0,0,Oklahoma City,31,24,24,34,0,0,0,0,20150313,99,113,5,6,7,14,14,212,14,2014,0,4,694,0
Atlanta,28,20,17,31,0,0,0,0,Phoenix,23,27,23,14,0,0,0,0,20150313,96,87,5,-2,-8,9,9,183,-9,2014,0,4,1588,0
LA Clippers,24,27,27,21,0,0,0,0,Dallas,21,38,32,38,0,0,0,0,20150313,99,129,-3,8,13,30,30,228,30,2014,0,4,1237,0
Chicago,35,25,10,21,0,0,0,0,Charlotte,19,33,25,24,0,0,0,0,20150313,91,101,-16,-8,7,10,10,192,10,2014,0,4,586,0
Orlando,23,27,22,16,0,0,0,0,Boston,19,21,26,29,0,0,0,0,20150313,88,95,-4,-10,-6,7,7,183,7,2014,0,4,1115,0
Golden State,26,28,29,20,0,0,0,0,Denver,34,28,20,32,0,0,0,0,20150313,103,114,8,8,-1,11,11,217,11,2014,0,4,947,0
New York,27,25,21,21,0,0,0,0,Golden State,26,47,38,14,0,0,0,0,20150314,94,125,-1,21,38,31,31,219,31,2014,0,5,2565,0
Boston,20,25,22,26,0,0,0,0,Indiana,18,19,23,29,0,0,0,0,20150314,93,89,2,8,7,4,4,182,-4,2014,0,5,805,0
Milwaukee,20,22,19,22,0,0,0,0,Memphis,22,27,29,18,0,0,0,0,20150314,83,96,2,7,17,13,13,179,13,2014,0,5,557,0
Brooklyn,27,24,23,20,0,0,0,0,Philadelphia,29,27,10,21,0,0,0,0,20150314,94,87,-2,-5,8,7,7,181,-7,2014,0,5,80,0
Detroit,18,25,12,30,0,0,0,0,Utah,18,31,13,26,0,0,0,0,20150314,85,88,0,6,7,3,3,173,3,2014,0,5,1488,0
Sacramento,25,39,21,12,0,0,0,0,Washington,21,25,38,29,0,0,0,0,20150314,97,113,-4,-18,-1,16,16,210,16,2014,0,5,2371,0
New York,29,19,18,23,0,0,0,0,Phoenix,23,24,28,27,0,0,0,0,20150315,89,102,-6,-1,9,13,13,191,13,2014,0,6,2139,0
Portland,33,31,27,22,0,0,0,0,Toronto,31,22,26,18,0,0,0,0,20150315,113,97,2,11,12,16,16,210,-16,2014,0,6,2108,0
Minnesota,23,27,13,34,0,0,0,0,San Antonio,29,31,33,30,0,0,0,0,20150315,97,123,6,10,30,26,26,220,26,2014,0,6,1112,0
Chicago,15,32,23,30,0,0,0,0,Oklahoma City,17,30,28,34,0,0,0,0,20150315,100,109,2,0,5,9,9,209,9,2014,0,6,690,0
Atlanta,23,18,27,23,0,0,0,0,LA Lakers,14,24,20,28,0,0,0,0,20150315,91,86,9,3,10,5,5,177,-5,2014,0,6,1932,0
Denver,21,29,21,30,8,9,0,0,New Orleans,26,21,30,24,8,2,0,0,20150315,118,111,-5,3,-6,0,7,229,-7,2014,2,6,1079,0
Houston,22,36,26,16,0,0,0,0,LA Clippers,30,20,24,24,0,0,0,0,20150315,100,98,-8,8,10,2,2,198,-2,2014,0,6,1371,0
Cleveland,26,40,34,23,0,0,0,0,Orlando,28,27,31,22,0,0,0,0,20150315,123,108,-2,11,14,15,15,231,-15,2014,0,6,895,0
Portland,20,20,34,23,0,0,0,0,Washington,27,33,21,24,0,0,0,0,20150316,97,105,7,20,7,8,8,202,8,2014,0,0,2347,0
Atlanta,28,26,28,28,0,0,0,0,Sacramento,29,18,29,27,0,0,0,0,20150316,110,103,-1,7,6,7,7,213,-7,2014,0,0,2082,0
Brooklyn,33,34,31,24,0,0,0,0,Minnesota,29,26,24,27,0,0,0,0,20150316,122,106,4,12,19,16,16,228,-16,2014,0,0,1016,0
Cleveland,22,16,25,29,0,0,0,0,Miami,27,29,27,23,0,0,0,0,20150316,92,106,5,18,20,14,14,198,14,2014,0,0,1089,0
Charlotte,16,14,16,20,0,0,0,0,Utah,30,31,24,9,0,0,0,0,20150316,66,94,14,31,39,28,28,160,28,2014,0,0,1723,0
Toronto,29,29,30,29,0,0,0,0,Indiana,24,30,27,17,0,0,0,0,20150316,117,98,5,4,7,19,19,215,-19,2014,0,0,438,0
LA Lakers,30,24,24,27,0,0,0,0,Golden State,30,28,24,26,0,0,0,0,20150316,105,108,0,4,4,3,3,213,3,2014,0,0,347,0
Oklahoma City,29,34,29,23,0,0,0,0,Dallas,27,26,39,27,0,0,0,0,20150316,115,119,-2,-10,0,4,4,234,4,2014,0,0,189,0
Philadelphia,18,16,34,21,0,0,0,0,Boston,38,19,32,19,0,0,0,0,20150316,89,108,20,23,21,19,19,197,19,2014,0,0,270,0
Denver,18,19,26,18,0,0,0,0,Memphis,24,23,18,27,0,0,0,0,20150316,81,92,6,10,2,11,11,173,11,2014,0,0,877,0
Memphis,30,24,22,19,0,0,0,0,Detroit,18,21,36,30,0,0,0,0,20150317,95,105,-12,-15,-1,10,10,200,10,2014,0,1,622,0
Orlando,24,26,28,16,0,0,0,0,Houston,28,23,26,30,0,0,0,0,20150317,94,107,4,1,-1,13,13,201,13,2014,0,1,847,0
Charlotte,20,21,33,18,0,0,0,0,LA Clippers,28,31,18,22,0,0,0,0,20150317,92,99,8,18,3,7,7,191,7,2014,0,1,2115,0
Milwaukee,21,23,18,22,0,0,0,0,New Orleans,32,10,28,15,0,0,0,0,20150317,84,85,11,-2,8,1,1,169,1,2014,0,1,911,0
San Antonio,29,23,23,21,4,0,0,0,New York,25,17,26,28,8,0,0,0,20150317,100,104,-4,-10,-7,0,4,204,4,2014,1,1,1581,0
Boston,24,33,24,37,0,0,0,0,Oklahoma City,28,25,40,29,0,0,0,0,20150318,118,122,4,-4,12,4,4,240,4,2014,0,2,1492,0
Minnesota,32,22,21,25,0,0,0,0,Toronto,31,23,28,23,0,0,0,0,20150318,100,105,-1,0,7,5,5,205,5,2014,0,2,691,0
LA Clippers,28,23,29,36,0,0,0,0,Sacramento,24,25,24,32,0,0,0,0,20150318,116,105,4,2,7,11,11,221,-11,2014,0,2,361,0
Detroit,21,18,26,18,0,0,0,0,Philadelphia,24,25,19,26,0,0,0,0,20150318,83,94,3,10,3,11,11,177,11,2014,0,2,441,0
Washington,26,16,25,21,0,0,0,0,Utah,21,19,21,23,0,0,0,0,20150318,88,84,5,2,6,4,4,172,-4,2014,0,2,1841,0
Portland,32,25,24,23,0,0,0,0,Miami,27,21,31,29,0,0,0,0,20150318,104,108,-5,-9,-2,4,4,212,4,2014,0,2,2704,0
Atlanta,24,23,17,31,0,0,0,0,Golden State,28,31,24,31,0,0,0,0,20150318,95,114,4,12,19,19,19,209,19,2014,0,2,2135,0
Orlando,23,25,22,32,0,0,0,0,Dallas,31,34,21,21,0,0,0,0,20150318,102,107,8,17,16,5,5,209,5,2014,0,2,961,0
Brooklyn,26,21,26,19,0,0,0,0,Cleveland,23,36,35,23,0,0,0,0,20150318,92,117,-3,12,21,25,25,209,25,2014,0,2,403,0
Indiana,22,19,27,18,0,0,0,0,Chicago,24,27,25,27,0,0,0,0,20150318,86,103,2,10,8,17,17,189,17,2014,0,2,163,0
San Antonio,27,36,28,23,0,0,0,0,Milwaukee,28,26,26,23,0,0,0,0,20150318,114,103,-1,9,11,11,11,217,-11,2014,0,2,1108,0
Denver,27,22,24,35,0,0,0,0,Houston,33,32,25,28,0,0,0,0,20150319,108,118,6,16,17,10,10,226,10,2014,0,3,878,0
Utah,18,15,25,22,0,0,0,0,LA Lakers,16,20,19,18,0,0,0,0,20150319,80,73,2,-3,3,7,7,153,-7,2014,0,3,579,0
Minnesota,29,25,15,16,10,0,0,0,New York,26,20,23,16,7,0,0,0,20150319,95,92,3,8,0,0,3,187,-3,2014,1,3,1016,0
New Orleans,15,19,19,19,0,0,0,0,Phoenix,21,22,12,19,0,0,0,0,20150319,72,74,6,9,2,2,2,146,2,2014,0,3,1312,0
Boston,19,23,21,26,0,0,0,0,San Antonio,32,24,28,17,0,0,0,0,20150320,89,101,13,14,21,12,12,190,12,2014,0,4,1765,0
Charlotte,22,24,23,22,0,0,0,0,Sacramento,29,28,23,21,0,0,0,0,20150320,91,101,7,11,11,10,10,192,10,2014,0,4,2239,0
New York,23,25,18,15,0,0,0,0,Philadelphia,29,25,26,17,0,0,0,0,20150320,81,97,6,6,14,16,16,178,16,2014,0,4,80,0
Portland,19,37,25,23,0,0,0,0,Orlando,25,33,17,36,0,0,0,0,20150320,104,111,6,2,-6,7,7,215,7,2014,0,4,2525,0
Atlanta,35,33,27,20,0,0,0,0,Oklahoma City,34,27,29,33,0,0,0,0,20150320,115,123,-1,-7,-5,8,8,238,8,2014,0,4,755,0
Denver,23,23,32,13,0,0,0,0,Miami,22,37,28,21,0,0,0,0,20150320,91,108,-1,13,9,17,17,199,17,2014,0,4,1724,0
Indiana,20,21,31,20,0,0,0,0,Cleveland,25,20,27,23,0,0,0,0,20150320,92,95,5,4,0,3,3,187,3,2014,0,4,262,0
New Orleans,26,16,26,28,0,0,0,0,Golden State,30,23,33,26,0,0,0,0,20150320,96,112,4,11,18,16,16,208,16,2014,0,4,1921,0
Memphis,25,19,39,29,0,0,0,0,Dallas,18,19,31,33,0,0,0,0,20150320,112,101,7,7,15,11,11,213,-11,2014,0,4,419,0
Toronto,24,24,20,24,0,0,0,0,Chicago,32,28,26,22,0,0,0,0,20150320,92,108,8,12,18,16,16,200,16,2014,0,4,436,0
Milwaukee,30,38,16,17,10,6,10,0,Brooklyn,31,27,21,22,10,6,12,0,20150320,127,129,1,-10,-5,0,2,256,2,2014,3,4,732,0
Washington,21,33,23,22,0,0,0,0,LA Clippers,35,31,24,23,0,0,0,0,20150320,99,113,14,12,13,14,14,212,14,2014,0,4,2294,0
Brooklyn,31,32,25,35,0,0,0,0,Indiana,29,27,31,24,0,0,0,0,20150321,123,111,2,7,1,12,12,234,-12,2014,0,5,643,0
Phoenix,33,29,37,18,0,0,0,0,Houston,37,24,25,16,0,0,0,0,20150321,117,102,-4,1,13,15,15,219,-15,2014,0,5,1014,0
Portland,27,17,18,24,0,0,0,0,Memphis,35,18,24,20,0,0,0,0,20150321,86,97,8,9,15,11,11,183,11,2014,0,5,1845,0
Chicago,20,36,23,12,0,0,0,0,Detroit,30,14,36,27,0,0,0,0,20150321,91,107,10,-12,1,16,16,198,16,2014,0,5,238,0
Utah,15,25,33,18,0,0,0,0,Golden State,19,30,36,21,0,0,0,0,20150321,91,106,4,9,12,15,15,197,15,2014,0,5,599,0
San Antonio,26,33,24,31,0,0,0,0,Atlanta,13,28,24,30,0,0,0,0,20150322,114,95,13,18,18,19,19,209,-19,2014,0,6,881,0
Detroit,26,15,22,25,17,0,0,0,Boston,23,24,22,19,9,0,0,0,20150322,105,97,3,-6,-6,0,8,202,-8,2014,1,6,611,0
New Orleans,28,25,24,23,0,0,0,0,LA Clippers,27,23,31,26,0,0,0,0,20150322,100,107,-1,-3,4,7,7,207,7,2014,0,6,1669,0
Philadelphia,20,27,28,12,0,0,0,0,LA Lakers,18,23,33,27,0,0,0,0,20150322,87,101,-2,-6,-1,14,14,188,14,2014,0,6,2388,0
Cleveland,25,19,31,33,0,0,0,0,Milwaukee,26,27,20,17,0,0,0,0,20150322,108,90,-1,-9,2,18,18,198,-18,2014,0,6,334,0
Charlotte,18,36,28,27,0,0,0,0,Minnesota,27,32,19,20,0,0,0,0,20150322,109,98,-9,-5,4,11,11,207,-11,2014,0,6,938,0
Miami,21,17,20,17,0,0,0,0,Oklahoma City,25,23,18,27,0,0,0,0,20150322,75,93,4,10,8,18,18,168,18,2014,0,6,1225,0
Denver,28,41,33,17,0,0,0,0,Orlando,25,26,21,28,0,0,0,0,20150322,119,100,3,18,30,19,19,219,-19,2014,0,6,1548,0
Dallas,27,15,33,17,0,0,0,0,Phoenix,33,24,19,22,0,0,0,0,20150322,92,98,6,15,1,6,6,190,6,2014,0,6,884,0
Washington,29,21,20,16,0,0,0,0,Sacramento,34,23,33,19,0,0,0,0,20150322,86,109,5,7,20,23,23,195,23,2014,0,6,2371,0
New York,23,18,25,23,0,0,0,0,Toronto,27,29,18,32,0,0,0,0,20150322,89,106,4,15,8,17,17,195,17,2014,0,6,341,0
Minnesota,20,22,18,36,10,0,0,0,Utah,22,26,15,33,8,0,0,0,20150323,106,104,-2,-6,-3,0,2,210,-2,2014,1,0,984,0
Memphis,30,20,24,29,0,0,0,0,New York,20,28,13,21,0,0,0,0,20150323,103,82,10,2,13,21,21,185,-21,2014,0,0,953,0
Houston,26,27,23,34,0,0,0,0,Indiana,15,24,29,32,0,0,0,0,20150323,110,100,11,14,8,10,10,210,-10,2014,0,0,865,0
Boston,23,31,29,27,0,0,0,0,Brooklyn,28,21,25,17,0,0,0,0,20150323,110,91,-5,5,9,19,19,201,-19,2014,0,0,190,0
Charlotte,26,23,20,17,0,0,0,0,Chicago,28,20,26,24,0,0,0,0,20150323,86,98,2,-1,5,12,12,184,12,2014,0,0,586,0
Washington,24,25,8,19,0,0,0,0,Golden State,27,25,29,26,0,0,0,0,20150323,76,107,3,3,24,31,31,183,31,2014,0,0,2435,0
San Antonio,29,17,20,28,0,0,0,0,Dallas,17,26,33,25,0,0,0,0,20150324,94,101,-12,-3,10,7,7,195,7,2014,0,1,252,0
Toronto,27,21,27,29,0,0,0,0,Detroit,37,23,25,23,0,0,0,0,20150324,104,108,10,12,10,4,4,212,4,2014,0,1,205,0
Miami,27,24,28,9,0,0,0,0,Milwaukee,22,27,16,24,0,0,0,0,20150324,88,89,-5,-2,-14,1,1,177,1,2014,0,1,1269,0
LA Lakers,27,26,35,29,0,0,0,0,Oklahoma City,37,31,32,27,0,0,0,0,20150324,117,127,10,15,12,10,10,244,10,2014,0,1,1178,0
Golden State,26,31,36,29,0,0,0,0,Portland,30,32,18,28,0,0,0,0,20150324,122,108,-4,-5,13,14,14,230,-14,2014,0,1,535,0
Philadelphia,31,39,14,22,0,0,0,0,Sacramento,27,36,24,20,0,0,0,0,20150324,106,107,-4,-7,3,1,1,213,1,2014,0,1,2451,0
Oklahoma City,28,22,24,17,0,0,0,0,San Antonio,32,39,29,30,0,0,0,0,20150325,91,130,4,21,26,39,39,221,39,2014,0,2,421,0
Chicago,20,30,27,39,0,0,0,0,Toronto,29,25,28,21,0,0,0,0,20150325,116,103,-9,-4,-5,13,13,219,-13,2014,0,2,436,0
LA Lakers,24,25,24,17,11,0,0,0,Minnesota,15,28,23,24,9,0,0,0,20150325,101,99,9,6,7,0,2,200,-2,2014,1,2,1521,0
Indiana,14,28,28,33,0,0,0,0,Washington,20,24,32,25,0,0,0,0,20150325,103,101,-6,-2,-6,2,2,204,-2,2014,0,2,490,0
Sacramento,31,27,25,25,0,0,0,0,Phoenix,26,27,17,29,0,0,0,0,20150325,108,99,5,5,13,9,9,207,-9,2014,0,2,634,0
Portland,12,25,18,37,0,0,0,0,Utah,21,18,26,24,0,0,0,0,20150325,92,89,-9,-2,-10,3,3,181,-3,2014,0,2,634,0
Atlanta,23,24,21,27,0,0,0,0,Orlando,31,21,19,12,0,0,0,0,20150325,95,83,-8,-5,-3,12,12,178,-12,2014,0,2,401,0
Philadelphia,22,27,23,27,0,0,0,0,Denver,21,25,30,9,0,0,0,0,20150325,99,85,1,3,-4,14,14,184,-14,2014,0,2,1574,0
Houston,19,30,29,17,0,0,0,0,New Orleans,34,18,18,23,0,0,0,0,20150325,95,93,-15,-3,8,2,2,188,-2,2014,0,2,317,0
Cleveland,22,33,36,20,0,0,0,0,Memphis,19,23,24,23,0,0,0,0,20150325,111,89,3,13,25,22,22,200,-22,2014,0,2,629,0
LA Clippers,28,35,27,21,0,0,0,0,New York,17,16,21,26,0,0,0,0,20150325,111,80,11,30,36,31,31,191,-31,2014,0,2,2445,0
Brooklyn,23,19,26,23,0,0,0,0,Charlotte,26,20,18,24,0,0,0,0,20150325,91,88,-3,-4,4,3,3,179,-3,2014,0,2,531,0
Miami,27,30,25,11,0,0,0,0,Boston,20,20,22,24,0,0,0,0,20150325,93,86,7,17,20,7,7,179,-7,2014,0,2,1257,0
Indiana,15,32,27,33,0,0,0,0,Milwaukee,34,25,26,26,0,0,0,0,20150326,107,111,19,12,11,4,4,218,4,2014,0,3,243,0
Charlotte,19,35,25,17,5,6,0,0,Washington,28,31,16,21,5,9,0,0,20150327,107,110,9,5,-4,0,3,217,3,2014,2,4,329,0
LA Lakers,24,24,18,17,0,0,0,0,Toronto,17,29,25,23,0,0,0,0,20150327,83,94,-7,-2,5,11,11,177,11,2014,0,4,2170,0
Dallas,18,23,20,15,0,0,0,0,San Antonio,28,26,15,25,0,0,0,0,20150327,76,94,10,13,8,18,18,170,18,2014,0,4,252,0
Portland,29,18,13,27,0,0,0,0,Phoenix,21,26,19,15,0,0,0,0,20150327,87,81,8,0,-6,6,6,168,-6,2014,0,4,1005,0
LA Clippers,34,28,32,25,0,0,0,0,Philadelphia,19,35,14,30,0,0,0,0,20150327,119,98,15,8,26,21,21,217,-21,2014,0,4,2388,0
Boston,21,26,23,26,0,0,0,0,New York,22,17,24,29,0,0,0,0,20150327,96,92,-1,8,7,4,4,188,-4,2014,0,4,190,0
Detroit,30,24,33,24,0,0,0,0,Orlando,27,26,23,21,0,0,0,0,20150327,111,97,3,1,11,14,14,208,-14,2014,0,4,957,0
Golden State,31,23,31,22,0,0,0,0,Memphis,24,25,16,19,0,0,0,0,20150327,107,84,7,5,20,23,23,191,-23,2014,0,4,1798,0
Minnesota,22,28,30,30,0,0,0,0,Houston,31,29,30,30,0,0,0,0,20150327,110,120,9,10,10,10,10,230,10,2014,0,4,1057,0
Utah,20,19,24,28,0,0,0,0,Denver,22,30,23,32,0,0,0,0,20150327,91,107,2,13,12,16,16,198,16,2014,0,4,370,0
Cleveland,27,29,23,19,0,0,0,0,Brooklyn,29,28,22,27,0,0,0,0,20150327,98,106,2,1,0,8,8,204,8,2014,0,4,403,0
Miami,20,17,30,19,0,0,0,0,Atlanta,27,28,34,10,0,0,0,0,20150327,86,99,7,18,22,13,13,185,13,2014,0,4,605,0
Sacramento,20,22,24,22,0,0,0,0,New Orleans,18,28,28,28,0,0,0,0,20150327,88,102,-2,4,8,14,14,190,14,2014,0,4,1879,0
New York,17,17,19,27,0,0,0,0,Chicago,28,26,30,27,0,0,0,0,20150328,80,111,11,20,31,31,31,191,31,2014,0,5,711,0
Atlanta,23,29,24,24,0,0,0,0,Charlotte,27,30,33,25,0,0,0,0,20150328,100,115,4,5,14,15,15,215,15,2014,0,5,226,0
Golden State,24,24,34,26,0,0,0,0,Milwaukee,23,15,25,32,0,0,0,0,20150328,108,95,1,10,19,13,13,203,-13,2014,0,5,1838,0
Denver,25,28,25,36,0,0,0,0,Portland,31,27,28,34,0,0,0,0,20150328,114,120,6,5,8,6,6,234,6,2014,0,5,981,0
Oklahoma City,32,17,17,23,0,0,0,0,Utah,21,26,29,18,0,0,0,0,20150328,89,94,-11,-2,10,5,5,183,5,2014,0,5,861,0
Oklahoma City,24,30,22,33,0,0,0,0,Phoenix,35,27,17,18,0,0,0,0,20150329,109,97,-11,-8,-3,12,12,206,-12,2014,0,6,840,0
Houston,28,31,17,23,0,0,0,0,Washington,20,26,21,24,0,0,0,0,20150329,99,91,8,13,9,8,8,190,-8,2014,0,6,1217,0
Memphis,21,21,24,23,0,0,0,0,San Antonio,28,23,19,33,0,0,0,0,20150329,89,103,7,9,4,14,14,192,14,2014,0,6,631,0
Minnesota,11,30,29,18,0,0,0,0,New Orleans,25,25,27,33,0,0,0,0,20150329,88,110,14,9,7,22,22,198,22,2014,0,6,1052,0
LA Clippers,34,34,37,14,0,0,0,0,Boston,20,27,32,27,0,0,0,0,20150329,119,106,14,21,26,13,13,225,-13,2014,0,6,2590,0
Dallas,27,34,18,20,0,0,0,0,Indiana,33,22,23,26,0,0,0,0,20150329,99,104,6,-6,-1,5,5,203,5,2014,0,6,763,0
Philadelphia,20,25,24,17,0,0,0,0,Cleveland,26,27,19,15,0,0,0,0,20150329,86,87,6,8,3,1,1,173,1,2014,0,6,358,0
LA Lakers,19,31,24,25,0,0,0,0,Brooklyn,30,31,24,22,0,0,0,0,20150329,99,107,11,11,11,8,8,206,8,2014,0,6,2445,0
Detroit,27,17,21,37,0,0,0,0,Miami,25,24,22,38,0,0,0,0,20150329,102,109,-2,5,6,7,7,211,7,2014,0,6,1155,0
Houston,27,25,24,20,0,0,0,0,Toronto,27,21,26,25,0,0,0,0,20150330,96,99,0,-4,-2,3,3,195,3,2014,0,0,1299,0
LA Lakers,17,34,25,26,11,0,0,0,Philadelphia,28,22,21,31,9,0,0,0,20150330,113,111,-11,1,5,0,2,224,-2,2014,1,0,2388,0
Utah,25,25,31,23,0,0,0,0,Minnesota,18,22,17,27,0,0,0,0,20150330,104,84,7,10,24,20,20,188,-20,2014,0,0,984,0
Phoenix,22,27,16,21,0,0,0,0,Portland,31,24,37,17,0,0,0,0,20150330,86,109,9,6,27,23,23,195,23,2014,0,0,1005,0
Boston,26,30,29,31,0,0,0,0,Charlotte,24,20,25,35,0,0,0,0,20150330,116,104,2,12,16,12,12,220,-12,2014,0,0,720,0
Milwaukee,20,19,25,24,0,0,0,0,Atlanta,25,21,26,29,0,0,0,0,20150330,88,101,5,7,8,13,13,189,13,2014,0,0,669,0
Sacramento,20,23,21,19,0,0,0,0,Memphis,24,32,19,22,0,0,0,0,20150330,83,97,4,13,11,14,14,180,14,2014,0,0,1745,0
Indiana,15,39,25,27,0,0,0,0,Brooklyn,33,24,27,27,0,0,0,0,20150331,106,111,18,3,5,5,5,217,5,2014,0,1,643,0
Atlanta,28,22,22,23,0,0,0,0,Detroit,33,19,24,29,0,0,0,0,20150331,95,105,5,2,4,10,10,200,10,2014,0,1,597,0
Golden State,18,28,36,28,0,0,0,0,LA Clippers,30,23,35,18,0,0,0,0,20150331,110,106,-12,-7,-6,4,4,216,-4,2014,0,1,347,0
San Antonio,19,28,24,24,0,0,0,0,Miami,20,22,18,21,0,0,0,0,20150331,95,81,-1,5,11,14,14,176,-14,2014,0,1,1147,0
Dallas,28,38,35,34,0,0,0,0,Oklahoma City,25,38,38,30,0,0,0,0,20150401,135,131,3,3,0,4,4,266,-4,2014,0,2,189,0
Philadelphia,21,21,20,31,0,0,0,0,Washington,31,34,28,13,0,0,0,0,20150401,93,106,10,23,31,13,13,199,13,2014,0,2,123,0
Denver,29,13,17,25,0,0,0,0,Utah,22,32,27,17,0,0,0,0,20150401,84,98,-7,12,22,14,14,182,14,2014,0,2,370,0
San Antonio,23,29,30,21,0,0,0,0,Orlando,19,21,20,31,0,0,0,0,20150401,103,91,4,12,22,12,12,194,-12,2014,0,2,1035,0
Brooklyn,30,28,27,15,0,0,0,0,New York,21,32,18,27,0,0,0,0,20150401,100,98,9,5,14,2,2,198,-2,2014,0,2,0,0
LA Clippers,26,29,30,41,0,0,0,0,Portland,33,35,24,30,0,0,0,0,20150401,126,122,-7,-13,-7,4,4,248,-4,2014,0,2,826,0
Chicago,25,23,26,17,0,0,0,0,Milwaukee,20,28,22,25,0,0,0,0,20150401,91,95,-5,0,-4,4,4,186,4,2014,0,2,83,0
New Orleans,29,31,30,23,0,0,0,0,LA Lakers,31,18,21,22,0,0,0,0,20150401,113,92,-2,11,20,21,21,205,-21,2014,0,2,1669,0
Sacramento,25,30,31,25,0,0,0,0,Houston,35,23,39,18,0,0,0,0,20150401,111,115,10,3,11,4,4,226,4,2014,0,2,1606,0
Toronto,31,29,26,27,0,0,0,0,Minnesota,27,19,23,30,0,0,0,0,20150401,113,99,4,14,17,14,14,212,-14,2014,0,2,691,0
Detroit,25,20,17,16,0,0,0,0,Charlotte,33,23,17,29,0,0,0,0,20150401,78,102,8,11,11,24,24,180,24,2014,0,2,504,0
Indiana,16,23,23,25,0,0,0,0,Boston,22,28,18,32,0,0,0,0,20150401,87,100,6,11,6,13,13,187,13,2014,0,2,805,0
Miami,27,23,22,16,0,0,0,0,Cleveland,34,27,30,23,0,0,0,0,20150402,88,114,7,11,19,26,26,202,26,2014,0,3,1089,0
Houston,28,19,30,31,0,0,0,0,Dallas,25,30,28,18,0,0,0,0,20150402,108,101,3,-8,-6,7,7,209,-7,2014,0,3,225,0
Phoenix,22,22,27,35,0,0,0,0,Golden State,27,28,22,30,0,0,0,0,20150402,106,107,5,11,6,1,1,213,1,2014,0,3,652,0
New York,10,36,21,20,0,0,0,0,Washington,30,24,29,18,0,0,0,0,20150403,87,101,20,8,16,14,14,188,14,2014,0,4,204,0
Denver,25,22,23,23,0,0,0,0,San Antonio,45,22,33,23,0,0,0,0,20150403,93,123,20,20,30,30,30,216,30,2014,0,4,802,0
New Orleans,31,25,18,27,0,0,0,0,Sacramento,23,19,29,24,0,0,0,0,20150403,101,95,8,14,3,6,6,196,-6,2014,0,4,1879,0
Orlando,29,23,20,25,0,0,0,0,Minnesota,23,19,23,19,0,0,0,0,20150403,97,84,6,10,7,13,13,181,-13,2014,0,4,1309,0
Oklahoma City,26,23,20,23,0,0,0,0,Memphis,24,31,22,23,0,0,0,0,20150403,92,100,-2,6,8,8,8,192,8,2014,0,4,421,0
Detroit,26,9,24,23,0,0,0,0,Chicago,25,22,12,29,0,0,0,0,20150403,82,88,-1,12,0,6,6,170,6,2014,0,4,238,0
Charlotte,25,13,9,27,0,0,0,0,Indiana,22,27,21,23,0,0,0,0,20150403,74,93,-3,11,23,19,19,167,19,2014,0,4,428,0
Toronto,27,27,25,30,0,0,0,0,Brooklyn,34,15,28,37,0,0,0,0,20150403,109,114,7,-5,-2,5,5,223,5,2014,0,4,341,0
Milwaukee,21,29,36,24,0,0,0,0,Boston,25,27,23,26,0,0,0,0,20150403,110,101,-4,-2,11,9,9,211,-9,2014,0,4,855,0
Portland,26,26,22,33,0,0,0,0,LA Lakers,12,27,24,14,0,0,0,0,20150403,107,77,14,13,11,30,30,184,-30,2014,0,4,826,0
Orlando,22,29,21,25,0,0,0,0,Milwaukee,31,22,20,17,0,0,0,0,20150404,97,90,-9,-2,-1,7,7,187,-7,2014,0,5,1065,0
New Orleans,24,20,28,18,0,0,0,0,Portland,22,34,19,24,0,0,0,0,20150404,90,99,-2,12,3,9,9,189,9,2014,0,5,2059,0
Utah,18,19,31,17,0,0,0,0,Phoenix,13,34,18,22,0,0,0,0,20150404,85,87,-5,10,-3,2,2,172,2,2014,0,5,505,0
Washington,29,20,22,21,0,0,0,0,Memphis,18,20,21,24,0,0,0,0,20150404,92,83,11,11,12,9,9,175,-9,2014,0,5,762,0
Boston,15,32,34,23,13,0,0,0,Toronto,24,23,23,34,12,0,0,0,20150404,117,116,-9,0,11,0,1,233,-1,2014,1,5,430,0
LA Clippers,29,26,27,25,0,0,0,0,Denver,15,24,31,22,0,0,0,0,20150404,107,92,14,16,12,15,15,199,-15,2014,0,5,830,0
Golden State,26,33,31,33,0,0,0,0,Dallas,24,24,28,34,0,0,0,0,20150404,123,110,2,11,14,13,13,233,-13,2014,0,5,1480,0
Philadelphia,16,35,18,22,0,0,0,0,Charlotte,19,30,23,20,0,0,0,0,20150404,91,92,3,-2,3,1,1,183,1,2014,0,5,450,0
Brooklyn,22,26,23,28,0,0,0,0,Atlanta,31,35,42,23,0,0,0,0,20150404,99,131,9,18,37,32,32,230,32,2014,0,5,745,0
Miami,24,31,26,17,0,0,0,0,Detroit,29,21,22,27,0,0,0,0,20150404,98,99,5,-5,-9,1,1,197,1,2014,0,5,1155,0
Chicago,23,22,26,23,0,0,0,0,Cleveland,27,27,25,20,0,0,0,0,20150405,94,99,4,9,8,5,5,193,5,2014,0,6,308,0
Miami,19,28,19,23,0,0,0,0,Indiana,22,29,26,35,0,0,0,0,20150405,89,112,3,4,11,23,23,201,23,2014,0,6,1026,0
LA Clippers,23,26,34,23,0,0,0,0,LA Lakers,16,20,18,24,0,0,0,0,20150405,106,78,7,13,29,28,28,184,-28,2014,0,6,0,0
Philadelphia,20,31,21,19,0,0,0,0,New York,26,28,25,22,0,0,0,0,20150405,91,101,6,3,7,10,10,192,10,2014,0,6,80,0
Houston,27,28,28,32,0,0,0,0,Oklahoma City,17,30,30,35,0,0,0,0,20150405,115,112,10,8,6,3,3,227,-3,2014,0,6,413,0
Utah,31,18,27,25,0,0,0,0,Sacramento,27,22,24,22,0,0,0,0,20150405,101,95,4,0,3,6,6,196,-6,2014,0,6,532,0
Golden State,17,21,29,25,0,0,0,0,San Antonio,31,26,32,18,0,0,0,0,20150405,92,107,14,19,22,15,15,199,15,2014,0,6,1487,0
Portland,25,13,26,32,0,0,0,0,Brooklyn,22,32,23,29,0,0,0,0,20150406,96,106,-3,16,13,10,10,202,10,2014,0,0,2439,0
Minnesota,31,18,25,37,0,0,0,0,Sacramento,23,31,36,26,0,0,0,0,20150407,111,116,-8,5,16,5,5,227,5,2014,0,1,1511,0
San Antonio,29,34,25,25,0,0,0,0,Oklahoma City,10,31,16,31,0,0,0,0,20150407,113,88,19,22,31,25,25,201,-25,2014,0,1,421,0
Golden State,27,28,23,22,0,0,0,0,New Orleans,19,24,36,24,0,0,0,0,20150407,100,103,-8,-12,1,3,3,203,3,2014,0,1,1921,0
LA Lakers,21,18,30,31,0,0,0,0,LA Clippers,23,27,26,29,0,0,0,0,20150407,100,105,2,11,7,5,5,205,5,2014,0,1,0,0
Phoenix,17,26,13,13,0,0,0,0,Atlanta,24,28,17,27,0,0,0,0,20150407,69,96,7,9,13,27,27,165,27,2014,0,1,1588,0
Charlotte,25,30,20,25,0,0,0,0,Miami,28,27,27,23,0,0,0,0,20150407,100,105,3,0,7,5,5,205,5,2014,0,1,654,0
Houston,33,20,18,27,0,0,0,0,San Antonio,32,25,28,25,0,0,0,0,20150408,98,110,-1,4,14,12,12,208,12,2014,0,2,189,0
Minnesota,19,17,26,29,0,0,0,0,Portland,29,26,29,32,0,0,0,0,20150408,91,116,10,19,22,25,25,207,25,2014,0,2,1423,0
Washington,35,35,25,24,0,0,0,0,Philadelphia,24,30,23,13,0,0,0,0,20150408,119,90,11,16,18,29,29,209,-29,2014,0,2,123,0
Chicago,29,30,28,16,0,0,0,0,Orlando,21,31,27,26,0,0,0,0,20150408,103,105,-8,-7,-8,2,2,208,2,2014,0,2,984,0
Indiana,26,28,29,19,0,0,0,0,New York,14,24,17,31,0,0,0,0,20150408,102,86,12,16,28,16,16,188,-16,2014,0,2,643,0
Cleveland,26,26,22,30,0,0,0,0,Milwaukee,22,22,28,27,0,0,0,0,20150408,104,99,4,8,2,5,5,203,-5,2014,0,2,334,0
New Orleans,24,12,19,19,0,0,0,0,Memphis,27,28,26,29,0,0,0,0,20150408,74,110,3,19,26,36,36,184,36,2014,0,2,358,0
LA Lakers,33,21,17,30,0,0,0,0,Denver,35,23,35,26,0,0,0,0,20150408,101,119,2,4,22,18,18,220,18,2014,0,2,830,0
Phoenix,30,33,22,19,0,0,0,0,Dallas,27,32,26,22,0,0,0,0,20150408,104,107,-3,-4,0,3,3,211,3,2014,0,2,884,0
Toronto,20,27,22,23,0,0,0,0,Charlotte,15,16,14,29,0,0,0,0,20150408,92,74,5,16,24,18,18,166,-18,2014,0,2,585,0
Atlanta,33,32,29,20,0,0,0,0,Brooklyn,26,30,26,29,0,0,0,0,20150408,114,111,7,9,12,3,3,225,-3,2014,0,2,745,0
Sacramento,22,27,24,18,0,0,0,0,Utah,21,22,32,28,0,0,0,0,20150408,91,103,-1,-6,2,12,12,194,12,2014,0,2,532,0
Boston,30,25,36,22,0,0,0,0,Detroit,16,31,27,29,0,0,0,0,20150408,113,103,14,8,17,10,10,216,-10,2014,0,2,611,0
Chicago,20,12,33,24,0,0,0,0,Miami,18,33,8,19,0,0,0,0,20150409,89,78,2,-19,6,11,11,167,-11,2014,0,3,1189,0
Portland,27,27,30,21,0,0,0,0,Golden State,30,27,27,32,0,0,0,0,20150409,105,116,3,3,0,11,11,221,11,2014,0,3,535,0
Charlotte,15,33,12,20,0,0,0,0,Atlanta,15,32,23,34,0,0,0,0,20150410,80,104,0,-1,10,24,24,184,24,2014,0,4,226,0
Memphis,29,20,24,16,0,0,0,0,Utah,23,26,23,16,0,0,0,0,20150410,89,88,6,0,1,1,1,177,-1,2014,0,4,1247,0
Sacramento,24,25,27,27,0,0,0,0,Oklahoma City,34,23,25,34,0,0,0,0,20150410,103,116,10,8,6,13,13,219,13,2014,0,4,1336,0
Milwaukee,28,24,29,18,0,0,0,0,New York,21,28,16,26,0,0,0,0,20150410,99,91,7,3,16,8,8,190,-8,2014,0,4,732,0
Phoenix,21,20,19,15,0,0,0,0,New Orleans,27,20,23,20,0,0,0,0,20150410,75,90,6,6,10,15,15,165,15,2014,0,4,1312,0
Minnesota,21,26,24,27,0,0,0,0,LA Lakers,30,22,28,26,0,0,0,0,20150410,98,106,9,5,9,8,8,204,8,2014,0,4,1521,0
Toronto,29,20,27,25,0,0,0,0,Orlando,19,32,25,23,0,0,0,0,20150410,101,99,10,-2,0,2,2,200,-2,2014,0,4,1048,0
Indiana,23,28,28,28,0,0,0,0,Detroit,21,26,32,24,0,0,0,0,20150410,107,103,2,4,0,4,4,210,-4,2014,0,4,240,0
Dallas,35,38,20,28,13,10,0,0,Denver,27,25,37,32,13,9,0,0,20150410,144,143,8,21,4,0,1,287,-1,2014,2,4,661,0
Boston,28,26,25,20,0,0,0,0,Cleveland,17,23,37,13,0,0,0,0,20150410,99,90,11,14,2,9,9,189,-9,2014,0,4,549,0
Washington,14,24,24,18,0,0,0,0,Brooklyn,31,23,21,42,0,0,0,0,20150410,80,117,17,16,13,37,37,197,37,2014,0,4,204,0
San Antonio,23,23,34,24,0,0,0,0,Houston,30,18,27,28,0,0,0,0,20150410,104,103,-7,-2,5,1,1,207,-1,2014,0,4,189,0
Philadelphia,26,27,25,29,0,0,0,0,Chicago,28,24,29,33,0,0,0,0,20150411,107,114,2,-1,3,7,7,221,7,2014,0,5,664,0
Minnesota,31,24,14,32,0,0,0,0,Golden State,28,32,26,24,0,0,0,0,20150411,101,110,-3,5,17,9,9,211,9,2014,0,5,1581,0
Memphis,21,28,19,18,0,0,0,0,LA Clippers,26,26,17,25,0,0,0,0,20150411,86,94,5,3,1,8,8,180,8,2014,0,5,1599,0
Toronto,27,31,21,28,0,0,0,0,Miami,29,29,23,23,0,0,0,0,20150411,107,104,-2,0,-2,3,3,211,-3,2014,0,5,1234,0
New York,30,8,23,19,0,0,0,0,Orlando,24,7,19,29,0,0,0,0,20150411,80,79,6,7,11,1,1,159,-1,2014,0,5,939,0
Utah,32,24,21,34,0,0,0,0,Portland,19,27,34,25,0,0,0,0,20150411,111,105,13,10,-3,6,6,216,-6,2014,0,5,634,0
Brooklyn,24,17,18,14,0,0,0,0,Milwaukee,26,17,30,23,0,0,0,0,20150412,73,96,2,2,14,23,23,169,23,2014,0,6,732,0
Atlanta,22,23,30,24,0,0,0,0,Washington,38,28,24,18,0,0,0,0,20150412,99,108,16,21,15,9,9,207,9,2014,0,6,541,0
Phoenix,18,21,26,26,0,0,0,0,San Antonio,20,31,25,31,0,0,0,0,20150412,91,107,2,12,11,16,16,198,16,2014,0,6,846,0
Oklahoma City,32,19,25,28,0,0,0,0,Indiana,29,27,26,34,0,0,0,0,20150412,104,116,-3,5,6,12,12,220,12,2014,0,6,688,0
Dallas,33,29,27,31,0,0,0,0,LA Lakers,27,30,25,24,0,0,0,0,20150412,120,106,6,5,7,14,14,226,-14,2014,0,6,1237,0
Charlotte,10,24,20,23,0,0,0,0,Detroit,30,29,23,34,0,0,0,0,20150412,77,116,20,25,28,39,39,193,39,2014,0,6,504,0
Sacramento,28,31,25,27,0,0,0,0,Denver,37,23,34,28,0,0,0,0,20150412,111,122,9,1,10,11,11,233,11,2014,0,6,886,0
Cleveland,22,9,24,23,0,0,0,0,Boston,21,34,29,33,0,0,0,0,20150412,78,117,-1,24,29,39,39,195,39,2014,0,6,549,0
New Orleans,28,27,31,28,0,0,0,0,Houston,22,30,34,35,0,0,0,0,20150412,114,121,-6,-3,0,7,7,235,7,2014,0,6,317,0
Portland,21,21,28,20,0,0,0,0,Oklahoma City,35,14,32,20,0,0,0,0,20150413,90,101,14,7,11,11,11,191,11,2014,0,0,1484,0
Dallas,26,31,12,23,0,0,0,0,Utah,29,28,30,22,0,0,0,0,20150413,92,109,3,0,18,17,17,201,17,2014,0,0,998,0
LA Lakers,24,27,23,18,0,0,0,0,Sacramento,24,27,24,27,0,0,0,0,20150413,92,102,0,0,1,10,10,194,10,2014,0,0,361,0
Milwaukee,24,28,28,27,0,0,0,0,Philadelphia,31,27,20,19,0,0,0,0,20150413,107,97,-7,-6,2,10,10,204,-10,2014,0,0,692,0
New Orleans,22,28,23,27,0,0,0,0,Minnesota,20,15,27,26,0,0,0,0,20150413,100,88,2,15,11,12,12,188,-12,2014,0,0,1052,0
Orlando,22,17,27,27,0,0,0,0,Miami,33,24,27,16,0,0,0,0,20150413,93,100,11,18,18,7,7,193,7,2014,0,0,204,0
Memphis,21,25,20,41,0,0,0,0,Golden State,36,32,25,18,0,0,0,0,20150413,107,111,15,22,27,4,4,218,4,2014,0,0,1798,0
Detroit,14,23,36,24,0,0,0,0,Cleveland,36,26,31,16,0,0,0,0,20150413,97,109,22,25,20,12,12,206,12,2014,0,0,90,0
Houston,24,28,31,17,0,0,0,0,Charlotte,23,29,23,15,0,0,0,0,20150413,100,90,1,0,8,10,10,190,-10,2014,0,0,925,0
Chicago,26,31,30,26,0,0,0,0,Brooklyn,21,29,15,21,0,0,0,0,20150413,113,86,5,7,22,27,27,199,-27,2014,0,0,711,0
New York,32,30,21,29,0,0,0,0,Atlanta,28,21,29,30,0,0,0,0,20150413,112,108,4,13,5,4,4,220,-4,2014,0,0,745,0
Denver,31,26,21,25,0,0,0,0,LA Clippers,31,23,29,27,0,0,0,0,20150413,103,110,0,-3,5,7,7,213,7,2014,0,0,830,0
Toronto,26,27,17,23,0,0,0,0,Boston,19,27,27,22,0,0,0,0,20150414,93,95,-7,-7,3,2,2,188,2,2014,0,1,430,0
Washington,16,25,18,22,4,10,0,0,Indiana,16,17,23,25,4,14,0,0,20150414,95,99,0,-8,-3,0,4,194,4,2014,2,1,490,0
LA Clippers,32,37,22,21,0,0,0,0,Phoenix,26,17,27,31,0,0,0,0,20150414,112,101,6,26,21,11,11,213,-11,2014,0,1,356,0
Oklahoma City,47,29,30,32,0,0,0,0,Minnesota,29,25,31,28,0,0,0,0,20150415,138,113,18,22,21,25,25,251,-25,2014,0,2,694,0
Detroit,34,21,29,28,0,0,0,0,New York,25,21,24,20,0,0,0,0,20150415,112,90,9,9,14,22,22,202,-22,2014,0,2,480,0
Boston,22,27,24,32,0,0,0,0,Milwaukee,25,20,27,28,0,0,0,0,20150415,105,100,-3,4,1,5,5,205,-5,2014,0,2,855,0
Charlotte,20,24,23,20,0,0,0,0,Toronto,25,30,23,14,0,0,0,0,20150415,87,92,5,11,11,5,5,179,5,2014,0,2,585,0
Miami,29,35,11,30,0,0,0,0,Philadelphia,23,23,25,30,0,0,0,0,20150415,105,101,6,18,4,4,4,206,-4,2014,0,2,1021,0
Indiana,24,17,20,22,0,0,0,0,Memphis,22,32,19,22,0,0,0,0,20150415,83,95,-2,13,12,12,12,178,12,2014,0,2,383,0
San Antonio,19,28,24,32,0,0,0,0,New Orleans,34,29,19,26,0,0,0,0,20150415,103,108,15,16,11,5,5,211,5,2014,0,2,506,0
Utah,20,15,25,31,0,0,0,0,Houston,31,34,28,24,0,0,0,0,20150415,91,117,11,30,33,26,26,208,26,2014,0,2,1199,0
Denver,23,44,33,26,0,0,0,0,Golden State,35,36,29,33,0,0,0,0,20150415,126,133,12,4,0,7,7,259,7,2014,0,2,947,0
Portland,19,32,21,26,0,0,0,0,Dallas,29,27,35,23,0,0,0,0,20150415,98,114,10,5,19,16,16,212,16,2014,0,2,1630,0
Sacramento,33,34,29,26,0,0,0,0,LA Lakers,23,30,24,22,0,0,0,0,20150415,122,99,10,14,19,23,23,221,-23,2014,0,2,361,0
Washington,28,28,23,22,7,0,0,0,Cleveland,20,33,21,27,12,0,0,0,20150415,108,113,-8,-3,-5,0,5,221,5,2014,1,2,304,0
Atlanta,22,27,23,13,0,0,0,0,Chicago,17,25,28,21,0,0,0,0,20150415,85,91,-5,-7,-2,6,6,176,6,2014,0,2,587,0
Orlando,28,24,23,13,0,0,0,0,Brooklyn,23,25,27,26,0,0,0,0,20150415,88,101,-5,-4,0,13,13,189,13,2014,0,2,939,0
Milwaukee,29,22,24,16,0,0,0,0,Chicago,30,30,26,17,0,0,0,0,20150418,91,103,1,9,11,12,12,194,12,2014,0,5,83,1
New Orleans,13,28,25,33,0,0,0,0,Golden State,28,31,25,22,0,0,0,0,20150418,99,106,15,18,18,7,7,205,7,2014,0,5,1921,1
Dallas,19,36,22,31,0,0,0,0,Houston,32,27,25,34,0,0,0,0,20150418,108,118,13,4,7,10,10,226,10,2014,0,5,225,1
Washington,19,27,19,17,11,0,0,0,Toronto,23,19,14,26,4,0,0,0,20150418,93,86,-4,4,9,0,7,179,-7,2014,1,5,349,1
Portland,15,24,23,24,0,0,0,0,Memphis,25,33,28,14,0,0,0,0,20150419,86,100,10,19,24,14,14,186,14,2014,0,6,1845,1
San Antonio,18,25,21,28,0,0,0,0,LA Clippers,30,19,30,28,0,0,0,0,20150419,92,107,12,6,15,15,15,199,15,2014,0,6,1201,1
Brooklyn,20,25,17,30,0,0,0,0,Atlanta,32,23,19,25,0,0,0,0,20150419,92,99,12,10,12,7,7,191,7,2014,0,6,745,1
Boston,31,23,22,24,0,0,0,0,Cleveland,27,35,29,22,0,0,0,0,20150419,100,113,-4,8,15,13,13,213,13,2014,0,6,549,1
Milwaukee,16,22,30,14,0,0,0,0,Chicago,11,28,32,20,0,0,0,0,20150420,82,91,-5,1,3,9,9,173,9,2014,0,0,83,1
New Orleans,28,24,19,16,0,0,0,0,Golden State,17,38,16,26,0,0,0,0,20150420,87,97,-11,3,0,10,10,184,10,2014,0,0,1921,1
Boston,26,24,18,23,0,0,0,0,Cleveland,25,26,24,24,0,0,0,0,20150421,91,99,-1,1,7,8,8,190,8,2014,0,1,549,1
Dallas,24,27,29,19,0,0,0,0,Houston,23,30,28,30,0,0,0,0,20150421,99,111,-1,2,1,12,12,210,12,2014,0,1,225,1
Washington,26,34,37,20,0,0,0,0,Toronto,31,18,26,31,0,0,0,0,20150421,117,106,-5,11,22,11,11,223,-11,2014,0,1,349,1
Brooklyn,24,23,20,24,0,0,0,0,Atlanta,29,21,25,21,0,0,0,0,20150422,91,96,5,3,8,5,5,187,5,2014,0,2,745,1
San Antonio,28,24,25,17,17,0,0,0,LA Clippers,24,23,27,20,13,0,0,0,20150422,111,107,4,5,3,0,4,218,-4,2014,1,2,1201,1
Portland,21,18,21,22,0,0,0,0,Memphis,19,31,23,24,0,0,0,0,20150422,82,97,-2,11,13,15,15,179,15,2014,0,2,1845,1
Golden State,25,27,17,39,15,0,0,0,New Orleans,26,37,26,19,11,0,0,0,20150423,123,119,-1,-11,-20,0,4,242,-4,2014,1,3,1921,1
Cleveland,31,25,28,19,0,0,0,0,Boston,25,23,28,19,0,0,0,0,20150423,103,95,6,8,8,8,8,198,-8,2014,0,3,549,1
Chicago,27,22,25,21,6,12,0,0,Milwaukee,27,26,18,24,6,5,0,0,20150423,113,106,0,-4,3,0,7,219,-7,2014,2,3,83,1
LA Clippers,16,22,11,24,0,0,0,0,San Antonio,25,21,24,30,0,0,0,0,20150424,73,100,9,8,21,27,27,173,27,2014,0,4,1201,1
Toronto,35,13,22,29,0,0,0,0,Washington,33,21,18,34,0,0,0,0,20150424,99,106,-2,6,2,7,7,205,7,2014,0,4,349,1
Houston,42,23,36,29,0,0,0,0,Dallas,36,36,27,29,0,0,0,0,20150424,130,128,6,-7,2,2,2,258,-2,2014,0,4,225,1
Atlanta,16,24,22,21,0,0,0,0,Brooklyn,31,16,20,24,0,0,0,0,20150425,83,91,15,7,5,8,8,174,8,2014,0,5,745,1
Chicago,23,27,21,19,0,0,0,0,Milwaukee,19,31,23,19,0,0,0,0,20150425,90,92,-4,0,2,2,2,182,2,2014,0,5,83,1
Golden State,31,36,21,21,0,0,0,0,New Orleans,24,30,13,31,0,0,0,0,20150425,109,98,7,13,21,11,11,207,-11,2014,0,5,1921,1
Memphis,24,38,23,30,0,0,0,0,Portland,19,30,26,34,0,0,0,0,20150425,115,109,5,13,10,6,6,224,-6,2014,0,5,1845,1
Cleveland,29,28,13,31,0,0,0,0,Boston,19,17,25,32,0,0,0,0,20150426,101,93,10,21,9,8,8,194,-8,2014,0,6,549,1
Houston,34,19,22,34,0,0,0,0,Dallas,25,36,33,27,0,0,0,0,20150426,109,121,-9,8,19,12,12,230,12,2014,0,6,225,1
LA Clippers,25,26,30,33,0,0,0,0,San Antonio,25,22,29,29,0,0,0,0,20150426,114,105,0,4,5,9,9,219,-9,2014,0,6,1201,1
Toronto,22,28,20,24,0,0,0,0,Washington,36,30,36,23,0,0,0,0,20150426,94,125,14,16,32,31,31,219,31,2014,0,6,349,1
Atlanta,24,27,31,22,11,0,0,0,Brooklyn,25,20,29,30,16,0,0,0,20150427,115,120,1,-6,-8,0,5,235,5,2014,1,0,745,1
Milwaukee,23,29,24,18,0,0,0,0,Chicago,22,27,21,18,0,0,0,0,20150427,94,88,1,3,6,6,6,182,-6,2014,0,0,83,1
Memphis,22,26,27,17,0,0,0,0,Portland,27,28,13,31,0,0,0,0,20150427,92,99,5,7,-7,7,7,191,7,2014,0,0,1845,1
Dallas,22,28,25,19,0,0,0,0,Houston,31,25,26,21,0,0,0,0,20150428,94,103,9,6,7,9,9,197,9,2014,0,1,225,1
San Antonio,22,31,29,29,0,0,0,0,LA Clippers,27,27,28,25,0,0,0,0,20150428,111,107,-5,-1,0,4,4,218,-4,2014,0,1,1201,1
Portland,20,19,27,27,0,0,0,0,Memphis,20,26,22,31,0,0,0,0,20150429,93,99,0,7,2,6,6,192,6,2014,0,2,1845,1
Brooklyn,16,28,26,27,0,0,0,0,Atlanta,33,20,29,25,0,0,0,0,20150429,97,107,17,9,12,10,10,204,10,2014,0,2,745,1
Chicago,34,31,26,29,0,0,0,0,Milwaukee,16,17,19,14,0,0,0,0,20150430,120,66,18,32,39,54,54,186,-54,2014,0,3,83,1
LA Clippers,26,25,25,26,0,0,0,0,San Antonio,26,25,21,24,0,0,0,0,20150430,102,96,0,0,4,6,6,198,-6,2014,0,3,1201,1
Atlanta,36,15,41,19,0,0,0,0,Brooklyn,23,22,21,21,0,0,0,0,20150501,111,87,13,6,26,24,24,198,-24,2014,0,4,745,1
San Antonio,30,25,23,31,0,0,0,0,LA Clippers,28,29,22,32,0,0,0,0,20150502,109,111,-2,2,1,2,2,220,2,2014,0,5,1201,1
Washington,26,27,28,23,0,0,0,0,Atlanta,37,26,20,15,0,0,0,0,20150503,104,98,-11,-10,-2,6,6,202,-6,2014,0,6,541,1
Memphis,25,27,14,20,0,0,0,0,Golden State,32,29,22,18,0,0,0,0,20150503,86,101,7,9,17,15,15,187,15,2014,0,6,1798,1
Chicago,27,22,32,18,0,0,0,0,Cleveland,15,29,26,22,0,0,0,0,20150504,99,92,12,5,11,7,7,191,-7,2014,0,0,308,1
LA Clippers,19,27,37,34,0,0,0,0,Houston,25,25,27,24,0,0,0,0,20150504,117,101,-6,-4,6,16,16,218,-16,2014,0,0,1371,1
Washington,20,26,29,15,0,0,0,0,Atlanta,28,25,27,26,0,0,0,0,20150505,90,106,8,7,5,16,16,196,16,2014,0,1,541,1
Memphis,28,22,23,24,0,0,0,0,Golden State,22,17,24,27,0,0,0,0,20150505,97,90,6,11,10,7,7,187,-7,2014,0,1,1798,1
LA Clippers,24,41,20,24,0,0,0,0,Houston,35,21,27,32,0,0,0,0,20150506,109,115,11,-9,-2,6,6,224,6,2014,0,2,1371,1
Chicago,18,27,26,20,0,0,0,0,Cleveland,38,26,23,19,0,0,0,0,20150506,91,106,20,19,16,15,15,197,15,2014,0,2,308,1
Houston,24,33,19,23,0,0,0,0,LA Clippers,33,31,35,25,0,0,0,0,20150508,99,124,9,7,23,25,25,223,25,2014,0,4,1371,1
Cleveland,24,25,24,23,0,0,0,0,Chicago,18,29,27,25,0,0,0,0,20150508,96,99,-6,-2,1,3,3,195,3,2014,0,4,308,1
Golden State,20,19,25,25,0,0,0,0,Memphis,23,32,24,20,0,0,0,0,20150509,89,99,3,16,15,10,10,188,10,2014,0,5,1798,1
Atlanta,18,25,23,35,0,0,0,0,Washington,28,28,29,18,0,0,0,0,20150509,101,103,10,13,19,2,2,204,2,2014,0,5,541,1
Cleveland,26,23,12,25,0,0,0,0,Chicago,28,17,23,16,0,0,0,0,20150510,86,84,-2,4,-7,2,2,170,-2,2014,0,6,308,1
Houston,33,21,25,16,0,0,0,0,LA Clippers,30,30,43,25,0,0,0,0,20150510,95,128,-3,6,24,33,33,223,33,2014,0,6,1371,1
Golden State,28,33,21,19,0,0,0,0,Memphis,20,24,20,20,0,0,0,0,20150511,101,84,8,17,18,17,17,185,-17,2014,0,0,1798,1
Atlanta,29,36,20,21,0,0,0,0,Washington,26,29,20,26,0,0,0,0,20150511,106,101,3,10,10,5,5,207,-5,2014,0,0,541,1
Chicago,24,20,27,30,0,0,0,0,Cleveland,25,29,26,26,0,0,0,0,20150512,101,106,1,10,9,5,5,207,5,2014,0,1,308,1
LA Clippers,22,26,28,27,0,0,0,0,Houston,27,36,27,34,0,0,0,0,20150512,103,124,5,15,14,21,21,227,21,2014,0,1,1371,1
Washington,19,28,15,19,0,0,0,0,Atlanta,23,18,22,19,0,0,0,0,20150513,81,82,4,-6,1,1,1,163,1,2014,0,2,541,1
Memphis,25,16,16,21,0,0,0,0,Golden State,26,23,25,24,0,0,0,0,20150513,78,98,1,8,17,20,20,176,20,2014,0,2,1798,1
Cleveland,33,25,15,21,0,0,0,0,Chicago,31,13,16,13,0,0,0,0,20150514,94,73,2,14,13,21,21,167,-21,2014,0,3,308,1
Houston,25,37,17,40,0,0,0,0,LA Clippers,29,35,28,15,0,0,0,0,20150514,119,107,-4,-2,-13,12,12,226,-12,2014,0,3,1371,1
Atlanta,19,26,27,22,0,0,0,0,Washington,20,19,25,27,0,0,0,0,20150515,94,91,-1,6,8,3,3,185,-3,2014,0,4,541,1
Golden State,32,26,18,32,0,0,0,0,Memphis,19,30,19,27,0,0,0,0,20150515,108,95,13,9,8,13,13,203,-13,2014,0,4,1798,1
LA Clippers,21,25,22,32,0,0,0,0,Houston,28,28,29,28,0,0,0,0,20150517,100,113,7,10,17,13,13,213,13,2014,0,6,1371,1
Houston,31,24,24,27,0,0,0,0,Golden State,24,34,26,26,0,0,0,0,20150519,106,110,-7,3,5,4,4,216,4,2014,0,1,1642,1
Cleveland,20,31,23,23,0,0,0,0,Atlanta,26,25,16,22,0,0,0,0,20150520,97,89,-6,0,7,8,8,186,-8,2014,0,2,555,1
Houston,28,27,20,23,0,0,0,0,Golden State,36,19,22,22,0,0,0,0,20150521,98,99,8,0,2,1,1,197,1,2014,0,3,1642,1
Cleveland,26,28,30,10,0,0,0,0,Atlanta,21,28,17,16,0,0,0,0,20150522,94,82,5,5,18,12,12,176,-12,2014,0,4,555,1
Golden State,30,32,30,23,0,0,0,0,Houston,18,19,24,19,0,0,0,0,20150523,115,80,12,25,31,35,35,195,-35,2014,0,5,1642,1
Atlanta,24,25,27,28,7,0,0,0,Cleveland,21,27,33,23,10,0,0,0,20150524,111,114,-3,-1,5,0,3,225,3,2014,1,6,555,1
Golden State,22,37,25,31,0,0,0,0,Houston,45,24,30,29,0,0,0,0,20150525,115,128,23,10,15,13,13,243,13,2014,0,0,1642,1
Atlanta,20,22,18,28,0,0,0,0,Cleveland,32,27,26,33,0,0,0,0,20150526,88,118,12,17,25,30,30,206,30,2014,0,1,555,1
Houston,22,24,22,22,0,0,0,0,Golden State,17,35,22,30,0,0,0,0,20150527,90,104,-5,6,6,14,14,194,14,2014,0,2,1642,1
Cleveland,29,22,22,25,2,0,0,0,Golden State,19,29,25,25,10,0,0,0,20150604,100,108,-10,-3,0,0,8,208,8,2014,1,3,2161,1
Cleveland,20,27,15,25,8,0,0,0,Golden State,20,25,14,28,6,0,0,0,20150607,95,93,0,2,3,0,2,188,-2,2014,1,6,2161,1
Golden State,20,17,18,36,0,0,0,0,Cleveland,24,20,28,24,0,0,0,0,20150609,91,96,4,7,17,5,5,187,5,2014,0,1,2161,1
Golden State,31,23,22,27,0,0,0,0,Cleveland,24,18,28,12,0,0,0,0,20150611,103,82,7,12,6,21,21,185,-21,2014,0,3,2161,1
Cleveland,22,28,17,24,0,0,0,0,Golden State,22,29,22,31,0,0,0,0,20150614,91,104,0,1,6,13,13,195,13,2014,0,6,2161,1
Golden State,28,17,28,32,0,0,0,0,Cleveland,15,28,18,36,0,0,0,0,20150616,105,97,13,2,12,8,8,202,-8,2014,0,1,2161,1
Detroit,25,23,34,24,0,0,0,0,Atlanta,25,18,23,28,0,0,0,0,20151027,106,94,0,5,16,12,12,200,-12,2015,0,1,597,0
Cleveland,17,23,28,27,0,0,0,0,Chicago,26,20,25,26,0,0,0,0,20151027,95,97,9,6,3,2,2,192,2,2015,0,1,308,0
New Orleans,35,14,26,20,0,0,0,0,Golden State,39,20,35,17,0,0,0,0,20151027,95,111,4,10,19,16,16,206,16,2015,0,1,1921,0
Indiana,30,15,23,31,0,0,0,0,Toronto,20,17,35,34,0,0,0,0,20151028,99,106,-10,-8,4,7,7,205,7,2015,0,2,438,0
LA Clippers,25,31,29,26,0,0,0,0,Sacramento,17,29,28,30,0,0,0,0,20151028,111,104,8,10,11,7,7,215,-7,2015,0,2,361,0
New Orleans,18,25,24,27,0,0,0,0,Portland,43,27,17,25,0,0,0,0,20151028,94,112,25,27,20,18,18,206,18,2015,0,2,2059,0
Dallas,24,30,34,23,0,0,0,0,Phoenix,22,23,21,29,0,0,0,0,20151028,111,95,2,9,22,16,16,206,-16,2015,0,2,884,0
Washington,31,22,12,23,0,0,0,0,Orlando,29,22,16,20,0,0,0,0,20151028,88,87,2,2,-2,1,1,175,-1,2015,0,2,757,0
New York,27,36,27,32,0,0,0,0,Milwaukee,23,28,22,24,0,0,0,0,20151028,122,97,4,12,17,25,25,219,-25,2015,0,2,732,0
San Antonio,27,28,28,23,0,0,0,0,Oklahoma City,29,21,29,33,0,0,0,0,20151028,106,112,2,-5,-4,6,6,218,6,2015,0,2,421,0
Cleveland,26,27,26,27,0,0,0,0,Memphis,10,22,23,21,0,0,0,0,20151028,106,76,16,21,24,30,30,182,-30,2015,0,2,629,0
Minnesota,22,29,37,24,0,0,0,0,LA Lakers,31,29,35,16,0,0,0,0,20151028,112,111,-9,-9,-7,1,1,223,-1,2015,0,2,1521,0
Denver,27,26,23,29,0,0,0,0,Houston,21,28,14,22,0,0,0,0,20151028,105,85,6,4,13,20,20,190,-20,2015,0,2,878,0
Utah,15,29,20,23,0,0,0,0,Detroit,16,25,28,23,0,0,0,0,20151028,87,92,1,-3,5,5,5,179,5,2015,0,2,1488,0
Chicago,30,28,28,29,0,0,0,0,Brooklyn,19,36,16,29,0,0,0,0,20151028,115,100,11,3,15,15,15,215,-15,2015,0,2,711,0
Philadelphia,26,14,27,28,0,0,0,0,Boston,21,30,28,33,0,0,0,0,20151028,95,112,-5,11,12,17,17,207,17,2015,0,2,270,0
Charlotte,27,17,16,34,0,0,0,0,Miami,23,31,19,31,0,0,0,0,20151028,94,104,-4,10,13,10,10,198,10,2015,0,2,654,0
Memphis,29,21,23,39,0,0,0,0,Indiana,20,29,26,28,0,0,0,0,20151029,112,103,9,1,-2,9,9,215,-9,2015,0,3,383,0
Dallas,17,26,25,20,0,0,0,0,LA Clippers,22,29,34,19,0,0,0,0,20151029,88,104,5,8,17,16,16,192,16,2015,0,3,1237,0
Atlanta,30,31,23,28,0,0,0,0,New York,20,25,27,29,0,0,0,0,20151029,112,101,10,16,12,11,11,213,-11,2015,0,3,745,0
Oklahoma City,31,22,22,42,9,13,0,0,Orlando,35,32,26,24,9,10,0,0,20151030,139,136,-4,-14,-18,0,3,275,-3,2015,2,4,1057,0
Brooklyn,21,26,17,11,0,0,0,0,San Antonio,25,17,34,26,0,0,0,0,20151030,75,102,4,-5,12,27,27,177,27,2015,0,4,1581,0
LA Lakers,24,26,33,31,0,0,0,0,Sacramento,40,34,28,30,0,0,0,0,20151030,114,132,16,24,19,18,18,246,18,2015,0,4,361,0
Portland,23,26,20,23,0,0,0,0,Phoenix,27,28,28,27,0,0,0,0,20151030,92,110,4,6,14,18,18,202,18,2015,0,4,1005,0
Utah,28,22,24,25,0,0,0,0,Philadelphia,19,14,20,18,0,0,0,0,20151030,99,71,9,17,21,28,28,170,-28,2015,0,4,1920,0
Washington,22,39,21,36,0,0,0,0,Milwaukee,33,32,27,21,0,0,0,0,20151030,118,113,-11,-4,-10,5,5,231,-5,2015,0,4,634,0
Chicago,19,20,25,19,11,0,0,0,Detroit,23,12,29,19,15,0,0,0,20151030,94,98,4,-4,0,0,4,192,4,2015,1,4,238,0
Minnesota,26,23,30,16,0,0,0,0,Denver,16,23,24,15,0,0,0,0,20151030,95,78,10,10,16,17,17,173,-17,2015,0,4,698,0
Miami,23,19,25,25,0,0,0,0,Cleveland,29,18,29,26,0,0,0,0,20151030,92,102,6,5,9,10,10,194,10,2015,0,4,1089,0
Toronto,26,28,30,29,0,0,0,0,Boston,26,28,21,28,0,0,0,0,20151030,113,103,0,0,9,10,10,216,-10,2015,0,4,430,0
Charlotte,22,30,17,25,0,0,0,0,Atlanta,29,24,23,21,0,0,0,0,20151030,94,97,7,1,7,3,3,191,3,2015,0,4,226,0
Golden State,30,27,24,31,0,0,0,0,Houston,29,15,21,27,0,0,0,0,20151030,112,92,1,13,16,20,20,204,-20,2015,0,4,1642,0
New York,29,30,28,30,0,0,0,0,Washington,29,27,34,20,0,0,0,0,20151031,117,110,0,3,-3,7,7,227,-7,2015,0,5,204,0
Utah,23,19,28,27,0,0,0,0,Indiana,29,20,12,15,0,0,0,0,20151031,97,76,-6,-7,9,21,21,173,-21,2015,0,5,1353,0
Sacramento,31,24,24,30,0,0,0,0,LA Clippers,24,35,24,31,0,0,0,0,20151031,109,114,-7,4,4,5,5,223,5,2015,0,5,361,0
Brooklyn,26,19,24,22,0,0,0,0,Memphis,31,25,23,22,0,0,0,0,20151031,91,101,5,11,10,10,10,192,10,2015,0,5,953,0
Golden State,31,33,41,29,0,0,0,0,New Orleans,28,37,26,29,0,0,0,0,20151031,134,120,3,-1,14,14,14,254,-14,2015,0,5,1921,0
Phoenix,27,29,18,27,0,0,0,0,Portland,23,25,23,19,0,0,0,0,20151031,101,90,4,8,3,11,11,191,-11,2015,0,5,1005,0
Milwaukee,19,22,30,16,0,0,0,0,Toronto,24,31,26,25,0,0,0,0,20151101,87,106,5,14,10,19,19,193,19,2015,0,6,429,0
Denver,22,28,20,23,0,0,0,0,Oklahoma City,29,29,37,22,0,0,0,0,20151101,93,117,7,8,25,24,24,210,24,2015,0,6,503,0
Houston,35,28,12,14,0,0,0,0,Miami,30,14,31,34,0,0,0,0,20151101,89,109,-5,-19,0,20,20,198,20,2015,0,6,966,0
Atlanta,28,18,24,24,0,0,0,0,Charlotte,18,21,37,16,0,0,0,0,20151101,94,92,10,7,-6,2,2,186,-2,2015,0,6,226,0
Orlando,26,14,23,24,0,0,0,0,Chicago,29,25,21,17,0,0,0,0,20151101,87,92,3,14,12,5,5,179,5,2015,0,6,984,0
San Antonio,23,21,20,31,0,0,0,0,Boston,13,18,23,33,0,0,0,0,20151101,95,87,10,13,10,8,8,182,-8,2015,0,6,1765,0
Dallas,32,22,27,22,0,0,0,0,LA Lakers,21,24,19,29,0,0,0,0,20151101,103,93,11,9,17,10,10,196,-10,2015,0,6,1237,0
Portland,21,32,30,23,0,0,0,0,Minnesota,34,19,27,21,0,0,0,0,20151102,106,101,-13,0,3,5,5,207,-5,2015,0,0,1423,0
Cleveland,18,31,33,25,0,0,0,0,Philadelphia,32,22,18,28,0,0,0,0,20151102,107,100,-14,-5,10,7,7,207,-7,2015,0,0,358,0
Phoenix,23,16,33,24,0,0,0,0,LA Clippers,22,26,27,27,0,0,0,0,20151102,96,102,-1,9,3,6,6,198,6,2015,0,0,356,0
San Antonio,18,29,23,24,0,0,0,0,New York,21,14,30,19,0,0,0,0,20151102,94,84,-3,12,5,10,10,178,-10,2015,0,0,1581,0
Memphis,22,12,15,20,0,0,0,0,Golden State,21,32,40,26,0,0,0,0,20151102,69,119,-1,19,44,50,50,188,50,2015,0,0,1798,0
Milwaukee,33,26,21,23,0,0,0,0,Brooklyn,33,15,32,16,0,0,0,0,20151102,103,96,0,11,0,7,7,199,-7,2015,0,0,732,0
Oklahoma City,26,39,14,26,0,0,0,0,Houston,21,33,28,28,0,0,0,0,20151102,105,110,-5,-11,3,5,5,215,5,2015,0,0,413,0
Memphis,25,25,33,20,0,0,0,0,Sacramento,29,11,27,22,0,0,0,0,20151103,103,89,-4,10,16,14,14,192,-14,2015,0,1,1745,0
Orlando,28,29,21,25,0,0,0,0,New Orleans,17,26,26,25,0,0,0,0,20151103,103,94,11,14,9,9,9,197,-9,2015,0,1,533,0
Atlanta,25,26,28,19,0,0,0,0,Miami,24,16,25,27,0,0,0,0,20151103,98,92,1,11,14,6,6,190,-6,2015,0,1,605,0
Chicago,20,27,30,28,0,0,0,0,Charlotte,37,32,31,30,0,0,0,0,20151103,105,130,17,22,23,25,25,235,25,2015,0,1,586,0
Indiana,24,35,26,9,0,0,0,0,Detroit,30,17,20,15,0,0,0,0,20151103,94,82,-6,12,18,12,12,176,-12,2015,0,1,240,0
Toronto,31,18,25,28,0,0,0,0,Dallas,25,26,22,18,0,0,0,0,20151103,102,91,6,-2,1,11,11,193,-11,2015,0,1,1201,0
Denver,30,30,33,27,0,0,0,0,LA Lakers,36,21,26,26,0,0,0,0,20151103,120,109,-6,3,10,11,11,229,-11,2015,0,1,830,0
San Antonio,23,28,22,26,0,0,0,0,Washington,22,25,19,36,0,0,0,0,20151104,99,102,-1,-4,-7,3,3,201,3,2015,0,2,1385,0
Portland,27,30,19,32,0,0,0,0,Utah,26,23,19,24,0,0,0,0,20151104,108,92,1,8,8,16,16,200,-16,2015,0,2,634,0
Sacramento,18,22,29,28,0,0,0,0,Phoenix,28,21,32,37,0,0,0,0,20151104,97,118,10,9,12,21,21,215,21,2015,0,2,634,0
Philadelphia,21,24,22,20,0,0,0,0,Milwaukee,29,18,21,23,0,0,0,0,20151104,87,91,8,2,1,4,4,178,4,2015,0,2,692,0
Toronto,13,27,33,30,0,0,0,0,Oklahoma City,23,16,42,17,0,0,0,0,20151104,103,98,-10,1,-8,5,5,201,-5,2015,0,2,1114,0
Orlando,35,24,29,22,4,0,0,0,Houston,34,34,22,20,9,0,0,0,20151104,114,119,-1,9,2,0,5,233,5,2015,1,2,847,0
LA Clippers,25,31,27,25,0,0,0,0,Golden State,31,32,19,30,0,0,0,0,20151104,108,112,6,7,-1,4,4,220,4,2015,0,2,347,0
New York,32,14,23,17,0,0,0,0,Cleveland,18,20,32,26,0,0,0,0,20151104,86,96,-14,-8,1,10,10,182,10,2015,0,2,403,0
Brooklyn,17,26,27,17,0,0,0,0,Atlanta,23,18,31,29,0,0,0,0,20151104,87,101,6,-2,2,14,14,188,14,2015,0,2,745,0
Boston,16,27,29,26,0,0,0,0,Indiana,23,26,24,27,0,0,0,0,20151104,98,100,7,6,1,2,2,198,2,2015,0,2,805,0
Memphis,23,23,25,25,0,0,0,0,Portland,18,32,40,25,0,0,0,0,20151105,96,115,-5,4,19,19,19,211,19,2015,0,3,1845,0
Oklahoma City,28,22,23,25,0,0,0,0,Chicago,25,32,19,28,0,0,0,0,20151105,98,104,-3,7,3,6,6,202,6,2015,0,3,690,0
Charlotte,27,27,24,30,0,0,0,0,Dallas,23,30,14,27,0,0,0,0,20151105,108,94,4,1,11,14,14,202,-14,2015,0,3,928,0
Utah,19,21,25,31,0,0,0,0,Denver,24,18,22,20,0,0,0,0,20151105,96,84,-5,-2,1,12,12,180,-12,2015,0,3,370,0
Miami,22,27,24,23,0,0,0,0,Minnesota,15,24,22,23,0,0,0,0,20151105,96,84,7,10,12,12,12,180,-12,2015,0,3,1513,0
Toronto,15,21,33,18,0,0,0,0,Orlando,21,24,19,28,0,0,0,0,20151106,87,92,6,9,-5,5,5,179,5,2015,0,4,1048,0
Milwaukee,30,26,19,24,0,0,0,0,New York,20,33,20,19,0,0,0,0,20151106,99,92,10,3,2,7,7,191,-7,2015,0,4,732,0
Houston,29,32,24,31,0,0,0,0,Sacramento,23,27,28,32,0,0,0,0,20151106,116,110,6,11,7,6,6,226,-6,2015,0,4,1606,0
Detroit,21,21,25,33,0,0,0,0,Phoenix,14,26,23,29,0,0,0,0,20151106,100,92,7,2,4,8,8,192,-8,2015,0,4,1687,0
Atlanta,26,32,31,32,0,0,0,0,New Orleans,28,19,32,36,0,0,0,0,20151106,121,115,-2,11,10,6,6,236,-6,2015,0,4,424,0
LA Lakers,18,34,27,25,0,0,0,0,Brooklyn,27,20,25,26,0,0,0,0,20151106,104,98,-9,5,7,6,6,202,-6,2015,0,4,2445,0
Denver,23,21,31,29,0,0,0,0,Golden State,40,34,25,20,0,0,0,0,20151106,104,119,17,30,24,15,15,223,15,2015,0,4,947,0
Washington,25,24,25,24,0,0,0,0,Boston,40,32,28,18,0,0,0,0,20151106,98,118,15,23,26,20,20,216,20,2015,0,4,394,0
Miami,26,23,19,19,0,0,0,0,Indiana,16,33,22,19,0,0,0,0,20151106,87,90,-10,0,3,3,3,177,3,2015,0,4,1026,0
Philadelphia,25,25,23,29,0,0,0,0,Cleveland,28,21,32,27,0,0,0,0,20151106,102,108,3,-1,8,6,6,210,6,2015,0,4,358,0
Washington,19,26,33,21,0,0,0,0,Atlanta,19,22,34,39,0,0,0,0,20151107,99,114,0,-4,-3,15,15,213,15,2015,0,5,541,0
Minnesota,30,28,18,17,9,0,0,0,Chicago,28,29,20,16,0,0,0,0,20151107,102,93,2,1,-1,0,9,195,-9,2015,1,5,355,0
New Orleans,21,27,22,28,0,0,0,0,Dallas,26,16,30,35,0,0,0,0,20151107,98,107,5,-6,2,9,9,205,9,2015,0,5,442,0
Houston,32,24,27,26,0,0,0,0,LA Clippers,32,26,20,27,0,0,0,0,20151107,109,105,0,-2,5,4,4,214,-4,2015,0,5,1371,0
Brooklyn,24,20,17,25,0,0,0,0,Milwaukee,18,26,23,27,0,0,0,0,20151107,86,94,-6,0,6,8,8,180,8,2015,0,5,732,0
Orlando,25,26,30,24,0,0,0,0,Philadelphia,17,27,29,24,0,0,0,0,20151107,105,97,8,7,8,8,8,202,-8,2015,0,5,864,0
Golden State,20,26,26,31,0,0,0,0,Sacramento,14,24,30,26,0,0,0,0,20151107,103,94,6,8,4,9,9,197,-9,2015,0,5,75,0
Charlotte,21,26,29,18,0,0,0,0,San Antonio,29,22,42,21,0,0,0,0,20151107,94,114,8,4,17,20,20,208,20,2015,0,5,1103,0
Memphis,19,19,19,22,0,0,0,0,Utah,21,30,26,12,0,0,0,0,20151107,79,89,2,13,20,10,10,168,10,2015,0,5,1247,0
Detroit,23,24,32,41,0,0,0,0,Portland,32,25,35,11,0,0,0,0,20151108,120,103,-9,-10,-13,17,17,223,-17,2015,0,6,1964,0
Phoenix,29,25,23,26,0,0,0,0,Oklahoma City,29,31,29,35,0,0,0,0,20151108,103,124,0,6,12,21,21,227,21,2015,0,6,840,0
LA Lakers,25,24,21,25,0,0,0,0,New York,25,20,26,28,0,0,0,0,20151108,95,99,0,-4,1,4,4,194,4,2015,0,6,2445,0
Toronto,24,23,16,13,0,0,0,0,Miami,22,22,30,22,0,0,0,0,20151108,76,96,-2,-3,11,20,20,172,20,2015,0,6,1234,0
Indiana,22,20,31,24,0,0,0,0,Cleveland,24,23,27,27,0,0,0,0,20151108,97,101,2,5,1,4,4,198,4,2015,0,6,262,0
Minnesota,30,42,21,24,0,0,0,0,Atlanta,19,23,42,23,0,0,0,0,20151109,117,107,11,30,9,10,10,224,-10,2015,0,0,908,0
Portland,33,25,22,24,0,0,0,0,Denver,29,28,22,29,0,0,0,0,20151109,104,108,-4,-1,-1,4,4,212,4,2015,0,0,981,0
Detroit,15,31,30,19,0,0,0,0,Golden State,27,28,25,29,0,0,0,0,20151109,95,109,12,9,4,14,14,204,14,2015,0,0,2087,0
Orlando,25,23,23,13,0,0,0,0,Indiana,25,24,23,25,0,0,0,0,20151109,84,97,0,1,1,13,13,181,13,2015,0,0,822,0
Memphis,26,20,20,26,0,0,0,0,LA Clippers,25,21,24,24,0,0,0,0,20151109,92,94,-1,0,4,2,2,186,2,2015,0,0,1599,0
Chicago,31,21,24,35,0,0,0,0,Philadelphia,22,21,19,26,0,0,0,0,20151109,111,88,9,9,14,23,23,199,-23,2015,0,0,664,0
San Antonio,23,26,23,34,0,0,0,0,Sacramento,24,19,26,19,0,0,0,0,20151109,106,88,-1,6,3,18,18,194,-18,2015,0,0,1456,0
Oklahoma City,37,31,29,28,0,0,0,0,Washington,23,27,21,30,0,0,0,0,20151110,125,101,14,18,26,24,24,226,-24,2015,0,1,1149,0
New York,24,36,25,26,0,0,0,0,Toronto,17,35,33,24,0,0,0,0,20151110,111,109,7,8,0,2,2,220,-2,2015,0,1,341,0
Dallas,22,18,35,30,0,0,0,0,New Orleans,29,29,36,26,0,0,0,0,20151110,105,120,7,18,19,15,15,225,15,2015,0,1,442,0
LA Lakers,23,26,17,22,0,0,0,0,Miami,29,21,25,26,0,0,0,0,20151110,88,101,6,1,9,13,13,189,13,2015,0,1,2335,0
Boston,24,22,30,23,0,0,0,0,Milwaukee,24,18,17,24,0,0,0,0,20151110,99,83,0,4,17,16,16,182,-16,2015,0,1,855,0
Charlotte,32,31,22,19,0,0,0,0,Minnesota,31,28,21,15,0,0,0,0,20151110,104,95,1,4,5,9,9,199,-9,2015,0,1,938,0
Utah,22,26,32,34,0,0,0,0,Cleveland,27,25,28,38,0,0,0,0,20151110,114,118,5,4,0,4,4,232,4,2015,0,1,1564,0
New Orleans,26,30,19,23,0,0,0,0,Atlanta,24,23,29,30,0,0,0,0,20151111,98,106,-2,-9,1,8,8,204,8,2015,0,2,424,0
Detroit,23,26,21,22,0,0,0,0,Sacramento,36,25,25,15,0,0,0,0,20151111,92,101,13,12,16,9,9,193,9,2015,0,2,2020,0
Toronto,29,34,33,23,0,0,0,0,Philadelphia,34,23,20,26,0,0,0,0,20151111,119,103,-5,6,19,16,16,222,-16,2015,0,2,334,0
Golden State,26,21,27,26,0,0,0,0,Memphis,15,26,22,21,0,0,0,0,20151111,100,84,11,6,11,16,16,184,-16,2015,0,2,1798,0
Brooklyn,22,33,24,27,0,0,0,0,Houston,28,21,34,15,0,0,0,0,20151111,106,98,-6,6,-4,8,8,204,-8,2015,0,2,1417,0
San Antonio,28,30,23,32,0,0,0,0,Portland,24,22,29,26,0,0,0,0,20151111,113,101,4,12,6,12,12,214,-12,2015,0,2,1718,0
LA Clippers,35,19,24,30,0,0,0,0,Dallas,27,26,31,34,0,0,0,0,20151111,108,118,-8,-1,6,10,10,226,10,2015,0,2,1237,0
New York,27,20,32,14,0,0,0,0,Charlotte,18,31,20,26,0,0,0,0,20151111,93,95,-9,2,-10,2,2,188,2,2015,0,2,531,0
Indiana,31,20,30,21,0,0,0,0,Boston,23,26,25,17,0,0,0,0,20151111,102,91,8,2,7,11,11,193,-11,2015,0,2,805,0
Milwaukee,32,32,16,22,0,0,0,0,Denver,25,28,34,16,0,0,0,0,20151111,102,103,-7,-11,7,1,1,205,1,2015,0,2,912,0
LA Lakers,25,20,25,29,0,0,0,0,Orlando,26,22,26,27,0,0,0,0,20151111,99,101,1,3,4,2,2,200,2,2015,0,2,2197,0
Utah,22,23,21,25,0,0,0,0,Miami,28,18,20,26,0,0,0,0,20151112,91,92,6,1,0,1,1,183,1,2015,0,3,2086,0
Golden State,40,35,22,32,0,0,0,0,Minnesota,27,36,24,29,0,0,0,0,20151112,129,116,13,12,10,13,13,245,-13,2015,0,3,1581,0
LA Clippers,25,24,24,31,0,0,0,0,Phoenix,30,28,35,25,0,0,0,0,20151112,104,118,5,9,20,14,14,222,14,2015,0,3,356,0
New Orleans,21,19,21,20,0,0,0,0,Toronto,17,23,32,28,0,0,0,0,20151113,81,100,-4,0,11,19,19,181,19,2015,0,4,1112,0
Cleveland,29,17,20,24,0,0,0,0,New York,23,30,19,12,0,0,0,0,20151113,90,84,6,-7,-6,6,6,174,-6,2015,0,4,403,0
Brooklyn,30,30,22,27,0,0,0,0,Sacramento,23,31,31,26,0,0,0,0,20151113,109,111,-7,-6,3,2,2,220,2,2015,0,4,2499,0
Utah,15,25,23,30,0,0,0,0,Orlando,33,19,28,22,0,0,0,0,20151113,93,102,18,12,17,9,9,195,9,2015,0,4,1915,0
Philadelphia,24,19,18,24,0,0,0,0,Oklahoma City,18,30,23,31,0,0,0,0,20151113,85,102,-6,5,10,17,17,187,17,2015,0,4,1256,0
Minnesota,27,23,23,30,0,0,0,0,Indiana,24,37,29,17,0,0,0,0,20151113,103,107,-3,11,17,4,4,210,4,2015,0,4,510,0
Houston,23,28,23,24,0,0,0,0,Denver,30,29,23,25,0,0,0,0,20151113,98,107,7,8,8,9,9,205,9,2015,0,4,878,0
LA Lakers,24,16,15,27,0,0,0,0,Dallas,29,19,16,26,0,0,0,0,20151113,82,90,5,8,9,8,8,172,8,2015,0,4,1237,0
Charlotte,23,23,29,22,0,0,0,0,Chicago,23,27,23,29,0,0,0,0,20151113,97,102,0,4,-2,5,5,199,5,2015,0,4,586,0
Atlanta,26,19,24,24,0,0,0,0,Boston,23,22,35,26,0,0,0,0,20151113,93,106,-3,0,11,13,13,199,13,2015,0,4,935,0
Portland,24,28,18,30,0,0,0,0,Memphis,23,30,26,22,0,0,0,0,20151113,100,101,-1,1,9,1,1,201,1,2015,0,4,1845,0
Orlando,27,29,20,23,0,0,0,0,Washington,29,21,29,29,0,0,0,0,20151114,99,108,2,-6,3,9,9,207,9,2015,0,5,757,0
Denver,13,15,26,27,0,0,0,0,Phoenix,27,33,28,17,0,0,0,0,20151114,81,105,14,32,34,24,24,186,24,2015,0,5,585,0
Cleveland,23,21,17,27,8,9,0,0,Milwaukee,23,27,20,18,8,12,0,0,20151114,105,108,0,6,9,0,3,213,3,2015,2,5,334,0
Philadelphia,12,27,21,23,0,0,0,0,San Antonio,20,23,33,16,0,0,0,0,20151114,83,92,8,4,16,9,9,175,9,2015,0,5,1505,0
Dallas,32,25,25,28,0,0,0,0,Houston,20,14,33,31,0,0,0,0,20151114,110,98,12,23,15,12,12,208,-12,2015,0,5,225,0
Brooklyn,36,18,23,20,2,0,0,0,Golden State,21,31,18,27,10,0,0,0,20151114,99,107,-15,-2,-7,0,8,206,8,2015,1,5,2565,0
Detroit,28,32,20,16,0,0,0,0,LA Clippers,25,26,30,20,0,0,0,0,20151114,96,101,-3,-9,1,5,5,197,5,2015,0,5,1979,0
Utah,27,20,27,23,0,0,0,0,Atlanta,24,28,22,22,0,0,0,0,20151115,97,96,3,-5,0,1,1,193,-1,2015,0,6,1580,0
Portland,27,18,21,28,0,0,0,0,Charlotte,35,36,18,17,0,0,0,0,20151115,94,106,8,26,23,12,12,200,12,2015,0,6,2284,0
Detroit,18,26,22,19,0,0,0,0,LA Lakers,21,27,18,31,0,0,0,0,20151115,85,97,3,4,0,12,12,182,12,2015,0,6,1979,0
Memphis,22,33,26,33,0,0,0,0,Minnesota,23,26,30,27,0,0,0,0,20151115,114,106,-1,6,2,8,8,220,-8,2015,0,6,700,0
New Orleans,27,17,21,22,0,0,0,0,New York,23,19,26,27,0,0,0,0,20151115,87,95,-4,-2,3,8,8,182,8,2015,0,6,1168,0
Boston,24,21,27,28,0,0,0,0,Oklahoma City,24,28,22,11,0,0,0,0,20151115,100,85,0,-7,-2,15,15,185,-15,2015,0,6,1492,0
Toronto,23,28,31,19,0,0,0,0,Sacramento,22,31,26,28,0,0,0,0,20151115,101,107,-1,2,-3,6,6,208,6,2015,0,6,2195,0
LA Lakers,22,31,22,26,0,0,0,0,Phoenix,26,31,23,40,0,0,0,0,20151116,101,120,4,4,5,19,19,221,19,2015,0,0,356,0
Dallas,28,21,19,24,0,0,0,0,Philadelphia,15,29,21,21,0,0,0,0,20151116,92,86,13,5,3,6,6,178,-6,2015,0,0,1297,0
Portland,13,15,32,20,0,0,0,0,San Antonio,17,19,29,28,0,0,0,0,20151116,80,93,4,8,5,13,13,173,13,2015,0,0,1718,0
Boston,24,31,32,24,0,0,0,0,Houston,28,27,13,27,0,0,0,0,20151116,111,95,-4,0,19,16,16,206,-16,2015,0,0,1603,0
Indiana,21,24,30,20,0,0,0,0,Chicago,31,22,26,17,0,0,0,0,20151116,95,96,10,8,4,1,1,191,1,2015,0,0,163,0
Oklahoma City,25,27,28,34,0,0,0,0,Memphis,27,31,21,43,0,0,0,0,20151116,114,122,2,6,-1,8,8,236,8,2015,0,0,421,0
Atlanta,19,27,22,20,0,0,0,0,Brooklyn,17,28,27,18,0,0,0,0,20151117,88,90,-2,-1,4,2,2,178,2,2015,0,1,745,0
Cleveland,27,29,25,18,0,0,0,0,Detroit,31,24,20,29,0,0,0,0,20151117,99,104,4,-1,-6,5,5,203,5,2015,0,1,90,0
Toronto,25,22,36,27,0,0,0,0,Golden State,29,34,27,25,0,0,0,0,20151117,110,115,4,16,7,5,5,225,5,2015,0,1,2263,0
Minnesota,20,25,17,41,0,0,0,0,Miami,25,25,19,22,0,0,0,0,20151117,103,91,-5,-5,-7,12,12,194,-12,2015,0,1,1513,0
Denver,31,20,32,32,0,0,0,0,New Orleans,21,32,22,23,0,0,0,0,20151117,115,98,10,-2,8,17,17,213,-17,2015,0,1,1079,0
Charlotte,21,27,24,22,0,0,0,0,New York,26,20,34,22,0,0,0,0,20151117,94,102,5,-2,8,8,8,196,8,2015,0,1,531,0
Milwaukee,29,17,20,20,0,0,0,0,Washington,27,37,21,30,0,0,0,0,20151117,86,115,-2,18,19,29,29,201,29,2015,0,1,634,0
Toronto,19,26,19,25,0,0,0,0,Utah,24,18,17,34,0,0,0,0,20151118,89,93,5,-3,-5,4,4,182,4,2015,0,2,1664,0
Denver,24,34,21,19,0,0,0,0,San Antonio,31,34,28,16,0,0,0,0,20151118,98,109,7,7,14,11,11,207,11,2015,0,2,802,0
Chicago,31,22,19,31,0,0,0,0,Phoenix,18,29,23,27,0,0,0,0,20151118,103,97,13,6,2,6,6,200,-6,2015,0,2,1450,0
Indiana,23,29,32,28,0,0,0,0,Philadelphia,18,20,24,23,0,0,0,0,20151118,112,85,5,14,22,27,27,197,-27,2015,0,2,582,0
Minnesota,25,27,24,17,8,0,0,0,Orlando,17,21,33,22,11,0,0,0,20151118,101,104,-8,-14,-5,0,3,205,3,2015,1,2,1309,0
Portland,21,25,30,23,4,0,0,0,Houston,22,13,26,38,9,0,0,0,20151118,103,108,1,-11,-15,0,5,211,5,2015,1,2,1833,0
Brooklyn,32,24,30,25,0,0,0,0,Charlotte,32,20,34,30,0,0,0,0,20151118,111,116,0,-4,0,5,5,227,5,2015,0,2,531,0
Dallas,16,29,25,36,0,0,0,0,Boston,31,23,24,24,0,0,0,0,20151118,106,102,-15,-9,-8,4,4,208,-4,2015,0,2,1548,0
Sacramento,30,22,27,18,0,0,0,0,Atlanta,27,35,19,22,0,0,0,0,20151118,97,103,-3,10,2,6,6,200,6,2015,0,2,2082,0
New Orleans,27,18,29,29,0,0,0,0,Oklahoma City,21,32,27,30,0,0,0,0,20151118,103,110,-6,8,6,7,7,213,7,2015,0,2,576,0
Milwaukee,23,25,31,21,0,0,0,0,Cleveland,28,35,23,29,0,0,0,0,20151119,100,115,5,15,7,15,15,215,15,2015,0,3,334,0
Golden State,25,29,31,39,0,0,0,0,LA Clippers,41,27,23,26,0,0,0,0,20151119,124,117,-16,-14,-6,7,7,241,-7,2015,0,3,347,0
Sacramento,21,25,30,33,0,0,0,0,Miami,25,31,26,34,0,0,0,0,20151119,109,116,4,10,6,7,7,225,7,2015,0,3,2547,0
Houston,19,26,25,14,0,0,0,0,Memphis,23,36,20,17,0,0,0,0,20151120,84,96,4,14,9,12,12,180,12,2015,0,4,484,0
New York,25,23,25,20,0,0,0,0,Oklahoma City,20,24,18,28,0,0,0,0,20151120,93,90,5,4,11,3,3,183,-3,2015,0,4,1324,0
San Antonio,20,21,33,16,0,0,0,0,New Orleans,22,26,30,26,0,0,0,0,20151120,90,104,2,7,4,14,14,194,14,2015,0,4,506,0
LA Clippers,23,24,26,18,0,0,0,0,Portland,23,25,27,27,0,0,0,0,20151120,91,102,0,1,2,11,11,193,11,2015,0,4,826,0
Toronto,27,22,27,26,0,0,0,0,LA Lakers,21,29,18,23,0,0,0,0,20151120,102,91,6,-1,8,11,11,193,-11,2015,0,4,2170,0
Detroit,22,16,30,28,0,0,0,0,Minnesota,26,18,21,21,0,0,0,0,20151120,96,86,-4,-6,3,10,10,182,-10,2015,0,4,542,0
Phoenix,17,32,31,34,0,0,0,0,Denver,29,34,21,23,0,0,0,0,20151120,114,107,-12,-14,-4,7,7,221,-7,2015,0,4,585,0
Brooklyn,19,23,25,28,0,0,0,0,Boston,23,43,25,29,0,0,0,0,20151120,95,120,4,24,24,25,25,215,25,2015,0,4,190,0
Chicago,29,18,26,21,0,0,0,0,Golden State,28,22,27,29,0,0,0,0,20151120,94,106,-1,3,4,12,12,200,12,2015,0,4,1853,0
Utah,26,17,28,22,0,0,0,0,Dallas,21,35,24,22,0,0,0,0,20151120,93,102,-5,13,9,9,9,195,9,2015,0,4,998,0
Philadelphia,19,22,29,18,0,0,0,0,Charlotte,30,32,23,28,0,0,0,0,20151120,88,113,11,21,15,25,25,201,25,2015,0,4,450,0
Atlanta,19,23,22,33,0,0,0,0,Cleveland,27,30,20,32,0,0,0,0,20151121,97,109,8,15,13,12,12,206,12,2015,0,5,555,0
Washington,30,22,23,22,0,0,0,0,Detroit,24,28,21,22,0,0,0,0,20151121,97,95,6,0,2,2,2,192,-2,2015,0,5,394,0
New York,24,34,21,28,0,0,0,0,Houston,26,27,24,25,0,0,0,0,20151121,107,102,-2,5,2,5,5,209,-5,2015,0,5,1417,0
Milwaukee,25,26,16,19,0,0,0,0,Indiana,28,27,35,33,0,0,0,0,20151121,86,123,3,4,23,37,37,209,37,2015,0,5,243,0
Philadelphia,28,19,27,17,0,0,0,0,Miami,16,16,35,29,0,0,0,0,20151121,91,96,-12,-15,-7,5,5,187,5,2015,0,5,1021,0
Sacramento,27,26,30,14,0,0,0,0,Orlando,22,25,20,24,0,0,0,0,20151121,97,91,5,6,16,6,6,188,-6,2015,0,5,2390,0
Memphis,19,20,22,21,0,0,0,0,San Antonio,24,29,21,18,0,0,0,0,20151121,82,92,5,14,13,10,10,174,10,2015,0,5,631,0
Boston,19,23,36,23,0,0,0,0,Brooklyn,24,35,27,25,0,0,0,0,20151122,101,111,5,17,8,10,10,212,10,2015,0,6,190,0
Golden State,34,30,27,27,0,0,0,0,Denver,23,35,21,26,0,0,0,0,20151122,118,105,11,6,12,13,13,223,-13,2015,0,6,947,0
Toronto,33,30,8,20,0,0,0,0,LA Clippers,23,11,21,25,0,0,0,0,20151122,91,80,10,29,16,11,11,171,-11,2015,0,6,2170,0
Portland,32,24,28,23,0,0,0,0,LA Lakers,23,29,22,19,0,0,0,0,20151122,107,93,9,4,10,14,14,200,-14,2015,0,6,826,0
Phoenix,21,34,30,31,0,0,0,0,New Orleans,27,29,36,30,0,0,0,0,20151122,116,122,6,1,7,6,6,238,6,2015,0,6,1312,0
Dallas,25,27,33,29,0,0,0,0,Oklahoma City,31,29,27,30,0,0,0,0,20151122,114,117,6,8,2,3,3,231,3,2015,0,6,189,0
Oklahoma City,23,40,25,23,0,0,0,0,Utah,20,26,22,21,0,0,0,0,20151123,111,89,3,17,20,22,22,200,-22,2015,0,0,861,0
Phoenix,17,17,26,24,0,0,0,0,San Antonio,20,24,23,31,0,0,0,0,20151123,84,98,3,10,7,14,14,182,14,2015,0,0,846,0
Philadelphia,26,26,21,22,0,0,0,0,Minnesota,19,27,28,26,0,0,0,0,20151123,95,100,-7,-6,1,5,5,195,5,2015,0,0,983,0
New York,19,11,26,22,0,0,0,0,Miami,26,26,21,22,0,0,0,0,20151123,78,95,7,22,17,17,17,173,17,2015,0,0,1091,0
Orlando,27,28,21,27,0,0,0,0,Cleveland,29,30,33,25,0,0,0,0,20151123,103,117,2,4,16,14,14,220,14,2015,0,0,895,0
Sacramento,30,30,31,21,10,0,0,0,Charlotte,33,27,14,38,15,0,0,0,20151123,122,127,3,0,-17,0,5,249,5,2015,1,0,2239,0
Detroit,26,22,14,26,0,0,0,0,Milwaukee,25,33,30,21,0,0,0,0,20151123,88,109,-1,10,26,21,21,197,21,2015,0,0,251,0
Boston,28,20,25,24,0,0,0,0,Atlanta,33,24,24,40,0,0,0,0,20151124,97,121,5,9,8,24,24,218,24,2015,0,1,935,0
LA Clippers,25,26,32,28,0,0,0,0,Denver,26,19,27,22,0,0,0,0,20151124,111,94,-1,6,11,17,17,205,-17,2015,0,1,830,0
LA Lakers,11,27,17,22,0,0,0,0,Golden State,30,24,35,22,0,0,0,0,20151124,77,111,19,16,34,34,34,188,34,2015,0,1,347,0
Dallas,17,19,24,36,0,0,0,0,Memphis,21,25,36,28,0,0,0,0,20151124,96,110,4,10,22,14,14,206,14,2015,0,1,419,0
Chicago,29,19,23,22,0,0,0,0,Portland,22,17,24,25,0,0,0,0,20151124,93,88,7,9,8,5,5,181,-5,2015,0,1,1754,0
Indiana,33,29,31,30,0,0,0,0,Washington,31,30,21,24,0,0,0,0,20151124,123,106,2,1,11,17,17,229,-17,2015,0,1,490,0
Brooklyn,26,26,24,23,0,0,0,0,Oklahoma City,25,31,27,27,0,0,0,0,20151125,99,110,-1,4,7,11,11,209,11,2015,0,2,1324,0
Cleveland,25,24,31,19,0,0,0,0,Toronto,25,24,33,21,0,0,0,0,20151125,99,103,0,0,2,4,4,202,4,2015,0,2,187,0
Dallas,18,21,21,23,0,0,0,0,San Antonio,24,22,17,25,0,0,0,0,20151125,83,88,6,7,3,5,5,171,5,2015,0,2,252,0
New Orleans,25,33,30,32,0,0,0,0,Phoenix,39,21,25,29,0,0,0,0,20151125,120,114,-14,-2,3,6,6,234,-6,2015,0,2,1312,0
New York,17,18,28,28,0,0,0,0,Orlando,20,26,26,28,0,0,0,0,20151125,91,100,3,11,9,9,9,191,9,2015,0,2,939,0
Atlanta,23,25,26,21,0,0,0,0,Minnesota,27,23,20,29,0,0,0,0,20151125,95,99,4,2,-4,4,4,194,4,2015,0,2,908,0
Philadelphia,24,23,15,18,0,0,0,0,Boston,26,14,17,27,0,0,0,0,20151125,80,84,2,-7,-5,4,4,164,4,2015,0,2,270,0
Utah,21,24,28,29,0,0,0,0,LA Clippers,23,22,23,23,0,0,0,0,20151125,102,91,-2,0,5,11,11,193,-11,2015,0,2,579,0
Memphis,28,28,26,20,0,0,0,0,Houston,24,29,24,16,0,0,0,0,20151125,102,93,4,3,5,9,9,195,-9,2015,0,2,484,0
Miami,19,24,19,19,0,0,0,0,Detroit,25,35,23,21,0,0,0,0,20151125,81,104,6,17,21,23,23,185,23,2015,0,2,1155,0
Washington,24,30,27,6,0,0,0,0,Charlotte,28,30,16,27,0,0,0,0,20151125,87,101,4,4,-7,14,14,188,14,2015,0,2,329,0
Sacramento,40,29,27,33,0,0,0,0,Milwaukee,33,33,26,26,0,0,0,0,20151125,129,118,7,3,4,11,11,247,-11,2015,0,2,1771,0
Minnesota,29,24,22,26,0,0,0,0,Sacramento,28,19,21,23,0,0,0,0,20151127,101,91,1,6,7,10,10,192,-10,2015,0,4,1511,0
Golden State,44,31,28,32,0,0,0,0,Phoenix,27,30,24,35,0,0,0,0,20151127,135,116,17,18,22,19,19,251,-19,2015,0,4,652,0
Milwaukee,22,21,22,25,0,0,0,0,Orlando,22,27,37,28,0,0,0,0,20151127,90,114,0,6,21,24,24,204,24,2015,0,4,1065,0
Detroit,31,24,16,16,0,0,0,0,Oklahoma City,29,19,28,27,0,0,0,0,20151127,87,103,-2,-7,5,16,16,190,16,2015,0,4,909,0
Miami,26,24,24,23,0,0,0,0,New York,27,22,14,15,0,0,0,0,20151127,97,78,-1,1,11,19,19,175,-19,2015,0,4,1091,0
Atlanta,29,24,32,31,0,0,0,0,Memphis,36,22,24,19,0,0,0,0,20151127,116,101,-7,-5,3,15,15,217,-15,2015,0,4,336,0
Chicago,18,24,21,29,0,0,0,0,Indiana,30,21,21,32,0,0,0,0,20151127,92,104,12,9,9,12,12,196,12,2015,0,4,163,0
Philadelphia,19,30,31,34,0,0,0,0,Houston,30,26,35,25,0,0,0,0,20151127,114,116,11,7,11,2,2,230,2,2015,0,4,1339,0
San Antonio,16,30,24,21,0,0,0,0,Denver,16,26,17,21,0,0,0,0,20151127,91,80,0,4,11,11,11,171,-11,2015,0,4,802,0
Cleveland,23,27,22,23,0,0,0,0,Charlotte,22,30,24,14,0,0,0,0,20151127,95,90,1,-2,-4,5,5,185,-5,2015,0,4,435,0
Washington,18,18,20,22,0,0,0,0,Boston,29,25,25,32,0,0,0,0,20151127,78,111,11,18,23,33,33,189,33,2015,0,4,394,0
New Orleans,18,24,30,18,0,0,0,0,LA Clippers,28,35,27,21,0,0,0,0,20151127,90,111,10,21,18,21,21,201,21,2015,0,4,1669,0
New Orleans,16,23,21,27,0,0,0,0,Utah,23,25,28,25,0,0,0,0,20151128,87,101,7,9,16,14,14,188,14,2015,0,5,1432,0
Toronto,16,23,23,22,0,0,0,0,Washington,23,22,23,14,0,0,0,0,20151128,84,82,-7,-6,-6,2,2,166,-2,2015,0,5,349,0
Atlanta,25,12,22,29,0,0,0,0,San Antonio,23,31,26,28,0,0,0,0,20151128,88,108,-2,17,21,20,20,196,20,2015,0,5,881,0
Sacramento,29,17,25,30,0,0,0,0,Golden State,30,26,36,28,0,0,0,0,20151128,101,120,1,10,21,19,19,221,19,2015,0,5,75,0
Denver,25,27,5,24,0,0,0,0,Dallas,22,26,25,19,0,0,0,0,20151128,81,92,-3,-4,16,11,11,173,11,2015,0,5,661,0
LA Lakers,21,25,30,20,0,0,0,0,Portland,34,26,24,24,0,0,0,0,20151128,96,108,13,14,8,12,12,204,12,2015,0,5,826,0
Brooklyn,24,26,18,20,0,0,0,0,Cleveland,17,27,25,21,0,0,0,0,20151128,88,90,-7,-6,1,2,2,178,2,2015,0,5,403,0
Detroit,22,19,26,16,0,0,0,0,Brooklyn,18,17,24,28,0,0,0,0,20151129,83,87,-4,-6,-8,4,4,170,4,2015,0,6,480,0
Milwaukee,28,9,22,23,0,0,0,0,Charlotte,22,23,20,22,0,0,0,0,20151129,82,87,-6,8,6,5,5,169,5,2015,0,6,658,0
Minnesota,19,18,24,38,0,0,0,0,LA Clippers,23,25,23,36,0,0,0,0,20151129,99,107,4,11,10,8,8,206,8,2015,0,6,1521,0
Indiana,28,20,32,27,0,0,0,0,LA Lakers,12,23,30,38,0,0,0,0,20151129,107,103,16,13,15,4,4,210,-4,2015,0,6,1805,0
Philadelphia,13,18,36,17,0,0,0,0,Memphis,21,16,27,28,0,0,0,0,20151129,84,92,8,6,-3,8,8,176,8,2015,0,6,878,0
Houston,21,20,28,32,15,0,0,0,New York,25,29,23,24,10,0,0,0,20151129,116,111,-4,-13,-8,0,5,227,-5,2015,1,6,1417,0
Boston,20,25,22,24,0,0,0,0,Orlando,21,32,31,26,0,0,0,0,20151129,91,110,1,8,17,19,19,201,19,2015,0,6,1115,0
Phoenix,21,32,28,26,0,0,0,0,Toronto,18,31,23,30,0,0,0,0,20151129,107,102,3,4,9,5,5,209,-5,2015,0,6,1885,0
Golden State,26,27,30,23,0,0,0,0,Utah,20,28,29,26,0,0,0,0,20151130,106,103,6,5,6,3,3,209,-3,2015,0,0,599,0
Dallas,32,26,13,27,0,0,0,0,Sacramento,23,31,22,36,0,0,0,0,20151130,98,112,-9,-4,5,14,14,210,14,2015,0,0,1437,0
Denver,23,21,16,14,0,0,0,0,Milwaukee,28,18,21,25,0,0,0,0,20151130,74,92,5,2,7,18,18,166,18,2015,0,0,912,0
Boston,32,25,24,24,0,0,0,0,Miami,23,28,24,20,0,0,0,0,20151130,105,95,9,6,6,10,10,200,-10,2015,0,0,1257,0
Portland,18,31,15,23,0,0,0,0,LA Clippers,29,20,25,28,0,0,0,0,20151130,87,102,11,0,10,15,15,189,15,2015,0,0,826,0
Houston,21,20,32,32,0,0,0,0,Detroit,29,35,20,32,0,0,0,0,20151130,105,116,8,23,11,11,11,221,11,2015,0,0,1105,0
San Antonio,23,25,25,16,0,0,0,0,Chicago,17,32,21,22,0,0,0,0,20151130,89,92,-6,1,-3,3,3,181,3,2015,0,0,1050,0
Oklahoma City,21,31,22,26,0,0,0,0,Atlanta,31,22,26,27,0,0,0,0,20151130,100,106,10,1,5,6,6,206,6,2015,0,0,755,0
Phoenix,20,22,31,18,0,0,0,0,Brooklyn,25,26,19,24,0,0,0,0,20151201,91,94,5,9,-3,3,3,185,3,2015,0,1,2139,0
Washington,27,27,26,17,0,0,0,0,Cleveland,24,19,24,18,0,0,0,0,20151201,97,85,3,11,13,12,12,182,-12,2015,0,1,304,0
Orlando,21,33,22,20,0,0,0,0,Minnesota,14,27,26,26,0,0,0,0,20151201,96,93,7,13,9,3,3,189,-3,2015,0,1,1309,0
Memphis,27,37,27,22,0,0,0,0,New Orleans,38,27,20,19,0,0,0,0,20151201,113,104,-11,-1,6,9,9,217,-9,2015,0,1,358,0
LA Lakers,33,25,17,16,0,0,0,0,Philadelphia,26,24,30,23,0,0,0,0,20151201,91,103,-7,-8,5,12,12,194,12,2015,0,1,2388,0
Dallas,27,23,24,22,19,0,0,0,Portland,18,34,21,23,16,0,0,0,20151201,115,112,9,-2,1,0,3,227,-3,2015,1,1,1630,0
LA Lakers,34,23,21,30,0,0,0,0,Washington,22,29,24,29,0,0,0,0,20151202,108,104,12,6,3,4,4,212,-4,2015,0,2,2294,0
Milwaukee,21,17,17,15,0,0,0,0,San Antonio,28,20,28,19,0,0,0,0,20151202,70,95,7,10,21,25,25,165,25,2015,0,2,1108,0
Philadelphia,21,18,19,29,0,0,0,0,New York,27,27,27,18,0,0,0,0,20151202,87,99,6,15,23,12,12,186,12,2015,0,2,80,0
Indiana,29,18,25,31,0,0,0,0,LA Clippers,29,21,19,22,0,0,0,0,20151202,103,91,0,-3,3,12,12,194,-12,2015,0,2,1805,0
Toronto,16,16,25,39,0,0,0,0,Atlanta,18,28,20,20,0,0,0,0,20151202,96,86,-2,-14,-9,10,10,182,-10,2015,0,2,733,0
Phoenix,26,31,32,23,10,0,0,0,Detroit,31,26,23,32,15,0,0,0,20151202,122,127,5,0,-9,0,5,249,5,2015,1,2,1687,0
Golden State,32,28,33,23,0,0,0,0,Charlotte,23,28,21,27,0,0,0,0,20151202,116,99,9,9,21,17,17,215,-17,2015,0,2,2296,0
Denver,21,25,26,18,0,0,0,0,Chicago,28,23,17,31,0,0,0,0,20151202,90,99,7,5,-4,9,9,189,9,2015,0,2,916,0
New Orleans,29,21,32,19,0,0,0,0,Houston,17,31,36,24,0,0,0,0,20151202,101,108,-12,-2,2,7,7,209,7,2015,0,2,317,0
San Antonio,20,25,29,29,0,0,0,0,Memphis,21,15,21,26,0,0,0,0,20151203,103,83,-1,9,17,20,20,186,-20,2015,0,3,631,0
Oklahoma City,28,23,25,19,0,0,0,0,Miami,23,27,24,23,0,0,0,0,20151203,95,97,-5,-1,-2,2,2,192,2,2015,0,3,1225,0
Indiana,31,28,31,21,0,0,0,0,Portland,28,28,41,26,0,0,0,0,20151203,111,123,-3,-3,7,12,12,234,12,2015,0,3,1880,0
Boston,32,19,39,24,0,0,0,0,Sacramento,17,19,32,29,0,0,0,0,20151203,114,97,15,15,22,17,17,211,-17,2015,0,3,2624,0
Denver,29,27,25,25,0,0,0,0,Toronto,19,23,29,34,0,0,0,0,20151203,106,105,10,14,10,1,1,211,-1,2015,0,3,1341,0
Orlando,29,25,23,26,0,0,0,0,Utah,25,32,21,16,0,0,0,0,20151203,103,94,4,-3,-1,9,9,197,-9,2015,0,3,1915,0
Phoenix,31,29,25,21,0,0,0,0,Washington,22,29,27,31,0,0,0,0,20151204,106,109,-9,-9,-7,3,3,215,3,2015,0,4,1977,0
Brooklyn,21,21,25,24,0,0,0,0,New York,42,23,27,16,0,0,0,0,20151204,91,108,21,23,25,17,17,199,17,2015,0,4,0,0
Cleveland,27,26,24,28,3,0,0,0,New Orleans,21,31,32,21,9,0,0,0,20151204,108,114,-6,-1,7,0,6,222,6,2015,1,4,924,0
LA Lakers,19,17,30,21,0,0,0,0,Atlanta,23,29,20,28,0,0,0,0,20151204,87,100,4,16,6,13,13,187,13,2015,0,4,1932,0
Houston,26,31,21,22,0,0,0,0,Dallas,28,25,25,18,0,0,0,0,20151204,100,96,-2,4,0,4,4,196,-4,2015,0,4,225,0
Milwaukee,16,24,19,36,0,0,0,0,Detroit,17,34,16,35,0,0,0,0,20151204,95,102,1,11,8,7,7,197,7,2015,0,4,251,0
Portland,22,24,34,29,0,0,0,0,Minnesota,32,27,23,21,0,0,0,0,20151205,109,103,-10,-13,-2,6,6,212,-6,2015,0,5,1423,0
Golden State,32,27,24,29,0,0,0,0,Toronto,21,28,30,30,0,0,0,0,20151205,112,109,11,10,4,3,3,221,-3,2015,0,5,2263,0
Boston,27,22,22,34,0,0,0,0,San Antonio,29,29,28,22,0,0,0,0,20151205,105,108,2,9,15,3,3,213,3,2015,0,5,1765,0
Denver,29,23,25,31,0,0,0,0,Philadelphia,25,34,26,20,0,0,0,0,20151205,108,105,4,-7,-8,3,3,213,-3,2015,0,5,1574,0
Indiana,19,33,32,26,9,0,0,0,Utah,27,30,27,26,12,0,0,0,20151205,119,122,8,5,0,0,3,241,3,2015,1,5,1353,0
New York,24,24,21,22,0,0,0,0,Milwaukee,29,23,29,25,0,0,0,0,20151205,91,106,5,4,12,15,15,197,15,2015,0,5,732,0
Orlando,24,26,29,22,0,0,0,0,LA Clippers,22,31,21,29,0,0,0,0,20151205,101,103,-2,3,-5,2,2,204,2,2015,0,5,2197,0
Charlotte,26,26,20,30,0,0,0,0,Chicago,22,28,25,21,0,0,0,0,20151205,102,96,4,2,-3,6,6,198,-6,2015,0,5,586,0
Cleveland,22,20,22,20,0,0,0,0,Miami,34,26,23,16,0,0,0,0,20151205,84,99,12,18,19,15,15,183,15,2015,0,5,1089,0
Sacramento,16,34,35,28,0,0,0,0,Houston,29,23,32,36,0,0,0,0,20151205,113,120,13,2,-1,7,7,233,7,2015,0,5,1606,0
Golden State,30,27,30,27,0,0,0,0,Brooklyn,16,38,26,18,0,0,0,0,20151206,114,98,14,3,7,16,16,212,-16,2015,0,6,2565,0
LA Lakers,19,23,23,26,0,0,0,0,Detroit,32,33,25,21,0,0,0,0,20151206,91,111,13,23,25,20,20,202,20,2015,0,6,1979,0
Phoenix,16,25,27,25,0,0,0,0,Memphis,20,23,24,28,0,0,0,0,20151206,93,95,4,2,-1,2,2,188,2,2015,0,6,1260,0
Sacramento,25,23,16,31,0,0,0,0,Oklahoma City,28,23,25,22,0,0,0,0,20151206,95,98,3,3,12,3,3,193,3,2015,0,6,1336,0
Dallas,29,26,32,29,0,0,0,0,Washington,28,30,26,20,0,0,0,0,20151206,116,104,1,-3,3,12,12,220,-12,2015,0,6,1181,0
Dallas,34,29,25,16,0,0,0,0,New York,28,22,22,25,0,0,0,0,20151207,104,97,6,13,16,7,7,201,-7,2015,0,0,1370,0
LA Lakers,22,20,29,22,0,0,0,0,Toronto,25,27,19,31,0,0,0,0,20151207,93,102,3,10,0,9,9,195,9,2015,0,0,2170,0
San Antonio,33,32,31,23,0,0,0,0,Philadelphia,17,12,23,16,0,0,0,0,20151207,119,68,16,36,44,51,51,187,-51,2015,0,0,1505,0
Boston,25,28,28,30,0,0,0,0,New Orleans,25,19,23,26,0,0,0,0,20151207,111,93,0,9,14,18,18,204,-18,2015,0,0,1358,0
LA Clippers,29,21,21,39,0,0,0,0,Minnesota,25,27,25,29,0,0,0,0,20151207,110,106,4,-2,-6,4,4,216,-4,2015,0,0,1521,0
Portland,16,17,29,26,0,0,0,0,Milwaukee,25,17,18,30,0,0,0,0,20151207,88,90,9,9,-2,2,2,178,2,2015,0,0,1714,0
Washington,29,31,27,27,0,0,0,0,Miami,19,36,29,19,0,0,0,0,20151207,114,103,10,5,3,11,11,217,-11,2015,0,0,924,0
Detroit,20,31,19,14,0,0,0,0,Charlotte,28,34,26,16,0,0,0,0,20151207,84,104,8,11,18,20,20,188,20,2015,0,0,504,0
Phoenix,27,24,10,42,0,0,0,0,Chicago,30,21,26,24,0,0,0,0,20151207,103,101,-3,0,-16,2,2,204,-2,2015,0,0,1450,0
Houston,24,22,26,33,0,0,0,0,Brooklyn,31,26,23,30,0,0,0,0,20151208,105,110,7,11,8,5,5,215,5,2015,0,1,1417,0
Portland,25,31,19,25,0,0,0,0,Cleveland,17,30,30,28,0,0,0,0,20151208,100,105,-8,-9,2,5,5,205,5,2015,0,1,2049,0
Orlando,26,14,22,23,0,0,0,0,Denver,26,21,16,11,0,0,0,0,20151208,85,74,0,-7,-1,11,11,159,-11,2015,0,1,1548,0
Golden State,44,35,32,20,0,0,0,0,Indiana,28,32,23,40,0,0,0,0,20151208,131,123,16,19,28,8,8,254,-8,2015,0,1,1944,0
Oklahoma City,28,31,39,27,0,0,0,0,Memphis,25,22,16,25,0,0,0,0,20151208,125,88,3,12,35,37,37,213,-37,2015,0,1,421,0
Utah,22,26,32,26,0,0,0,0,Sacramento,33,21,32,28,0,0,0,0,20151208,106,114,11,6,6,8,8,220,8,2015,0,1,532,0
San Antonio,21,25,16,32,0,0,0,0,Toronto,27,26,20,24,0,0,0,0,20151209,94,97,6,7,11,3,3,191,3,2015,0,2,1438,0
Memphis,24,19,24,26,0,0,0,0,Detroit,17,30,27,18,0,0,0,0,20151209,93,92,7,-4,-7,1,1,185,-1,2015,0,2,622,0
Houston,30,26,26,27,0,0,0,0,Washington,17,30,36,20,0,0,0,0,20151209,109,103,13,9,-1,6,6,212,-6,2015,0,2,1217,0
New York,11,24,24,26,0,0,0,0,Utah,29,31,22,24,0,0,0,0,20151209,85,106,18,25,23,21,21,191,21,2015,0,2,1967,0
Orlando,24,23,26,31,0,0,0,0,Phoenix,21,28,35,23,0,0,0,0,20151209,104,107,-3,2,11,3,3,211,3,2015,0,2,1842,0
Atlanta,22,27,27,22,0,0,0,0,Dallas,23,21,28,23,0,0,0,0,20151209,98,95,-1,5,4,3,3,193,-3,2015,0,2,719,0
LA Clippers,25,22,28,34,0,0,0,0,Milwaukee,26,22,20,27,0,0,0,0,20151209,109,95,-1,-1,7,14,14,204,-14,2015,0,2,1741,0
Miami,17,19,18,27,0,0,0,0,Charlotte,27,29,24,19,0,0,0,0,20151209,81,99,10,20,26,18,18,180,18,2015,0,2,654,0
Chicago,24,30,21,25,0,0,0,0,Boston,24,27,24,30,0,0,0,0,20151209,100,105,0,-3,0,5,5,205,5,2015,0,2,849,0
LA Lakers,32,25,24,33,8,0,0,0,Minnesota,35,24,25,30,9,0,0,0,20151209,122,123,3,2,3,0,1,245,1,2015,1,2,1521,0
Philadelphia,13,31,30,17,0,0,0,0,Brooklyn,24,28,18,30,0,0,0,0,20151210,91,100,11,8,-4,9,9,191,9,2015,0,3,80,0
LA Clippers,24,11,19,26,0,0,0,0,Chicago,23,21,20,19,0,0,0,0,20151210,80,83,-1,9,10,3,3,163,3,2015,0,3,1741,0
Atlanta,28,21,26,19,0,0,0,0,Oklahoma City,35,25,23,24,0,0,0,0,20151210,94,107,7,11,8,13,13,201,13,2015,0,3,755,0
New York,16,23,26,32,0,0,0,0,Sacramento,24,22,30,23,0,0,0,0,20151210,97,99,8,7,11,2,2,196,2,2015,0,3,2499,0
Oklahoma City,27,25,20,22,0,0,0,0,Utah,15,29,23,23,0,0,0,0,20151211,94,90,12,8,5,4,4,184,-4,2015,0,4,861,0
Milwaukee,17,14,29,23,0,0,0,0,Toronto,24,25,21,20,0,0,0,0,20151211,83,90,7,18,10,7,7,173,7,2015,0,4,429,0
LA Lakers,27,22,22,16,0,0,0,0,San Antonio,31,20,28,30,0,0,0,0,20151211,87,109,4,2,8,22,22,196,22,2015,0,4,1201,0
Portland,33,24,21,28,0,0,0,0,Phoenix,26,35,21,14,0,0,0,0,20151211,106,96,7,-4,-4,10,10,202,-10,2015,0,4,1005,0
Detroit,35,23,31,18,0,0,0,0,Philadelphia,14,32,20,29,0,0,0,0,20151211,107,95,21,12,23,12,12,202,-12,2015,0,4,441,0
Charlotte,29,30,34,30,0,0,0,0,Memphis,35,19,19,26,0,0,0,0,20151211,123,99,-6,5,20,24,24,222,-24,2015,0,4,519,0
Washington,27,27,23,28,0,0,0,0,New Orleans,29,26,22,30,0,0,0,0,20151211,105,107,2,1,0,2,2,212,2,2015,0,4,964,0
Miami,21,27,20,15,0,0,0,0,Indiana,20,27,30,19,0,0,0,0,20151211,83,96,-1,-1,9,13,13,179,13,2015,0,4,1026,0
Minnesota,29,27,22,22,8,0,0,0,Denver,23,18,32,27,11,0,0,0,20151211,108,111,-6,-15,-5,0,3,219,3,2015,1,4,698,0
Golden State,26,31,25,21,7,14,0,0,Boston,25,28,22,28,7,9,0,0,20151211,124,119,1,4,7,0,5,243,-5,2015,2,4,2692,0
Cleveland,22,31,30,28,0,0,0,0,Orlando,20,17,15,24,0,0,0,0,20151211,111,76,2,16,31,35,35,187,-35,2015,0,4,895,0
Indiana,29,26,24,17,0,0,0,0,Detroit,28,37,37,16,0,0,0,0,20151212,96,118,-1,10,23,22,22,214,22,2015,0,5,240,0
Golden State,28,20,29,18,0,0,0,0,Milwaukee,30,29,21,28,0,0,0,0,20151212,95,108,2,11,3,13,13,203,13,2015,0,5,1838,0
LA Lakers,25,21,30,21,0,0,0,0,Houston,32,31,28,35,0,0,0,0,20151212,97,126,7,17,15,29,29,223,29,2015,0,5,1371,0
New York,21,34,21,36,0,0,0,0,Portland,29,27,30,24,0,0,0,0,20151212,112,110,-8,-1,-10,2,2,222,-2,2015,0,5,2439,0
Boston,16,22,35,25,0,0,0,0,Charlotte,17,25,27,24,0,0,0,0,20151212,98,93,-1,-4,4,5,5,191,-5,2015,0,5,720,0
New Orleans,28,17,25,24,0,0,0,0,Chicago,20,22,22,34,0,0,0,0,20151212,94,98,-8,-3,-6,4,4,192,4,2015,0,5,832,0
LA Clippers,28,29,20,28,0,0,0,0,Brooklyn,20,24,19,37,0,0,0,0,20151212,105,100,8,13,14,5,5,205,-5,2015,0,5,2445,0
San Antonio,22,25,32,24,0,0,0,0,Atlanta,13,12,30,23,0,0,0,0,20151212,103,78,9,22,24,25,25,181,-25,2015,0,5,881,0
Washington,26,25,39,24,0,0,0,0,Dallas,28,22,22,39,0,0,0,0,20151212,114,111,-2,1,18,3,3,225,-3,2015,0,5,1181,0
Memphis,27,29,22,19,0,0,0,0,Miami,21,27,23,29,0,0,0,0,20151213,97,100,-6,-8,-7,3,3,197,3,2015,0,6,873,0
Utah,21,30,25,20,2,0,0,0,Oklahoma City,16,22,33,25,8,0,0,0,20151213,98,104,-5,-13,-5,0,6,202,6,2015,1,6,861,0
Minnesota,27,22,17,35,0,0,0,0,Phoenix,25,30,30,23,0,0,0,0,20151213,101,108,-2,6,19,7,7,209,7,2015,0,6,1278,0
Philadelphia,24,20,14,18,0,0,0,0,Toronto,32,20,17,27,0,0,0,0,20151213,76,96,8,8,11,20,20,172,20,2015,0,6,334,0
Utah,15,21,22,23,0,0,0,0,San Antonio,29,30,39,20,0,0,0,0,20151214,81,118,14,23,40,37,37,199,37,2015,0,0,1087,0
New Orleans,31,17,21,32,0,0,0,0,Portland,26,24,28,27,0,0,0,0,20151214,101,105,-5,2,9,4,4,206,4,2015,0,0,2059,0
Washington,21,25,15,34,0,0,0,0,Memphis,25,32,26,29,0,0,0,0,20151214,95,112,4,11,22,17,17,207,17,2015,0,0,762,0
Toronto,28,13,23,26,0,0,0,0,Indiana,27,25,21,33,0,0,0,0,20151214,90,106,-1,11,9,16,16,196,16,2015,0,0,438,0
LA Clippers,27,21,25,21,11,0,0,0,Detroit,27,12,24,31,9,0,0,0,20151214,105,103,0,9,10,0,2,208,-2,2015,1,0,1979,0
Phoenix,21,22,15,36,0,0,0,0,Dallas,25,21,31,27,0,0,0,0,20151214,94,104,4,3,19,10,10,198,10,2015,0,0,884,0
Philadelphia,19,37,12,28,0,0,0,0,Chicago,24,27,34,30,0,0,0,0,20151214,96,115,5,-5,17,19,19,211,19,2015,0,0,664,0
Orlando,25,27,31,22,0,0,0,0,Brooklyn,25,20,24,13,0,0,0,0,20151214,105,82,0,7,14,23,23,187,-23,2015,0,0,939,0
Miami,22,25,27,26,0,0,0,0,Atlanta,20,18,23,27,0,0,0,0,20151214,100,88,2,9,13,12,12,188,-12,2015,0,0,605,0
Houston,22,36,24,26,0,0,0,0,Denver,36,18,34,26,0,0,0,0,20151214,108,114,14,-4,6,6,6,222,6,2015,0,0,878,0
Cleveland,23,17,29,20,0,0,0,0,Boston,25,21,15,16,0,0,0,0,20151215,89,77,-2,-6,8,12,12,166,-12,2015,0,1,549,0
Milwaukee,25,21,20,29,0,0,0,0,LA Lakers,30,25,31,27,0,0,0,0,20151215,95,113,5,9,20,18,18,208,18,2015,0,1,1741,0
Denver,27,36,29,20,0,0,0,0,Minnesota,24,25,31,20,0,0,0,0,20151215,112,100,3,14,12,12,12,212,-12,2015,0,1,698,0
Houston,31,19,24,23,0,0,0,0,Sacramento,31,26,25,25,0,0,0,0,20151215,97,107,0,7,8,10,10,204,10,2015,0,1,1606,0
Minnesota,26,14,30,32,0,0,0,0,New York,27,33,18,29,0,0,0,0,20151216,102,107,1,20,8,5,5,209,5,2015,0,2,1016,0
Washington,31,21,19,24,0,0,0,0,San Antonio,26,29,31,28,0,0,0,0,20151216,95,114,-5,3,15,19,19,209,19,2015,0,2,1385,0
Charlotte,23,22,28,25,0,0,0,0,Orlando,30,28,31,24,0,0,0,0,20151216,98,113,7,13,16,15,15,211,15,2015,0,2,463,0
Portland,26,19,22,23,0,0,0,0,Oklahoma City,31,21,36,18,0,0,0,0,20151216,90,106,5,7,21,16,16,196,16,2015,0,2,1484,0
New Orleans,27,24,22,31,0,0,0,0,Utah,24,26,29,15,0,0,0,0,20151216,104,94,3,1,-6,10,10,198,-10,2015,0,2,1432,0
Milwaukee,21,22,23,24,0,0,0,0,LA Clippers,29,25,24,25,0,0,0,0,20151216,90,103,8,11,12,13,13,193,13,2015,0,2,1741,0
Boston,25,27,31,33,0,0,0,0,Detroit,18,37,30,34,0,0,0,0,20151216,116,119,-7,3,2,3,3,235,3,2015,0,2,611,0
Phoenix,28,18,19,38,0,0,0,0,Golden State,26,33,46,23,0,0,0,0,20151216,103,128,-2,13,40,25,25,231,25,2015,0,2,652,0
Memphis,26,27,13,19,0,0,0,0,Chicago,30,20,24,24,0,0,0,0,20151216,85,98,4,-3,8,13,13,183,13,2015,0,2,480,0
Miami,22,33,29,20,0,0,0,0,Brooklyn,30,20,28,20,0,0,0,0,20151216,104,98,-8,5,6,6,6,202,-6,2015,0,2,1091,0
Philadelphia,23,32,21,30,0,0,0,0,Atlanta,32,34,36,25,0,0,0,0,20151216,106,127,9,11,26,21,21,233,21,2015,0,2,665,0
Dallas,19,28,17,17,0,0,0,0,Indiana,20,25,30,32,0,0,0,0,20151216,81,107,1,-2,11,26,26,188,26,2015,0,2,763,0
Toronto,20,24,21,25,9,0,0,0,Charlotte,25,31,21,13,19,0,0,0,20151217,99,109,5,12,12,0,10,208,10,2015,1,3,585,0
Oklahoma City,28,19,31,22,0,0,0,0,Cleveland,26,20,28,30,0,0,0,0,20151217,100,104,-2,-1,-4,4,4,204,4,2015,0,3,949,0
Houston,29,23,26,29,0,0,0,0,LA Lakers,18,21,29,19,0,0,0,0,20151217,107,87,11,13,10,20,20,194,-20,2015,0,3,1371,0
Denver,23,26,24,15,0,0,0,0,Utah,30,23,24,20,0,0,0,0,20151218,88,97,7,4,4,9,9,185,9,2015,0,4,370,0
LA Clippers,30,25,33,19,0,0,0,0,San Antonio,26,29,30,30,0,0,0,0,20151218,107,115,-4,0,-3,8,8,222,8,2015,0,4,1201,0
New Orleans,17,25,22,24,0,0,0,0,Phoenix,28,25,24,27,0,0,0,0,20151218,88,104,11,11,13,16,16,192,16,2015,0,4,1312,0
New York,30,35,24,18,0,0,0,0,Philadelphia,23,21,24,29,0,0,0,0,20151218,107,97,7,21,21,10,10,204,-10,2015,0,4,80,0
Portland,26,22,20,26,0,0,0,0,Orlando,29,20,25,28,0,0,0,0,20151218,94,102,3,1,6,8,8,196,8,2015,0,4,2525,0
Sacramento,24,30,23,18,0,0,0,0,Minnesota,31,27,25,16,0,0,0,0,20151218,95,99,7,4,6,4,4,194,4,2015,0,4,1511,0
Memphis,26,23,17,22,0,0,0,0,Dallas,25,30,20,22,0,0,0,0,20151218,88,97,-1,6,9,9,9,185,9,2015,0,4,419,0
Brooklyn,18,29,30,20,0,0,0,0,Indiana,23,26,23,32,0,0,0,0,20151218,97,104,5,2,-5,7,7,201,7,2015,0,4,643,0
Milwaukee,36,34,23,19,0,0,0,0,Golden State,33,25,27,36,0,0,0,0,20151218,112,121,-3,-12,-8,9,9,233,9,2015,0,4,1838,0
Detroit,30,25,19,31,11,7,4,20,Chicago,27,25,25,28,11,7,4,17,20151218,147,144,3,3,-3,0,3,291,-3,2015,4,4,238,0
Atlanta,19,23,29,38,0,0,0,0,Boston,25,18,30,28,0,0,0,0,20151218,109,101,-6,-1,-2,8,8,210,-8,2015,0,4,935,0
Toronto,27,23,31,27,0,0,0,0,Miami,25,30,22,17,0,0,0,0,20151218,108,94,2,-5,4,14,14,202,-14,2015,0,4,1234,0
Charlotte,27,26,22,26,0,0,0,0,Washington,28,31,27,23,0,0,0,0,20151219,101,109,1,6,11,8,8,210,8,2015,0,5,329,0
LA Lakers,15,26,14,23,0,0,0,0,Oklahoma City,35,32,25,26,0,0,0,0,20151219,78,118,20,26,37,40,40,196,40,2015,0,5,1178,0
Indiana,16,27,23,18,0,0,0,0,Memphis,21,23,26,26,0,0,0,0,20151219,84,96,5,1,4,12,12,180,12,2015,0,5,383,0
LA Clippers,17,29,25,26,0,0,0,0,Houston,38,19,26,24,0,0,0,0,20151219,97,107,21,11,12,10,10,204,10,2015,0,5,1371,0
Chicago,18,21,29,23,0,0,0,0,New York,25,24,28,30,0,0,0,0,20151219,91,107,7,10,9,16,16,198,16,2015,0,5,711,0
Minnesota,26,26,23,25,0,0,0,0,Brooklyn,16,27,22,20,0,0,0,0,20151220,100,85,10,9,10,15,15,185,-15,2015,0,6,1016,0
Philadelphia,25,13,22,26,0,0,0,0,Cleveland,21,34,33,20,0,0,0,0,20151220,86,108,-4,17,28,22,22,194,22,2015,0,6,358,0
New Orleans,36,31,32,31,0,0,0,0,Denver,31,43,22,29,0,0,0,0,20151220,130,125,5,-7,3,5,5,255,-5,2015,0,6,1079,0
Portland,32,30,24,23,0,0,0,0,Miami,23,29,30,34,0,0,0,0,20151220,109,116,-9,-10,-4,7,7,225,7,2015,0,6,2704,0
Atlanta,25,27,25,26,0,0,0,0,Orlando,29,13,36,22,0,0,0,0,20151220,103,100,-4,10,-1,3,3,203,-3,2015,0,6,401,0
Milwaukee,27,18,25,31,0,0,0,0,Phoenix,26,27,18,24,0,0,0,0,20151220,101,95,1,-8,-1,6,6,196,-6,2015,0,6,1462,0
Sacramento,37,18,23,26,0,0,0,0,Toronto,18,30,22,24,0,0,0,0,20151220,104,94,19,7,8,10,10,198,-10,2015,0,6,2195,0
Sacramento,35,24,25,15,0,0,0,0,Washington,34,29,21,29,0,0,0,0,20151221,99,113,-1,4,0,14,14,212,14,2015,0,0,2371,0
Phoenix,21,22,18,28,0,0,0,0,Utah,33,21,25,31,0,0,0,0,20151221,89,110,12,11,18,21,21,199,21,2015,0,0,505,0
Indiana,21,27,22,22,0,0,0,0,San Antonio,23,27,29,27,0,0,0,0,20151221,92,106,2,2,9,14,14,198,14,2015,0,0,999,0
Oklahoma City,23,27,22,28,0,0,0,0,LA Clippers,29,23,25,22,0,0,0,0,20151221,100,99,-6,-2,-5,1,1,199,-1,2015,0,0,1178,0
Orlando,29,23,26,29,0,0,0,0,New York,21,25,27,26,0,0,0,0,20151221,107,99,8,6,5,8,8,206,-8,2015,0,0,939,0
Brooklyn,29,29,27,20,0,0,0,0,Chicago,22,33,23,24,0,0,0,0,20151221,105,102,7,3,7,3,3,207,-3,2015,0,0,711,0
Minnesota,26,27,19,27,0,0,0,0,Boston,34,26,32,21,0,0,0,0,20151221,99,113,8,7,20,14,14,212,14,2015,0,0,1120,0
Portland,17,26,15,39,0,0,0,0,Atlanta,26,29,22,29,0,0,0,0,20151221,97,106,9,12,19,9,9,203,9,2015,0,0,2168,0
Charlotte,28,16,16,35,0,0,0,0,Houston,27,18,24,33,0,0,0,0,20151221,95,102,-1,1,9,7,7,197,7,2015,0,0,925,0
LA Lakers,26,25,32,28,0,0,0,0,Denver,34,30,16,27,0,0,0,0,20151222,111,107,-8,-13,3,4,4,218,-4,2015,0,1,830,0
Detroit,18,36,18,21,0,0,0,0,Miami,34,18,23,17,0,0,0,0,20151222,93,92,-16,2,-3,1,1,185,-1,2015,0,1,1155,0
Memphis,31,22,24,27,0,0,0,0,Philadelphia,23,24,19,24,0,0,0,0,20151222,104,90,8,6,11,14,14,194,-14,2015,0,1,878,0
Dallas,16,20,31,32,0,0,0,0,Toronto,32,17,23,31,0,0,0,0,20151222,99,103,16,13,5,4,4,202,4,2015,0,1,1201,0
San Antonio,28,24,25,31,0,0,0,0,Minnesota,16,22,23,22,0,0,0,0,20151223,108,83,12,14,16,25,25,191,-25,2015,0,2,1112,0
Memphis,18,30,17,26,0,0,0,0,Washington,25,34,22,19,0,0,0,0,20151223,91,100,7,11,16,9,9,191,9,2015,0,2,762,0
Denver,33,23,23,25,0,0,0,0,Phoenix,21,29,22,24,0,0,0,0,20151223,104,96,12,6,7,8,8,200,-8,2015,0,2,585,0
Houston,33,20,21,27,0,0,0,0,Orlando,27,32,28,17,0,0,0,0,20151223,101,104,-6,6,13,3,3,205,3,2015,0,2,847,0
Portland,23,13,29,24,0,0,0,0,New Orleans,26,27,27,35,0,0,0,0,20151223,89,115,3,17,15,26,26,204,26,2015,0,2,2059,0
Philadelphia,18,28,24,30,0,0,0,0,Milwaukee,35,30,27,21,0,0,0,0,20151223,100,113,17,19,22,13,13,213,13,2015,0,2,692,0
Oklahoma City,27,30,35,28,0,0,0,0,LA Lakers,17,29,15,24,0,0,0,0,20151223,120,85,10,11,31,35,35,205,-35,2015,0,2,1178,0
Sacramento,30,34,20,24,0,0,0,0,Indiana,27,22,33,24,0,0,0,0,20151223,108,106,3,15,2,2,2,214,-2,2015,0,2,1882,0
Utah,13,25,20,27,0,0,0,0,Golden State,23,24,26,30,0,0,0,0,20151223,85,103,10,9,15,18,18,188,18,2015,0,2,599,0
New York,24,26,22,12,0,0,0,0,Cleveland,31,24,17,19,0,0,0,0,20151223,84,91,7,5,0,7,7,175,7,2015,0,2,403,0
Boston,29,18,27,28,0,0,0,0,Charlotte,21,19,22,27,0,0,0,0,20151223,102,89,8,7,12,13,13,191,-13,2015,0,2,720,0
Dallas,32,32,17,27,11,0,0,0,Brooklyn,26,27,34,21,10,0,0,0,20151223,119,118,6,11,-6,0,1,237,-1,2015,1,2,1370,0
Detroit,26,19,22,33,0,0,0,0,Atlanta,27,34,21,25,0,0,0,0,20151223,100,107,1,16,15,7,7,207,7,2015,0,2,597,0
Chicago,32,22,32,19,0,0,0,0,Oklahoma City,26,26,16,28,0,0,0,0,20151225,105,96,6,2,18,9,9,201,-9,2015,0,4,690,0
New Orleans,15,23,14,26,10,0,0,0,Miami,27,15,21,15,16,0,0,0,20151225,88,94,12,4,11,0,6,182,6,2015,1,4,668,0
LA Clippers,32,28,25,9,0,0,0,0,LA Lakers,22,22,13,27,0,0,0,0,20151225,94,84,10,16,28,10,10,178,-10,2015,0,4,0,0
San Antonio,22,21,17,24,0,0,0,0,Houston,25,13,23,27,0,0,0,0,20151225,84,88,3,-5,1,4,4,172,4,2015,0,4,189,0
Cleveland,19,23,17,24,0,0,0,0,Golden State,28,17,19,25,0,0,0,0,20151225,83,89,9,3,5,6,6,172,6,2015,0,4,2161,0
LA Clippers,18,30,31,30,0,0,0,0,Utah,26,27,24,27,0,0,0,0,20151226,109,104,-8,-5,2,5,5,213,-5,2015,0,5,579,0
Denver,20,22,23,21,0,0,0,0,San Antonio,22,34,20,25,0,0,0,0,20151226,86,101,2,14,11,15,15,187,15,2015,0,5,802,0
Cleveland,12,22,25,17,0,0,0,0,Portland,34,29,27,15,0,0,0,0,20151226,76,105,22,29,31,29,29,181,29,2015,0,5,2049,0
Philadelphia,29,22,34,26,0,0,0,0,Phoenix,15,30,30,29,0,0,0,0,20151226,111,104,14,6,10,7,7,215,-7,2015,0,5,2078,0
Miami,20,24,25,39,0,0,0,0,Orlando,24,32,20,25,0,0,0,0,20151226,108,101,-4,-12,-7,7,7,209,-7,2015,0,5,204,0
Houston,41,21,29,17,0,0,0,0,New Orleans,33,30,21,26,0,0,0,0,20151226,108,110,-8,1,-7,2,2,218,2,2015,0,5,317,0
Washington,34,18,27,32,0,0,0,0,Brooklyn,26,24,27,19,0,0,0,0,20151226,111,96,8,2,2,15,15,207,-15,2015,0,5,204,0
Toronto,22,34,20,35,0,0,0,0,Milwaukee,17,35,27,11,0,0,0,0,20151226,111,90,5,4,-3,21,21,201,-21,2015,0,5,429,0
Boston,25,26,25,23,0,0,0,0,Detroit,24,22,15,32,0,0,0,0,20151226,99,93,1,5,15,6,6,192,-6,2015,0,5,611,0
Chicago,26,34,29,22,0,0,0,0,Dallas,33,26,31,28,0,0,0,0,20151226,111,118,7,-1,1,7,7,229,7,2015,0,5,802,0
Memphis,28,25,21,18,0,0,0,0,Charlotte,30,23,21,24,0,0,0,0,20151226,92,98,2,0,0,6,6,190,6,2015,0,5,519,0
New York,32,31,12,23,0,0,0,0,Atlanta,22,38,27,30,0,0,0,0,20151226,98,117,-10,-3,12,19,19,215,19,2015,0,5,745,0
Indiana,21,22,23,36,0,0,0,0,Minnesota,21,23,24,20,0,0,0,0,20151226,102,88,0,-1,-2,14,14,190,-14,2015,0,5,510,0
Portland,29,20,31,18,0,0,0,0,Sacramento,30,21,29,14,0,0,0,0,20151227,98,94,-1,-2,0,4,4,192,-4,2015,0,6,483,0
Denver,31,30,29,22,0,0,0,0,Oklahoma City,32,21,38,31,0,0,0,0,20151227,112,122,1,-8,1,10,10,234,10,2015,0,6,503,0
LA Lakers,23,23,28,22,0,0,0,0,Memphis,32,27,33,20,0,0,0,0,20151227,96,112,9,13,18,16,16,208,16,2015,0,6,1599,0
New York,18,23,24,26,0,0,0,0,Boston,22,29,26,23,0,0,0,0,20151227,91,100,4,10,12,9,9,191,9,2015,0,6,190,0
LA Clippers,34,25,27,22,0,0,0,0,Washington,20,26,25,20,0,0,0,0,20151228,108,91,14,13,15,17,17,199,-17,2015,0,0,2294,0
Minnesota,27,25,20,23,0,0,0,0,San Antonio,26,24,26,25,0,0,0,0,20151228,95,101,-1,-2,4,6,6,196,6,2015,0,0,1112,0
Cleveland,34,26,21,20,0,0,0,0,Phoenix,30,24,19,24,0,0,0,0,20151228,101,97,4,6,8,4,4,198,-4,2015,0,0,1745,0
New Orleans,23,23,18,25,0,0,0,0,Orlando,25,25,25,29,0,0,0,0,20151228,89,104,2,4,11,15,15,193,15,2015,0,0,533,0
Brooklyn,24,20,34,33,0,0,0,0,Miami,26,32,19,28,0,0,0,0,20151228,111,105,-2,-14,1,6,6,216,-6,2015,0,0,1091,0
Philadelphia,23,22,33,13,0,0,0,0,Utah,37,21,20,17,0,0,0,0,20151228,91,95,14,13,0,4,4,186,4,2015,0,0,1920,0
Sacramento,29,32,14,28,0,0,0,0,Golden State,27,31,32,32,0,0,0,0,20151228,103,122,-2,-3,15,19,19,225,19,2015,0,0,75,0
Milwaukee,24,27,21,21,0,0,0,0,Dallas,34,26,19,24,0,0,0,0,20151228,93,103,10,9,7,10,10,196,10,2015,0,0,857,0
LA Lakers,26,32,23,17,0,0,0,0,Charlotte,31,27,27,23,0,0,0,0,20151228,98,108,5,0,4,10,10,206,10,2015,0,0,2115,0
Toronto,32,20,21,24,0,0,0,0,Chicago,23,26,29,26,0,0,0,0,20151228,97,104,-9,-3,5,7,7,201,7,2015,0,0,436,0
Atlanta,27,13,28,19,0,0,0,0,Indiana,21,31,22,19,0,0,0,0,20151228,87,93,-6,12,6,6,6,180,6,2015,0,0,427,0
Cleveland,26,27,19,21,0,0,0,0,Denver,21,21,20,25,0,0,0,0,20151229,93,87,5,11,10,6,6,180,-6,2015,0,1,1223,0
Atlanta,25,31,29,36,0,0,0,0,Houston,41,30,21,23,0,0,0,0,20151229,121,115,-16,-15,-7,6,6,236,-6,2015,0,1,700,0
Miami,30,17,15,21,7,0,0,0,Memphis,26,21,22,14,16,0,0,0,20151229,90,99,-4,0,7,0,9,189,9,2015,1,1,873,0
Detroit,26,23,23,24,0,0,0,0,New York,25,25,29,29,0,0,0,0,20151229,96,108,-1,1,7,12,12,204,12,2015,0,1,480,0
Milwaukee,31,23,34,35,0,0,0,0,Oklahoma City,30,35,27,39,0,0,0,0,20151229,123,131,-1,11,4,8,8,254,8,2015,0,1,732,0
Denver,27,24,20,32,0,0,0,0,Portland,26,32,26,26,0,0,0,0,20151230,103,110,-1,7,13,7,7,213,7,2015,0,2,981,0
Washington,27,14,24,26,0,0,0,0,Toronto,28,24,25,17,0,0,0,0,20151230,91,94,1,11,12,3,3,185,3,2015,0,2,349,0
Philadelphia,30,27,28,25,0,0,0,0,Sacramento,31,26,24,24,0,0,0,0,20151230,110,105,-1,0,4,5,5,215,-5,2015,0,2,2451,0
Brooklyn,26,26,21,20,0,0,0,0,Orlando,26,19,23,32,0,0,0,0,20151230,93,100,0,-7,-5,7,7,193,7,2015,0,2,939,0
Phoenix,12,21,23,23,0,0,0,0,San Antonio,32,29,23,28,0,0,0,0,20151230,79,112,20,28,28,33,33,191,33,2015,0,2,846,0
Golden State,21,21,26,23,0,0,0,0,Dallas,27,33,27,27,0,0,0,0,20151230,91,114,6,18,19,23,23,205,23,2015,0,2,1480,0
LA Clippers,32,33,27,30,0,0,0,0,Charlotte,25,31,30,31,0,0,0,0,20151230,122,117,7,9,6,5,5,239,-5,2015,0,2,2115,0
Indiana,21,19,22,29,9,0,0,0,Chicago,21,29,16,25,11,0,0,0,20151230,100,102,0,10,4,0,2,202,2,2015,1,2,163,0
LA Lakers,24,34,31,23,0,0,0,0,Boston,27,29,22,26,0,0,0,0,20151230,112,104,-3,2,11,8,8,216,-8,2015,0,2,2590,0
Utah,13,18,21,28,0,0,0,0,Minnesota,19,19,24,32,0,0,0,0,20151230,80,94,6,7,10,14,14,174,14,2015,0,2,984,0
Minnesota,22,15,33,20,0,0,0,0,Detroit,15,30,33,37,0,0,0,0,20151231,90,115,-7,8,8,25,25,205,25,2015,0,3,542,0
Golden State,33,28,29,24,0,0,0,0,Houston,30,29,23,28,0,0,0,0,20151231,114,110,3,2,8,4,4,224,-4,2015,0,3,1642,0
Milwaukee,33,26,30,31,0,0,0,0,Indiana,24,28,25,39,0,0,0,0,20151231,120,116,9,7,12,4,4,236,-4,2015,0,3,243,0
LA Clippers,20,30,21,24,0,0,0,0,New Orleans,25,23,15,26,0,0,0,0,20151231,95,89,-5,2,8,6,6,184,-6,2015,0,3,1669,0
Phoenix,26,27,27,26,0,0,0,0,Oklahoma City,28,26,33,23,0,0,0,0,20151231,106,110,2,1,7,4,4,216,4,2015,0,3,840,0
Portland,25,14,32,25,0,0,0,0,Utah,25,32,29,23,0,0,0,0,20151231,96,109,0,18,15,13,13,205,13,2015,0,3,634,0
Orlando,21,22,29,19,0,0,0,0,Washington,24,24,24,31,0,0,0,0,20160101,91,103,3,5,0,12,12,194,12,2015,0,4,757,0
Dallas,10,35,16,21,0,0,0,0,Miami,22,36,22,26,0,0,0,0,20160101,82,106,12,13,19,24,24,188,24,2015,0,4,1110,0
Charlotte,28,27,27,12,0,0,0,0,Toronto,29,26,19,30,0,0,0,0,20160101,94,104,1,0,-8,10,10,198,10,2015,0,4,585,0
New York,18,32,23,8,0,0,0,0,Chicago,34,22,21,31,0,0,0,0,20160101,81,108,16,6,4,27,27,189,27,2015,0,4,711,0
Philadelphia,21,20,19,24,0,0,0,0,LA Lakers,21,19,22,31,0,0,0,0,20160101,84,93,0,-1,2,9,9,177,9,2015,0,4,2388,0
Brooklyn,31,25,25,19,0,0,0,0,Boston,29,26,16,26,0,0,0,0,20160102,100,97,2,1,10,3,3,197,-3,2015,0,5,190,0
Oklahoma City,34,32,21,22,0,0,0,0,Charlotte,22,32,22,14,0,0,0,0,20160102,109,90,12,12,11,19,19,199,-19,2015,0,5,938,0
Orlando,13,19,21,26,0,0,0,0,Cleveland,29,26,26,23,0,0,0,0,20160102,79,104,16,23,28,25,25,183,25,2015,0,5,895,0
New Orleans,26,22,26,31,0,0,0,0,Dallas,25,22,19,32,0,0,0,0,20160102,105,98,1,1,8,7,7,203,-7,2015,0,5,442,0
Denver,13,34,30,25,6,0,0,0,Golden State,37,26,27,12,9,0,0,0,20160102,108,111,24,16,13,0,3,219,3,2015,1,5,947,0
Detroit,20,22,17,23,0,0,0,0,Indiana,24,17,23,30,0,0,0,0,20160102,82,94,4,-1,5,12,12,176,12,2015,0,5,240,0
Philadelphia,29,23,22,25,0,0,0,0,LA Clippers,31,38,34,27,0,0,0,0,20160102,99,130,2,17,29,31,31,229,31,2015,0,5,2388,0
Milwaukee,15,29,28,23,0,0,0,0,Minnesota,28,19,23,15,0,0,0,0,20160102,95,85,-13,-3,2,10,10,180,-10,2015,0,5,298,0
Phoenix,18,35,34,32,0,0,0,0,Sacramento,31,28,44,39,0,0,0,0,20160102,119,142,13,6,16,23,23,261,23,2015,0,5,634,0
Houston,27,28,17,31,0,0,0,0,San Antonio,29,31,36,25,0,0,0,0,20160102,103,121,2,5,24,18,18,224,18,2015,0,5,189,0
Memphis,25,20,24,15,3,0,0,0,Utah,28,18,20,18,8,0,0,0,20160102,87,92,3,1,-3,0,5,179,5,2015,1,5,1247,0
Miami,25,25,23,24,0,0,0,0,Washington,24,7,20,24,0,0,0,0,20160103,97,75,1,19,22,22,22,172,-22,2015,0,6,924,0
Chicago,26,22,33,34,0,0,0,0,Toronto,26,34,27,26,0,0,0,0,20160103,115,113,0,-12,-6,2,2,228,-2,2015,0,6,436,0
Atlanta,21,24,31,21,0,0,0,0,New York,22,33,31,25,0,0,0,0,20160103,97,111,1,10,10,14,14,208,14,2015,0,6,745,0
Portland,23,38,19,32,0,0,0,0,Denver,22,34,24,26,0,0,0,0,20160103,112,106,1,5,0,6,6,218,-6,2015,0,6,981,0
Phoenix,10,12,29,26,0,0,0,0,LA Lakers,25,18,38,16,0,0,0,0,20160103,77,97,15,21,30,20,20,174,20,2015,0,6,356,0
Houston,28,20,21,24,0,0,0,0,Utah,21,37,19,14,0,0,0,0,20160104,93,91,7,-10,-8,2,2,184,-2,2015,0,0,1199,0
Minnesota,25,25,29,20,0,0,0,0,Philadelphia,29,18,33,29,0,0,0,0,20160104,99,109,4,-3,1,10,10,208,10,2015,0,0,983,0
Sacramento,31,37,22,26,0,0,0,0,Oklahoma City,33,33,16,22,0,0,0,0,20160104,116,104,-2,2,8,12,12,220,-12,2015,0,0,1336,0
San Antonio,29,31,30,33,0,0,0,0,Milwaukee,30,19,26,23,0,0,0,0,20160104,123,98,-1,11,15,25,25,221,-25,2015,0,0,1108,0
Memphis,17,21,32,21,0,0,0,0,Portland,15,19,18,26,0,0,0,0,20160104,91,78,2,4,18,13,13,169,-13,2015,0,0,1845,0
Charlotte,24,30,23,24,0,0,0,0,Golden State,32,30,33,16,0,0,0,0,20160104,101,111,8,8,18,10,10,212,10,2015,0,0,2296,0
Orlando,23,24,27,15,0,0,0,0,Detroit,31,26,31,27,0,0,0,0,20160104,89,115,8,10,14,26,26,204,26,2015,0,0,957,0
Toronto,29,27,22,22,0,0,0,0,Cleveland,33,25,32,32,0,0,0,0,20160104,100,122,4,2,12,22,22,222,22,2015,0,0,187,0
Boston,37,19,23,24,0,0,0,0,Brooklyn,22,20,26,26,0,0,0,0,20160104,103,94,15,14,11,9,9,197,-9,2015,0,0,190,0
Indiana,29,18,27,21,5,0,0,0,Miami,19,25,22,29,8,0,0,0,20160104,100,103,-10,-3,-8,0,3,203,3,2015,1,0,1026,0
New York,29,25,30,23,0,0,0,0,Atlanta,20,29,22,30,0,0,0,0,20160105,107,101,9,5,13,6,6,208,-6,2015,0,1,745,0
Milwaukee,28,33,28,17,0,0,0,0,Chicago,36,31,27,23,0,0,0,0,20160105,106,117,8,6,5,11,11,223,11,2015,0,1,83,0
Sacramento,24,19,27,28,6,12,0,0,Dallas,27,22,29,20,6,13,0,0,20160105,116,117,3,6,8,0,1,233,1,2015,2,1,1437,0
Golden State,37,25,30,17,0,0,0,0,LA Lakers,25,22,13,28,0,0,0,0,20160105,109,88,12,15,32,21,21,197,-21,2015,0,1,347,0
Indiana,22,15,29,29,0,0,0,0,Orlando,20,18,21,27,0,0,0,0,20160106,95,86,2,-1,7,9,9,181,-9,2015,0,2,822,0
Cleveland,24,38,33,26,0,0,0,0,Washington,26,24,39,26,0,0,0,0,20160106,121,115,-2,12,6,6,6,236,-6,2015,0,2,304,0
LA Clippers,31,32,22,24,0,0,0,0,Portland,18,22,30,28,0,0,0,0,20160106,109,98,13,23,15,11,11,207,-11,2015,0,2,826,0
Charlotte,32,20,33,17,0,0,0,0,Phoenix,34,26,26,25,0,0,0,0,20160106,102,111,2,8,1,9,9,213,9,2015,0,2,1778,0
Memphis,16,20,29,29,0,0,0,0,Oklahoma City,25,31,27,29,0,0,0,0,20160106,94,112,9,20,18,18,18,206,18,2015,0,2,421,0
Utah,22,29,23,24,0,0,0,0,San Antonio,32,36,27,28,0,0,0,0,20160106,98,123,10,17,21,25,25,221,25,2015,0,2,1087,0
Denver,21,21,24,12,0,0,0,0,Minnesota,25,19,21,9,0,0,0,0,20160106,78,74,-4,-2,1,4,4,152,-4,2015,0,2,698,0
New York,22,25,24,27,0,0,0,0,Miami,21,18,20,31,0,0,0,0,20160106,98,90,1,8,12,8,8,188,-8,2015,0,2,1091,0
Toronto,24,21,25,21,0,0,0,0,Brooklyn,17,19,20,18,0,0,0,0,20160106,91,74,7,9,14,17,17,165,-17,2015,0,2,341,0
Detroit,24,24,18,33,0,0,0,0,Boston,33,22,20,19,0,0,0,0,20160106,99,94,-9,-7,-9,5,5,193,-5,2015,0,2,611,0
Dallas,22,27,22,29,0,0,0,0,New Orleans,24,26,18,23,0,0,0,0,20160106,100,91,-2,-1,3,9,9,191,-9,2015,0,2,442,0
Boston,27,20,16,29,0,0,0,0,Chicago,21,27,26,27,0,0,0,0,20160107,92,101,-6,1,11,9,9,193,9,2015,0,3,849,0
Utah,25,19,22,28,0,0,0,0,Houston,22,17,33,31,0,0,0,0,20160107,94,103,-3,-5,6,9,9,197,9,2015,0,3,1199,0
Atlanta,22,39,36,29,0,0,0,0,Philadelphia,21,23,32,22,0,0,0,0,20160107,126,98,1,17,21,28,28,224,-28,2015,0,3,665,0
LA Lakers,21,27,38,29,0,0,0,0,Sacramento,38,31,33,16,0,0,0,0,20160107,115,118,17,21,16,3,3,233,3,2015,0,3,361,0
Toronto,18,29,26,24,0,0,0,0,Washington,26,21,14,27,0,0,0,0,20160108,97,88,-8,0,12,9,9,185,-9,2015,0,4,349,0
New York,30,19,25,25,0,0,0,0,San Antonio,26,26,27,21,0,0,0,0,20160108,99,100,-4,3,5,1,1,199,1,2015,0,4,1581,0
Golden State,38,36,32,22,0,0,0,0,Portland,21,31,35,21,0,0,0,0,20160108,128,108,17,22,19,20,20,236,-20,2015,0,4,535,0
Miami,21,32,24,26,0,0,0,0,Phoenix,20,20,33,22,0,0,0,0,20160108,103,95,1,13,4,8,8,198,-8,2015,0,4,1978,0
Indiana,16,22,30,23,0,0,0,0,New Orleans,30,13,27,16,0,0,0,0,20160108,91,86,-14,-5,-2,5,5,177,-5,2015,0,4,713,0
Dallas,18,21,36,20,0,0,0,0,Milwaukee,28,27,24,17,0,0,0,0,20160108,95,96,10,16,4,1,1,191,1,2015,0,4,857,0
Denver,30,7,29,18,0,0,0,0,Memphis,29,20,18,24,0,0,0,0,20160108,84,91,-1,12,1,7,7,175,7,2015,0,4,877,0
Oklahoma City,32,28,30,27,0,0,0,0,LA Lakers,28,25,32,28,0,0,0,0,20160108,117,113,4,7,5,4,4,230,-4,2015,0,4,1178,0
Orlando,26,11,23,23,0,0,0,0,Brooklyn,17,21,24,15,0,0,0,0,20160108,83,77,9,-1,-2,6,6,160,-6,2015,0,4,939,0
Cleveland,35,27,33,30,0,0,0,0,Minnesota,27,19,30,23,0,0,0,0,20160108,125,99,8,16,19,26,26,224,-26,2015,0,4,629,0
Chicago,19,32,32,22,0,0,0,0,Atlanta,30,34,25,31,0,0,0,0,20160109,105,120,11,13,6,15,15,225,15,2015,0,5,587,0
Brooklyn,23,23,20,23,0,0,0,0,Detroit,33,23,16,31,0,0,0,0,20160109,89,103,10,10,6,14,14,192,14,2015,0,5,480,0
Charlotte,18,28,18,19,0,0,0,0,LA Clippers,27,16,27,27,0,0,0,0,20160109,83,97,9,-3,6,14,14,180,14,2015,0,5,2115,0
Washington,27,33,25,20,0,0,0,0,Orlando,17,32,21,29,0,0,0,0,20160109,105,99,10,11,15,6,6,204,-6,2015,0,5,757,0
Toronto,25,32,18,33,0,0,0,0,Philadelphia,26,18,25,26,0,0,0,0,20160109,108,95,-1,13,6,13,13,203,-13,2015,0,5,334,0
Golden State,26,34,36,32,0,0,0,0,Sacramento,27,31,26,32,0,0,0,0,20160109,128,116,-1,2,12,12,12,244,-12,2015,0,5,75,0
Miami,29,20,19,15,0,0,0,0,Utah,19,26,27,26,0,0,0,0,20160109,83,98,-10,-4,4,15,15,181,15,2015,0,5,2086,0
Oklahoma City,27,19,39,25,0,0,0,0,Portland,26,26,28,35,0,0,0,0,20160110,110,115,-1,6,-5,5,5,225,5,2015,0,6,1484,0
Cleveland,26,22,27,20,0,0,0,0,Philadelphia,20,27,22,16,0,0,0,0,20160110,95,85,6,1,6,10,10,180,-10,2015,0,6,358,0
Milwaukee,24,17,19,28,0,0,0,0,New York,24,27,31,18,0,0,0,0,20160110,88,100,0,10,22,12,12,188,12,2015,0,6,732,0
Boston,34,19,23,22,0,0,0,0,Memphis,16,22,30,33,0,0,0,0,20160110,98,101,-18,-15,-8,3,3,199,3,2015,0,6,1134,0
Dallas,22,26,20,25,0,0,0,0,Minnesota,22,20,13,32,0,0,0,0,20160110,93,87,0,6,13,6,6,180,-6,2015,0,6,863,0
New Orleans,24,25,27,25,10,0,0,0,LA Clippers,19,37,28,17,13,0,0,0,20160110,111,114,-5,7,8,0,3,225,3,2015,1,6,1669,0
Indiana,24,26,27,16,10,0,0,0,Houston,28,20,16,29,14,0,0,0,20160110,103,107,4,-2,-13,0,4,210,4,2015,1,6,865,0
Charlotte,26,30,21,15,0,0,0,0,Denver,36,17,28,14,0,0,0,0,20160110,92,95,10,-3,4,3,3,187,3,2015,0,6,1355,0
Utah,15,28,18,25,0,0,0,0,LA Lakers,14,16,20,24,0,0,0,0,20160110,86,74,1,13,11,12,12,160,-12,2015,0,6,579,0
San Antonio,22,23,32,29,0,0,0,0,Brooklyn,20,18,18,23,0,0,0,0,20160111,106,79,2,7,21,27,27,185,-27,2015,0,0,1581,0
Washington,28,34,21,31,0,0,0,0,Chicago,25,23,26,26,0,0,0,0,20160111,114,100,3,14,9,14,14,214,-14,2015,0,0,594,0
Miami,25,29,23,26,0,0,0,0,Golden State,27,29,24,31,0,0,0,0,20160111,103,111,2,2,3,8,8,214,8,2015,0,0,2590,0
Boston,27,22,32,33,0,0,0,0,New York,36,23,26,35,0,0,0,0,20160112,114,120,9,10,4,6,6,234,6,2015,0,1,190,0
Chicago,29,22,26,24,0,0,0,0,Milwaukee,20,26,28,32,0,0,0,0,20160112,101,106,-9,-5,-3,5,5,207,5,2015,0,1,83,0
Houston,22,29,21,35,0,0,0,0,Memphis,24,20,25,22,0,0,0,0,20160112,107,91,-2,7,3,16,16,198,-16,2015,0,1,484,0
Oklahoma City,32,28,20,21,0,0,0,0,Minnesota,21,27,18,30,0,0,0,0,20160112,101,96,11,12,14,5,5,197,-5,2015,0,1,694,0
Phoenix,19,23,34,21,0,0,0,0,Indiana,25,27,28,36,0,0,0,0,20160112,97,116,6,10,4,19,19,213,19,2015,0,1,1496,0
San Antonio,24,29,28,28,0,0,0,0,Detroit,25,19,22,33,0,0,0,0,20160112,109,99,-1,9,15,10,10,208,-10,2015,0,1,1238,0
Cleveland,22,25,20,28,15,0,0,0,Dallas,25,27,20,23,12,0,0,0,20160112,110,107,-3,-5,-5,0,3,217,-3,2015,1,1,1024,0
New Orleans,22,19,30,20,0,0,0,0,LA Lakers,15,23,29,28,0,0,0,0,20160112,91,95,-7,-3,-4,4,4,186,4,2015,0,1,1669,0
Milwaukee,18,25,31,27,0,0,0,0,Washington,29,27,15,35,0,0,0,0,20160113,101,106,11,13,-3,5,5,207,5,2015,0,2,634,0
New Orleans,28,31,31,19,0,0,0,0,Sacramento,19,25,21,32,0,0,0,0,20160113,109,97,9,15,25,12,12,206,-12,2015,0,2,1879,0
Utah,19,18,25,23,0,0,0,0,Portland,18,25,34,22,0,0,0,0,20160113,85,99,-1,6,15,14,14,184,14,2015,0,2,634,0
Dallas,20,22,22,25,0,0,0,0,Oklahoma City,30,35,18,25,0,0,0,0,20160113,89,108,10,23,19,19,19,197,19,2015,0,2,189,0
Miami,25,27,17,21,0,0,0,0,LA Clippers,17,28,34,25,0,0,0,0,20160113,90,104,-8,-7,10,14,14,194,14,2015,0,2,2335,0
Minnesota,24,26,27,27,0,0,0,0,Houston,23,34,24,26,0,0,0,0,20160113,104,107,-1,7,4,3,3,211,3,2015,0,2,1057,0
Atlanta,19,17,22,26,0,0,0,0,Charlotte,20,25,35,27,0,0,0,0,20160113,84,107,1,9,22,23,23,191,23,2015,0,2,226,0
New York,20,31,24,29,0,0,0,0,Brooklyn,29,25,20,36,0,0,0,0,20160113,104,110,9,3,-1,6,6,214,6,2015,0,2,0,0
Indiana,24,25,27,18,0,0,0,0,Boston,28,29,21,25,0,0,0,0,20160113,94,103,4,8,2,9,9,197,9,2015,0,2,805,0
Golden State,25,29,19,37,0,0,0,0,Denver,32,23,28,29,0,0,0,0,20160113,110,112,7,1,10,2,2,222,2,2015,0,2,947,0
Sacramento,26,30,26,21,0,0,0,0,Utah,12,33,26,30,0,0,0,0,20160114,103,101,14,11,11,2,2,204,-2,2015,0,3,532,0
Cleveland,32,18,23,22,0,0,0,0,San Antonio,20,24,28,27,0,0,0,0,20160114,95,99,-12,-6,-1,4,4,194,4,2015,0,3,1256,0
Chicago,22,24,31,27,11,0,0,0,Philadelphia,34,28,17,25,7,0,0,0,20160114,115,111,-12,-16,-2,0,4,226,-4,2015,1,3,664,0
Detroit,24,19,28,30,0,0,0,0,Memphis,21,27,31,24,0,0,0,0,20160114,101,103,-3,5,8,2,2,204,2,2015,0,3,622,0
LA Lakers,23,26,23,26,0,0,0,0,Golden State,24,28,34,30,0,0,0,0,20160114,98,116,1,3,14,18,18,214,18,2015,0,3,347,0
Toronto,31,30,16,19,10,0,0,0,Orlando,18,36,19,23,7,0,0,0,20160114,106,103,13,7,4,0,3,209,-3,2015,1,3,1048,0
Phoenix,29,18,31,25,0,0,0,0,Boston,36,32,28,21,0,0,0,0,20160115,103,117,7,21,18,14,14,220,14,2015,0,4,2295,0
Portland,22,34,27,33,0,0,0,0,Brooklyn,23,26,30,25,0,0,0,0,20160115,116,104,-1,7,4,12,12,220,-12,2015,0,4,2439,0
Dallas,18,18,23,24,0,0,0,0,Chicago,22,24,15,16,0,0,0,0,20160115,83,77,-4,-10,-2,6,6,160,-6,2015,0,4,802,0
Miami,20,26,30,22,0,0,0,0,Denver,31,31,16,17,0,0,0,0,20160115,98,95,-11,-16,-2,3,3,193,-3,2015,0,4,1724,0
Cleveland,23,23,22,23,0,0,0,0,Houston,21,14,16,26,0,0,0,0,20160115,91,77,2,11,17,14,14,168,-14,2015,0,4,1113,0
Washington,24,35,29,30,0,0,0,0,Indiana,27,19,26,32,0,0,0,0,20160115,118,104,-3,13,16,14,14,222,-14,2015,0,4,490,0
Atlanta,28,23,25,19,6,0,0,0,Milwaukee,22,24,27,22,13,0,0,0,20160115,101,108,-6,-5,-3,0,7,209,7,2015,1,4,669,0
Charlotte,34,15,32,26,0,0,0,0,New Orleans,32,25,27,25,0,0,0,0,20160115,107,109,-2,8,3,2,2,216,2,2015,0,4,648,0
Minnesota,17,26,22,28,0,0,0,0,Oklahoma City,31,26,25,31,0,0,0,0,20160115,93,113,14,14,17,20,20,206,20,2015,0,4,694,0
Boston,24,30,29,36,0,0,0,0,Washington,31,30,25,31,0,0,0,0,20160116,119,117,-7,-7,-3,2,2,236,-2,2015,0,5,394,0
LA Lakers,18,18,23,23,0,0,0,0,Utah,32,28,29,20,0,0,0,0,20160116,82,109,14,24,30,27,27,191,27,2015,0,5,579,0
Portland,17,26,19,27,0,0,0,0,Philadelphia,29,39,22,24,0,0,0,0,20160116,89,114,12,25,28,25,25,203,25,2015,0,5,2405,0
New York,31,23,19,22,0,0,0,0,Memphis,28,24,21,30,0,0,0,0,20160116,95,103,-3,-2,0,8,8,198,8,2015,0,5,953,0
Milwaukee,19,33,32,21,0,0,0,0,Charlotte,29,19,23,21,0,0,0,0,20160116,105,92,-10,4,13,13,13,197,-13,2015,0,5,658,0
Golden State,30,19,25,21,0,0,0,0,Detroit,27,38,20,28,0,0,0,0,20160116,95,113,-3,16,11,18,18,208,18,2015,0,5,2087,0
Brooklyn,23,25,20,18,0,0,0,0,Atlanta,27,28,29,30,0,0,0,0,20160116,86,114,4,7,16,28,28,200,28,2015,0,5,745,0
Sacramento,30,34,18,28,0,0,0,0,LA Clippers,30,30,19,24,0,0,0,0,20160116,110,103,0,4,3,7,7,213,-7,2015,0,5,361,0
Dallas,16,20,20,27,0,0,0,0,San Antonio,14,32,32,34,0,0,0,0,20160117,83,112,-2,10,22,29,29,195,29,2015,0,6,252,0
Indiana,30,36,25,35,0,0,0,0,Denver,30,24,30,45,0,0,0,0,20160117,126,129,0,-12,-7,3,3,255,3,2015,0,6,998,0
Houston,32,28,34,18,0,0,0,0,LA Lakers,36,21,18,20,0,0,0,0,20160117,112,95,-4,3,19,17,17,207,-17,2015,0,6,1371,0
Phoenix,23,25,21,18,0,0,0,0,Minnesota,24,34,25,34,0,0,0,0,20160117,87,117,1,10,14,30,30,204,30,2015,0,6,1278,0
Miami,18,24,16,16,0,0,0,0,Oklahoma City,24,20,31,24,0,0,0,0,20160117,74,99,6,2,17,25,25,173,25,2015,0,6,1225,0
Philadelphia,29,18,16,33,11,6,0,0,New York,29,23,24,20,11,12,0,0,20160118,113,119,0,5,13,0,6,232,6,2015,2,0,80,0
New Orleans,26,25,25,23,0,0,0,0,Memphis,24,25,23,29,0,0,0,0,20160118,99,101,-2,-2,-4,2,2,200,2,2015,0,0,358,0
Portland,32,27,35,14,0,0,0,0,Washington,17,40,19,22,0,0,0,0,20160118,108,98,15,2,18,10,10,206,-10,2015,0,0,2347,0
Brooklyn,29,20,35,16,0,0,0,0,Toronto,19,33,29,31,0,0,0,0,20160118,100,112,-10,3,-3,12,12,212,12,2015,0,0,341,0
Houston,21,31,28,42,10,0,0,0,LA Clippers,33,26,35,28,18,0,0,0,20160118,132,140,12,7,14,0,8,272,8,2015,1,0,1371,0
Golden State,34,36,34,28,0,0,0,0,Cleveland,21,23,23,31,0,0,0,0,20160118,132,98,13,26,37,34,34,230,-34,2015,0,0,2161,0
Boston,16,23,33,26,15,0,0,0,Dallas,29,23,18,28,20,0,0,0,20160118,113,118,13,13,-2,0,5,231,5,2015,1,0,1548,0
Chicago,26,30,27,28,0,0,0,0,Detroit,32,21,26,22,0,0,0,0,20160118,111,101,-6,3,4,10,10,212,-10,2015,0,0,238,0
Utah,28,15,21,31,13,11,0,0,Charlotte,29,23,21,22,13,16,0,0,20160118,119,124,1,9,9,0,5,243,5,2015,2,0,1723,0
Orlando,17,21,21,22,0,0,0,0,Atlanta,24,27,21,26,0,0,0,0,20160118,81,98,7,13,13,17,17,179,17,2015,0,0,401,0
Oklahoma City,25,32,27,26,0,0,0,0,Denver,31,22,26,25,0,0,0,0,20160119,110,104,-6,4,5,6,6,214,-6,2015,0,1,503,0
Milwaukee,19,30,26,16,0,0,0,0,Miami,18,21,18,22,0,0,0,0,20160119,91,79,1,10,18,12,12,170,-12,2015,0,1,1269,0
Minnesota,38,22,15,24,0,0,0,0,New Orleans,25,26,31,32,0,0,0,0,20160119,99,114,-13,-9,7,15,15,213,15,2015,0,1,1052,0
Indiana,25,19,27,26,0,0,0,0,Phoenix,17,18,26,33,0,0,0,0,20160119,97,94,8,9,10,3,3,191,-3,2015,0,1,1496,0
Miami,22,15,27,23,0,0,0,0,Washington,26,25,30,25,0,0,0,0,20160120,87,106,4,14,17,19,19,193,19,2015,0,2,924,0
Boston,27,35,28,19,0,0,0,0,Toronto,35,21,40,19,0,0,0,0,20160120,109,115,8,-6,6,6,6,224,6,2015,0,2,430,0
Atlanta,29,19,26,30,0,0,0,0,Portland,18,25,29,26,0,0,0,0,20160120,104,98,11,5,2,6,6,202,-6,2015,0,2,2168,0
Philadelphia,23,24,34,15,0,0,0,0,Orlando,21,25,25,16,0,0,0,0,20160120,96,87,2,1,10,9,9,183,-9,2015,0,2,864,0
Charlotte,22,23,25,25,0,0,0,0,Oklahoma City,30,22,36,21,0,0,0,0,20160120,95,109,8,7,18,14,14,204,14,2015,0,2,938,0
Utah,22,26,28,23,12,0,0,0,New York,17,20,31,31,19,0,0,0,20160120,111,118,-5,-11,-8,0,7,229,7,2015,1,2,1967,0
Sacramento,28,29,29,26,0,0,0,0,LA Lakers,18,34,25,16,0,0,0,0,20160120,112,93,10,5,9,19,19,205,-19,2015,0,2,361,0
Detroit,33,23,29,38,0,0,0,0,Houston,23,24,32,35,0,0,0,0,20160120,123,114,10,9,6,9,9,237,-9,2015,0,2,1105,0
Minnesota,33,16,18,22,5,0,0,0,Dallas,23,26,15,25,17,0,0,0,20160120,94,106,-10,0,-3,0,12,200,12,2015,1,2,863,0
Golden State,34,29,24,38,0,0,0,0,Chicago,18,26,19,31,0,0,0,0,20160120,125,94,16,19,24,31,31,219,-31,2015,0,2,1853,0
Cleveland,23,28,22,18,0,0,0,0,Brooklyn,17,21,17,23,0,0,0,0,20160120,91,78,6,13,18,13,13,169,-13,2015,0,2,403,0
LA Clippers,31,19,22,30,0,0,0,0,Cleveland,28,31,29,27,0,0,0,0,20160121,102,115,-3,9,16,13,13,217,13,2015,0,3,2044,0
Memphis,37,18,24,23,0,0,0,0,Denver,23,25,29,24,0,0,0,0,20160121,102,101,14,7,2,1,1,203,-1,2015,0,3,877,0
Detroit,27,26,24,22,0,0,0,0,New Orleans,35,37,18,25,0,0,0,0,20160121,99,115,8,19,13,16,16,214,16,2015,0,3,939,0
San Antonio,25,26,28,38,0,0,0,0,Phoenix,18,21,30,20,0,0,0,0,20160121,117,89,7,12,10,28,28,206,-28,2015,0,3,846,0
Atlanta,20,24,19,25,0,0,0,0,Sacramento,27,20,25,19,0,0,0,0,20160121,88,91,7,3,9,3,3,179,3,2015,0,3,2082,0
Miami,20,24,23,14,0,0,0,0,Toronto,31,29,20,21,0,0,0,0,20160122,81,101,11,16,13,20,20,182,20,2015,0,4,1234,0
Charlotte,30,25,24,30,11,0,0,0,Orlando,35,26,33,15,7,0,0,0,20160122,120,116,-5,-6,-15,0,4,236,-4,2015,1,4,463,0
LA Clippers,31,24,31,30,0,0,0,0,New York,24,21,19,24,0,0,0,0,20160122,116,88,7,10,22,28,28,204,-28,2015,0,4,2445,0
San Antonio,31,25,31,21,0,0,0,0,LA Lakers,22,21,28,24,0,0,0,0,20160122,108,95,9,13,16,13,13,203,-13,2015,0,4,1201,0
Chicago,23,26,33,19,0,0,0,0,Boston,34,30,26,20,0,0,0,0,20160122,101,110,11,15,8,9,9,211,9,2015,0,4,849,0
Indiana,18,33,24,35,0,0,0,0,Golden State,32,32,24,34,0,0,0,0,20160122,110,122,14,13,13,12,12,232,12,2015,0,4,1944,0
Oklahoma City,27,21,37,24,0,0,0,0,Dallas,25,31,18,32,0,0,0,0,20160122,109,106,2,-8,11,3,3,215,-3,2015,0,4,189,0
Utah,22,26,37,23,0,0,0,0,Brooklyn,23,17,17,29,0,0,0,0,20160122,108,86,-1,8,28,22,22,194,-22,2015,0,4,1967,0
Milwaukee,28,17,21,32,0,0,0,0,Houston,31,26,22,23,0,0,0,0,20160122,98,102,3,12,13,4,4,200,4,2015,0,4,1005,0
Indiana,25,20,25,27,0,0,0,0,Sacramento,31,19,31,27,0,0,0,0,20160123,97,108,6,5,11,11,11,205,11,2015,0,5,1882,0
LA Lakers,22,30,24,27,0,0,0,0,Portland,37,25,39,20,0,0,0,0,20160123,103,121,15,10,25,18,18,224,18,2015,0,5,826,0
Milwaukee,23,28,23,25,0,0,0,0,New Orleans,22,30,32,32,0,0,0,0,20160123,99,116,-1,1,10,17,17,215,17,2015,0,5,911,0
Atlanta,23,16,25,31,0,0,0,0,Phoenix,29,19,26,24,0,0,0,0,20160123,95,98,6,9,10,3,3,193,3,2015,0,5,1588,0
Detroit,32,22,20,27,0,0,0,0,Denver,26,19,39,20,0,0,0,0,20160123,101,104,-6,-9,10,3,3,205,3,2015,0,5,1154,0
Chicago,21,23,28,24,0,0,0,0,Cleveland,14,25,19,25,0,0,0,0,20160123,96,83,7,5,14,13,13,179,-13,2015,0,5,308,0
New York,22,21,13,28,0,0,0,0,Charlotte,20,25,32,20,0,0,0,0,20160123,84,97,-2,2,21,13,13,181,13,2015,0,5,531,0
Memphis,25,21,28,27,0,0,0,0,Minnesota,20,37,27,22,0,0,0,0,20160123,101,106,-5,11,10,5,5,207,5,2015,0,5,700,0
Oklahoma City,28,24,25,29,0,0,0,0,Brooklyn,30,30,25,31,0,0,0,0,20160124,106,116,2,8,8,10,10,222,10,2015,0,6,1324,0
Dallas,29,29,27,19,0,0,0,0,Houston,36,14,34,31,0,0,0,0,20160124,104,115,7,-8,-1,11,11,219,11,2015,0,6,225,0
Boston,30,28,36,18,0,0,0,0,Philadelphia,25,18,26,23,0,0,0,0,20160124,112,92,5,15,25,20,20,204,-20,2015,0,6,270,0
LA Clippers,34,15,22,23,0,0,0,0,Toronto,27,35,21,29,0,0,0,0,20160124,94,112,-7,13,12,18,18,206,18,2015,0,6,2170,0
Houston,32,26,35,19,0,0,0,0,New Orleans,29,31,32,19,0,0,0,0,20160125,112,111,3,-2,1,1,1,223,-1,2015,0,0,317,0
Boston,22,31,31,32,0,0,0,0,Washington,20,29,21,21,0,0,0,0,20160125,116,91,2,4,14,25,25,207,-25,2015,0,0,394,0
Detroit,22,26,21,26,0,0,0,0,Utah,13,23,23,33,0,0,0,0,20160125,95,92,9,12,10,3,3,187,-3,2015,0,0,1488,0
Orlando,33,32,16,19,2,0,0,0,Memphis,31,33,16,20,8,0,0,0,20160125,102,108,-2,-1,-1,0,6,210,6,2015,1,0,683,0
Charlotte,16,30,42,27,9,5,0,0,Sacramento,31,25,28,31,9,4,0,0,20160125,129,128,-15,-10,4,0,1,257,-1,2015,2,0,2239,0
Atlanta,31,35,24,29,0,0,0,0,Denver,30,20,26,29,0,0,0,0,20160125,119,105,1,16,14,14,14,224,-14,2015,0,0,1209,0
San Antonio,23,24,19,24,0,0,0,0,Golden State,29,33,33,25,0,0,0,0,20160125,90,120,6,15,29,30,30,210,30,2015,0,0,1487,0
Minnesota,29,26,18,34,0,0,0,0,Cleveland,32,27,24,31,0,0,0,0,20160125,107,114,3,4,10,7,7,221,7,2015,0,0,629,0
Miami,18,31,12,28,0,0,0,0,Chicago,23,24,21,16,0,0,0,0,20160125,89,84,-5,2,-7,5,5,173,-5,2015,0,0,1189,0
Miami,24,27,26,25,0,0,0,0,Brooklyn,29,28,16,25,0,0,0,0,20160126,102,98,-5,-6,4,4,4,200,-4,2015,0,1,1091,0
LA Clippers,25,21,28,17,0,0,0,0,Indiana,25,26,21,17,0,0,0,0,20160126,91,89,0,-5,2,2,2,180,-2,2015,0,1,1805,0
Dallas,32,24,21,15,0,0,0,0,LA Lakers,25,33,20,12,0,0,0,0,20160126,92,90,7,-2,-1,2,2,182,-2,2015,0,1,1237,0
Orlando,30,26,22,22,0,0,0,0,Milwaukee,23,30,29,25,0,0,0,0,20160126,100,107,-7,-3,4,7,7,207,7,2015,0,1,1065,0
Oklahoma City,38,23,27,25,15,0,0,0,New York,34,29,28,22,9,0,0,0,20160126,128,122,4,-2,-3,0,6,250,-6,2015,1,1,1324,0
Phoenix,24,21,26,32,0,0,0,0,Philadelphia,31,23,30,29,0,0,0,0,20160126,103,113,7,9,13,10,10,216,10,2015,0,1,2078,0
Sacramento,29,23,22,23,0,0,0,0,Portland,33,25,30,24,0,0,0,0,20160126,97,112,4,6,14,15,15,209,15,2015,0,1,483,0
Washington,18,32,20,19,0,0,0,0,Toronto,24,29,24,29,0,0,0,0,20160126,89,106,6,3,7,17,17,195,17,2015,0,1,349,0
Charlotte,18,13,20,22,0,0,0,0,Utah,18,25,27,32,0,0,0,0,20160127,73,102,0,12,19,29,29,175,29,2015,0,2,1723,0
Houston,29,20,24,26,0,0,0,0,San Antonio,35,34,33,28,0,0,0,0,20160127,99,130,6,20,29,31,31,229,31,2015,0,2,189,0
Oklahoma City,28,34,29,35,0,0,0,0,Minnesota,28,36,30,29,0,0,0,0,20160127,126,123,0,-2,-3,3,3,249,-3,2015,0,2,694,0
Dallas,22,26,29,30,0,0,0,0,Golden State,32,24,39,32,0,0,0,0,20160127,107,127,10,8,18,20,20,234,20,2015,0,2,1480,0
Phoenix,26,24,21,22,0,0,0,0,Cleveland,23,32,32,28,0,0,0,0,20160127,93,115,-3,5,16,22,22,208,22,2015,0,2,1745,0
Denver,21,24,26,32,0,0,0,0,Boston,29,26,31,25,0,0,0,0,20160127,103,111,8,10,15,8,8,214,8,2015,0,2,1765,0
LA Clippers,17,26,21,21,0,0,0,0,Atlanta,23,22,21,17,0,0,0,0,20160127,85,83,-6,-2,-2,2,2,168,-2,2015,0,2,1932,0
Philadelphia,20,25,34,18,0,0,0,0,Detroit,12,32,30,36,0,0,0,0,20160127,97,110,-8,-1,-5,13,13,207,13,2015,0,2,441,0
Atlanta,24,20,31,17,0,0,0,0,Indiana,27,24,31,29,0,0,0,0,20160128,92,111,3,7,7,19,19,203,19,2015,0,3,427,0
Chicago,32,26,32,24,0,0,0,0,LA Lakers,15,25,31,20,0,0,0,0,20160128,114,91,17,18,19,23,23,205,-23,2015,0,3,1741,0
Milwaukee,27,14,21,21,0,0,0,0,Memphis,23,27,26,27,0,0,0,0,20160128,83,103,-4,9,14,20,20,186,20,2015,0,3,557,0
Sacramento,19,34,26,26,0,0,0,0,New Orleans,37,26,29,22,0,0,0,0,20160128,105,114,18,10,13,9,9,219,9,2015,0,3,1879,0
New York,21,22,20,30,0,0,0,0,Toronto,27,26,20,30,0,0,0,0,20160128,93,103,6,10,10,10,10,196,10,2015,0,3,341,0
Denver,29,35,27,26,0,0,0,0,Washington,29,29,21,34,0,0,0,0,20160128,117,113,0,6,12,4,4,230,-4,2015,0,3,1489,0
Houston,29,29,25,25,0,0,0,0,Oklahoma City,22,33,34,27,0,0,0,0,20160129,108,116,-7,-3,6,8,8,224,8,2015,0,4,413,0
Minnesota,29,26,14,21,0,0,0,0,Utah,27,29,26,21,0,0,0,0,20160129,90,103,-2,1,13,13,13,193,13,2015,0,4,984,0
Charlotte,25,20,24,22,0,0,0,0,Portland,21,29,33,26,0,0,0,0,20160129,91,109,-4,5,14,18,18,200,18,2015,0,4,2284,0
Phoenix,16,24,21,23,0,0,0,0,New York,26,32,27,17,0,0,0,0,20160129,84,102,10,18,24,18,18,186,18,2015,0,4,2139,0
Orlando,22,28,27,17,0,0,0,0,Boston,26,32,28,27,0,0,0,0,20160129,94,113,4,8,9,19,19,207,19,2015,0,4,1115,0
LA Lakers,29,20,22,22,0,0,0,0,LA Clippers,28,26,24,27,0,0,0,0,20160129,93,105,-1,5,7,12,12,198,12,2015,0,4,0,0
Cleveland,33,33,30,18,0,0,0,0,Detroit,27,31,20,28,0,0,0,0,20160129,114,106,6,8,18,8,8,220,-8,2015,0,4,90,0
Brooklyn,18,21,16,24,0,0,0,0,Dallas,25,26,20,20,0,0,0,0,20160129,79,91,7,12,16,12,12,170,12,2015,0,4,1370,0
Miami,33,22,26,26,0,0,0,0,Milwaukee,28,20,35,20,0,0,0,0,20160129,107,103,5,7,-2,4,4,210,-4,2015,0,4,1269,0
Golden State,34,39,18,17,0,0,0,0,Philadelphia,28,26,18,33,0,0,0,0,20160130,108,105,6,19,19,3,3,213,-3,2015,0,5,2516,0
Brooklyn,22,29,15,37,0,0,0,0,New Orleans,16,28,27,34,0,0,0,0,20160130,103,105,-6,-7,5,2,2,208,2,2015,0,5,1168,0
Sacramento,22,29,26,40,0,0,0,0,Memphis,36,29,27,29,0,0,0,0,20160130,117,121,14,14,15,4,4,238,4,2015,0,5,1745,0
Detroit,17,30,25,35,0,0,0,0,Toronto,26,29,26,30,0,0,0,0,20160130,107,111,9,8,9,4,4,218,4,2015,0,5,205,0
Washington,28,31,31,33,0,0,0,0,Houston,32,30,26,34,0,0,0,0,20160130,123,122,-4,-3,2,1,1,245,-1,2015,0,5,1217,0
San Antonio,30,19,27,27,0,0,0,0,Cleveland,37,29,26,25,0,0,0,0,20160130,103,117,7,17,16,14,14,220,14,2015,0,5,1256,0
Denver,27,24,32,16,6,0,0,0,Indiana,35,24,21,19,10,0,0,0,20160130,105,109,8,8,-3,0,4,214,4,2015,1,5,998,0
Phoenix,23,22,24,9,0,0,0,0,Dallas,21,30,17,23,0,0,0,0,20160131,78,91,-2,6,-1,13,13,169,13,2015,0,6,884,0
Chicago,22,25,26,20,0,0,0,0,LA Clippers,24,27,33,36,0,0,0,0,20160131,93,120,2,4,11,27,27,213,27,2015,0,6,1741,0
Charlotte,21,37,25,18,0,0,0,0,LA Lakers,16,27,17,22,0,0,0,0,20160131,101,82,5,15,23,19,19,183,-19,2015,0,6,2115,0
Atlanta,17,17,28,25,0,0,0,0,Miami,27,20,28,30,0,0,0,0,20160131,87,105,10,13,13,18,18,192,18,2015,0,6,605,0
Golden State,18,37,27,34,0,0,0,0,New York,20,29,16,30,0,0,0,0,20160131,116,95,-2,6,17,21,21,211,-21,2015,0,6,2565,0
Boston,32,22,27,33,0,0,0,0,Orlando,24,23,34,38,0,0,0,0,20160131,114,119,-8,-7,0,5,5,233,5,2015,0,6,1115,0
Minnesota,21,18,26,28,0,0,0,0,Portland,21,27,15,33,0,0,0,0,20160131,93,96,0,9,-2,3,3,189,3,2015,0,6,1423,0
Washington,26,26,24,22,0,0,0,0,Oklahoma City,36,28,28,22,0,0,0,0,20160201,98,114,10,12,16,16,16,212,16,2015,0,0,1149,0
Orlando,24,20,26,22,0,0,0,0,San Antonio,35,17,23,32,0,0,0,0,20160201,92,107,11,8,5,15,15,199,15,2015,0,0,1035,0
Milwaukee,32,24,18,30,0,0,0,0,Sacramento,25,28,21,37,0,0,0,0,20160201,104,111,-7,-3,0,7,7,215,7,2015,0,0,1771,0
Memphis,22,32,23,33,0,0,0,0,New Orleans,27,25,23,20,0,0,0,0,20160201,110,95,-5,2,2,15,15,205,-15,2015,0,0,358,0
Chicago,26,25,17,25,3,0,0,0,Utah,26,21,20,26,12,0,0,0,20160201,96,105,0,-4,-1,0,9,201,9,2015,1,0,1256,0
Toronto,28,21,16,28,0,0,0,0,Denver,28,32,20,32,0,0,0,0,20160201,93,112,0,11,15,19,19,205,19,2015,0,0,1341,0
Detroit,28,26,24,27,0,0,0,0,Brooklyn,26,31,18,25,0,0,0,0,20160201,105,100,2,-3,3,5,5,205,-5,2015,0,0,480,0
Dallas,15,31,27,24,0,0,0,0,Atlanta,27,26,33,26,0,0,0,0,20160201,97,112,12,7,13,15,15,209,15,2015,0,0,719,0
Cleveland,33,27,15,21,15,0,0,0,Indiana,26,23,30,17,10,0,0,0,20160201,111,106,7,11,-4,0,5,217,-5,2015,1,0,262,0
Miami,31,24,25,22,0,0,0,0,Houston,31,29,27,28,0,0,0,0,20160202,102,115,0,5,7,13,13,217,13,2015,0,1,966,0
Minnesota,26,26,29,34,0,0,0,0,LA Lakers,27,39,26,27,0,0,0,0,20160202,115,119,1,14,11,4,4,234,4,2015,0,1,1521,0
Boston,21,24,25,27,0,0,0,0,New York,22,25,18,24,0,0,0,0,20160202,97,89,-1,-2,5,8,8,186,-8,2015,0,1,190,0
Toronto,28,24,26,26,0,0,0,0,Phoenix,32,13,26,26,0,0,0,0,20160202,104,97,-4,7,7,7,7,201,-7,2015,0,1,1885,0
Milwaukee,19,30,24,22,0,0,0,0,Portland,27,29,23,28,0,0,0,0,20160202,95,107,8,7,6,12,12,202,12,2015,0,1,1714,0
Golden State,43,31,29,31,0,0,0,0,Washington,28,32,32,29,0,0,0,0,20160203,134,121,15,14,11,13,13,255,-13,2015,0,2,2435,0
Denver,23,23,17,18,0,0,0,0,Utah,21,19,21,24,0,0,0,0,20160203,81,85,-2,-6,-2,4,4,166,4,2015,0,2,370,0
New Orleans,27,18,34,18,0,0,0,0,San Antonio,30,23,30,27,0,0,0,0,20160203,97,110,3,8,4,13,13,207,13,2015,0,2,506,0
Chicago,34,26,20,27,0,0,0,0,Sacramento,25,32,18,27,0,0,0,0,20160203,107,102,9,3,5,5,5,209,-5,2015,0,2,1788,0
Atlanta,27,31,30,36,0,0,0,0,Philadelphia,17,25,20,24,0,0,0,0,20160203,124,86,10,16,26,38,38,210,-38,2015,0,2,665,0
Orlando,32,33,29,20,0,0,0,0,Oklahoma City,32,34,30,21,0,0,0,0,20160203,114,117,0,1,2,3,3,231,3,2015,0,2,1057,0
Minnesota,27,26,23,32,0,0,0,0,LA Clippers,27,28,19,28,0,0,0,0,20160203,108,102,0,-2,2,6,6,210,-6,2015,0,2,1521,0
Miami,21,26,27,19,0,0,0,0,Dallas,21,25,19,25,0,0,0,0,20160203,93,90,0,1,9,3,3,183,-3,2015,0,2,1110,0
Cleveland,23,35,17,22,0,0,0,0,Charlotte,23,26,33,24,0,0,0,0,20160203,97,106,0,-9,7,9,9,203,9,2015,0,2,435,0
Indiana,26,36,25,27,0,0,0,0,Brooklyn,23,20,34,23,0,0,0,0,20160203,114,100,3,19,10,14,14,214,-14,2015,0,2,643,0
Detroit,16,20,24,35,0,0,0,0,Boston,27,29,22,24,0,0,0,0,20160203,95,102,11,20,18,7,7,197,7,2015,0,2,611,0
New York,15,21,35,34,0,0,0,0,Detroit,27,33,18,33,0,0,0,0,20160204,105,111,12,24,7,6,6,216,6,2015,0,3,480,0
LA Lakers,26,33,20,20,0,0,0,0,New Orleans,28,20,21,27,0,0,0,0,20160204,99,96,-2,11,10,3,3,195,-3,2015,0,3,1669,0
Houston,19,37,32,23,0,0,0,0,Phoenix,28,31,21,25,0,0,0,0,20160204,111,105,-9,-3,8,6,6,216,-6,2015,0,3,1014,0
Toronto,37,22,23,28,0,0,0,0,Portland,25,26,24,28,0,0,0,0,20160204,110,103,12,8,7,7,7,213,-7,2015,0,3,2108,0
Philadelphia,18,29,25,22,0,0,0,0,Washington,38,22,22,24,0,0,0,0,20160205,94,106,20,13,10,12,12,200,12,2015,0,4,123,0
Milwaukee,19,25,16,21,0,0,0,0,Utah,18,22,21,23,0,0,0,0,20160205,81,84,-1,-4,1,3,3,165,3,2015,0,4,1239,0
LA Clippers,28,27,22,30,0,0,0,0,Orlando,20,24,29,20,0,0,0,0,20160205,107,93,8,11,4,14,14,200,-14,2015,0,4,2197,0
Memphis,24,26,19,22,0,0,0,0,New York,18,22,22,23,0,0,0,0,20160205,91,85,6,10,7,6,6,176,-6,2015,0,4,953,0
Chicago,26,31,32,21,0,0,0,0,Denver,30,25,18,42,0,0,0,0,20160205,110,115,4,-2,-16,5,5,225,5,2015,0,4,916,0
Sacramento,25,36,24,34,0,0,0,0,Brooklyn,33,32,38,25,0,0,0,0,20160205,119,128,8,4,18,9,9,247,9,2015,0,4,2499,0
Boston,20,23,22,39,0,0,0,0,Cleveland,32,17,24,30,0,0,0,0,20160205,104,103,-12,-6,-8,1,1,207,-1,2015,0,4,549,0
Miami,25,22,20,31,0,0,0,0,Charlotte,31,16,26,22,0,0,0,0,20160205,98,95,-6,0,-6,3,3,193,-3,2015,0,4,654,0
Indiana,29,22,21,24,0,0,0,0,Atlanta,26,24,23,29,0,0,0,0,20160205,96,102,-3,-1,1,6,6,198,6,2015,0,4,427,0
San Antonio,27,35,26,28,0,0,0,0,Dallas,12,14,34,30,0,0,0,0,20160205,116,90,15,36,28,26,26,206,-26,2015,0,4,252,0
LA Lakers,20,31,30,21,0,0,0,0,San Antonio,29,25,25,27,0,0,0,0,20160206,102,106,9,3,-2,4,4,208,4,2015,0,5,1201,0
Utah,31,22,18,27,0,0,0,0,Phoenix,12,23,23,31,0,0,0,0,20160206,98,89,19,18,13,9,9,187,-9,2015,0,5,505,0
Brooklyn,12,27,25,34,0,0,0,0,Philadelphia,24,17,28,34,0,0,0,0,20160206,98,103,12,2,5,5,5,201,5,2015,0,5,80,0
Dallas,25,29,25,23,12,0,0,0,Memphis,30,22,28,22,8,0,0,0,20160206,114,110,-5,2,-1,0,4,224,-4,2015,1,5,419,0
Chicago,21,34,29,21,0,0,0,0,Minnesota,26,23,35,28,0,0,0,0,20160206,105,112,5,-6,0,7,7,217,7,2015,0,5,355,0
Portland,29,26,19,22,0,0,0,0,Houston,23,13,17,26,0,0,0,0,20160206,96,79,6,19,21,17,17,175,-17,2015,0,5,1833,0
Oklahoma City,31,28,24,25,0,0,0,0,Golden State,36,37,18,25,0,0,0,0,20160206,108,116,5,14,8,8,8,224,8,2015,0,5,1386,0
New Orleans,20,23,27,14,0,0,0,0,Cleveland,28,26,20,25,0,0,0,0,20160206,84,99,8,11,4,15,15,183,15,2015,0,5,924,0
Washington,25,33,17,29,0,0,0,0,Charlotte,25,23,30,30,0,0,0,0,20160206,104,108,0,-10,3,4,4,212,4,2015,0,5,329,0
Detroit,22,26,33,23,0,0,0,0,Indiana,34,28,25,25,0,0,0,0,20160206,104,112,12,14,6,8,8,216,8,2015,0,5,240,0
Sacramento,37,21,29,32,0,0,0,0,Boston,46,28,21,33,0,0,0,0,20160207,119,128,9,16,8,9,9,247,9,2015,0,6,2624,0
LA Clippers,15,31,27,27,0,0,0,0,Miami,19,26,20,28,0,0,0,0,20160207,100,93,-4,1,8,7,7,193,-7,2015,0,6,2335,0
Denver,31,29,17,24,0,0,0,0,New York,20,29,30,17,0,0,0,0,20160207,101,96,11,11,-2,5,5,197,-5,2015,0,6,1627,0
Atlanta,19,22,19,34,0,0,0,0,Orlando,30,18,23,25,0,0,0,0,20160207,94,96,11,7,11,2,2,190,2,2015,0,6,401,0
Portland,25,26,27,24,10,0,0,0,Memphis,27,22,29,24,4,0,0,0,20160208,112,106,-2,2,0,0,6,218,-6,2015,1,0,1845,0
LA Clippers,22,27,16,23,10,0,0,0,Philadelphia,25,34,14,15,4,0,0,0,20160208,98,92,-3,-10,-8,0,6,190,-6,2015,1,0,2388,0
Oklahoma City,28,29,32,33,0,0,0,0,Phoenix,19,38,28,21,0,0,0,0,20160208,122,106,9,0,4,16,16,228,-16,2015,0,0,840,0
LA Lakers,22,16,21,28,0,0,0,0,Indiana,23,23,18,25,0,0,0,0,20160208,87,89,1,8,5,2,2,176,2,2015,0,0,1805,0
New Orleans,28,35,32,21,0,0,0,0,Minnesota,22,24,24,32,0,0,0,0,20160208,116,102,6,17,25,14,14,218,-14,2015,0,0,1052,0
Sacramento,23,22,25,30,0,0,0,0,Cleveland,31,30,30,29,0,0,0,0,20160208,100,120,8,16,21,20,20,220,20,2015,0,0,2096,0
Chicago,20,22,23,26,0,0,0,0,Charlotte,38,19,30,21,0,0,0,0,20160208,91,108,18,15,22,17,17,199,17,2015,0,0,586,0
Denver,22,27,29,26,0,0,0,0,Brooklyn,26,29,26,24,0,0,0,0,20160208,104,105,4,6,3,1,1,209,1,2015,0,0,1627,0
Orlando,18,23,31,29,16,0,0,0,Atlanta,30,24,29,18,9,0,0,0,20160208,117,110,-12,-13,-11,0,7,227,-7,2015,1,0,401,0
Toronto,19,30,21,33,0,0,0,0,Detroit,24,19,22,24,0,0,0,0,20160208,103,89,-5,6,5,14,14,192,-14,2015,0,0,205,0
Utah,21,30,27,32,11,0,0,0,Dallas,29,29,29,23,9,0,0,0,20160209,121,119,-8,-7,-9,0,2,240,-2,2015,1,1,998,0
Houston,27,39,27,17,0,0,0,0,Golden State,42,27,24,30,0,0,0,0,20160209,110,123,15,3,0,13,13,233,13,2015,0,1,1642,0
San Antonio,20,34,31,34,0,0,0,0,Miami,24,23,28,26,0,0,0,0,20160209,119,101,-4,7,10,18,18,220,-18,2015,0,1,1147,0
Boston,30,24,20,37,0,0,0,0,Milwaukee,26,27,40,19,0,0,0,0,20160209,111,112,-4,-1,19,1,1,223,1,2015,0,1,855,0
Washington,35,28,20,28,0,0,0,0,New York,21,29,33,25,0,0,0,0,20160209,111,108,14,13,0,3,3,219,-3,2015,0,1,204,0
Houston,29,17,35,22,0,0,0,0,Portland,29,28,35,24,0,0,0,0,20160210,103,116,0,11,11,13,13,219,13,2015,0,2,1833,0
Golden State,29,28,34,21,0,0,0,0,Phoenix,28,15,32,29,0,0,0,0,20160210,112,104,1,14,16,8,8,216,-8,2015,0,2,652,0
Sacramento,24,24,27,39,0,0,0,0,Philadelphia,30,33,24,23,0,0,0,0,20160210,114,110,-6,-15,-12,4,4,224,-4,2015,0,2,2451,0
San Antonio,29,21,17,31,0,0,0,0,Orlando,23,28,28,17,0,0,0,0,20160210,98,96,6,-1,-12,2,2,194,-2,2015,0,2,1035,0
Utah,22,23,32,19,0,0,0,0,New Orleans,20,27,24,29,0,0,0,0,20160210,96,100,-2,2,-6,4,4,196,4,2015,0,2,1432,0
Toronto,32,36,21,23,0,0,0,0,Minnesota,26,29,33,29,0,0,0,0,20160210,112,117,-6,-13,-1,5,5,229,5,2015,0,2,691,0
Denver,20,32,23,28,0,0,0,0,Detroit,22,31,18,21,0,0,0,0,20160210,103,92,-2,-1,4,11,11,195,-11,2015,0,2,1154,0
LA Lakers,25,22,27,37,0,0,0,0,Cleveland,35,29,29,27,0,0,0,0,20160210,111,120,10,17,19,9,9,231,9,2015,0,2,2044,0
Atlanta,28,25,38,22,0,0,0,0,Chicago,29,19,25,17,0,0,0,0,20160210,113,90,-1,5,18,23,23,203,-23,2015,0,2,587,0
Memphis,22,28,39,20,0,0,0,0,Brooklyn,27,18,18,27,0,0,0,0,20160210,109,90,-5,5,26,19,19,199,-19,2015,0,2,953,0
LA Clippers,37,27,27,31,12,0,0,0,Boston,33,38,27,24,17,0,0,0,20160210,134,139,-4,7,7,0,5,273,5,2015,1,2,2590,0
Charlotte,25,35,29,28,0,0,0,0,Indiana,25,18,27,25,0,0,0,0,20160210,117,95,0,17,19,22,22,212,-22,2015,0,2,428,0
Washington,27,19,24,22,0,0,0,0,Milwaukee,18,37,14,30,0,0,0,0,20160211,92,99,-9,9,-1,7,7,191,7,2015,0,3,634,0
New Orleans,25,28,21,21,0,0,0,0,Oklahoma City,29,33,33,26,0,0,0,0,20160211,95,121,4,9,21,26,26,216,26,2015,0,3,576,0
Chicago,19,23,22,31,0,0,0,0,Cleveland,26,22,30,28,0,0,0,0,20160218,95,106,7,6,14,11,11,201,11,2015,0,3,308,0
San Antonio,15,19,29,23,0,0,0,0,LA Clippers,21,21,30,33,0,0,0,0,20160218,86,105,6,8,9,19,19,191,19,2015,0,3,1201,0
Utah,23,19,26,21,0,0,0,0,Washington,28,21,27,27,0,0,0,0,20160218,89,103,5,7,8,14,14,192,14,2015,0,3,1841,0
Houston,21,35,25,35,0,0,0,0,Phoenix,24,21,20,35,0,0,0,0,20160219,116,100,-3,11,16,16,16,216,-16,2015,0,4,1014,0
Golden State,31,31,17,26,0,0,0,0,Portland,42,26,36,33,0,0,0,0,20160219,105,137,11,6,25,32,32,242,32,2015,0,4,535,0
Dallas,13,38,30,17,6,0,0,0,Orlando,31,25,16,26,12,0,0,0,20160219,104,110,18,5,-9,0,6,214,6,2015,1,4,961,0
Detroit,15,25,21,25,0,0,0,0,Washington,29,26,28,15,0,0,0,0,20160219,86,98,14,15,22,12,12,184,12,2015,0,4,394,0
Boston,24,25,23,21,0,0,0,0,Utah,26,28,29,28,0,0,0,0,20160219,93,111,2,5,11,18,18,204,18,2015,0,4,2093,0
Denver,24,33,20,33,0,0,0,0,Sacramento,31,39,18,28,0,0,0,0,20160219,110,116,7,13,11,6,6,226,6,2015,0,4,886,0
Indiana,24,20,23,34,0,0,0,0,Oklahoma City,24,27,25,22,0,0,0,0,20160219,101,98,0,-7,-9,3,3,199,-3,2015,0,4,688,0
New York,32,20,24,22,0,0,0,0,Brooklyn,23,27,34,25,0,0,0,0,20160219,98,109,-9,-2,8,11,11,207,11,2015,0,4,0,0
Charlotte,28,24,18,28,0,0,0,0,Milwaukee,25,27,26,17,0,0,0,0,20160219,98,95,3,0,-8,3,3,193,-3,2015,0,4,658,0
Minnesota,27,21,33,23,0,0,0,0,Memphis,28,23,25,33,0,0,0,0,20160219,104,109,1,3,-5,5,5,213,5,2015,0,4,700,0
San Antonio,33,27,25,34,0,0,0,0,LA Lakers,30,19,26,38,0,0,0,0,20160219,119,113,3,11,10,6,6,232,-6,2015,0,4,1201,0
Toronto,35,23,23,25,0,0,0,0,Chicago,24,28,37,27,0,0,0,0,20160219,106,116,-11,-6,8,10,10,222,10,2015,0,4,436,0
Miami,22,30,27,36,0,0,0,0,Atlanta,19,33,29,30,0,0,0,0,20160219,115,111,3,0,-2,4,4,226,-4,2015,0,4,605,0
Philadelphia,26,29,35,24,0,0,0,0,New Orleans,37,34,21,29,0,0,0,0,20160219,114,121,11,16,2,7,7,235,7,2015,0,4,1088,0
Milwaukee,31,23,21,19,11,12,0,0,Atlanta,29,21,18,26,11,4,0,0,20160220,117,109,2,4,7,0,8,226,-8,2015,2,5,669,0
Golden State,33,30,30,22,0,0,0,0,LA Clippers,20,33,31,28,0,0,0,0,20160220,115,112,13,10,9,3,3,227,-3,2015,0,5,347,0
Washington,19,25,24,26,0,0,0,0,Miami,30,29,23,32,0,0,0,0,20160220,94,114,11,15,14,20,20,208,20,2015,0,5,924,0
New York,31,28,22,22,0,0,0,0,Minnesota,16,32,13,34,0,0,0,0,20160220,103,95,15,11,20,8,8,198,-8,2015,0,5,1016,0
Memphis,20,23,21,21,0,0,0,0,Toronto,22,24,28,24,0,0,0,0,20160221,85,98,2,3,10,13,13,183,13,2015,0,6,815,0
Utah,25,27,30,29,0,0,0,0,Portland,18,29,33,35,0,0,0,0,20160221,111,115,-7,-5,-2,4,4,226,4,2015,0,6,634,0
San Antonio,30,30,28,30,0,0,0,0,Phoenix,21,29,32,29,0,0,0,0,20160221,118,111,9,10,6,7,7,229,-7,2015,0,6,846,0
Indiana,20,27,33,25,0,0,0,0,Orlando,22,25,32,23,0,0,0,0,20160221,105,102,-2,0,1,3,3,207,-3,2015,0,6,822,0
Cleveland,27,35,33,20,0,0,0,0,Oklahoma City,28,25,20,19,0,0,0,0,20160221,115,92,-1,9,22,23,23,207,-23,2015,0,6,949,0
LA Lakers,30,28,23,34,0,0,0,0,Chicago,31,31,35,29,0,0,0,0,20160221,115,126,1,4,16,11,11,241,11,2015,0,6,1741,0
Boston,35,29,27,30,0,0,0,0,Denver,17,32,29,23,0,0,0,0,20160221,121,101,18,15,13,20,20,222,-20,2015,0,6,1765,0
Philadelphia,30,24,26,23,0,0,0,0,Dallas,28,38,29,34,0,0,0,0,20160221,103,129,-2,12,15,26,26,232,26,2015,0,6,1297,0
Charlotte,29,26,31,18,0,0,0,0,Brooklyn,26,22,25,23,0,0,0,0,20160221,104,96,3,7,13,8,8,200,-8,2015,0,6,531,0
New Orleans,28,27,25,31,0,0,0,0,Detroit,25,30,20,31,0,0,0,0,20160221,111,106,3,0,5,5,5,217,-5,2015,0,6,939,0
Boston,23,30,31,38,0,0,0,0,Minnesota,31,28,34,31,0,0,0,0,20160222,122,124,8,6,9,2,2,246,2,2015,0,0,1120,0
Toronto,26,31,29,36,0,0,0,0,New York,28,15,25,27,0,0,0,0,20160222,122,95,-2,14,18,27,27,217,-27,2015,0,0,341,0
Indiana,25,19,25,19,5,0,0,0,Miami,15,26,29,18,13,0,0,0,20160222,93,101,-10,-3,1,0,8,194,8,2015,1,0,1026,0
LA Lakers,19,29,17,36,0,0,0,0,Milwaukee,29,25,36,18,0,0,0,0,20160222,101,108,10,6,25,7,7,209,7,2015,0,0,1741,0
Phoenix,17,25,19,23,0,0,0,0,LA Clippers,36,23,31,34,0,0,0,0,20160222,84,124,19,17,29,40,40,208,40,2015,0,0,356,0
Detroit,33,23,19,21,0,0,0,0,Cleveland,28,21,19,20,0,0,0,0,20160222,96,88,5,7,7,8,8,184,-8,2015,0,0,90,0
Golden State,30,28,18,26,0,0,0,0,Atlanta,15,24,36,17,0,0,0,0,20160222,102,92,15,19,1,10,10,194,-10,2015,0,0,2135,0
Sacramento,28,33,30,23,0,0,0,0,Denver,25,25,27,33,0,0,0,0,20160223,114,110,3,11,14,4,4,224,-4,2015,0,1,886,0
Orlando,33,34,30,27,0,0,0,0,Philadelphia,31,31,31,22,0,0,0,0,20160223,124,115,2,5,4,9,9,239,-9,2015,0,1,864,0
Brooklyn,21,28,33,22,0,0,0,0,Portland,34,29,22,27,0,0,0,0,20160223,104,112,13,14,3,8,8,216,8,2015,0,1,2439,0
Houston,23,28,32,23,8,0,0,0,Utah,34,22,23,27,11,0,0,0,20160223,114,117,11,5,-4,0,3,231,3,2015,1,1,1199,0
New Orleans,19,32,14,24,0,0,0,0,Washington,24,30,31,24,0,0,0,0,20160223,89,109,5,3,20,20,20,198,20,2015,0,1,964,0
Minnesota,28,30,28,19,0,0,0,0,Toronto,37,24,26,27,0,0,0,0,20160224,105,114,9,3,1,9,9,219,9,2015,0,2,691,0
San Antonio,25,24,27,32,0,0,0,0,Sacramento,24,14,32,22,0,0,0,0,20160224,108,92,1,11,6,16,16,200,-16,2015,0,2,1456,0
Golden State,21,30,29,38,0,0,0,0,Miami,30,25,28,29,0,0,0,0,20160224,118,112,-9,-4,-3,6,6,230,-6,2015,0,2,2590,0
LA Lakers,26,32,26,35,0,0,0,0,Memphis,36,31,30,31,0,0,0,0,20160224,119,128,10,9,13,9,9,247,9,2015,0,2,1599,0
Denver,23,30,18,16,0,0,0,0,LA Clippers,19,20,23,19,0,0,0,0,20160224,87,81,4,14,9,6,6,168,-6,2015,0,2,830,0
Philadelphia,20,22,19,30,0,0,0,0,Detroit,33,32,20,26,0,0,0,0,20160224,91,111,13,23,24,20,20,202,20,2015,0,2,441,0
Oklahoma City,33,25,29,29,0,0,0,0,Dallas,24,27,30,22,0,0,0,0,20160224,116,103,9,7,6,13,13,219,-13,2015,0,2,189,0
Charlotte,24,28,24,27,0,0,0,0,Cleveland,23,40,25,26,0,0,0,0,20160224,103,114,-1,11,12,11,11,217,11,2015,0,2,435,0
Washington,31,24,24,25,0,0,0,0,Chicago,28,29,32,20,0,0,0,0,20160224,104,109,-3,2,10,5,5,213,5,2015,0,2,594,0
New York,26,28,26,25,0,0,0,0,Indiana,28,24,28,28,0,0,0,0,20160224,105,108,2,-2,0,3,3,213,3,2015,0,2,643,0
Milwaukee,25,27,21,34,0,0,0,0,Boston,35,27,26,24,0,0,0,0,20160225,107,112,10,10,15,5,5,219,5,2015,0,3,855,0
Oklahoma City,32,32,23,32,0,0,0,0,New Orleans,35,26,28,34,0,0,0,0,20160225,119,123,3,-3,2,4,4,242,4,2015,0,3,576,0
Golden State,33,26,40,31,0,0,0,0,Orlando,30,33,28,23,0,0,0,0,20160225,130,114,3,-4,8,16,16,244,-16,2015,0,3,2437,0
Brooklyn,34,32,24,26,0,0,0,0,Phoenix,29,16,26,35,0,0,0,0,20160225,116,106,5,21,19,10,10,222,-10,2015,0,3,2139,0
Houston,28,21,37,33,0,0,0,0,Portland,34,30,29,12,0,0,0,0,20160225,119,105,-6,-15,-7,14,14,224,-14,2015,0,3,1833,0
San Antonio,18,21,26,31,0,0,0,0,Utah,23,12,22,21,0,0,0,0,20160225,96,78,-5,4,8,18,18,174,-18,2015,0,3,1087,0
Washington,21,27,28,27,0,0,0,0,Philadelphia,26,26,20,22,0,0,0,0,20160226,103,94,-5,-4,4,9,9,197,-9,2015,0,4,123,0
Cleveland,31,18,28,20,0,0,0,0,Toronto,21,24,23,31,0,0,0,0,20160226,97,99,-10,-4,-9,2,2,196,2,2015,0,4,187,0
LA Clippers,30,34,34,19,0,0,0,0,Sacramento,30,37,16,24,0,0,0,0,20160226,117,107,0,-3,15,10,10,224,-10,2015,0,4,361,0
Orlando,23,21,25,26,0,0,0,0,New York,32,30,20,26,0,0,0,0,20160226,95,108,9,18,13,13,13,203,13,2015,0,4,939,0
Chicago,21,23,23,21,0,0,0,0,Atlanta,26,25,28,24,0,0,0,0,20160226,88,103,5,7,12,15,15,191,15,2015,0,4,587,0
Charlotte,29,24,24,19,0,0,0,0,Indiana,26,24,20,25,0,0,0,0,20160226,96,95,3,3,7,1,1,191,-1,2015,0,4,428,0
Denver,28,28,24,28,8,0,0,0,Dallas,20,24,32,32,14,0,0,0,20160226,116,122,-8,-12,-4,0,6,238,6,2015,1,4,661,0
Memphis,32,35,23,22,0,0,0,0,LA Lakers,25,25,21,24,0,0,0,0,20160226,112,95,7,17,19,17,17,207,-17,2015,0,4,1599,0
Memphis,18,28,30,30,0,0,0,0,Phoenix,25,29,32,25,0,0,0,0,20160227,106,111,7,8,10,5,5,217,5,2015,0,5,1260,0
Golden State,20,26,32,25,18,0,0,0,Oklahoma City,30,27,26,20,15,0,0,0,20160227,121,118,-10,-11,-5,0,3,239,-3,2015,1,5,1386,0
Minnesota,25,20,31,36,0,0,0,0,New Orleans,26,30,30,24,0,0,0,0,20160227,112,110,-1,-11,-10,2,2,222,-2,2015,0,5,1052,0
Brooklyn,20,28,22,28,0,0,0,0,Utah,22,21,18,35,0,0,0,0,20160227,98,96,-2,5,9,2,2,194,-2,2015,0,5,1967,0
San Antonio,26,25,25,28,0,0,0,0,Houston,11,20,26,37,0,0,0,0,20160227,104,94,15,20,19,10,10,198,-10,2015,0,5,189,0
Portland,21,30,28,24,0,0,0,0,Chicago,21,20,32,22,0,0,0,0,20160227,103,95,0,10,6,8,8,198,-8,2015,0,5,1754,0
Miami,26,23,21,19,0,0,0,0,Boston,18,28,26,29,0,0,0,0,20160227,89,101,-8,-3,2,12,12,190,12,2015,0,5,1257,0
Detroit,34,25,21,22,0,0,0,0,Milwaukee,24,25,24,18,0,0,0,0,20160227,102,91,10,10,7,11,11,193,-11,2015,0,5,251,0
Charlotte,9,23,25,19,0,0,0,0,Atlanta,25,21,22,19,0,0,0,0,20160228,76,87,16,14,11,11,11,163,11,2015,0,6,226,0
Minnesota,24,30,20,27,0,0,0,0,Dallas,39,26,34,29,0,0,0,0,20160228,101,128,15,11,25,27,27,229,27,2015,0,6,863,0
Toronto,25,27,20,29,0,0,0,0,Detroit,23,29,37,25,0,0,0,0,20160228,101,114,-2,0,17,13,13,215,13,2015,0,6,205,0
Portland,39,26,22,24,0,0,0,0,Indiana,27,27,23,25,0,0,0,0,20160228,111,102,12,11,10,9,9,213,-9,2015,0,6,1880,0
Miami,23,21,25,29,0,0,0,0,New York,19,20,26,16,0,0,0,0,20160228,98,81,4,5,4,17,17,179,-17,2015,0,6,1091,0
Philadelphia,26,25,36,29,0,0,0,0,Orlando,40,37,25,28,0,0,0,0,20160228,116,130,14,26,15,14,14,246,14,2015,0,6,864,0
Cleveland,28,26,16,29,0,0,0,0,Washington,35,28,33,17,0,0,0,0,20160228,99,113,7,9,26,14,14,212,14,2015,0,6,304,0
Houston,26,38,28,29,0,0,0,0,Milwaukee,32,33,27,36,0,0,0,0,20160229,121,128,6,1,0,7,7,249,7,2015,0,0,1005,0
Oklahoma City,29,32,33,37,0,0,0,0,Sacramento,25,28,31,32,0,0,0,0,20160229,131,116,4,8,10,15,15,247,-15,2015,0,0,1336,0
Brooklyn,27,19,33,16,0,0,0,0,LA Clippers,29,23,29,24,0,0,0,0,20160229,95,105,2,6,2,10,10,200,10,2015,0,0,2445,0
Philadelphia,23,25,34,26,0,0,0,0,Washington,27,33,19,37,0,0,0,0,20160229,108,116,4,12,-3,8,8,224,8,2015,0,0,123,0
Indiana,19,24,30,23,0,0,0,0,Cleveland,18,26,30,26,0,0,0,0,20160229,96,100,-1,1,1,4,4,196,4,2015,0,0,262,0
Utah,29,17,27,22,0,0,0,0,Boston,23,20,29,28,0,0,0,0,20160229,95,100,-6,-3,-1,5,5,195,5,2015,0,0,2093,0
Memphis,22,26,23,32,0,0,0,0,Denver,19,28,24,25,0,0,0,0,20160229,103,96,3,1,0,7,7,199,-7,2015,0,0,877,0
Portland,27,31,27,19,0,0,0,0,New York,25,25,22,13,0,0,0,0,20160301,104,85,2,8,13,19,19,189,-19,2015,0,1,2439,0
Chicago,30,32,20,29,0,0,0,0,Miami,36,29,30,34,0,0,0,0,20160301,111,129,6,3,13,18,18,240,18,2015,0,1,1189,0
Brooklyn,19,31,24,27,0,0,0,0,LA Lakers,24,34,21,28,0,0,0,0,20160301,101,107,5,8,5,6,6,208,6,2015,0,1,2445,0
Phoenix,18,24,19,31,0,0,0,0,Charlotte,35,33,30,28,0,0,0,0,20160301,92,126,17,26,37,34,34,218,34,2015,0,1,1778,0
Orlando,27,34,20,27,0,0,0,0,Dallas,35,34,27,25,0,0,0,0,20160301,108,121,8,8,15,13,13,229,13,2015,0,1,961,0
Atlanta,26,22,22,27,8,0,0,0,Golden State,32,27,16,22,12,0,0,0,20160301,105,109,6,11,5,0,4,214,4,2015,1,1,2135,0
Utah,26,23,25,20,0,0,0,0,Toronto,24,28,33,19,0,0,0,0,20160302,94,104,-2,3,11,10,10,198,10,2015,0,2,1664,0
Detroit,26,25,14,16,0,0,0,0,San Antonio,28,24,27,18,0,0,0,0,20160302,81,97,2,1,14,16,16,178,16,2015,0,2,1238,0
Chicago,23,27,17,22,0,0,0,0,Orlando,33,27,24,18,0,0,0,0,20160302,89,102,10,10,17,13,13,191,13,2015,0,2,984,0
Washington,29,31,25,19,0,0,0,0,Minnesota,32,22,23,21,0,0,0,0,20160302,104,98,-3,6,8,6,6,202,-6,2015,0,2,931,0
Indiana,22,27,24,31,0,0,0,0,Milwaukee,22,17,24,36,0,0,0,0,20160302,104,99,0,10,10,5,5,203,-5,2015,0,2,243,0
Charlotte,32,26,25,36,0,0,0,0,Philadelphia,29,21,24,25,0,0,0,0,20160302,119,99,3,8,9,20,20,218,-20,2015,0,2,450,0
Oklahoma City,37,21,27,13,0,0,0,0,LA Clippers,24,14,30,35,0,0,0,0,20160302,98,103,-13,-20,-17,5,5,201,5,2015,0,2,1178,0
New Orleans,28,24,24,19,0,0,0,0,Houston,25,28,23,24,0,0,0,0,20160302,95,100,-3,1,0,5,5,195,5,2015,0,2,317,0
LA Lakers,29,31,22,25,0,0,0,0,Denver,27,30,26,34,0,0,0,0,20160302,107,117,-2,-3,1,10,10,224,10,2015,0,2,830,0
Portland,33,22,12,26,0,0,0,0,Boston,30,31,30,25,0,0,0,0,20160302,93,116,-3,6,24,23,23,209,23,2015,0,2,2532,0
Sacramento,28,15,35,20,0,0,0,0,Memphis,31,28,24,21,0,0,0,0,20160302,98,104,3,16,5,6,6,202,6,2015,0,2,1745,0
Sacramento,19,31,23,31,0,0,0,0,Dallas,24,21,24,32,0,0,0,0,20160303,104,101,-5,5,4,3,3,205,-3,2015,0,3,1437,0
Oklahoma City,28,33,22,23,0,0,0,0,Golden State,29,34,19,39,0,0,0,0,20160303,106,121,1,2,-1,15,15,227,15,2015,0,3,1386,0
Phoenix,21,22,25,24,0,0,0,0,Miami,29,28,27,24,0,0,0,0,20160303,92,108,8,14,16,16,16,200,16,2015,0,3,1978,0
San Antonio,22,23,23,26,0,0,0,0,New Orleans,26,20,22,18,0,0,0,0,20160303,94,86,-4,-1,0,8,8,180,-8,2015,0,3,506,0
Minnesota,35,21,25,20,0,0,0,0,Milwaukee,29,33,36,18,0,0,0,0,20160304,101,116,-6,6,17,15,15,217,15,2015,0,4,298,0
Miami,40,19,25,28,0,0,0,0,Philadelphia,29,20,28,25,0,0,0,0,20160304,112,102,11,10,7,10,10,214,-10,2015,0,4,1021,0
Portland,30,22,25,38,0,0,0,0,Toronto,31,27,32,27,0,0,0,0,20160304,115,117,1,6,13,2,2,232,2,2015,0,4,2108,0
Utah,28,11,33,16,0,0,0,0,Memphis,19,30,18,27,0,0,0,0,20160304,88,94,-9,10,-5,6,6,182,6,2015,0,4,1247,0
Phoenix,29,29,26,18,0,0,0,0,Orlando,29,21,16,18,0,0,0,0,20160304,102,84,0,8,18,18,18,186,-18,2015,0,4,1842,0
Brooklyn,31,32,27,22,9,0,0,0,Denver,25,32,33,22,8,0,0,0,20160304,121,120,6,6,0,0,1,241,-1,2015,1,4,1627,0
Washington,23,19,21,20,0,0,0,0,Cleveland,27,32,24,25,0,0,0,0,20160304,83,108,4,17,20,25,25,191,25,2015,0,4,304,0
Indiana,30,20,32,19,0,0,0,0,Charlotte,31,24,25,28,0,0,0,0,20160304,101,108,1,5,-2,7,7,209,7,2015,0,4,428,0
New York,31,27,29,17,0,0,0,0,Boston,27,26,28,24,0,0,0,0,20160304,104,105,-4,-5,-6,1,1,209,1,2015,0,4,190,0
Atlanta,26,28,20,32,0,0,0,0,LA Lakers,19,17,23,18,0,0,0,0,20160304,106,77,7,18,15,29,29,183,-29,2015,0,4,1932,0
Houston,23,20,32,25,0,0,0,0,Chicago,29,26,28,25,0,0,0,0,20160305,100,108,6,12,8,8,8,208,8,2015,0,5,939,0
Boston,35,19,29,20,0,0,0,0,Cleveland,22,33,36,29,0,0,0,0,20160305,103,120,-13,1,8,17,17,223,17,2015,0,5,549,0
Atlanta,25,25,30,27,0,0,0,0,LA Clippers,37,18,24,18,0,0,0,0,20160305,107,97,-12,-5,1,10,10,204,-10,2015,0,5,1932,0
Brooklyn,30,21,28,39,0,0,0,0,Minnesota,37,31,29,35,0,0,0,0,20160305,118,132,7,17,18,14,14,250,14,2015,0,5,1016,0
Utah,29,22,33,22,0,0,0,0,New Orleans,20,25,25,24,0,0,0,0,20160305,106,94,9,6,14,12,12,200,-12,2015,0,5,1432,0
Detroit,21,21,28,19,0,0,0,0,New York,22,35,22,23,0,0,0,0,20160305,89,102,1,15,9,13,13,191,13,2015,0,5,480,0
Sacramento,22,32,13,27,0,0,0,0,San Antonio,29,28,29,18,0,0,0,0,20160305,94,104,7,3,19,10,10,198,10,2015,0,5,1456,0
Indiana,31,25,22,22,0,0,0,0,Washington,37,27,16,19,0,0,0,0,20160305,100,99,-6,-8,-2,1,1,199,-1,2015,0,5,490,0
Houston,26,25,26,36,0,0,0,0,Toronto,30,31,24,22,0,0,0,0,20160306,113,107,-4,-10,-8,6,6,220,-6,2015,0,6,1299,0
Oklahoma City,32,32,20,20,0,0,0,0,Milwaukee,12,36,31,17,0,0,0,0,20160306,104,96,20,16,5,8,8,200,-8,2015,0,6,732,0
Philadelphia,25,24,20,29,0,0,0,0,Miami,30,17,22,34,0,0,0,0,20160306,98,103,5,-2,0,5,5,201,5,2015,0,6,1021,0
Dallas,19,31,29,27,8,0,0,0,Denver,22,35,20,29,10,0,0,0,20160306,114,116,3,7,-2,0,2,230,2,2015,1,6,661,0
Golden State,21,28,24,22,0,0,0,0,LA Lakers,22,38,24,28,0,0,0,0,20160306,95,112,1,11,11,17,17,207,17,2015,0,6,347,0
Portland,16,35,24,28,0,0,0,0,Detroit,30,28,27,38,0,0,0,0,20160306,103,123,14,7,10,20,20,226,20,2015,0,6,1964,0
Phoenix,24,29,32,24,0,0,0,0,Memphis,24,35,15,26,0,0,0,0,20160306,109,100,0,-6,11,9,9,209,-9,2015,0,6,1260,0
San Antonio,13,19,30,29,0,0,0,0,Indiana,25,20,28,26,0,0,0,0,20160307,91,99,12,13,11,8,8,190,8,2015,0,0,999,0
Milwaukee,16,24,29,21,0,0,0,0,Chicago,25,22,26,27,0,0,0,0,20160307,90,100,9,7,4,10,10,190,10,2015,0,0,83,0
Minnesota,18,31,26,28,0,0,0,0,Charlotte,23,24,35,26,0,0,0,0,20160307,103,108,5,-2,7,5,5,211,5,2015,0,0,938,0
Memphis,33,25,24,24,0,0,0,0,Cleveland,25,24,25,29,0,0,0,0,20160307,106,103,8,9,8,3,3,209,-3,2015,0,0,629,0
LA Clippers,23,27,33,26,0,0,0,0,Dallas,24,28,16,22,0,0,0,0,20160307,109,90,-1,-2,15,19,19,199,-19,2015,0,0,1237,0
Orlando,18,28,31,36,0,0,0,0,Golden State,31,28,35,25,0,0,0,0,20160307,113,119,13,13,17,6,6,232,6,2015,0,0,2437,0
Sacramento,31,32,26,23,0,0,0,0,New Orleans,33,17,33,32,0,0,0,0,20160307,112,115,2,-13,-6,3,3,227,3,2015,0,0,1879,0
Orlando,26,25,26,21,0,0,0,0,LA Lakers,20,25,39,23,0,0,0,0,20160308,98,107,-6,-6,7,9,9,205,9,2015,0,1,2197,0
Atlanta,16,25,25,25,0,0,0,0,Utah,27,15,15,27,0,0,0,0,20160308,91,84,-11,-1,9,7,7,175,-7,2015,0,1,1580,0
Brooklyn,23,35,22,19,0,0,0,0,Toronto,28,14,36,26,0,0,0,0,20160308,99,104,5,-16,-2,5,5,203,5,2015,0,1,341,0
New York,25,24,19,26,0,0,0,0,Denver,31,29,22,28,0,0,0,0,20160308,94,110,6,11,14,16,16,204,16,2015,0,1,1627,0
San Antonio,27,32,34,23,0,0,0,0,Minnesota,24,23,21,23,0,0,0,0,20160308,116,91,3,12,25,25,25,207,-25,2015,0,1,1112,0
Washington,22,33,26,23,5,0,0,0,Portland,29,25,31,19,12,0,0,0,20160308,109,116,7,-1,4,0,7,225,7,2015,1,1,2347,0
Memphis,26,29,12,29,0,0,0,0,Boston,24,28,31,33,0,0,0,0,20160309,96,116,-2,-3,16,20,20,212,20,2015,0,2,1134,0
New York,29,34,25,40,0,0,0,0,Phoenix,19,24,32,22,0,0,0,0,20160309,128,97,10,20,13,31,31,225,-31,2015,0,2,2139,0
Houston,21,40,32,25,0,0,0,0,Philadelphia,27,25,27,25,0,0,0,0,20160309,118,104,-6,9,14,14,14,222,-14,2015,0,2,1339,0
LA Clippers,29,33,21,25,0,0,0,0,Oklahoma City,39,25,29,27,0,0,0,0,20160309,108,120,10,2,10,12,12,228,12,2015,0,2,1178,0
Cleveland,28,26,35,31,0,0,0,0,Sacramento,25,35,24,27,0,0,0,0,20160309,120,111,3,-6,5,9,9,231,-9,2015,0,2,2096,0
Utah,21,20,22,31,0,0,0,0,Golden State,23,29,29,34,0,0,0,0,20160309,94,115,2,11,18,21,21,209,21,2015,0,2,599,0
Detroit,26,28,22,26,0,0,0,0,Dallas,28,24,22,22,0,0,0,0,20160309,102,96,-2,2,2,6,6,198,-6,2015,0,2,999,0
New Orleans,28,32,30,23,0,0,0,0,Charlotte,39,32,28,23,0,0,0,0,20160309,113,122,11,11,9,9,9,235,9,2015,0,2,648,0
Miami,22,32,31,23,0,0,0,0,Milwaukee,29,28,23,34,0,0,0,0,20160309,108,114,7,3,-5,6,6,222,6,2015,0,2,1269,0
Phoenix,18,23,33,24,0,0,0,0,Denver,25,30,27,34,0,0,0,0,20160310,98,116,7,14,8,18,18,214,18,2015,0,3,585,0
Cleveland,33,31,31,25,0,0,0,0,LA Lakers,31,24,27,26,0,0,0,0,20160310,120,108,2,9,13,12,12,228,-12,2015,0,3,2044,0
Chicago,27,20,27,27,0,0,0,0,San Antonio,27,27,30,25,0,0,0,0,20160310,101,109,0,7,10,8,8,210,8,2015,0,3,1050,0
Atlanta,21,27,27,21,0,0,0,0,Toronto,20,32,30,22,0,0,0,0,20160310,96,104,-1,4,7,8,8,200,8,2015,0,3,733,0
Minnesota,24,26,19,30,0,0,0,0,Oklahoma City,21,32,20,23,0,0,0,0,20160311,99,96,3,-3,-4,3,3,195,-3,2015,0,4,694,0
Washington,29,19,20,25,0,0,0,0,Utah,32,24,32,26,0,0,0,0,20160311,93,114,3,8,20,21,21,207,21,2015,0,4,1841,0
Orlando,27,23,30,27,0,0,0,0,Sacramento,21,28,26,25,0,0,0,0,20160311,107,100,6,1,5,7,7,207,-7,2015,0,4,2390,0
Brooklyn,21,24,22,22,0,0,0,0,Philadelphia,27,26,19,23,0,0,0,0,20160311,89,95,6,8,5,6,6,184,6,2015,0,4,80,0
New Orleans,24,23,19,33,15,0,0,0,Memphis,20,28,25,26,22,0,0,0,20160311,114,121,-4,1,7,0,7,235,7,2015,1,4,358,0
Houston,19,27,31,25,0,0,0,0,Boston,23,20,30,25,0,0,0,0,20160311,102,98,-4,3,4,4,4,200,-4,2015,0,4,1603,0
Portland,27,34,25,26,0,0,0,0,Golden State,40,41,29,18,0,0,0,0,20160311,112,128,13,20,24,16,16,240,16,2015,0,4,535,0
Detroit,32,21,28,22,0,0,0,0,Charlotte,38,31,19,30,0,0,0,0,20160311,103,118,6,16,7,15,15,221,15,2015,0,4,504,0
Miami,23,31,30,34,0,0,0,0,Chicago,31,27,23,15,0,0,0,0,20160311,118,96,-8,-4,3,22,22,214,-22,2015,0,4,1189,0
New York,22,28,24,20,0,0,0,0,LA Clippers,29,32,15,25,0,0,0,0,20160311,94,101,7,11,2,7,7,195,7,2015,0,4,2445,0
Detroit,27,25,38,35,0,0,0,0,Philadelphia,32,25,30,24,0,0,0,0,20160312,125,111,-5,-5,3,14,14,236,-14,2015,0,5,441,0
Miami,24,22,25,26,7,0,0,0,Toronto,28,25,17,27,15,0,0,0,20160312,104,112,4,7,-1,0,8,216,8,2015,1,5,1234,0
Oklahoma City,22,27,19,17,0,0,0,0,San Antonio,25,20,21,27,0,0,0,0,20160312,85,93,3,-4,-2,8,8,178,8,2015,0,5,421,0
Orlando,24,18,23,19,0,0,0,0,Portland,31,32,27,31,0,0,0,0,20160312,84,121,7,21,25,37,37,205,37,2015,0,5,2525,0
New Orleans,28,24,19,21,0,0,0,0,Milwaukee,33,22,22,26,0,0,0,0,20160312,92,103,5,3,6,11,11,195,11,2015,0,5,911,0
Houston,19,38,30,22,0,0,0,0,Charlotte,34,28,28,35,0,0,0,0,20160312,109,125,15,5,3,16,16,234,16,2015,0,5,925,0
Washington,23,27,33,17,0,0,0,0,Denver,27,25,23,41,0,0,0,0,20160312,100,116,4,2,-8,16,16,216,16,2015,0,5,1489,0
Phoenix,24,32,39,21,0,0,0,0,Golden State,31,29,26,37,0,0,0,0,20160312,116,123,7,4,-9,7,7,239,7,2015,0,5,652,0
Memphis,22,19,17,25,0,0,0,0,Atlanta,18,31,22,24,0,0,0,0,20160312,83,95,-4,8,13,12,12,178,12,2015,0,5,336,0
Indiana,26,29,28,29,0,0,0,0,Dallas,23,28,24,30,0,0,0,0,20160312,112,105,3,4,8,7,7,217,-7,2015,0,5,763,0
Indiana,17,21,18,19,0,0,0,0,Atlanta,30,22,37,15,0,0,0,0,20160313,75,104,13,14,33,29,29,179,29,2015,0,6,427,0
Milwaukee,27,23,28,31,0,0,0,0,Brooklyn,25,26,28,21,0,0,0,0,20160313,109,100,2,-1,-1,9,9,209,-9,2015,0,6,732,0
Cleveland,21,37,33,23,0,0,0,0,LA Clippers,19,22,27,22,0,0,0,0,20160313,114,90,2,17,23,24,24,204,-24,2015,0,6,2044,0
New York,18,28,19,25,0,0,0,0,LA Lakers,11,24,25,27,0,0,0,0,20160313,90,87,7,11,5,3,3,177,-3,2015,0,6,2445,0
Utah,36,25,23,24,0,0,0,0,Sacramento,18,27,24,30,0,0,0,0,20160313,108,99,18,16,15,9,9,207,-9,2015,0,6,532,0
Memphis,22,19,15,25,0,0,0,0,Houston,34,31,32,33,0,0,0,0,20160314,81,130,12,24,41,49,49,211,49,2015,0,0,484,0
Detroit,15,24,24,18,0,0,0,0,Washington,34,26,33,31,0,0,0,0,20160314,81,124,19,21,30,43,43,205,43,2015,0,0,394,0
Cleveland,26,18,22,19,0,0,0,0,Utah,28,20,18,28,0,0,0,0,20160314,85,94,2,4,0,9,9,179,9,2015,0,0,1564,0
Chicago,34,24,26,25,0,0,0,0,Toronto,29,23,25,30,0,0,0,0,20160314,109,107,5,6,7,2,2,216,-2,2015,0,0,436,0
Minnesota,25,32,21,26,0,0,0,0,Phoenix,27,20,29,31,0,0,0,0,20160314,104,107,2,-10,-2,3,3,211,3,2015,0,0,1278,0
New Orleans,24,26,19,38,0,0,0,0,Golden State,28,31,35,31,0,0,0,0,20160314,107,125,4,9,25,18,18,232,18,2015,0,0,1921,0
Denver,33,29,29,28,0,0,0,0,Miami,36,28,26,34,0,0,0,0,20160314,119,124,3,2,-1,5,5,243,5,2015,0,0,1724,0
Dallas,22,30,19,36,0,0,0,0,Charlotte,18,15,32,31,0,0,0,0,20160314,107,96,4,19,6,11,11,203,-11,2015,0,0,928,0
Portland,22,20,30,22,0,0,0,0,Oklahoma City,31,35,36,26,0,0,0,0,20160314,94,128,9,24,30,34,34,222,34,2015,0,0,1484,0
LA Clippers,21,23,26,17,0,0,0,0,San Antonio,19,29,23,37,0,0,0,0,20160315,87,108,-2,4,1,21,21,195,21,2015,0,1,1201,0
Denver,25,21,33,31,0,0,0,0,Orlando,32,29,24,31,0,0,0,0,20160315,110,116,7,15,6,6,6,226,6,2015,0,1,1548,0
Toronto,22,30,29,26,0,0,0,0,Milwaukee,28,21,17,23,0,0,0,0,20160315,107,89,-6,3,15,18,18,196,-18,2015,0,1,429,0
Sacramento,32,25,22,27,0,0,0,0,LA Lakers,15,26,26,31,0,0,0,0,20160315,106,98,17,16,12,8,8,204,-8,2015,0,1,361,0
Philadelphia,15,36,32,31,0,0,0,0,Brooklyn,32,39,29,31,0,0,0,0,20160315,114,131,17,20,17,17,17,245,17,2015,0,1,80,0
Boston,20,19,31,28,0,0,0,0,Indiana,20,23,28,32,0,0,0,0,20160315,98,103,0,4,1,5,5,201,5,2015,0,1,805,0
New Orleans,33,41,24,25,0,0,0,0,Sacramento,31,22,30,25,0,0,0,0,20160316,123,108,2,21,15,15,15,231,-15,2015,0,2,1879,0
Minnesota,42,22,26,24,0,0,0,0,Memphis,25,30,23,30,0,0,0,0,20160316,114,108,17,9,12,6,6,222,-6,2015,0,2,700,0
LA Clippers,35,37,25,25,0,0,0,0,Houston,26,24,25,31,0,0,0,0,20160316,122,106,9,22,22,16,16,228,-16,2015,0,2,1371,0
New York,19,27,18,21,0,0,0,0,Golden State,31,31,35,24,0,0,0,0,20160316,85,121,12,16,33,36,36,206,36,2015,0,2,2565,0
Chicago,25,27,22,22,0,0,0,0,Washington,32,31,29,25,0,0,0,0,20160316,96,117,7,11,18,21,21,213,21,2015,0,2,594,0
Dallas,28,23,17,30,0,0,0,0,Cleveland,31,26,27,15,0,0,0,0,20160316,98,99,3,6,16,1,1,197,1,2015,0,2,1024,0
Orlando,30,13,28,28,0,0,0,0,Charlotte,26,35,31,15,0,0,0,0,20160316,99,107,-4,18,21,8,8,206,8,2015,0,2,463,0
Oklahoma City,35,31,42,22,0,0,0,0,Boston,30,25,26,28,0,0,0,0,20160316,130,109,5,11,27,21,21,239,-21,2015,0,2,1492,0
Atlanta,30,31,26,31,0,0,0,0,Detroit,32,30,26,26,0,0,0,0,20160316,118,114,-2,-1,-1,4,4,232,-4,2015,0,2,597,0
Denver,23,25,28,22,0,0,0,0,Atlanta,33,21,33,29,0,0,0,0,20160317,98,116,10,6,11,18,18,214,18,2015,0,3,1209,0
Brooklyn,14,23,37,28,0,0,0,0,Chicago,24,31,24,39,0,0,0,0,20160317,102,118,10,18,5,16,16,220,16,2015,0,3,711,0
Toronto,27,16,20,22,16,0,0,0,Indiana,25,21,14,25,9,0,0,0,20160317,101,94,2,-3,3,0,7,195,-7,2015,1,3,438,0
Charlotte,26,28,28,27,0,0,0,0,Miami,29,23,21,33,0,0,0,0,20160317,109,106,-3,2,9,3,3,215,-3,2015,0,3,654,0
Memphis,32,21,20,13,0,0,0,0,Milwaukee,32,15,21,28,0,0,0,0,20160317,86,96,0,-6,-5,10,10,182,10,2015,0,3,557,0
Washington,30,28,15,26,0,0,0,0,Philadelphia,22,17,22,33,0,0,0,0,20160317,99,94,8,19,12,5,5,193,-5,2015,0,3,123,0
Portland,28,26,24,32,0,0,0,0,San Antonio,23,33,39,23,0,0,0,0,20160317,110,118,-5,2,17,8,8,228,8,2015,0,3,1718,0
Phoenix,21,17,16,15,0,0,0,0,Utah,24,22,25,32,0,0,0,0,20160317,69,103,3,8,17,34,34,172,34,2015,0,3,505,0
Cleveland,27,36,20,26,0,0,0,0,Orlando,29,25,32,17,0,0,0,0,20160318,109,103,-2,9,-3,6,6,212,-6,2015,0,4,895,0
Boston,14,27,33,17,0,0,0,0,Toronto,30,25,24,26,0,0,0,0,20160318,91,105,16,14,5,14,14,196,14,2015,0,4,430,0
Portland,36,31,26,24,0,0,0,0,New Orleans,30,23,28,31,0,0,0,0,20160318,117,112,6,14,12,5,5,229,-5,2015,0,4,2059,0
Oklahoma City,27,26,32,26,0,0,0,0,Philadelphia,23,24,21,29,0,0,0,0,20160318,111,97,4,6,17,14,14,208,-14,2015,0,4,1256,0
Minnesota,23,29,26,33,0,0,0,0,Houston,31,23,34,28,0,0,0,0,20160318,111,116,8,2,10,5,5,227,5,2015,0,4,1057,0
Sacramento,25,29,29,25,0,0,0,0,Detroit,39,28,20,28,0,0,0,0,20160318,108,115,14,13,4,7,7,223,7,2015,0,4,2020,0
Golden State,42,31,21,36,0,0,0,0,Dallas,36,31,18,27,0,0,0,0,20160318,130,112,6,6,9,18,18,242,-18,2015,0,4,1480,0
Phoenix,26,21,21,27,0,0,0,0,LA Lakers,22,10,22,36,0,0,0,0,20160318,95,90,4,15,14,5,5,185,-5,2015,0,4,356,0
Houston,16,42,25,14,0,0,0,0,Atlanta,30,22,30,27,0,0,0,0,20160319,97,109,14,-6,-1,12,12,206,12,2015,0,5,700,0
Utah,19,21,27,18,0,0,0,0,Chicago,25,25,29,13,0,0,0,0,20160319,85,92,6,10,12,7,7,177,7,2015,0,5,1256,0
Denver,28,29,21,23,0,0,0,0,Charlotte,22,18,22,31,0,0,0,0,20160319,101,93,6,17,16,8,8,194,-8,2015,0,5,1355,0
Brooklyn,23,29,25,26,0,0,0,0,Detroit,29,25,23,38,0,0,0,0,20160319,103,115,6,2,0,12,12,218,12,2015,0,5,480,0
Oklahoma City,27,37,24,27,0,0,0,0,Indiana,28,26,33,24,0,0,0,0,20160319,115,111,-1,10,1,4,4,226,-4,2015,0,5,688,0
LA Clippers,29,29,17,27,0,0,0,0,Memphis,31,27,27,28,0,0,0,0,20160319,102,113,2,0,10,11,11,215,11,2015,0,5,1599,0
Cleveland,19,25,26,31,0,0,0,0,Miami,31,34,33,24,0,0,0,0,20160319,101,122,12,21,28,21,21,223,21,2015,0,5,1089,0
Golden State,18,19,28,14,0,0,0,0,San Antonio,17,26,22,22,0,0,0,0,20160319,79,87,-1,6,0,8,8,166,8,2015,0,5,1487,0
New York,29,24,13,23,0,0,0,0,Washington,20,23,33,23,0,0,0,0,20160319,89,99,-9,-10,10,10,10,188,10,2015,0,5,204,0
Orlando,25,30,27,18,0,0,0,0,Toronto,30,23,27,25,0,0,0,0,20160320,100,105,5,-2,-2,5,5,205,5,2015,0,6,1048,0
Boston,28,27,33,32,0,0,0,0,Philadelphia,16,28,35,26,0,0,0,0,20160320,120,105,12,11,9,15,15,225,-15,2015,0,6,270,0
Sacramento,28,22,19,19,0,0,0,0,New York,12,35,18,15,0,0,0,0,20160320,88,80,16,3,4,8,8,168,-8,2015,0,6,2499,0
Portland,36,19,27,31,7,0,0,0,Dallas,25,33,32,23,19,0,0,0,20160320,120,132,-11,3,8,0,12,252,12,2015,1,6,1630,0
Utah,23,19,31,21,0,0,0,0,Milwaukee,22,19,18,26,0,0,0,0,20160320,94,85,1,1,14,9,9,179,-9,2015,0,6,1239,0
LA Clippers,24,32,16,33,0,0,0,0,New Orleans,21,33,24,31,0,0,0,0,20160320,105,109,-3,-2,6,4,4,214,4,2015,0,6,1669,0
Golden State,27,34,28,20,0,0,0,0,Minnesota,29,29,31,15,0,0,0,0,20160321,109,104,-2,3,0,5,5,213,-5,2015,0,0,1581,0
Washington,27,34,28,28,0,0,0,0,Atlanta,30,29,27,16,0,0,0,0,20160321,117,102,-3,2,3,15,15,219,-15,2015,0,0,541,0
Orlando,17,32,29,18,0,0,0,0,Boston,22,34,35,16,0,0,0,0,20160321,96,107,5,7,13,11,11,203,11,2015,0,0,1115,0
Sacramento,26,25,30,21,0,0,0,0,Chicago,30,29,23,27,0,0,0,0,20160321,102,109,4,8,1,7,7,211,7,2015,0,0,1788,0
San Antonio,28,23,21,16,0,0,0,0,Charlotte,7,29,31,24,0,0,0,0,20160321,88,91,-21,-15,-5,3,3,179,3,2015,0,0,1103,0
Denver,23,25,24,19,0,0,0,0,Cleveland,38,18,31,37,0,0,0,0,20160321,91,124,15,8,15,33,33,215,33,2015,0,0,1223,0
Milwaukee,30,18,26,17,0,0,0,0,Detroit,17,28,20,27,0,0,0,0,20160321,91,92,-13,-3,-9,1,1,183,1,2015,0,0,251,0
Philadelphia,18,18,20,19,0,0,0,0,Indiana,25,22,19,25,0,0,0,0,20160321,75,91,7,11,10,16,16,166,16,2015,0,0,582,0
Memphis,24,15,31,33,0,0,0,0,Phoenix,21,29,23,24,0,0,0,0,20160321,103,97,3,-11,-3,6,6,200,-6,2015,0,0,1260,0
Houston,27,29,21,30,0,0,0,0,Oklahoma City,28,27,23,33,0,0,0,0,20160322,107,111,1,-1,1,4,4,218,4,2015,0,1,413,0
Miami,35,24,27,27,0,0,0,0,New Orleans,21,19,33,26,0,0,0,0,20160322,113,99,14,19,13,14,14,212,-14,2015,0,1,668,0
Memphis,25,22,31,22,0,0,0,0,LA Lakers,25,23,33,26,0,0,0,0,20160322,100,107,0,1,3,7,7,207,7,2015,0,1,1599,0
Charlotte,25,21,21,38,0,0,0,0,Brooklyn,14,22,28,36,0,0,0,0,20160322,105,100,11,10,3,5,5,205,-5,2015,0,1,531,0
Atlanta,22,30,29,41,0,0,0,0,Washington,25,31,19,26,0,0,0,0,20160323,122,101,-3,-4,6,21,21,223,-21,2015,0,2,541,0
Miami,21,26,16,25,0,0,0,0,San Antonio,26,30,32,24,0,0,0,0,20160323,88,112,5,9,25,24,24,200,24,2015,0,2,1147,0
LA Lakers,22,25,27,33,0,0,0,0,Phoenix,16,31,36,36,0,0,0,0,20160323,107,119,-6,0,9,12,12,226,12,2015,0,2,356,0
Sacramento,29,19,24,32,0,0,0,0,Minnesota,28,22,34,29,0,0,0,0,20160323,104,113,-1,2,12,9,9,217,9,2015,0,2,1511,0
Utah,21,13,26,29,0,0,0,0,Houston,25,24,17,21,0,0,0,0,20160323,89,87,-4,-15,-6,2,2,176,-2,2015,0,2,1199,0
Dallas,26,27,20,30,0,0,0,0,Portland,28,29,26,26,0,0,0,0,20160323,103,109,2,4,10,6,6,212,6,2015,0,2,1630,0
Orlando,21,36,30,15,0,0,0,0,Detroit,32,34,30,22,0,0,0,0,20160323,102,118,11,9,9,16,16,220,16,2015,0,2,957,0
Philadelphia,35,10,28,30,0,0,0,0,Denver,24,29,22,29,0,0,0,0,20160323,103,104,-11,8,2,1,1,207,1,2015,0,2,1574,0
Milwaukee,25,36,26,17,0,0,0,0,Cleveland,35,28,28,22,0,0,0,0,20160323,104,113,10,2,4,9,9,217,9,2015,0,2,334,0
New York,23,34,35,23,0,0,0,0,Chicago,30,25,18,34,0,0,0,0,20160323,115,107,-7,2,19,8,8,222,-8,2015,0,2,711,0
Toronto,25,21,16,17,0,0,0,0,Boston,25,21,23,22,0,0,0,0,20160323,79,91,0,0,7,12,12,170,12,2015,0,2,430,0
LA Clippers,28,21,23,26,0,0,0,0,Golden State,23,28,30,33,0,0,0,0,20160323,98,114,-5,2,9,16,16,212,16,2015,0,2,347,0
Cleveland,23,26,34,12,0,0,0,0,Brooklyn,26,33,21,24,0,0,0,0,20160324,95,104,3,10,-3,9,9,199,9,2015,0,3,403,0
New Orleans,22,17,22,23,0,0,0,0,Indiana,24,25,21,22,0,0,0,0,20160324,84,92,2,10,9,8,8,176,8,2015,0,3,713,0
Portland,21,18,26,29,0,0,0,0,LA Clippers,18,28,19,31,0,0,0,0,20160324,94,96,-3,7,0,2,2,190,2,2015,0,3,826,0
Chicago,27,18,20,29,0,0,0,0,New York,31,22,27,26,0,0,0,0,20160324,94,106,4,8,15,12,12,200,12,2015,0,3,711,0
Utah,23,16,21,31,0,0,0,0,Oklahoma City,26,24,31,32,0,0,0,0,20160324,91,113,3,11,21,22,22,204,22,2015,0,3,861,0
Phoenix,27,21,19,27,0,0,0,0,Sacramento,25,33,31,27,0,0,0,0,20160325,94,116,-2,10,22,22,22,210,22,2015,0,4,634,0
Minnesota,27,35,23,24,12,11,0,0,Washington,29,33,27,20,12,8,0,0,20160325,132,129,-2,0,-4,0,3,261,-3,2015,2,4,931,0
Memphis,23,28,33,20,0,0,0,0,San Antonio,37,27,24,22,0,0,0,0,20160325,104,110,14,13,4,6,6,214,6,2015,0,4,631,0
Orlando,31,26,12,28,0,0,0,0,Miami,28,26,31,23,0,0,0,0,20160325,97,108,-3,-3,16,11,11,205,11,2015,0,4,204,0
Denver,24,34,25,33,0,0,0,0,LA Lakers,31,15,31,28,0,0,0,0,20160325,116,105,-7,12,6,11,11,221,-11,2015,0,4,830,0
Toronto,21,37,20,31,0,0,0,0,Houston,29,25,25,33,0,0,0,0,20160325,109,112,8,-4,1,3,3,221,3,2015,0,4,1299,0
Dallas,33,25,31,31,0,0,0,0,Golden State,40,32,30,26,0,0,0,0,20160325,120,128,7,14,13,8,8,248,8,2015,0,4,1480,0
Charlotte,24,32,20,29,0,0,0,0,Detroit,36,36,26,14,0,0,0,0,20160325,105,112,12,16,22,7,7,217,7,2015,0,4,504,0
Milwaukee,21,25,25,19,0,0,0,0,Atlanta,29,22,24,26,0,0,0,0,20160325,90,101,8,5,4,11,11,191,11,2015,0,4,669,0
Philadelphia,27,22,25,31,0,0,0,0,Portland,31,26,29,22,0,0,0,0,20160326,105,108,4,8,12,3,3,213,3,2015,0,5,2405,0
Boston,35,23,23,21,0,0,0,0,Phoenix,22,19,34,24,0,0,0,0,20160326,102,99,13,17,6,3,3,201,-3,2015,0,5,2295,0
San Antonio,26,18,19,29,0,0,0,0,Oklahoma City,24,24,35,28,0,0,0,0,20160326,92,111,-2,4,20,19,19,203,19,2015,0,5,421,0
Cleveland,32,24,33,18,0,0,0,0,New York,15,17,40,21,0,0,0,0,20160326,107,93,17,24,17,14,14,200,-14,2015,0,5,403,0
Chicago,22,28,21,18,0,0,0,0,Orlando,36,32,21,22,0,0,0,0,20160326,89,111,14,18,18,22,22,200,22,2015,0,5,984,0
Utah,18,17,25,33,0,0,0,0,Minnesota,10,24,25,25,0,0,0,0,20160326,93,84,8,1,1,9,9,177,-9,2015,0,5,984,0
Charlotte,29,26,35,25,0,0,0,0,Milwaukee,17,21,26,27,0,0,0,0,20160326,115,91,12,17,26,24,24,206,-24,2015,0,5,658,0
Atlanta,27,29,27,29,0,0,0,0,Detroit,15,27,32,21,0,0,0,0,20160326,112,95,12,14,9,17,17,207,-17,2015,0,5,597,0
Indiana,29,37,27,17,0,0,0,0,Brooklyn,26,34,25,35,0,0,0,0,20160326,110,120,-3,-6,-8,10,10,230,10,2015,0,5,643,0
Toronto,20,28,37,30,0,0,0,0,New Orleans,15,21,25,30,0,0,0,0,20160326,115,91,5,12,24,24,24,206,-24,2015,0,5,1112,0
Philadelphia,31,24,24,26,0,0,0,0,Golden State,32,39,25,21,0,0,0,0,20160327,105,117,1,16,17,12,12,222,12,2015,0,6,2516,0
Houston,24,23,32,22,0,0,0,0,Indiana,30,27,24,23,0,0,0,0,20160327,101,104,6,10,2,3,3,205,3,2015,0,6,865,0
Denver,26,22,12,30,0,0,0,0,LA Clippers,31,21,25,28,0,0,0,0,20160327,90,105,5,4,17,15,15,195,15,2015,0,6,830,0
Washington,24,26,27,24,0,0,0,0,LA Lakers,27,17,15,29,0,0,0,0,20160327,101,88,-3,6,18,13,13,189,-13,2015,0,6,2294,0
Dallas,20,26,33,32,0,0,0,0,Sacramento,25,38,39,31,0,0,0,0,20160327,111,133,5,17,23,22,22,244,22,2015,0,6,1437,0
New York,28,26,10,27,0,0,0,0,New Orleans,24,25,19,31,0,0,0,0,20160328,91,99,-4,-5,4,8,8,190,8,2015,0,0,1168,0
Oklahoma City,27,34,36,22,0,0,0,0,Toronto,21,27,26,26,0,0,0,0,20160328,119,100,6,13,23,19,19,219,-19,2015,0,0,1114,0
Sacramento,32,20,11,30,0,0,0,0,Portland,37,31,23,14,0,0,0,0,20160328,93,105,5,16,28,12,12,198,12,2015,0,0,483,0
Phoenix,37,24,23,32,0,0,0,0,Minnesota,40,26,33,22,0,0,0,0,20160328,116,121,3,5,15,5,5,237,5,2015,0,0,1278,0
LA Lakers,16,21,21,17,0,0,0,0,Utah,34,30,34,25,0,0,0,0,20160328,75,123,18,27,40,48,48,198,48,2015,0,0,579,0
San Antonio,32,21,28,20,0,0,0,0,Memphis,18,27,23,19,0,0,0,0,20160328,101,87,14,8,13,14,14,188,-14,2015,0,0,631,0
Boston,24,26,20,20,0,0,0,0,LA Clippers,30,37,25,22,0,0,0,0,20160328,90,114,6,17,22,24,24,204,24,2015,0,0,2590,0
Dallas,28,22,22,25,0,0,0,0,Denver,24,22,20,22,0,0,0,0,20160328,97,88,4,4,6,9,9,185,-9,2015,0,0,661,0
Atlanta,22,30,28,22,0,0,0,0,Chicago,31,14,26,29,0,0,0,0,20160328,102,100,-9,7,9,2,2,202,-2,2015,0,0,587,0
Brooklyn,27,25,23,24,0,0,0,0,Miami,27,30,25,28,0,0,0,0,20160328,99,110,0,5,7,11,11,209,11,2015,0,0,1091,0
Houston,26,14,31,35,0,0,0,0,Cleveland,24,35,25,16,0,0,0,0,20160329,106,100,2,-19,-13,6,6,206,-6,2015,0,1,1113,0
Oklahoma City,21,27,9,25,0,0,0,0,Detroit,25,21,25,17,0,0,0,0,20160329,82,88,4,-2,14,6,6,170,6,2015,0,1,909,0
Washington,22,24,26,22,0,0,0,0,Golden State,27,22,30,23,0,0,0,0,20160329,94,102,5,3,7,8,8,196,8,2015,0,1,2435,0
Chicago,28,32,24,14,0,0,0,0,Indiana,27,31,26,12,0,0,0,0,20160329,98,96,1,2,0,2,2,194,-2,2015,0,1,163,0
Brooklyn,23,22,28,32,0,0,0,0,Orlando,32,41,30,36,0,0,0,0,20160329,105,139,9,28,30,34,34,244,34,2015,0,1,939,0
Charlotte,23,29,25,23,0,0,0,0,Philadelphia,19,17,26,23,0,0,0,0,20160329,100,85,4,16,15,15,15,185,-15,2015,0,1,450,0
Golden State,26,16,21,26,14,0,0,0,Utah,21,19,29,20,7,0,0,0,20160330,103,96,5,2,-6,0,7,199,-7,2015,1,2,599,0
Atlanta,20,21,26,30,0,0,0,0,Toronto,25,29,35,16,0,0,0,0,20160330,97,105,5,13,22,8,8,202,8,2015,0,2,733,0
New Orleans,26,13,16,37,0,0,0,0,San Antonio,27,19,27,27,0,0,0,0,20160330,92,100,1,7,18,8,8,192,8,2015,0,2,506,0
Washington,34,21,28,28,0,0,0,0,Sacramento,32,28,29,31,0,0,0,0,20160330,111,120,-2,5,6,9,9,231,9,2015,0,2,2371,0
LA Clippers,27,20,32,20,0,0,0,0,Minnesota,17,17,19,26,0,0,0,0,20160330,99,79,10,13,26,20,20,178,-20,2015,0,2,1521,0
Phoenix,32,15,28,19,0,0,0,0,Milwaukee,28,25,27,25,0,0,0,0,20160330,94,105,-4,6,5,11,11,199,11,2015,0,2,1462,0
Denver,26,33,25,25,0,0,0,0,Memphis,20,27,21,37,0,0,0,0,20160330,109,105,6,12,16,4,4,214,-4,2015,0,2,877,0
Miami,27,21,19,20,13,0,0,0,LA Lakers,25,16,26,20,15,0,0,0,20160330,100,102,-2,-7,0,0,2,202,2,2015,1,2,2335,0
New York,30,18,26,15,0,0,0,0,Dallas,24,27,16,24,0,0,0,0,20160330,89,91,-6,3,-7,2,2,180,2,2015,0,2,1370,0
Brooklyn,22,17,24,24,0,0,0,0,Cleveland,29,34,26,18,0,0,0,0,20160331,87,107,7,24,26,20,20,194,20,2015,0,3,403,0
Chicago,24,28,19,32,0,0,0,0,Houston,24,28,28,20,0,0,0,0,20160331,103,100,0,0,-9,3,3,203,-3,2015,0,3,939,0
Orlando,33,24,32,25,0,0,0,0,Indiana,28,23,28,15,0,0,0,0,20160331,114,94,5,6,10,20,20,208,-20,2015,0,3,822,0
Denver,26,28,24,17,0,0,0,0,New Orleans,31,25,21,24,0,0,0,0,20160331,95,101,5,2,-1,6,6,196,6,2015,0,3,1079,0
LA Clippers,30,39,28,20,0,0,0,0,Oklahoma City,37,28,28,26,0,0,0,0,20160331,117,119,7,-4,-4,2,2,236,2,2015,0,3,1178,0
Boston,31,27,25,26,0,0,0,0,Portland,30,24,27,35,0,0,0,0,20160331,109,116,-1,-4,-2,7,7,225,7,2015,0,3,2532,0
Miami,39,27,26,20,0,0,0,0,Sacramento,24,24,28,30,0,0,0,0,20160401,112,106,15,18,16,6,6,218,-6,2015,0,4,2547,0
Washington,25,25,27,29,0,0,0,0,Phoenix,26,26,27,20,0,0,0,0,20160401,106,99,-1,-2,-2,7,7,205,-7,2015,0,4,1977,0
Minnesota,24,25,19,17,0,0,0,0,Utah,25,26,26,21,0,0,0,0,20160401,85,98,1,2,9,13,13,183,13,2015,0,4,984,0
Brooklyn,17,29,24,21,0,0,0,0,New York,18,29,30,28,0,0,0,0,20160401,91,105,1,1,7,14,14,196,14,2015,0,4,0,0
Orlando,22,35,28,25,0,0,0,0,Milwaukee,31,27,26,29,0,0,0,0,20160401,110,113,9,1,-1,3,3,223,3,2015,0,4,1065,0
Dallas,25,26,20,27,0,0,0,0,Detroit,25,11,25,28,0,0,0,0,20160401,98,89,0,15,10,9,9,187,-9,2015,0,4,999,0
Boston,21,24,37,27,0,0,0,0,Golden State,23,20,36,27,0,0,0,0,20160401,109,106,-2,2,3,3,3,215,-3,2015,0,4,2692,0
Philadelphia,25,25,16,25,0,0,0,0,Charlotte,25,34,22,19,0,0,0,0,20160401,91,100,0,9,15,9,9,191,9,2015,0,4,450,0
Cleveland,32,23,22,19,14,0,0,0,Atlanta,23,18,30,25,12,0,0,0,20160401,110,108,9,14,6,0,2,218,-2,2015,1,4,555,0
Toronto,27,18,29,25,0,0,0,0,Memphis,23,30,19,23,0,0,0,0,20160401,99,95,4,-8,2,4,4,194,-4,2015,0,4,815,0
Detroit,26,20,24,24,0,0,0,0,Chicago,27,18,20,25,0,0,0,0,20160402,94,90,-1,1,5,4,4,184,-4,2015,0,5,238,0
Sacramento,23,32,29,31,0,0,0,0,Denver,27,35,26,18,0,0,0,0,20160402,115,106,-4,-7,-4,9,9,221,-9,2015,0,5,886,0
Indiana,28,33,13,41,0,0,0,0,Philadelphia,28,21,28,25,0,0,0,0,20160402,115,102,0,12,-3,13,13,217,-13,2015,0,5,582,0
Miami,22,20,25,26,0,0,0,0,Portland,20,39,28,23,0,0,0,0,20160402,93,110,-2,17,20,17,17,203,17,2015,0,5,2704,0
Toronto,18,28,20,29,0,0,0,0,San Antonio,26,29,16,31,0,0,0,0,20160402,95,102,8,9,5,7,7,197,7,2015,0,5,1438,0
Utah,16,30,28,27,0,0,0,0,Phoenix,23,10,31,22,0,0,0,0,20160403,101,86,-7,13,10,15,15,187,-15,2015,0,6,505,0
Memphis,30,26,29,22,0,0,0,0,Orlando,29,38,30,22,0,0,0,0,20160403,107,119,-1,11,12,12,12,226,12,2015,0,6,683,0
Indiana,18,36,20,18,0,0,0,0,New York,23,18,24,22,0,0,0,0,20160403,92,87,-5,13,9,5,5,179,-5,2015,0,6,643,0
Dallas,22,19,27,20,0,0,0,0,Minnesota,27,13,23,15,0,0,0,0,20160403,88,78,-5,1,5,10,10,166,-10,2015,0,6,863,0
Chicago,24,33,22,23,0,0,0,0,Milwaukee,24,17,32,25,0,0,0,0,20160403,102,98,0,16,6,4,4,200,-4,2015,0,6,83,0
Oklahoma City,26,27,29,28,0,0,0,0,Houston,31,21,28,38,0,0,0,0,20160403,110,118,5,-1,-2,8,8,228,8,2015,0,6,413,0
Washington,23,26,24,36,0,0,0,0,LA Clippers,33,27,24,30,0,0,0,0,20160403,109,114,10,11,11,5,5,223,5,2015,0,6,2294,0
Portland,37,19,33,22,0,0,0,0,Golden State,31,32,38,35,0,0,0,0,20160403,111,136,-6,7,12,25,25,247,25,2015,0,6,535,0
Charlotte,19,23,29,32,0,0,0,0,Cleveland,29,29,28,26,0,0,0,0,20160403,103,112,10,16,15,9,9,215,9,2015,0,6,435,0
New Orleans,18,35,22,31,0,0,0,0,Brooklyn,14,28,24,21,0,0,0,0,20160403,106,87,4,11,9,19,19,193,-19,2015,0,6,1168,0
Boston,31,26,20,30,0,0,0,0,LA Lakers,26,22,27,25,0,0,0,0,20160403,107,100,5,9,2,7,7,207,-7,2015,0,6,2590,0
Cleveland,33,34,26,16,0,0,0,0,Milwaukee,19,24,24,13,0,0,0,0,20160405,109,80,14,24,26,29,29,189,-29,2015,0,1,334,0
San Antonio,25,17,25,21,0,0,0,0,Utah,20,17,16,33,0,0,0,0,20160405,88,86,5,5,14,2,2,174,-2,2015,0,1,1087,0
Charlotte,16,26,17,31,0,0,0,0,Toronto,26,30,19,21,0,0,0,0,20160405,90,96,10,14,16,6,6,186,6,2015,0,1,585,0
New Orleans,29,22,22,20,0,0,0,0,Philadelphia,21,36,31,19,0,0,0,0,20160405,93,107,-8,6,15,14,14,200,14,2015,0,1,1088,0
Detroit,19,17,27,26,0,0,0,0,Miami,25,29,28,25,0,0,0,0,20160405,89,107,6,18,19,18,18,196,18,2015,0,1,1155,0
Portland,30,21,33,31,0,0,0,0,Sacramento,33,24,23,27,0,0,0,0,20160405,115,107,-3,-6,4,8,8,222,-8,2015,0,1,483,0
LA Lakers,22,22,16,21,0,0,0,0,LA Clippers,33,19,32,19,0,0,0,0,20160405,81,103,11,8,24,22,22,184,22,2015,0,1,0,0
Minnesota,19,27,32,28,18,0,0,0,Golden State,28,27,31,20,11,0,0,0,20160405,124,117,-9,-9,-8,0,7,241,-7,2015,1,1,1581,0
Chicago,21,23,21,27,0,0,0,0,Memphis,23,31,29,25,0,0,0,0,20160405,92,108,2,10,18,16,16,200,16,2015,0,1,480,0
Oklahoma City,32,36,39,17,0,0,0,0,Denver,30,21,26,25,0,0,0,0,20160405,124,102,2,17,30,22,22,226,-22,2015,0,1,503,0
Phoenix,38,18,17,17,0,0,0,0,Atlanta,28,16,26,33,0,0,0,0,20160405,90,103,-10,-12,-3,13,13,193,13,2015,0,1,1588,0
Brooklyn,23,29,23,28,0,0,0,0,Washington,30,24,34,33,0,0,0,0,20160406,103,121,7,2,13,18,18,224,18,2015,0,2,204,0
Oklahoma City,26,33,24,32,0,0,0,0,Portland,33,39,27,21,0,0,0,0,20160406,115,120,7,13,16,5,5,235,5,2015,0,2,1484,0
Charlotte,30,23,28,30,0,0,0,0,New York,25,27,20,25,0,0,0,0,20160406,111,97,5,1,9,14,14,208,-14,2015,0,2,531,0
Detroit,25,19,29,35,0,0,0,0,Orlando,21,30,26,27,0,0,0,0,20160406,108,104,4,-7,-4,4,4,212,-4,2015,0,2,957,0
Cleveland,33,28,21,27,0,0,0,0,Indiana,36,34,26,27,0,0,0,0,20160406,109,123,3,9,14,14,14,232,14,2015,0,2,262,0
Houston,22,22,27,15,0,0,0,0,Dallas,18,34,18,18,0,0,0,0,20160406,86,88,-4,8,-1,2,2,174,2,2015,0,2,225,0
New Orleans,17,28,28,24,0,0,0,0,Boston,23,30,23,28,0,0,0,0,20160406,97,104,6,8,3,7,7,201,7,2015,0,2,1358,0
LA Clippers,29,25,19,18,0,0,0,0,LA Lakers,25,17,19,20,0,0,0,0,20160406,91,81,4,12,12,10,10,172,-10,2015,0,2,0,0
Toronto,20,23,20,24,0,0,0,0,Atlanta,28,19,23,25,0,0,0,0,20160407,87,95,8,4,7,8,8,182,8,2015,0,3,733,0
San Antonio,15,25,29,32,0,0,0,0,Golden State,20,32,35,25,0,0,0,0,20160407,101,112,5,12,18,11,11,213,11,2015,0,3,1487,0
Phoenix,27,30,32,35,0,0,0,0,Houston,39,21,30,25,0,0,0,0,20160407,124,115,-12,-3,-1,9,9,239,-9,2015,0,3,1014,0
Chicago,22,24,23,29,0,0,0,0,Miami,21,19,35,31,0,0,0,0,20160407,98,106,-1,-6,6,8,8,204,8,2015,0,3,1189,0
Minnesota,31,27,25,22,0,0,0,0,Sacramento,27,24,25,21,0,0,0,0,20160407,105,97,4,7,7,8,8,202,-8,2015,0,3,1511,0
Miami,27,28,25,29,0,0,0,0,Orlando,19,34,26,33,0,0,0,0,20160408,109,112,-8,-2,-1,3,3,221,3,2015,0,4,204,0
LA Clippers,25,22,29,18,8,0,0,0,Utah,26,26,20,22,5,0,0,0,20160408,102,99,-1,-5,4,0,3,201,-3,2015,1,4,579,0
New York,28,21,33,27,0,0,0,0,Philadelphia,24,22,28,28,0,0,0,0,20160408,109,102,4,3,8,7,7,211,-7,2015,0,4,80,0
LA Lakers,27,19,21,35,0,0,0,0,New Orleans,24,33,30,23,0,0,0,0,20160408,102,110,-3,11,20,8,8,212,8,2015,0,4,1669,0
Indiana,15,31,20,32,0,0,0,0,Toronto,20,30,32,29,0,0,0,0,20160408,98,111,5,4,16,13,13,209,13,2015,0,4,438,0
San Antonio,18,35,19,26,0,0,0,0,Denver,24,27,26,25,0,0,0,0,20160408,98,102,6,-2,5,4,4,200,4,2015,0,4,802,0
Memphis,21,28,19,25,0,0,0,0,Dallas,18,28,28,29,0,0,0,0,20160408,93,103,-3,-3,6,10,10,196,10,2015,0,4,419,0
Brooklyn,25,18,21,35,0,0,0,0,Charlotte,25,25,34,29,0,0,0,0,20160408,99,113,0,7,20,14,14,212,14,2015,0,4,531,0
Milwaukee,35,23,22,29,0,0,0,0,Boston,30,35,36,23,0,0,0,0,20160408,109,124,-5,7,21,15,15,233,15,2015,0,4,855,0
Washington,25,30,29,15,0,0,0,0,Detroit,39,23,24,26,0,0,0,0,20160408,99,112,14,7,2,13,13,211,13,2015,0,4,394,0
Boston,32,39,20,16,0,0,0,0,Atlanta,34,33,26,25,0,0,0,0,20160409,107,118,2,-4,2,11,11,225,11,2015,0,5,935,0
Cleveland,31,23,28,20,0,0,0,0,Chicago,27,25,27,26,0,0,0,0,20160409,102,105,-4,-2,-3,3,3,207,3,2015,0,5,308,0
Golden State,31,22,17,30,0,0,0,0,Memphis,28,22,28,21,0,0,0,0,20160409,100,99,3,3,-8,1,1,199,-1,2015,0,5,1798,0
Phoenix,32,23,30,36,0,0,0,0,New Orleans,22,25,20,33,0,0,0,0,20160409,121,100,10,8,18,21,21,221,-21,2015,0,5,1312,0
Minnesota,21,32,22,31,0,0,0,0,Portland,28,21,23,33,0,0,0,0,20160409,106,105,-7,4,3,1,1,211,-1,2015,0,5,1423,0
Oklahoma City,30,22,32,28,0,0,0,0,Sacramento,22,34,27,31,0,0,0,0,20160409,112,114,-8,4,-1,2,2,226,2,2015,0,5,1336,0
Charlotte,27,21,26,24,0,0,0,0,Washington,28,27,31,27,0,0,0,0,20160410,98,113,1,7,12,15,15,211,15,2015,0,6,329,0
Golden State,14,21,27,30,0,0,0,0,San Antonio,19,16,26,25,0,0,0,0,20160410,92,86,-5,0,1,6,6,178,-6,2015,0,6,1487,0
Milwaukee,29,33,14,22,11,0,0,0,Philadelphia,23,22,25,28,10,0,0,0,20160410,109,108,6,17,6,0,1,217,-1,2015,1,6,692,0
Toronto,20,34,21,18,0,0,0,0,New York,25,26,18,20,0,0,0,0,20160410,93,89,-5,3,6,4,4,182,-4,2015,0,6,341,0
Orlando,28,21,20,27,0,0,0,0,Miami,31,25,33,29,0,0,0,0,20160410,96,118,3,7,20,22,22,214,22,2015,0,6,204,0
Brooklyn,19,22,31,33,0,0,0,0,Indiana,39,30,35,25,0,0,0,0,20160410,105,129,20,28,32,24,24,234,24,2015,0,6,643,0
LA Lakers,27,26,27,30,0,0,0,0,Houston,29,26,33,42,0,0,0,0,20160410,110,130,2,2,8,20,20,240,20,2015,0,6,1371,0
Utah,26,22,34,18,0,0,0,0,Denver,22,25,15,22,0,0,0,0,20160410,100,84,4,1,20,16,16,184,-16,2015,0,6,370,0
Dallas,21,26,12,32,0,0,0,0,LA Clippers,23,26,27,22,0,0,0,0,20160410,91,98,2,2,17,7,7,189,7,2015,0,6,1237,0
Charlotte,24,39,31,20,0,0,0,0,Boston,28,13,31,28,0,0,0,0,20160411,114,100,-4,22,22,14,14,214,-14,2015,0,0,720,0
Washington,34,36,30,20,0,0,0,0,Brooklyn,28,41,29,13,0,0,0,0,20160411,120,111,6,1,2,9,9,231,-9,2015,0,0,204,0
Atlanta,26,19,30,19,0,0,0,0,Cleveland,22,29,39,19,0,0,0,0,20160411,94,109,-4,6,15,15,15,203,15,2015,0,0,555,0
Houston,38,30,35,26,0,0,0,0,Minnesota,21,26,27,31,0,0,0,0,20160411,129,105,17,21,29,24,24,234,-24,2015,0,0,1057,0
Chicago,27,26,36,32,0,0,0,0,New Orleans,29,33,26,28,0,0,0,0,20160411,121,116,-2,-9,1,5,5,237,-5,2015,0,0,832,0
LA Lakers,21,27,13,18,0,0,0,0,Oklahoma City,27,31,31,23,0,0,0,0,20160411,79,112,6,10,28,33,33,191,33,2015,0,0,1178,0
Milwaukee,22,22,29,25,0,0,0,0,Orlando,32,26,27,22,0,0,0,0,20160411,98,107,10,14,12,9,9,205,9,2015,0,0,1065,0
Sacramento,26,30,31,18,0,0,0,0,Phoenix,22,27,23,29,0,0,0,0,20160411,105,101,4,7,15,4,4,206,-4,2015,0,0,634,0
Dallas,22,28,21,30,0,0,0,0,Utah,20,26,18,28,0,0,0,0,20160411,101,92,2,4,7,9,9,193,-9,2015,0,0,998,0
Philadelphia,23,38,13,24,0,0,0,0,Toronto,32,23,32,35,0,0,0,0,20160412,98,122,9,-6,13,24,24,220,24,2015,0,1,334,0
Memphis,22,21,21,20,0,0,0,0,LA Clippers,29,32,23,26,0,0,0,0,20160412,84,110,7,18,20,26,26,194,26,2015,0,1,1599,0
Oklahoma City,32,21,19,21,5,0,0,0,San Antonio,21,22,31,19,9,0,0,0,20160412,98,102,-11,-10,2,0,4,200,4,2015,1,1,421,0
Miami,19,31,21,28,0,0,0,0,Detroit,17,33,19,24,0,0,0,0,20160412,99,93,2,0,2,6,6,192,-6,2015,0,1,1155,0
New York,36,18,16,20,0,0,0,0,Indiana,29,24,26,23,0,0,0,0,20160412,90,102,-7,-1,9,12,12,192,12,2015,0,1,643,0
Miami,35,27,5,21,0,0,0,0,Boston,13,25,25,35,0,0,0,0,20160413,88,98,-22,-24,-4,10,10,186,10,2015,0,2,1257,0
Atlanta,33,26,17,22,0,0,0,0,Washington,33,24,27,25,0,0,0,0,20160413,98,109,0,-2,8,11,11,207,11,2015,0,2,541,0
New Orleans,23,27,29,30,0,0,0,0,Minnesota,40,32,34,38,0,0,0,0,20160413,109,144,17,22,27,35,35,253,35,2015,0,2,1052,0
Indiana,37,25,16,19,0,0,0,0,Milwaukee,20,26,24,22,0,0,0,0,20160413,97,92,17,16,8,5,5,189,-5,2015,0,2,243,0
Utah,21,36,18,21,0,0,0,0,LA Lakers,19,23,24,35,0,0,0,0,20160413,96,101,-2,-15,-9,5,5,197,5,2015,0,2,579,0
Sacramento,18,26,20,17,0,0,0,0,Houston,34,30,28,24,0,0,0,0,20160413,81,116,16,20,28,35,35,197,35,2015,0,2,1606,0
Denver,31,25,23,20,0,0,0,0,Portland,27,31,29,20,0,0,0,0,20160413,99,107,-4,2,8,8,8,206,8,2015,0,2,981,0
San Antonio,20,14,31,31,0,0,0,0,Dallas,27,25,15,24,0,0,0,0,20160413,96,91,-7,-18,-2,5,5,187,-5,2015,0,2,252,0
Memphis,23,27,31,23,0,0,0,0,Golden State,37,33,32,23,0,0,0,0,20160413,104,125,14,20,21,21,21,229,21,2015,0,2,1798,0
Toronto,16,33,29,25,0,0,0,0,Brooklyn,26,21,19,30,0,0,0,0,20160413,103,96,-10,2,12,7,7,199,-7,2015,0,2,341,0
LA Clippers,27,28,20,30,0,0,0,0,Phoenix,25,37,23,29,0,0,0,0,20160413,105,114,-2,7,10,9,9,219,9,2015,0,2,356,0
Orlando,22,28,29,24,0,0,0,0,Charlotte,38,28,20,31,0,0,0,0,20160413,103,117,16,16,7,14,14,220,14,2015,0,2,463,0
Detroit,29,29,24,21,9,0,0,0,Cleveland,24,20,28,31,7,0,0,0,20160413,112,110,5,14,10,0,2,222,-2,2015,1,2,90,0
Philadelphia,32,28,13,32,0,0,0,0,Chicago,16,35,35,29,0,0,0,0,20160413,105,115,-16,-9,13,10,10,220,10,2015,0,2,664,0
Boston,19,15,31,36,0,0,0,0,Atlanta,30,21,21,30,0,0,0,0,20160416,101,102,11,17,7,1,1,203,1,2015,0,5,935,1
Houston,15,18,27,18,0,0,0,0,Golden State,33,27,22,22,0,0,0,0,20160416,78,104,18,27,22,26,26,182,26,2015,0,5,1642,1
Indiana,19,24,27,30,0,0,0,0,Toronto,24,21,22,23,0,0,0,0,20160416,100,90,-5,-2,3,10,10,190,-10,2015,0,5,438,1
Dallas,11,22,18,19,0,0,0,0,Oklahoma City,26,33,34,15,0,0,0,0,20160416,70,108,15,26,42,38,38,178,38,2015,0,5,189,1
Detroit,25,33,20,23,0,0,0,0,Cleveland,27,26,23,30,0,0,0,0,20160417,101,106,2,-5,-2,5,5,207,5,2015,0,6,90,1
Portland,21,21,24,29,0,0,0,0,LA Clippers,26,24,31,34,0,0,0,0,20160417,95,115,5,8,15,20,20,210,20,2015,0,6,826,1
Charlotte,22,28,24,17,0,0,0,0,Miami,41,26,30,26,0,0,0,0,20160417,91,123,19,17,23,32,32,214,32,2015,0,6,654,1
Memphis,13,24,14,23,0,0,0,0,San Antonio,22,26,33,25,0,0,0,0,20160417,74,106,9,11,30,32,32,180,32,2015,0,6,631,1
Indiana,16,32,18,21,0,0,0,0,Toronto,27,26,21,24,0,0,0,0,20160418,87,98,11,5,8,11,11,185,11,2015,0,0,438,1
Houston,30,28,21,27,0,0,0,0,Golden State,33,33,20,29,0,0,0,0,20160418,106,115,3,8,7,9,9,221,9,2015,0,0,1642,1
Dallas,24,21,14,26,0,0,0,0,Oklahoma City,20,23,19,22,0,0,0,0,20160418,85,84,4,2,-3,1,1,169,-1,2015,0,0,189,1
Memphis,11,24,18,15,0,0,0,0,San Antonio,22,27,21,24,0,0,0,0,20160419,68,94,11,14,17,26,26,162,26,2015,0,1,631,1
Boston,7,21,18,26,0,0,0,0,Atlanta,24,19,18,28,0,0,0,0,20160419,72,89,17,15,15,17,17,161,17,2015,0,1,935,1
Detroit,28,25,15,22,0,0,0,0,Cleveland,23,32,27,25,0,0,0,0,20160420,90,107,-5,2,14,17,17,197,17,2015,0,2,90,1
Portland,17,26,18,20,0,0,0,0,LA Clippers,22,25,20,35,0,0,0,0,20160420,81,102,5,4,6,21,21,183,21,2015,0,2,826,1
Charlotte,29,31,18,25,0,0,0,0,Miami,29,43,19,24,0,0,0,0,20160420,103,115,0,12,13,12,12,218,12,2015,0,2,654,1
Oklahoma City,27,31,39,34,0,0,0,0,Dallas,21,27,30,24,0,0,0,0,20160421,131,102,6,10,19,29,29,233,-29,2015,0,3,189,1
Golden State,18,30,24,24,0,0,0,0,Houston,31,24,23,19,0,0,0,0,20160421,96,97,13,7,6,1,1,193,1,2015,0,3,1642,1
Toronto,24,29,18,30,0,0,0,0,Indiana,17,19,23,26,0,0,0,0,20160421,101,85,7,17,12,16,16,186,-16,2015,0,3,438,1
Atlanta,20,25,33,25,0,0,0,0,Boston,37,20,22,32,0,0,0,0,20160422,103,111,17,12,1,8,8,214,8,2015,0,4,935,1
Cleveland,24,30,25,22,0,0,0,0,Detroit,27,26,20,18,0,0,0,0,20160422,101,91,-3,1,6,10,10,192,-10,2015,0,4,90,1
San Antonio,26,18,26,26,0,0,0,0,Memphis,18,25,28,16,0,0,0,0,20160422,96,87,8,1,-1,9,9,183,-9,2015,0,4,631,1
Miami,28,16,14,22,0,0,0,0,Charlotte,29,20,26,21,0,0,0,0,20160423,80,96,1,5,17,16,16,176,16,2015,0,5,654,1
Oklahoma City,33,24,32,30,0,0,0,0,Dallas,18,30,31,29,0,0,0,0,20160423,119,108,15,9,10,11,11,227,-11,2015,0,5,189,1
Toronto,16,26,16,25,0,0,0,0,Indiana,28,29,16,27,0,0,0,0,20160423,83,100,12,15,15,17,17,183,17,2015,0,5,438,1
LA Clippers,19,21,27,21,0,0,0,0,Portland,22,27,21,26,0,0,0,0,20160423,88,96,3,9,3,8,8,184,8,2015,0,5,826,1
San Antonio,25,22,37,32,0,0,0,0,Memphis,19,26,21,29,0,0,0,0,20160424,116,95,6,2,18,21,21,211,-21,2015,0,6,631,1
Golden State,29,27,41,24,0,0,0,0,Houston,29,27,20,18,0,0,0,0,20160424,121,94,0,0,21,27,27,215,-27,2015,0,6,1642,1
Atlanta,21,27,25,19,3,0,0,0,Boston,24,22,24,22,12,0,0,0,20160424,95,104,3,-2,-3,0,9,199,9,2015,1,6,935,1
Cleveland,25,28,28,19,0,0,0,0,Detroit,28,24,26,20,0,0,0,0,20160424,100,98,-3,1,3,2,2,198,-2,2015,0,6,90,1
Miami,26,13,22,24,0,0,0,0,Charlotte,19,29,21,20,0,0,0,0,20160425,85,89,-7,9,8,4,4,174,4,2015,0,0,654,1
Dallas,24,37,22,21,0,0,0,0,Oklahoma City,35,33,25,25,0,0,0,0,20160425,104,118,11,7,10,14,14,222,14,2015,0,0,189,1
LA Clippers,20,23,21,20,0,0,0,0,Portland,24,23,19,32,0,0,0,0,20160425,84,98,4,4,2,14,14,182,14,2015,0,0,826,1
Boston,20,19,23,21,0,0,0,0,Atlanta,15,32,42,21,0,0,0,0,20160426,83,110,-5,8,27,27,27,193,27,2015,0,1,935,1
Indiana,35,26,29,9,0,0,0,0,Toronto,20,32,25,25,0,0,0,0,20160426,99,102,-15,-9,-13,3,3,201,3,2015,0,1,438,1
Houston,20,17,22,22,0,0,0,0,Golden State,37,22,30,25,0,0,0,0,20160427,81,114,17,22,30,33,33,195,33,2015,0,2,1642,1
Portland,18,27,26,37,0,0,0,0,LA Clippers,18,32,21,27,0,0,0,0,20160427,108,98,0,-5,0,10,10,206,-10,2015,0,2,826,1
Charlotte,28,21,16,25,0,0,0,0,Miami,25,22,24,17,0,0,0,0,20160427,90,88,3,2,-6,2,2,178,-2,2015,0,2,654,1
Atlanta,20,21,39,24,0,0,0,0,Boston,17,16,26,33,0,0,0,0,20160428,104,92,3,8,21,12,12,196,-12,2015,0,3,935,1
LA Clippers,24,24,34,21,0,0,0,0,Portland,24,26,30,26,0,0,0,0,20160429,103,106,0,2,-2,3,3,209,3,2015,0,4,826,1
Miami,27,32,16,22,0,0,0,0,Charlotte,24,26,20,20,0,0,0,0,20160429,97,90,3,9,5,7,7,187,-7,2015,0,4,654,1
Toronto,22,22,20,19,0,0,0,0,Indiana,20,20,31,30,0,0,0,0,20160429,83,101,-2,-4,7,18,18,184,18,2015,0,4,438,1
Oklahoma City,20,20,26,26,0,0,0,0,San Antonio,43,30,32,19,0,0,0,0,20160430,92,124,23,33,39,32,32,216,32,2015,0,5,421,1
Portland,17,34,22,33,0,0,0,0,Golden State,37,28,28,25,0,0,0,0,20160501,106,118,20,14,20,12,12,224,12,2015,0,6,535,1
Charlotte,18,24,11,20,0,0,0,0,Miami,29,25,29,23,0,0,0,0,20160501,73,106,11,12,30,33,33,179,33,2015,0,6,654,1
Indiana,23,21,20,20,0,0,0,0,Toronto,28,22,28,11,0,0,0,0,20160501,84,89,5,6,14,5,5,173,5,2015,0,6,438,1
Atlanta,19,22,29,23,0,0,0,0,Cleveland,30,21,23,30,0,0,0,0,20160502,93,104,11,10,4,11,11,197,11,2015,0,0,555,1
Oklahoma City,29,27,21,21,0,0,0,0,San Antonio,21,32,23,21,0,0,0,0,20160502,98,97,8,3,1,1,1,195,-1,2015,0,0,421,1
Portland,34,25,28,12,0,0,0,0,Golden State,21,30,25,34,0,0,0,0,20160503,99,110,-13,-8,-11,11,11,209,11,2015,0,1,535,1
Miami,18,23,27,22,12,0,0,0,Toronto,18,25,20,27,6,0,0,0,20160503,102,96,0,-2,5,0,6,198,-6,2015,1,1,1234,1
Atlanta,20,18,32,28,0,0,0,0,Cleveland,35,39,32,17,0,0,0,0,20160504,98,123,15,36,36,25,25,221,25,2015,0,2,555,1
Miami,19,22,24,21,6,0,0,0,Toronto,29,19,15,23,10,0,0,0,20160505,92,96,10,7,-2,0,4,188,4,2015,1,3,1234,1
San Antonio,27,20,25,28,0,0,0,0,Oklahoma City,20,22,27,27,0,0,0,0,20160506,100,96,7,5,3,4,4,196,-4,2015,0,4,421,1
Cleveland,31,24,30,36,0,0,0,0,Atlanta,28,35,28,17,0,0,0,0,20160506,121,108,3,-8,-6,13,13,229,-13,2015,0,4,555,1
Toronto,23,26,19,27,0,0,0,0,Miami,19,21,28,23,0,0,0,0,20160507,95,91,4,9,0,4,4,186,-4,2015,0,5,1234,1
Golden State,28,18,34,28,0,0,0,0,Portland,22,36,35,27,0,0,0,0,20160507,108,120,-6,12,13,12,12,228,12,2015,0,5,535,1
Cleveland,27,29,25,19,0,0,0,0,Atlanta,36,22,19,22,0,0,0,0,20160508,100,99,-9,-2,4,1,1,199,-1,2015,0,6,555,1
San Antonio,27,26,28,16,0,0,0,0,Oklahoma City,17,28,32,34,0,0,0,0,20160508,97,111,-10,-8,-4,14,14,208,14,2015,0,6,421,1
Toronto,21,14,27,21,4,0,0,0,Miami,25,19,16,23,11,0,0,0,20160509,87,94,4,9,-2,0,7,181,7,2015,1,0,1234,1
Golden State,18,39,29,25,21,0,0,0,Portland,26,41,18,26,14,0,0,0,20160509,132,125,-8,-10,1,0,7,257,-7,2015,1,0,535,1
Oklahoma City,22,21,26,26,0,0,0,0,San Antonio,16,32,24,19,0,0,0,0,20160510,95,91,6,-5,-3,4,4,186,-4,2015,0,1,421,1
Portland,30,33,28,30,0,0,0,0,Golden State,27,31,35,32,0,0,0,0,20160511,121,125,-3,-5,2,4,4,246,4,2015,0,2,535,1
Miami,18,27,17,29,0,0,0,0,Toronto,28,27,20,24,0,0,0,0,20160511,91,99,10,10,13,8,8,190,8,2015,0,2,1234,1
San Antonio,19,12,34,34,0,0,0,0,Oklahoma City,25,30,36,22,0,0,0,0,20160512,99,113,6,24,26,14,14,212,14,2015,0,3,421,1
Toronto,20,24,28,19,0,0,0,0,Miami,21,32,29,21,0,0,0,0,20160513,91,103,1,9,10,12,12,194,12,2015,0,4,1234,1
Miami,24,23,31,11,0,0,0,0,Toronto,25,28,33,30,0,0,0,0,20160515,89,116,1,6,8,27,27,205,27,2015,0,6,1234,1
Oklahoma City,21,26,38,23,0,0,0,0,Golden State,27,33,28,14,0,0,0,0,20160516,108,102,-6,-13,-3,6,6,210,-6,2015,0,0,1386,1
Toronto,28,16,23,17,0,0,0,0,Cleveland,33,33,29,20,0,0,0,0,20160517,84,115,5,22,28,31,31,199,31,2015,0,1,187,1
Oklahoma City,20,29,19,23,0,0,0,0,Golden State,27,30,31,30,0,0,0,0,20160518,91,118,7,8,20,27,27,209,27,2015,0,2,1386,1
Toronto,28,20,21,20,0,0,0,0,Cleveland,30,32,24,22,0,0,0,0,20160519,89,108,2,14,17,19,19,197,19,2015,0,3,187,1
Cleveland,24,23,23,14,0,0,0,0,Toronto,27,33,20,19,0,0,0,0,20160521,84,99,3,13,10,15,15,183,15,2015,0,5,187,1
Golden State,28,19,33,25,0,0,0,0,Oklahoma City,34,38,45,16,0,0,0,0,20160522,105,133,6,25,37,28,28,238,28,2015,0,6,1386,1
Cleveland,24,17,28,30,0,0,0,0,Toronto,27,30,21,27,0,0,0,0,20160523,99,105,3,16,9,6,6,204,6,2015,0,0,187,1
Golden State,26,27,29,12,0,0,0,0,Oklahoma City,30,42,22,24,0,0,0,0,20160524,94,118,4,19,12,24,24,212,24,2015,0,1,1386,1
Toronto,19,15,26,18,0,0,0,0,Cleveland,37,28,35,16,0,0,0,0,20160525,78,116,18,31,40,38,38,194,38,2015,0,2,187,1
Oklahoma City,21,29,27,34,0,0,0,0,Golden State,25,33,23,39,0,0,0,0,20160526,111,120,4,8,4,9,9,231,9,2015,0,3,1386,1
Cleveland,31,24,31,27,0,0,0,0,Toronto,25,16,33,13,0,0,0,0,20160527,113,87,6,14,12,26,26,200,-26,2015,0,4,187,1
Golden State,20,28,27,33,0,0,0,0,Oklahoma City,23,30,30,18,0,0,0,0,20160528,108,101,-3,-5,-8,7,7,209,-7,2015,0,5,1386,1
Oklahoma City,24,24,12,28,0,0,0,0,Golden State,19,23,29,25,0,0,0,0,20160530,88,96,-5,-6,11,8,8,184,8,2015,0,0,1386,1
Cleveland,24,19,25,21,0,0,0,0,Golden State,28,24,22,30,0,0,0,0,20160602,89,104,4,9,6,15,15,193,15,2015,0,3,2161,1
Cleveland,21,23,18,15,0,0,0,0,Golden State,19,33,30,28,0,0,0,0,20160605,77,110,-2,8,20,33,33,187,33,2015,0,6,2161,1
Golden State,16,27,26,21,0,0,0,0,Cleveland,33,18,38,31,0,0,0,0,20160608,90,120,17,8,20,30,30,210,30,2015,0,2,2161,1
Golden State,29,21,29,29,0,0,0,0,Cleveland,28,27,22,20,0,0,0,0,20160610,108,97,1,-5,2,11,11,205,-11,2015,0,4,2161,1
Cleveland,29,32,32,19,0,0,0,0,Golden State,32,29,23,13,0,0,0,0,20160613,112,97,-3,0,9,15,15,209,-15,2015,0,0,2161,1
Golden State,11,32,28,30,0,0,0,0,Cleveland,31,28,21,35,0,0,0,0,20160616,101,115,20,16,9,14,14,216,14,2015,0,3,2161,1
Cleveland,23,19,33,18,0,0,0,0,Golden State,22,27,27,13,0,0,0,0,20160619,93,89,1,-7,-1,4,4,182,-4,2015,0,6,2161,1
New York,18,27,19,24,0,0,0,0,Cleveland,28,20,34,35,0,0,0,0,20161025,88,117,10,3,18,29,29,205,29,2016,0,1,403,0
San Antonio,31,33,33,32,0,0,0,0,Golden State,20,26,31,23,0,0,0,0,20161025,129,100,11,18,20,29,29,229,-29,2016,0,1,1487,0
Utah,26,20,37,21,0,0,0,0,Portland,26,28,23,36,0,0,0,0,20161025,104,113,0,8,-6,9,9,217,9,2016,0,1,634,0
Oklahoma City,23,28,18,34,0,0,0,0,Philadelphia,24,27,24,22,0,0,0,0,20161026,103,97,-1,0,-6,6,6,200,-6,2016,0,2,1256,0
Minnesota,32,27,16,23,0,0,0,0,Memphis,29,21,26,26,0,0,0,0,20161026,98,102,-3,-9,1,4,4,200,4,2016,0,2,700,0
Detroit,23,23,25,20,0,0,0,0,Toronto,33,25,28,23,0,0,0,0,20161026,91,109,10,12,15,18,18,200,18,2016,0,2,205,0
Sacramento,30,27,27,29,0,0,0,0,Phoenix,19,19,29,27,0,0,0,0,20161026,113,94,11,19,17,19,19,207,-19,2016,0,2,634,0
Miami,23,27,30,28,0,0,0,0,Orlando,27,26,16,27,0,0,0,0,20161026,108,96,-4,-3,11,12,12,204,-12,2016,0,2,204,0
Dallas,21,31,33,30,6,0,0,0,Indiana,33,26,35,21,15,0,0,0,20161026,121,130,12,7,9,0,9,251,9,2016,1,2,763,0
Charlotte,32,24,27,24,0,0,0,0,Milwaukee,24,17,25,30,0,0,0,0,20161026,107,96,8,15,17,11,11,203,-11,2016,0,2,658,0
Houston,38,33,25,18,0,0,0,0,LA Lakers,38,25,27,30,0,0,0,0,20161026,114,120,0,-8,-6,6,6,234,6,2016,0,2,1371,0
Denver,30,30,25,22,0,0,0,0,New Orleans,24,24,29,25,0,0,0,0,20161026,107,102,6,12,8,5,5,209,-5,2016,0,2,1079,0
Brooklyn,31,27,23,36,0,0,0,0,Boston,33,31,33,25,0,0,0,0,20161026,117,122,2,6,16,5,5,239,5,2016,0,2,190,0
Washington,27,29,24,19,0,0,0,0,Atlanta,29,28,24,33,0,0,0,0,20161027,99,114,2,1,1,15,15,213,15,2016,0,3,541,0
Boston,20,29,24,26,0,0,0,0,Chicago,30,27,22,26,0,0,0,0,20161027,99,105,10,8,6,6,6,204,6,2016,0,3,849,0
LA Clippers,28,30,24,32,0,0,0,0,Portland,27,22,33,24,0,0,0,0,20161027,114,106,1,9,0,8,8,220,-8,2016,0,3,826,0
San Antonio,27,26,23,26,0,0,0,0,Sacramento,29,28,14,23,0,0,0,0,20161027,102,94,-2,-4,5,8,8,196,-8,2016,0,3,1456,0
LA Lakers,27,16,22,24,0,0,0,0,Utah,28,20,17,31,0,0,0,0,20161028,89,96,1,5,0,7,7,185,7,2016,0,4,579,0
Cleveland,28,22,21,23,0,0,0,0,Toronto,23,17,27,24,0,0,0,0,20161028,94,91,5,10,4,3,3,185,-3,2016,0,4,187,0
Phoenix,40,13,30,19,8,0,0,0,Oklahoma City,25,24,28,25,11,0,0,0,20161028,110,113,-15,-4,-6,0,3,223,3,2016,1,4,840,0
Golden State,32,27,33,30,0,0,0,0,New Orleans,22,28,31,33,0,0,0,0,20161028,122,114,10,9,11,8,8,236,-8,2016,0,4,1921,0
Houston,24,28,25,29,0,0,0,0,Dallas,24,26,17,31,0,0,0,0,20161028,106,98,0,2,10,8,8,204,-8,2016,0,4,225,0
Orlando,22,9,20,31,0,0,0,0,Detroit,24,30,32,22,0,0,0,0,20161028,82,108,2,23,35,26,26,190,26,2016,0,4,957,0
Indiana,27,21,31,15,0,0,0,0,Brooklyn,20,32,20,31,0,0,0,0,20161028,94,103,-7,4,-7,9,9,197,9,2016,0,4,643,0
Charlotte,21,25,27,24,0,0,0,0,Miami,23,34,20,14,0,0,0,0,20161028,97,91,-2,-11,-4,6,6,188,-6,2016,0,4,654,0
Memphis,19,30,28,27,0,0,0,0,New York,32,25,25,29,0,0,0,0,20161029,104,111,13,8,5,7,7,215,7,2016,0,5,953,0
Minnesota,34,31,12,26,0,0,0,0,Sacramento,25,29,31,21,0,0,0,0,20161029,103,106,-9,-11,8,3,3,209,3,2016,0,5,1511,0
New Orleans,23,22,15,19,0,0,0,0,San Antonio,28,27,28,15,0,0,0,0,20161029,79,98,5,10,23,19,19,177,19,2016,0,5,506,0
Brooklyn,18,23,32,35,0,0,0,0,Milwaukee,24,22,34,30,0,0,0,0,20161029,108,110,6,5,7,2,2,218,2,2016,0,5,732,0
Atlanta,29,24,21,30,0,0,0,0,Philadelphia,24,15,19,14,0,0,0,0,20161029,104,72,5,14,16,32,32,176,-32,2016,0,5,665,0
Orlando,20,25,17,37,0,0,0,0,Cleveland,33,29,18,25,0,0,0,0,20161029,99,105,13,17,18,6,6,204,6,2016,0,5,895,0
Boston,28,16,27,33,0,0,0,0,Charlotte,19,22,31,26,0,0,0,0,20161029,104,98,9,3,-1,6,6,202,-6,2016,0,5,720,0
Indiana,20,21,26,34,0,0,0,0,Chicago,24,38,30,26,0,0,0,0,20161029,101,118,4,21,25,17,17,219,17,2016,0,5,163,0
Portland,33,29,19,23,11,0,0,0,Denver,28,26,34,16,9,0,0,0,20161029,115,113,5,8,-7,0,2,228,-2,2016,1,5,981,0
Milwaukee,21,18,26,18,0,0,0,0,Detroit,24,26,25,23,0,0,0,0,20161030,83,98,3,11,10,15,15,181,15,2016,0,6,251,0
Dallas,25,28,17,22,0,0,0,0,Houston,34,29,17,13,0,0,0,0,20161030,92,93,9,10,10,1,1,185,1,2016,0,6,225,0
Utah,22,13,21,19,0,0,0,0,LA Clippers,19,23,27,19,0,0,0,0,20161030,75,88,-3,7,13,13,13,163,13,2016,0,6,579,0
Washington,22,32,23,23,3,0,0,0,Memphis,27,31,20,22,12,0,0,0,20161030,103,112,5,4,1,0,9,215,9,2016,1,6,762,0
San Antonio,24,28,25,29,0,0,0,0,Miami,19,25,28,27,0,0,0,0,20161030,106,99,5,8,5,7,7,205,-7,2016,0,6,1147,0
LA Lakers,24,22,25,25,0,0,0,0,Oklahoma City,30,28,19,36,0,0,0,0,20161030,96,113,6,12,6,17,17,209,17,2016,0,6,1178,0
Golden State,22,33,26,25,0,0,0,0,Phoenix,30,27,21,22,0,0,0,0,20161030,106,100,-8,-2,3,6,6,206,-6,2016,0,6,652,0
Denver,24,25,35,18,0,0,0,0,Toronto,33,29,26,17,0,0,0,0,20161031,102,105,9,13,4,3,3,207,3,2016,0,0,1341,0
Phoenix,24,12,34,28,0,0,0,0,LA Clippers,24,24,34,34,0,0,0,0,20161031,98,116,0,12,12,18,18,214,18,2016,0,0,356,0
Sacramento,15,29,37,14,0,0,0,0,Atlanta,22,31,26,27,0,0,0,0,20161031,95,106,7,9,-2,11,11,201,11,2016,0,0,2082,0
Chicago,38,27,28,25,0,0,0,0,Brooklyn,20,24,22,22,0,0,0,0,20161031,118,88,18,21,27,30,30,206,-30,2016,0,0,711,0
Golden State,34,25,41,27,0,0,0,0,Portland,25,28,20,31,0,0,0,0,20161101,127,104,9,6,27,23,23,231,-23,2016,0,1,535,0
Houston,35,24,25,36,0,0,0,0,Cleveland,29,34,22,43,0,0,0,0,20161101,120,128,-6,4,1,8,8,248,8,2016,0,1,1113,0
New York,29,26,24,10,0,0,0,0,Detroit,32,32,22,16,0,0,0,0,20161101,89,102,3,9,7,13,13,191,13,2016,0,1,480,0
LA Lakers,18,33,28,29,0,0,0,0,Indiana,27,35,22,31,0,0,0,0,20161101,108,115,9,11,5,7,7,223,7,2016,0,1,1805,0
Sacramento,26,24,17,24,5,0,0,0,Miami,28,26,19,18,17,0,0,0,20161101,96,108,2,4,6,0,12,204,12,2016,1,1,2547,0
Memphis,16,20,23,21,0,0,0,0,Minnesota,29,33,35,19,0,0,0,0,20161101,80,116,13,26,38,36,36,196,36,2016,0,1,700,0
Milwaukee,29,34,21,33,0,0,0,0,New Orleans,32,22,32,27,0,0,0,0,20161101,117,113,-3,9,-2,4,4,230,-4,2016,0,1,911,0
Orlando,24,19,41,19,0,0,0,0,Philadelphia,29,28,30,14,0,0,0,0,20161101,103,101,-5,-14,-3,2,2,204,-2,2016,0,1,864,0
Utah,38,16,19,33,0,0,0,0,San Antonio,28,22,21,20,0,0,0,0,20161101,106,91,10,4,2,15,15,197,-15,2016,0,1,1087,0
Dallas,14,19,26,22,0,0,0,0,Utah,15,26,25,31,0,0,0,0,20161102,81,97,1,8,7,16,16,178,16,2016,0,2,998,0
Houston,33,35,32,18,0,0,0,0,New York,25,26,27,21,0,0,0,0,20161102,118,99,8,17,22,19,19,217,-19,2016,0,2,1417,0
Toronto,27,27,30,29,0,0,0,0,Washington,29,27,19,28,0,0,0,0,20161102,113,103,-2,-2,9,10,10,216,-10,2016,0,2,349,0
New Orleans,13,35,11,16,8,0,0,0,Memphis,21,20,25,9,14,0,0,0,20161102,83,89,8,-7,7,0,6,172,6,2016,1,2,358,0
Portland,28,25,20,30,12,0,0,0,Phoenix,28,29,19,27,15,0,0,0,20161102,115,118,0,4,3,0,3,233,3,2016,1,2,1005,0
Philadelphia,26,27,20,20,0,0,0,0,Charlotte,26,20,39,24,0,0,0,0,20161102,93,109,0,-7,12,16,16,202,16,2016,0,2,450,0
Detroit,30,25,26,20,0,0,0,0,Brooklyn,38,33,21,17,0,0,0,0,20161102,101,109,8,16,11,8,8,210,8,2016,0,2,480,0
Oklahoma City,23,26,16,20,0,0,0,0,LA Clippers,24,17,25,17,0,0,0,0,20161102,85,83,-1,8,-1,2,2,168,-2,2016,0,2,1178,0
Chicago,25,27,18,30,0,0,0,0,Boston,36,19,26,26,0,0,0,0,20161102,100,107,11,3,11,7,7,207,7,2016,0,2,849,0
LA Lakers,28,23,39,33,0,0,0,0,Atlanta,37,23,34,22,0,0,0,0,20161102,123,116,-9,-9,-4,7,7,239,-7,2016,0,2,1932,0
Boston,25,26,32,39,0,0,0,0,Cleveland,36,32,32,28,0,0,0,0,20161103,122,128,11,17,17,6,6,250,6,2016,0,3,549,0
Oklahoma City,32,11,27,26,0,0,0,0,Golden State,31,37,30,24,0,0,0,0,20161103,96,122,-1,25,28,26,26,218,26,2016,0,3,1386,0
Indiana,30,27,22,28,0,0,0,0,Milwaukee,29,34,27,35,0,0,0,0,20161103,107,125,-1,6,11,18,18,232,18,2016,0,3,243,0
Denver,25,30,33,14,0,0,0,0,Minnesota,37,24,14,24,0,0,0,0,20161103,102,99,-12,-6,13,3,3,201,-3,2016,0,3,698,0
Sacramento,29,21,28,16,0,0,0,0,Orlando,23,33,28,18,0,0,0,0,20161103,94,102,-6,6,6,8,8,196,8,2016,0,3,2390,0
Atlanta,19,16,28,29,0,0,0,0,Washington,19,29,23,24,0,0,0,0,20161104,92,95,0,13,8,3,3,187,3,2016,0,4,541,0
San Antonio,27,26,29,18,0,0,0,0,Utah,17,24,25,20,0,0,0,0,20161104,100,86,10,12,16,14,14,186,-14,2016,0,4,1087,0
Miami,27,19,26,15,0,0,0,0,Toronto,25,27,23,21,0,0,0,0,20161104,87,96,-2,6,3,9,9,183,9,2016,0,4,1234,0
Phoenix,30,28,23,21,10,0,0,0,New Orleans,29,32,18,23,9,0,0,0,20161104,112,111,1,-3,2,0,1,223,-1,2016,1,4,1312,0
Charlotte,23,20,30,26,0,0,0,0,Brooklyn,23,27,20,25,0,0,0,0,20161104,99,95,0,-7,3,4,4,194,-4,2016,0,4,531,0
Golden State,15,34,33,15,0,0,0,0,LA Lakers,24,41,28,24,0,0,0,0,20161104,97,117,9,16,11,20,20,214,20,2016,0,4,347,0
Portland,26,29,24,26,0,0,0,0,Dallas,26,26,24,19,0,0,0,0,20161104,105,95,0,3,3,10,10,200,-10,2016,0,4,1630,0
New York,32,24,28,33,0,0,0,0,Chicago,23,34,24,23,0,0,0,0,20161104,117,104,9,-1,3,13,13,221,-13,2016,0,4,711,0
LA Clippers,23,30,23,23,0,0,0,0,Memphis,20,15,22,31,0,0,0,0,20161104,99,88,3,18,19,11,11,187,-11,2016,0,4,1599,0
Washington,24,26,20,16,0,0,0,0,Orlando,20,20,21,27,0,0,0,0,20161105,86,88,-4,-10,-9,2,2,174,2,2016,0,5,757,0
LA Clippers,39,34,16,27,0,0,0,0,San Antonio,24,31,17,20,0,0,0,0,20161105,116,92,15,18,17,24,24,208,-24,2016,0,5,1201,0
Minnesota,25,28,19,20,0,0,0,0,Oklahoma City,32,27,31,22,0,0,0,0,20161105,92,112,7,6,18,20,20,204,20,2016,0,5,694,0
Cleveland,34,23,25,20,0,0,0,0,Philadelphia,19,27,34,21,0,0,0,0,20161105,102,101,15,11,2,1,1,203,-1,2016,0,5,358,0
Chicago,15,28,21,30,0,0,0,0,Indiana,31,31,26,23,0,0,0,0,20161105,94,111,16,19,24,17,17,205,17,2016,0,5,163,0
Denver,12,32,23,19,0,0,0,0,Detroit,29,22,26,26,0,0,0,0,20161105,86,103,17,7,10,17,17,189,17,2016,0,5,1154,0
Houston,30,29,25,13,0,0,0,0,Atlanta,30,35,28,19,0,0,0,0,20161105,97,112,0,6,9,15,15,209,15,2016,0,5,700,0
Sacramento,24,24,15,28,0,0,0,0,Milwaukee,34,27,29,27,0,0,0,0,20161105,91,117,10,13,27,26,26,208,26,2016,0,5,1771,0
Denver,42,35,26,20,0,0,0,0,Boston,23,29,31,24,0,0,0,0,20161106,123,107,19,25,20,16,16,230,-16,2016,0,6,1765,0
Milwaukee,27,12,17,18,1,0,0,0,Dallas,19,28,12,15,12,0,0,0,20161106,75,86,-8,8,3,0,11,161,11,2016,1,6,857,0
Phoenix,15,28,33,32,0,0,0,0,LA Lakers,23,31,29,36,0,0,0,0,20161106,108,119,8,11,7,11,11,227,11,2016,0,6,356,0
Portland,25,22,29,24,0,0,0,0,Memphis,22,29,26,17,0,0,0,0,20161106,100,94,3,-4,-1,6,6,194,-6,2016,0,6,1845,0
Utah,20,29,29,36,0,0,0,0,New York,30,24,26,29,0,0,0,0,20161106,114,109,-10,-5,-2,5,5,223,-5,2016,0,6,1967,0
Sacramento,20,24,24,28,0,0,0,0,Toronto,23,27,16,25,0,0,0,0,20161106,96,91,-3,-6,2,5,5,187,-5,2016,0,6,2195,0
Houston,23,33,28,30,0,0,0,0,Washington,30,17,36,23,0,0,0,0,20161107,114,106,-7,9,1,8,8,220,-8,2016,0,0,1217,0
Utah,30,22,25,32,0,0,0,0,Philadelphia,24,19,18,23,0,0,0,0,20161107,109,84,6,9,16,25,25,193,-25,2016,0,0,1920,0
Miami,28,19,14,24,0,0,0,0,Oklahoma City,39,16,28,14,0,0,0,0,20161107,85,97,11,8,22,12,12,182,12,2016,0,0,1225,0
Detroit,15,17,21,29,0,0,0,0,LA Clippers,33,29,29,23,0,0,0,0,20161107,82,114,18,30,38,32,32,196,32,2016,0,0,1979,0
Indiana,34,21,23,22,0,0,0,0,Charlotte,43,32,24,23,0,0,0,0,20161107,100,122,9,20,21,22,22,222,22,2016,0,0,428,0
Orlando,24,28,11,17,0,0,0,0,Chicago,37,24,27,24,0,0,0,0,20161107,80,112,13,9,25,32,32,192,32,2016,0,0,984,0
New Orleans,24,25,29,28,0,0,0,0,Golden State,28,35,21,32,0,0,0,0,20161107,106,116,4,14,6,10,10,222,10,2016,0,0,1921,0
Minnesota,33,32,19,26,0,0,0,0,Brooklyn,33,33,22,31,0,0,0,0,20161108,110,119,0,1,4,9,9,229,9,2016,0,1,1016,0
Atlanta,20,33,31,26,0,0,0,0,Cleveland,20,22,37,27,0,0,0,0,20161108,110,106,0,11,5,4,4,216,-4,2016,0,1,555,0
Dallas,25,33,25,26,0,0,0,0,LA Lakers,27,27,23,20,0,0,0,0,20161108,109,97,-2,4,6,12,12,206,-12,2016,0,1,1237,0
Denver,26,30,20,31,0,0,0,0,Memphis,26,30,23,29,0,0,0,0,20161108,107,108,0,0,3,1,1,215,1,2016,0,1,877,0
Phoenix,25,30,27,39,0,0,0,0,Portland,42,21,26,35,0,0,0,0,20161108,121,124,17,8,7,3,3,245,3,2016,0,1,1005,0
New Orleans,26,20,24,24,0,0,0,0,Sacramento,33,20,23,26,0,0,0,0,20161108,94,102,7,7,6,8,8,196,8,2016,0,1,1879,0
Toronto,20,42,26,24,0,0,0,0,Oklahoma City,27,28,20,27,0,0,0,0,20161109,112,102,-7,7,13,10,10,214,-10,2016,0,2,1114,0
Houston,33,30,22,16,0,0,0,0,San Antonio,24,36,20,19,0,0,0,0,20161109,101,99,9,3,5,2,2,200,-2,2016,0,2,189,0
Boston,8,35,26,24,0,0,0,0,Washington,34,24,31,29,0,0,0,0,20161109,93,118,26,15,20,25,25,211,25,2016,0,2,394,0
Minnesota,39,35,23,26,0,0,0,0,Orlando,17,30,30,30,0,0,0,0,20161109,123,107,22,27,20,16,16,230,-16,2016,0,2,1309,0
Brooklyn,29,26,16,25,0,0,0,0,New York,19,31,22,38,0,0,0,0,20161109,96,110,-10,-5,1,14,14,206,14,2016,0,2,0,0
Detroit,28,23,25,24,0,0,0,0,Phoenix,19,35,27,26,0,0,0,0,20161109,100,107,-9,3,5,7,7,207,7,2016,0,2,1687,0
Philadelphia,26,34,24,25,6,0,0,0,Indiana,31,23,30,25,13,0,0,0,20161109,115,122,5,-6,0,0,7,237,7,2016,1,2,582,0
Dallas,15,21,32,27,0,0,0,0,Golden State,34,33,17,32,0,0,0,0,20161109,95,116,19,31,16,21,21,211,21,2016,0,2,1480,0
Utah,32,26,20,20,0,0,0,0,Charlotte,24,27,25,28,0,0,0,0,20161109,98,104,-8,-7,-2,6,6,202,6,2016,0,2,1723,0
Chicago,27,34,27,19,0,0,0,0,Atlanta,35,33,26,21,0,0,0,0,20161109,107,115,8,7,6,8,8,222,8,2016,0,2,587,0
Portland,16,16,18,30,0,0,0,0,LA Clippers,36,25,32,18,0,0,0,0,20161109,80,111,20,29,43,31,31,191,31,2016,0,2,826,0
Golden State,38,27,34,26,0,0,0,0,Denver,19,32,24,26,0,0,0,0,20161110,125,101,19,14,24,24,24,226,-24,2016,0,3,947,0
Chicago,23,30,17,28,0,0,0,0,Miami,22,31,17,25,0,0,0,0,20161110,98,95,1,0,0,3,3,193,-3,2016,0,3,1189,0
New Orleans,26,35,27,24,0,0,0,0,Milwaukee,27,27,27,25,0,0,0,0,20161110,112,106,-1,7,7,6,6,218,-6,2016,0,3,911,0
LA Lakers,16,29,25,31,0,0,0,0,Sacramento,30,25,18,18,0,0,0,0,20161110,101,91,-14,-10,-3,10,10,192,-10,2016,0,3,361,0
Cleveland,26,32,26,21,0,0,0,0,Washington,31,25,19,19,0,0,0,0,20161111,105,94,-5,2,9,11,11,199,-11,2016,0,4,304,0
Detroit,26,26,15,19,0,0,0,0,San Antonio,28,21,26,21,0,0,0,0,20161111,86,96,2,-3,8,10,10,182,10,2016,0,4,1238,0
Indiana,27,25,20,28,5,0,0,0,Philadelphia,21,30,25,24,9,0,0,0,20161111,105,109,-6,-1,4,0,4,214,4,2016,1,4,582,0
Sacramento,31,26,26,23,14,0,0,0,Portland,35,27,22,22,16,0,0,0,20161111,120,122,4,5,1,0,2,242,2,2016,1,4,483,0
LA Clippers,16,34,32,28,0,0,0,0,Oklahoma City,24,26,24,34,0,0,0,0,20161111,110,108,-8,0,8,2,2,218,-2,2016,0,4,1178,0
Toronto,28,30,21,34,0,0,0,0,Charlotte,27,17,38,29,0,0,0,0,20161111,113,111,1,14,-3,2,2,224,-2,2016,0,4,585,0
New York,27,24,22,14,0,0,0,0,Boston,31,30,25,29,0,0,0,0,20161111,87,115,4,10,13,28,28,202,28,2016,0,4,190,0
Utah,23,19,18,27,0,0,0,0,Orlando,17,21,26,10,0,0,0,0,20161111,87,74,6,4,-4,13,13,161,-13,2016,0,4,1915,0
New York,28,28,29,22,0,0,0,0,Toronto,24,29,34,31,0,0,0,0,20161112,107,118,-4,-3,2,11,11,225,11,2016,0,5,341,0
Brooklyn,23,35,32,32,0,0,0,0,Phoenix,21,24,38,21,0,0,0,0,20161112,122,104,2,13,7,18,18,226,-18,2016,0,5,2139,0
LA Lakers,30,25,29,42,0,0,0,0,New Orleans,26,30,15,28,0,0,0,0,20161112,126,99,4,-1,13,27,27,225,-27,2016,0,5,1669,0
LA Clippers,34,26,28,31,0,0,0,0,Minnesota,21,30,22,32,0,0,0,0,20161112,119,105,13,9,15,14,14,224,-14,2016,0,5,1521,0
Memphis,19,20,31,26,0,0,0,0,Milwaukee,24,20,31,31,0,0,0,0,20161112,96,106,5,5,5,10,10,202,10,2016,0,5,557,0
Boston,24,24,31,26,0,0,0,0,Indiana,31,14,31,23,0,0,0,0,20161112,105,99,-7,3,3,6,6,204,-6,2016,0,5,805,0
San Antonio,26,23,33,24,0,0,0,0,Houston,22,18,30,30,0,0,0,0,20161112,106,100,4,9,12,6,6,206,-6,2016,0,5,189,0
Detroit,36,21,23,26,0,0,0,0,Denver,21,28,22,24,0,0,0,0,20161112,106,95,15,8,9,11,11,201,-11,2016,0,5,1154,0
Washington,27,29,14,25,0,0,0,0,Chicago,28,25,28,25,0,0,0,0,20161112,95,106,1,-3,11,11,11,201,11,2016,0,5,594,0
Philadelphia,27,21,30,18,0,0,0,0,Atlanta,23,36,28,30,0,0,0,0,20161112,96,117,-4,11,9,21,21,213,21,2016,0,5,665,0
Utah,23,29,24,26,0,0,0,0,Miami,21,26,12,32,0,0,0,0,20161112,102,91,2,5,17,11,11,193,-11,2016,0,5,2086,0
Denver,28,29,15,33,0,0,0,0,Portland,20,30,36,26,0,0,0,0,20161113,105,112,-8,-7,14,7,7,217,7,2016,0,6,981,0
Orlando,27,30,25,37,0,0,0,0,Oklahoma City,13,34,37,33,0,0,0,0,20161113,119,117,14,10,-2,2,2,236,-2,2016,0,6,1057,0
Charlotte,22,32,18,21,0,0,0,0,Cleveland,32,20,19,29,0,0,0,0,20161113,93,100,10,-2,-1,7,7,193,7,2016,0,6,435,0
Phoenix,32,27,33,28,0,0,0,0,Golden State,28,34,37,34,0,0,0,0,20161113,120,133,-4,3,7,13,13,253,13,2016,0,6,652,0
LA Lakers,27,19,26,27,0,0,0,0,Minnesota,36,33,18,38,0,0,0,0,20161113,99,125,9,23,15,26,26,224,26,2016,0,6,1521,0
Oklahoma City,25,22,21,20,0,0,0,0,Detroit,28,31,19,26,0,0,0,0,20161114,88,104,3,12,10,16,16,192,16,2016,0,0,909,0
Philadelphia,26,26,16,20,0,0,0,0,Houston,38,27,28,22,0,0,0,0,20161114,88,115,12,13,25,27,27,203,27,2016,0,0,1339,0
Orlando,19,18,20,12,0,0,0,0,Indiana,16,25,30,17,0,0,0,0,20161114,69,88,-3,4,14,19,19,157,19,2016,0,0,822,0
Brooklyn,14,33,18,30,0,0,0,0,LA Clippers,39,32,28,28,0,0,0,0,20161114,95,127,25,24,34,32,32,222,32,2016,0,0,2445,0
Boston,26,25,23,31,0,0,0,0,New Orleans,27,29,28,22,0,0,0,0,20161114,105,106,1,5,10,1,1,211,1,2016,0,0,1358,0
Dallas,23,16,12,26,0,0,0,0,New York,15,21,31,26,0,0,0,0,20161114,77,93,-8,-3,16,16,16,170,16,2016,0,0,1370,0
Miami,19,21,20,30,0,0,0,0,San Antonio,25,30,16,23,0,0,0,0,20161114,90,94,6,15,11,4,4,184,4,2016,0,0,1147,0
Memphis,33,23,17,29,0,0,0,0,Utah,25,23,22,26,0,0,0,0,20161114,102,96,8,8,3,6,6,198,-6,2016,0,0,1247,0
Chicago,35,21,27,30,0,0,0,0,Portland,14,23,26,25,0,0,0,0,20161115,113,88,21,19,20,25,25,201,-25,2016,0,1,1754,0
Charlotte,31,15,36,33,0,0,0,0,Minnesota,30,28,17,33,0,0,0,0,20161115,115,108,1,-12,7,7,7,223,-7,2016,0,1,938,0
Atlanta,22,27,23,21,0,0,0,0,Miami,25,18,24,23,0,0,0,0,20161115,93,90,-3,6,5,3,3,183,-3,2016,0,1,605,0
Toronto,25,32,27,33,0,0,0,0,Cleveland,30,31,30,30,0,0,0,0,20161115,117,121,5,4,7,4,4,238,4,2016,0,1,187,0
Brooklyn,29,22,34,33,0,0,0,0,LA Lakers,27,29,37,32,0,0,0,0,20161115,118,125,-2,5,8,7,7,243,7,2016,0,1,2445,0
San Antonio,27,30,27,26,0,0,0,0,Sacramento,22,24,25,34,0,0,0,0,20161116,110,105,5,11,13,5,5,215,-5,2016,0,2,1456,0
Milwaukee,26,9,35,30,0,0,0,0,Atlanta,21,31,32,23,0,0,0,0,20161116,100,107,-5,17,14,7,7,207,7,2016,0,2,669,0
Dallas,17,14,23,29,0,0,0,0,Boston,29,10,18,33,0,0,0,0,20161116,83,90,12,8,3,7,7,173,7,2016,0,2,1548,0
Phoenix,17,26,33,28,0,0,0,0,Denver,28,33,28,31,0,0,0,0,20161116,104,120,11,18,13,16,16,224,16,2016,0,2,585,0
Cleveland,19,26,23,25,0,0,0,0,Indiana,30,20,30,23,0,0,0,0,20161116,93,103,11,5,12,10,10,196,10,2016,0,2,262,0
Memphis,26,35,22,28,0,0,0,0,LA Clippers,28,18,30,31,0,0,0,0,20161116,111,107,-2,15,7,4,4,218,-4,2016,0,2,1599,0
Detroit,27,22,25,28,0,0,0,0,New York,29,25,27,24,0,0,0,0,20161116,102,105,2,5,7,3,3,207,3,2016,0,2,480,0
Houston,32,31,27,13,0,0,0,0,Oklahoma City,38,27,20,20,0,0,0,0,20161116,103,105,6,2,-5,2,2,208,2,2016,0,2,413,0
New Orleans,19,21,23,19,0,0,0,0,Orlando,21,31,13,24,0,0,0,0,20161116,82,89,2,12,2,7,7,171,7,2016,0,2,533,0
Washington,15,33,28,26,0,0,0,0,Philadelphia,29,30,29,21,0,0,0,0,20161116,102,109,14,11,12,7,7,211,7,2016,0,2,123,0
Golden State,34,32,29,32,0,0,0,0,Toronto,38,15,33,35,0,0,0,0,20161116,127,121,-4,13,9,6,6,248,-6,2016,0,2,2263,0
New York,18,24,23,47,0,0,0,0,Washington,24,28,35,32,0,0,0,0,20161117,112,119,6,10,22,7,7,231,7,2016,0,3,204,0
Chicago,25,16,25,19,0,0,0,0,Utah,26,17,15,19,0,0,0,0,20161117,85,77,-1,-2,8,8,8,162,-8,2016,0,3,1256,0
Philadelphia,18,15,25,28,0,0,0,0,Minnesota,27,34,24,25,0,0,0,0,20161117,86,110,9,28,27,24,24,196,24,2016,0,3,983,0
Milwaukee,27,21,14,11,0,0,0,0,Miami,21,27,19,29,0,0,0,0,20161117,73,96,-6,0,5,23,23,169,23,2016,0,3,1269,0
Portland,29,33,21,26,0,0,0,0,Houston,41,21,38,26,0,0,0,0,20161117,109,126,12,0,17,17,17,235,17,2016,0,3,1833,0
Brooklyn,40,21,21,23,0,0,0,0,Oklahoma City,34,30,32,28,0,0,0,0,20161118,105,124,-6,3,14,19,19,229,19,2016,0,4,1324,0
Portland,28,23,24,26,0,0,0,0,New Orleans,31,33,24,25,0,0,0,0,20161118,101,113,3,13,13,12,12,214,12,2016,0,4,2059,0
San Antonio,26,26,39,25,0,0,0,0,LA Lakers,16,36,24,31,0,0,0,0,20161118,116,107,10,0,15,9,9,223,-9,2016,0,4,1201,0
Phoenix,27,30,32,27,0,0,0,0,Indiana,18,31,33,14,0,0,0,0,20161118,116,96,9,8,7,20,20,212,-20,2016,0,4,1496,0
LA Clippers,40,33,31,17,0,0,0,0,Sacramento,24,30,31,30,0,0,0,0,20161118,121,115,16,19,19,6,6,236,-6,2016,0,4,361,0
Memphis,19,17,20,24,0,0,0,0,Dallas,19,10,12,23,0,0,0,0,20161118,80,64,0,7,15,16,16,144,-16,2016,0,4,419,0
Detroit,19,20,17,25,0,0,0,0,Cleveland,30,26,26,22,0,0,0,0,20161118,81,104,11,17,26,23,23,185,23,2016,0,4,90,0
Atlanta,28,17,35,16,0,0,0,0,Charlotte,29,19,27,25,0,0,0,0,20161118,96,100,1,3,-5,4,4,196,4,2016,0,4,226,0
Golden State,29,26,31,18,0,0,0,0,Boston,27,21,9,31,0,0,0,0,20161118,104,88,2,7,29,16,16,192,-16,2016,0,4,2692,0
Toronto,29,23,25,25,11,0,0,0,Denver,19,38,25,20,9,0,0,0,20161118,113,111,10,-5,-5,0,2,224,-2,2016,1,4,1341,0
Miami,33,27,31,23,0,0,0,0,Washington,35,24,23,29,0,0,0,0,20161119,114,111,-2,1,9,3,3,225,-3,2016,0,5,924,0
Phoenix,19,29,27,30,0,0,0,0,Philadelphia,32,26,34,28,0,0,0,0,20161119,105,120,13,10,17,15,15,225,15,2016,0,5,2078,0
Dallas,16,29,24,18,0,0,0,0,Orlando,17,27,22,29,0,0,0,0,20161119,87,95,1,-1,-3,8,8,182,8,2016,0,5,961,0
Charlotte,23,23,39,23,8,0,0,0,New Orleans,21,26,27,34,13,0,0,0,20161119,116,121,-2,1,-11,0,5,237,5,2016,1,5,648,0
Minnesota,16,23,13,19,0,0,0,0,Memphis,18,25,22,28,0,0,0,0,20161119,71,93,2,4,13,22,22,164,22,2016,0,5,700,0
Chicago,33,19,25,18,0,0,0,0,LA Clippers,23,24,25,30,0,0,0,0,20161119,95,102,-10,-5,-5,7,7,197,7,2016,0,5,1741,0
Utah,22,22,26,32,0,0,0,0,Houston,28,27,26,30,0,0,0,0,20161119,102,111,6,11,11,9,9,213,9,2016,0,5,1199,0
Boston,30,20,21,23,0,0,0,0,Detroit,23,24,26,19,0,0,0,0,20161119,94,92,7,3,-2,2,2,186,-2,2016,0,5,611,0
Golden State,28,41,34,21,0,0,0,0,Milwaukee,37,29,26,29,0,0,0,0,20161119,124,121,-9,3,11,3,3,245,-3,2016,0,5,1838,0
Indiana,30,28,21,24,12,0,0,0,Oklahoma City,21,33,16,33,8,0,0,0,20161120,115,111,9,4,9,0,4,226,-4,2016,1,6,688,0
Toronto,28,35,18,18,0,0,0,0,Sacramento,36,22,28,16,0,0,0,0,20161120,99,102,8,-5,5,3,3,201,3,2016,0,6,2195,0
Atlanta,20,21,25,28,0,0,0,0,New York,24,22,29,29,0,0,0,0,20161120,94,104,4,5,9,10,10,198,10,2016,0,6,745,0
Utah,14,27,22,28,0,0,0,0,Denver,24,29,23,29,0,0,0,0,20161120,91,105,10,12,13,14,14,196,14,2016,0,6,370,0
Portland,32,38,29,30,0,0,0,0,Brooklyn,29,35,20,25,0,0,0,0,20161120,129,109,3,6,15,20,20,238,-20,2016,0,6,2439,0
Chicago,30,32,28,28,0,0,0,0,LA Lakers,30,31,24,25,0,0,0,0,20161120,118,110,0,1,5,8,8,228,-8,2016,0,6,1741,0
Phoenix,20,26,34,21,0,0,0,0,Washington,26,24,25,31,0,0,0,0,20161121,101,106,6,4,-5,5,5,207,5,2016,0,0,1977,0
Dallas,28,21,24,18,0,0,0,0,San Antonio,24,24,25,23,0,0,0,0,20161121,91,96,-4,-1,0,5,5,187,5,2016,0,0,252,0
Boston,23,19,26,31,0,0,0,0,Minnesota,21,31,29,12,0,0,0,0,20161121,99,93,2,-10,-13,6,6,192,-6,2016,0,0,1120,0
Orlando,27,17,30,15,0,0,0,0,Milwaukee,20,29,20,24,0,0,0,0,20161121,89,93,-7,5,-5,4,4,182,4,2016,0,0,1065,0
Miami,30,15,31,18,0,0,0,0,Philadelphia,24,22,32,23,0,0,0,0,20161121,94,101,-6,1,2,7,7,195,7,2016,0,0,1021,0
Golden State,34,27,39,20,0,0,0,0,Indiana,21,21,29,12,0,0,0,0,20161121,120,83,13,19,29,37,37,203,-37,2016,0,0,1944,0
Houston,18,33,28,20,0,0,0,0,Detroit,25,21,29,21,0,0,0,0,20161121,99,96,-7,5,4,3,3,195,-3,2016,0,0,1105,0
Memphis,32,37,15,21,0,0,0,0,Charlotte,22,23,26,19,0,0,0,0,20161121,105,90,10,24,13,15,15,195,-15,2016,0,0,519,0
Toronto,19,26,34,36,0,0,0,0,LA Clippers,23,31,34,35,0,0,0,0,20161121,115,123,4,9,9,8,8,238,8,2016,0,0,2170,0
New Orleans,34,32,29,17,0,0,0,0,Atlanta,14,30,27,23,0,0,0,0,20161122,112,94,20,22,24,18,18,206,-18,2016,0,1,424,0
Chicago,31,29,28,19,0,0,0,0,Denver,19,41,31,19,0,0,0,0,20161122,107,110,-12,0,3,3,3,217,3,2016,0,1,916,0
Oklahoma City,16,32,26,35,0,0,0,0,LA Lakers,29,20,31,31,0,0,0,0,20161122,109,111,13,1,6,2,2,220,2,2016,0,1,1178,0
Portland,33,25,23,22,0,0,0,0,New York,28,32,21,26,0,0,0,0,20161122,103,107,-5,2,0,4,4,210,4,2016,0,1,2439,0
Minnesota,26,24,18,28,0,0,0,0,New Orleans,31,22,36,28,0,0,0,0,20161123,96,117,5,3,21,21,21,213,21,2016,0,2,1052,0
Phoenix,24,22,22,24,0,0,0,0,Orlando,22,22,22,21,0,0,0,0,20161123,92,87,2,2,2,5,5,179,-5,2016,0,2,1842,0
Atlanta,31,18,25,22,0,0,0,0,Indiana,24,20,22,19,0,0,0,0,20161123,96,85,7,5,8,11,11,181,-11,2016,0,2,427,0
Oklahoma City,27,21,27,26,0,0,0,0,Sacramento,27,24,36,29,0,0,0,0,20161123,101,116,0,3,12,15,15,217,15,2016,0,2,1336,0
Memphis,20,23,20,23,5,13,0,0,Philadelphia,26,25,20,15,5,8,0,0,20161123,104,99,-6,-8,-8,0,5,203,-5,2016,2,2,878,0
Toronto,24,30,36,25,0,0,0,0,Houston,20,19,35,28,0,0,0,0,20161123,115,102,4,15,16,13,13,217,-13,2016,0,2,1299,0
Denver,27,20,14,22,0,0,0,0,Utah,36,17,31,24,0,0,0,0,20161123,83,108,9,6,23,25,25,191,25,2016,0,2,370,0
Miami,16,26,22,20,0,0,0,0,Detroit,28,28,30,21,0,0,0,0,20161123,84,107,12,14,22,23,23,191,23,2016,0,2,1155,0
LA Clippers,32,36,25,31,0,0,0,0,Dallas,26,19,25,34,0,0,0,0,20161123,124,104,6,23,23,20,20,228,-20,2016,0,2,1237,0
Portland,31,29,32,33,0,0,0,0,Cleveland,46,35,31,25,0,0,0,0,20161123,125,137,15,21,20,12,12,262,12,2016,0,2,2049,0
San Antonio,30,29,25,35,0,0,0,0,Charlotte,28,32,24,30,0,0,0,0,20161123,119,114,2,-1,0,5,5,233,-5,2016,0,2,1103,0
Boston,30,21,28,32,0,0,0,0,Brooklyn,16,33,17,26,0,0,0,0,20161123,111,92,14,2,13,19,19,203,-19,2016,0,2,190,0
LA Lakers,26,23,29,28,0,0,0,0,Golden State,41,39,26,43,0,0,0,0,20161123,106,149,15,31,28,43,43,255,43,2016,0,2,347,0
Atlanta,23,11,14,20,0,0,0,0,Utah,24,24,13,34,0,0,0,0,20161125,68,95,1,14,13,27,27,163,27,2016,0,4,1580,0
Houston,38,30,22,27,0,0,0,0,Sacramento,19,31,24,30,0,0,0,0,20161125,117,104,19,18,16,13,13,221,-13,2016,0,4,1606,0
New Orleans,34,23,26,21,0,0,0,0,Portland,32,34,34,19,0,0,0,0,20161125,104,119,-2,9,17,15,15,223,15,2016,0,4,2059,0
Minnesota,29,18,20,31,0,0,0,0,Phoenix,27,25,23,10,0,0,0,0,20161125,98,85,2,-5,-8,13,13,183,-13,2016,0,4,1278,0
Chicago,23,34,33,15,0,0,0,0,Philadelphia,19,28,17,25,0,0,0,0,20161125,105,89,4,10,26,16,16,194,-16,2016,0,4,664,0
Washington,26,22,24,22,0,0,0,0,Orlando,14,24,30,23,0,0,0,0,20161125,94,91,12,10,4,3,3,185,-3,2016,0,4,757,0
Toronto,27,20,26,32,0,0,0,0,Milwaukee,24,18,25,32,0,0,0,0,20161125,105,99,3,5,6,6,6,204,-6,2016,0,4,429,0
Charlotte,28,28,18,30,7,0,0,0,New York,30,22,27,25,9,0,0,0,20161125,111,113,2,-4,5,0,2,224,2,2016,1,4,531,0
Golden State,30,23,27,29,0,0,0,0,LA Lakers,20,23,21,21,0,0,0,0,20161125,109,85,10,10,16,24,24,194,-24,2016,0,4,347,0
Brooklyn,23,20,22,32,0,0,0,0,Indiana,28,30,34,26,0,0,0,0,20161125,97,118,5,15,27,21,21,215,21,2016,0,4,643,0
LA Clippers,23,25,32,17,0,0,0,0,Detroit,35,22,25,26,0,0,0,0,20161125,97,108,12,9,2,11,11,205,11,2016,0,4,1979,0
Oklahoma City,31,31,22,38,10,0,0,0,Denver,30,33,26,33,7,0,0,0,20161125,132,129,1,-1,-5,0,3,261,-3,2016,1,4,503,0
Dallas,16,22,17,35,0,0,0,0,Cleveland,36,36,24,32,0,0,0,0,20161125,90,128,20,34,41,38,38,218,38,2016,0,4,1024,0
San Antonio,22,24,29,34,0,0,0,0,Boston,32,16,26,29,0,0,0,0,20161125,109,103,-10,-2,1,6,6,212,-6,2016,0,4,1765,0
Miami,28,17,26,19,0,0,0,0,Memphis,19,20,18,24,0,0,0,0,20161125,90,81,9,6,14,9,9,171,-9,2016,0,4,873,0
New York,22,25,24,31,0,0,0,0,Charlotte,38,20,17,32,0,0,0,0,20161126,102,107,16,11,4,5,5,209,5,2016,0,5,531,0
Minnesota,33,15,25,29,0,0,0,0,Golden State,30,26,34,25,0,0,0,0,20161126,102,115,-3,8,17,13,13,217,13,2016,0,5,1581,0
Memphis,24,27,31,28,0,0,0,0,Miami,31,18,33,25,0,0,0,0,20161126,110,107,-7,2,0,3,3,217,-3,2016,0,5,873,0
Detroit,19,27,22,20,0,0,0,0,Oklahoma City,29,27,21,29,0,0,0,0,20161126,88,106,10,10,9,18,18,194,18,2016,0,5,909,0
San Antonio,23,31,36,22,0,0,0,0,Washington,22,22,32,24,0,0,0,0,20161126,112,100,1,10,14,12,12,212,-12,2016,0,5,1385,0
Houston,35,30,31,34,0,0,0,0,Portland,35,27,31,21,0,0,0,0,20161127,130,114,0,3,3,16,16,244,-16,2016,0,6,1833,0
Denver,29,34,23,34,0,0,0,0,Phoenix,28,15,36,35,0,0,0,0,20161127,120,114,1,20,7,6,6,234,-6,2016,0,6,585,0
Cleveland,24,28,25,35,0,0,0,0,Philadelphia,30,28,23,27,0,0,0,0,20161127,112,108,-6,-6,-4,4,4,220,-4,2016,0,6,358,0
Milwaukee,36,22,21,25,0,0,0,0,Orlando,29,23,20,24,0,0,0,0,20161127,104,96,7,6,7,8,8,200,-8,2016,0,6,1065,0
LA Clippers,20,20,18,12,0,0,0,0,Indiana,23,27,26,15,0,0,0,0,20161127,70,91,3,10,18,21,21,161,21,2016,0,6,1805,0
New Orleans,20,22,18,21,0,0,0,0,Dallas,26,18,16,31,0,0,0,0,20161127,81,91,6,2,0,10,10,172,10,2016,0,6,442,0
Sacramento,31,27,34,30,0,0,0,0,Brooklyn,35,24,18,28,0,0,0,0,20161127,122,105,-4,-1,15,17,17,227,-17,2016,0,6,2499,0
Atlanta,32,16,29,17,0,0,0,0,LA Lakers,21,35,28,25,0,0,0,0,20161127,94,109,-11,8,7,15,15,203,15,2016,0,6,1932,0
Atlanta,27,26,28,19,0,0,0,0,Golden State,29,21,30,25,0,0,0,0,20161128,100,105,2,-3,-1,5,5,205,5,2016,0,0,2135,0
Charlotte,25,31,25,23,0,0,0,0,Memphis,25,14,21,25,0,0,0,0,20161128,104,85,0,17,21,19,19,189,-19,2016,0,0,519,0
Boston,21,27,35,29,0,0,0,0,Miami,19,12,42,31,0,0,0,0,20161128,112,104,2,17,10,8,8,216,-8,2016,0,0,1257,0
Utah,22,28,24,38,0,0,0,0,Minnesota,27,18,24,34,0,0,0,0,20161128,112,103,-5,5,5,9,9,215,-9,2016,0,0,984,0
Oklahoma City,24,34,30,24,0,0,0,0,New York,29,26,26,22,0,0,0,0,20161128,112,103,-5,3,7,9,9,215,-9,2016,0,0,1324,0
Philadelphia,26,23,22,24,0,0,0,0,Toronto,33,27,31,31,0,0,0,0,20161128,95,122,7,11,20,27,27,217,27,2016,0,0,334,0
Sacramento,19,34,19,20,3,0,0,0,Washington,25,25,24,18,9,0,0,0,20161128,95,101,6,-3,2,0,6,196,6,2016,1,0,2371,0
Houston,29,21,23,28,0,0,0,0,Utah,38,24,23,35,0,0,0,0,20161129,101,120,9,12,12,19,19,221,19,2016,0,1,1199,0
Orlando,16,29,30,20,0,0,0,0,San Antonio,20,23,21,19,0,0,0,0,20161129,95,83,-4,2,11,12,12,178,-12,2016,0,1,1035,0
LA Lakers,22,19,22,25,0,0,0,0,New Orleans,33,32,24,16,0,0,0,0,20161129,88,105,11,24,26,17,17,193,17,2016,0,1,1669,0
Detroit,33,24,27,28,0,0,0,0,Charlotte,25,29,20,15,0,0,0,0,20161129,112,89,8,3,10,23,23,201,-23,2016,0,1,504,0
LA Clippers,28,37,21,21,11,4,0,0,Brooklyn,24,29,20,34,11,9,0,0,20161129,122,127,-4,-12,-13,0,5,249,5,2016,2,1,2445,0
Cleveland,32,22,20,27,0,0,0,0,Milwaukee,30,28,34,26,0,0,0,0,20161129,101,118,-2,4,18,17,17,219,17,2016,0,1,334,0
Detroit,31,28,33,29,0,0,0,0,Boston,28,25,31,30,0,0,0,0,20161130,121,114,3,6,8,7,7,235,-7,2016,0,2,611,0
LA Lakers,17,30,23,26,0,0,0,0,Chicago,28,19,26,17,0,0,0,0,20161130,96,90,-11,0,-3,6,6,186,-6,2016,0,2,1741,0
San Antonio,21,22,18,33,0,0,0,0,Dallas,17,23,26,21,0,0,0,0,20161130,94,87,4,3,-5,7,7,181,-7,2016,0,2,252,0
Miami,28,24,23,31,0,0,0,0,Denver,30,17,33,18,0,0,0,0,20161130,106,98,-2,5,-5,8,8,204,-8,2016,0,2,1724,0
New York,28,30,23,25,0,0,0,0,Minnesota,31,18,25,30,0,0,0,0,20161130,106,104,-3,9,7,2,2,210,-2,2016,0,2,1016,0
Washington,19,34,31,21,10,0,0,0,Oklahoma City,32,28,24,21,21,0,0,0,20161130,115,126,13,7,0,0,11,241,11,2016,1,2,1149,0
Atlanta,27,21,27,32,0,0,0,0,Phoenix,36,14,27,32,0,0,0,0,20161130,107,109,9,2,2,2,2,216,2,2016,0,2,1588,0
Indiana,23,35,25,26,0,0,0,0,Portland,31,42,36,22,0,0,0,0,20161130,109,131,8,15,26,22,22,240,22,2016,0,2,1880,0
Memphis,28,29,25,23,0,0,0,0,Toronto,25,30,34,31,0,0,0,0,20161130,105,120,-3,-2,7,15,15,225,15,2016,0,2,815,0
Miami,26,26,31,28,0,0,0,0,Utah,27,21,29,33,0,0,0,0,20161201,111,110,-1,4,6,1,1,221,-1,2016,0,3,2086,0
Orlando,28,21,19,26,0,0,0,0,Memphis,30,20,15,30,0,0,0,0,20161201,94,95,2,1,-3,1,1,189,1,2016,0,3,683,0
Houston,32,32,22,27,10,9,0,0,Golden State,30,29,23,31,10,4,0,0,20161201,132,127,2,5,4,0,5,259,-5,2016,2,3,1642,0
LA Clippers,24,34,27,28,0,0,0,0,Cleveland,28,22,15,29,0,0,0,0,20161201,113,94,-4,8,20,19,19,207,-19,2016,0,3,2044,0
Dallas,14,27,19,27,0,0,0,0,Charlotte,23,21,24,29,0,0,0,0,20161201,87,97,9,3,8,10,10,184,10,2016,0,3,928,0
Milwaukee,27,25,38,21,0,0,0,0,Brooklyn,26,25,27,15,0,0,0,0,20161201,111,93,1,1,12,18,18,204,-18,2016,0,3,732,0
Detroit,27,31,32,31,0,0,0,0,Atlanta,24,15,18,28,0,0,0,0,20161202,121,85,3,19,33,36,36,206,-36,2016,0,4,597,0
Sacramento,29,17,26,20,0,0,0,0,Boston,29,18,22,28,0,0,0,0,20161202,92,97,0,1,-3,5,5,189,5,2016,0,4,2624,0
Cleveland,33,27,20,25,0,0,0,0,Chicago,30,29,29,23,0,0,0,0,20161202,105,111,-3,-1,8,6,6,216,6,2016,0,4,308,0
Houston,42,31,26,29,0,0,0,0,Denver,33,30,21,26,0,0,0,0,20161202,128,110,9,10,15,18,18,238,-18,2016,0,4,878,0
LA Clippers,25,35,29,25,0,0,0,0,New Orleans,30,27,19,20,0,0,0,0,20161202,114,96,-5,3,13,18,18,210,-18,2016,0,4,1669,0
Minnesota,21,31,36,26,0,0,0,0,New York,30,32,36,20,0,0,0,0,20161202,114,118,9,10,10,4,4,232,4,2016,0,4,1016,0
Orlando,21,29,32,23,0,0,0,0,Philadelphia,14,28,19,27,0,0,0,0,20161202,105,88,7,8,21,17,17,193,-17,2016,0,4,864,0
Washington,28,32,14,31,0,0,0,0,San Antonio,24,33,23,27,0,0,0,0,20161202,105,107,-4,-3,6,2,2,212,2,2016,0,4,1385,0
LA Lakers,22,26,14,18,0,0,0,0,Toronto,28,41,15,29,0,0,0,0,20161202,80,113,6,21,22,33,33,193,33,2016,0,4,2170,0
Denver,21,26,16,35,0,0,0,0,Utah,24,25,33,23,0,0,0,0,20161203,98,105,3,2,19,7,7,203,7,2016,0,5,370,0
Atlanta,22,25,23,14,0,0,0,0,Toronto,32,30,24,42,0,0,0,0,20161203,84,128,10,15,16,44,44,212,44,2016,0,5,733,0
Miami,29,20,22,21,0,0,0,0,Portland,21,34,18,26,0,0,0,0,20161203,92,99,-8,6,2,7,7,191,7,2016,0,5,2704,0
Boston,22,23,29,33,0,0,0,0,Philadelphia,30,23,21,32,0,0,0,0,20161203,107,106,-8,-8,0,1,1,213,-1,2016,0,5,270,0
LA Lakers,25,37,20,18,0,0,0,0,Memphis,25,29,28,21,0,0,0,0,20161203,100,103,0,-8,0,3,3,203,3,2016,0,5,1599,0
Phoenix,30,27,27,25,0,0,0,0,Golden State,37,29,42,30,0,0,0,0,20161203,109,138,7,9,24,29,29,247,29,2016,0,5,652,0
Chicago,18,27,21,16,0,0,0,0,Dallas,29,28,25,25,0,0,0,0,20161203,82,107,11,12,16,25,25,189,25,2016,0,5,802,0
Brooklyn,22,18,32,31,0,0,0,0,Milwaukee,25,25,25,37,0,0,0,0,20161203,103,112,3,10,3,9,9,215,9,2016,0,5,732,0
Minnesota,19,30,25,32,19,0,0,0,Charlotte,29,23,32,22,14,0,0,0,20161203,125,120,-10,-3,-10,0,5,245,-5,2016,1,5,938,0
New Orleans,26,15,25,26,0,0,0,0,Oklahoma City,29,20,29,23,0,0,0,0,20161204,92,101,3,8,12,9,9,193,9,2016,0,6,576,0
Orlando,23,35,20,20,0,0,0,0,Detroit,27,23,23,19,0,0,0,0,20161204,98,92,-4,8,5,6,6,190,-6,2016,0,6,957,0
Indiana,17,31,35,28,0,0,0,0,LA Clippers,28,24,17,33,0,0,0,0,20161204,111,102,-11,-4,14,9,9,213,-9,2016,0,6,1805,0
Sacramento,21,20,36,21,0,0,0,0,New York,26,29,26,25,0,0,0,0,20161204,98,106,5,14,4,8,8,204,8,2016,0,6,2499,0
Memphis,17,27,30,20,6,10,0,0,New Orleans,21,25,23,25,6,8,0,0,20161205,110,108,-4,-2,5,0,2,218,-2,2016,2,0,358,0
Portland,29,36,21,26,0,0,0,0,Chicago,32,25,30,23,0,0,0,0,20161205,112,110,-3,8,-1,2,2,222,-2,2016,0,0,1754,0
Cleveland,30,32,28,26,0,0,0,0,Toronto,27,34,20,31,0,0,0,0,20161205,116,112,3,1,9,4,4,228,-4,2016,0,0,187,0
San Antonio,26,9,36,26,0,0,0,0,Milwaukee,24,24,25,23,0,0,0,0,20161205,97,96,2,-13,-2,1,1,193,-1,2016,0,0,1108,0
Denver,18,33,23,32,0,0,0,0,Philadelphia,27,26,17,28,0,0,0,0,20161205,106,98,-9,-2,4,8,8,204,-8,2016,0,0,1574,0
Utah,26,31,32,18,0,0,0,0,LA Lakers,26,27,21,27,0,0,0,0,20161205,107,101,0,4,15,6,6,208,-6,2016,0,0,579,0
Oklahoma City,23,32,28,19,0,0,0,0,Atlanta,21,33,15,30,0,0,0,0,20161205,102,99,2,1,14,3,3,201,-3,2016,0,0,755,0
Indiana,27,23,33,23,0,0,0,0,Golden State,38,42,36,26,0,0,0,0,20161205,106,142,11,30,33,36,36,248,36,2016,0,0,1944,0
Charlotte,23,25,27,34,0,0,0,0,Dallas,23,27,28,23,0,0,0,0,20161205,109,101,0,-2,-3,8,8,210,-8,2016,0,0,928,0
Washington,29,22,32,35,0,0,0,0,Brooklyn,32,34,15,32,0,0,0,0,20161205,118,113,-3,-15,2,5,5,231,-5,2016,0,0,204,0
Boston,17,31,35,23,0,0,0,0,Houston,26,32,19,30,0,0,0,0,20161205,106,107,9,10,-6,1,1,213,1,2016,0,0,1603,0
Phoenix,19,26,30,30,0,0,0,0,Utah,33,32,29,18,0,0,0,0,20161206,105,112,14,20,19,7,7,217,7,2016,0,1,505,0
San Antonio,19,24,29,33,0,0,0,0,Minnesota,22,24,18,27,0,0,0,0,20161206,105,91,-3,-3,8,14,14,196,-14,2016,0,1,1112,0
Orlando,25,40,31,28,0,0,0,0,Washington,24,28,29,35,0,0,0,0,20161206,124,116,1,13,15,8,8,240,-8,2016,0,1,757,0
Philadelphia,20,23,34,14,0,0,0,0,Memphis,28,19,29,20,0,0,0,0,20161206,91,96,8,4,-1,5,5,187,5,2016,0,1,878,0
Chicago,21,23,28,19,0,0,0,0,Detroit,32,19,20,31,0,0,0,0,20161206,91,102,11,7,-1,11,11,193,11,2016,0,1,238,0
New York,26,27,31,30,0,0,0,0,Miami,25,29,23,26,0,0,0,0,20161206,114,103,1,-1,7,11,11,217,-11,2016,0,1,1091,0
Boston,26,23,36,32,0,0,0,0,Orlando,27,23,23,14,0,0,0,0,20161207,117,87,-1,-1,12,30,30,204,-30,2016,0,2,1115,0
Miami,25,21,17,32,0,0,0,0,Atlanta,29,24,25,25,0,0,0,0,20161207,95,103,4,7,15,8,8,198,8,2016,0,2,605,0
Denver,23,29,27,32,0,0,0,0,Brooklyn,36,32,28,20,0,0,0,0,20161207,111,116,13,16,17,5,5,227,5,2016,0,2,1627,0
Detroit,24,15,19,19,0,0,0,0,Charlotte,23,15,23,26,0,0,0,0,20161207,77,87,-1,-1,3,10,10,164,10,2016,0,2,504,0
Sacramento,26,30,29,35,0,0,0,0,Dallas,23,29,12,25,0,0,0,0,20161207,120,89,3,4,21,31,31,209,-31,2016,0,2,1437,0
LA Lakers,27,28,22,18,0,0,0,0,Houston,43,24,39,28,0,0,0,0,20161207,95,134,16,12,29,39,39,229,39,2016,0,2,1371,0
Golden State,37,25,29,24,0,0,0,0,LA Clippers,19,30,26,23,0,0,0,0,20161207,115,98,18,13,16,17,17,213,-17,2016,0,2,347,0
Portland,28,30,18,31,0,0,0,0,Milwaukee,28,23,34,30,0,0,0,0,20161207,107,115,0,-7,9,8,8,222,8,2016,0,2,1714,0
Cleveland,36,27,29,34,0,0,0,0,New York,26,22,17,29,0,0,0,0,20161207,126,94,10,15,27,32,32,220,-32,2016,0,2,403,0
Indiana,23,26,33,27,0,0,0,0,Phoenix,22,31,27,14,0,0,0,0,20161207,109,94,1,-4,2,15,15,203,-15,2016,0,2,1496,0
Portland,22,28,19,17,0,0,0,0,Memphis,14,29,18,27,0,0,0,0,20161208,86,88,-8,-7,-8,2,2,174,2,2016,0,3,1845,0
Denver,29,23,21,12,0,0,0,0,Washington,18,29,28,17,0,0,0,0,20161208,85,92,-11,-5,2,7,7,177,7,2016,0,3,1489,0
Golden State,35,30,17,24,0,0,0,0,Utah,17,29,24,29,0,0,0,0,20161208,106,99,18,19,12,7,7,205,-7,2016,0,3,599,0
San Antonio,17,15,31,28,0,0,0,0,Chicago,21,24,27,23,0,0,0,0,20161208,91,95,4,13,9,4,4,186,4,2016,0,3,1050,0
Philadelphia,26,26,19,28,0,0,0,0,New Orleans,31,26,12,19,0,0,0,0,20161208,99,88,-5,-5,2,11,11,187,-11,2016,0,3,1088,0
Minnesota,32,27,30,21,0,0,0,0,Toronto,22,37,29,36,0,0,0,0,20161208,110,124,-10,0,-1,14,14,234,14,2016,0,3,691,0
Toronto,25,17,33,26,0,0,0,0,Boston,28,22,18,26,0,0,0,0,20161209,101,94,-3,-8,7,7,7,195,-7,2016,0,4,430,0
Orlando,21,25,24,18,0,0,0,0,Charlotte,20,32,39,18,0,0,0,0,20161209,88,109,-1,6,21,21,21,197,21,2016,0,4,463,0
Miami,27,19,23,15,0,0,0,0,Cleveland,31,26,30,27,0,0,0,0,20161209,84,114,4,11,18,30,30,198,30,2016,0,4,1089,0
Indiana,27,25,25,26,0,0,0,0,Dallas,25,29,31,26,0,0,0,0,20161209,103,111,-2,2,8,8,8,214,8,2016,0,4,763,0
Phoenix,32,30,27,30,0,0,0,0,LA Lakers,26,26,28,35,0,0,0,0,20161209,119,115,6,10,9,4,4,234,-4,2016,0,4,356,0
Atlanta,23,21,40,30,0,0,0,0,Milwaukee,30,34,28,18,0,0,0,0,20161209,114,110,-7,-20,-8,4,4,224,-4,2016,0,4,669,0
Detroit,25,24,33,35,0,0,0,0,Minnesota,20,23,25,22,0,0,0,0,20161209,117,90,5,6,14,27,27,207,-27,2016,0,4,542,0
Houston,25,30,31,16,0,0,0,0,Oklahoma City,23,26,28,22,0,0,0,0,20161209,102,99,2,6,9,3,3,201,-3,2016,0,4,413,0
New York,30,24,24,25,0,0,0,0,Sacramento,32,21,24,23,0,0,0,0,20161209,103,100,-2,1,1,3,3,203,-3,2016,0,4,2499,0
Milwaukee,32,20,25,28,0,0,0,0,Washington,23,29,25,33,0,0,0,0,20161210,105,110,-9,0,0,5,5,215,5,2016,0,5,634,0
Sacramento,25,25,26,8,0,0,0,0,Utah,29,23,26,26,0,0,0,0,20161210,84,104,4,2,2,20,20,188,20,2016,0,5,532,0
Brooklyn,26,26,18,31,0,0,0,0,San Antonio,41,26,36,27,0,0,0,0,20161210,101,130,15,15,33,29,29,231,29,2016,0,5,1581,0
Denver,32,33,27,29,0,0,0,0,Orlando,29,29,37,18,0,0,0,0,20161210,121,113,3,7,-3,8,8,234,-8,2016,0,5,1548,0
Golden State,16,22,27,24,0,0,0,0,Memphis,31,30,26,23,0,0,0,0,20161210,89,110,15,23,22,21,21,199,21,2016,0,5,1798,0
Miami,27,28,20,25,0,0,0,0,Chicago,29,26,28,22,0,0,0,0,20161210,100,105,2,0,8,5,5,205,5,2016,0,5,1189,0
Portland,44,27,27,13,0,0,0,0,Indiana,31,33,26,28,0,0,0,0,20161210,111,118,-13,-7,-8,7,7,229,7,2016,0,5,1880,0
Dallas,27,22,20,18,0,0,0,0,Houston,36,24,26,23,0,0,0,0,20161210,87,109,9,11,17,22,22,196,22,2016,0,5,225,0
Charlotte,26,26,29,24,0,0,0,0,Cleveland,36,31,25,24,0,0,0,0,20161210,105,116,10,15,11,11,11,221,11,2016,0,5,435,0
New Orleans,31,24,25,25,0,0,0,0,LA Clippers,35,26,37,35,0,0,0,0,20161210,105,133,4,6,18,28,28,238,28,2016,0,5,1669,0
New Orleans,25,26,25,34,10,0,0,0,Phoenix,31,27,24,28,9,0,0,0,20161211,120,119,-6,-7,-6,0,1,239,-1,2016,1,6,1312,0
Golden State,30,30,18,38,0,0,0,0,Minnesota,27,31,30,20,0,0,0,0,20161211,116,108,3,2,-10,8,8,224,-8,2016,0,6,1581,0
Boston,24,19,28,25,0,0,0,0,Oklahoma City,21,18,28,32,0,0,0,0,20161211,96,99,-3,-4,-4,3,3,195,3,2016,0,6,1492,0
Philadelphia,32,26,22,17,0,0,0,0,Detroit,12,23,29,15,0,0,0,0,20161211,97,79,20,23,16,18,18,176,-18,2016,0,6,441,0
New York,32,25,27,34,0,0,0,0,LA Lakers,30,26,19,37,0,0,0,0,20161211,118,112,2,1,9,6,6,230,-6,2016,0,6,2445,0
Denver,19,24,24,25,0,0,0,0,Dallas,27,38,27,20,0,0,0,0,20161212,92,112,8,22,25,20,20,204,20,2016,0,0,661,0
Brooklyn,24,19,42,33,0,0,0,0,Houston,29,24,37,32,0,0,0,0,20161212,118,122,5,10,5,4,4,240,4,2016,0,0,1417,0
Charlotte,20,23,30,21,0,0,0,0,Indiana,25,20,31,34,0,0,0,0,20161212,94,110,5,2,3,16,16,204,16,2016,0,0,428,0
Portland,27,33,26,34,0,0,0,0,LA Clippers,38,18,33,32,0,0,0,0,20161212,120,121,11,-4,3,1,1,241,1,2016,0,0,826,0
Washington,29,24,29,19,0,0,0,0,Miami,28,31,22,31,0,0,0,0,20161212,101,112,-1,6,-1,11,11,213,11,2016,0,0,924,0
LA Lakers,24,34,13,21,0,0,0,0,Sacramento,31,18,39,28,0,0,0,0,20161212,92,116,7,-9,17,24,24,208,24,2016,0,0,361,0
Milwaukee,23,26,33,18,0,0,0,0,Toronto,33,36,23,30,0,0,0,0,20161212,100,122,10,20,10,22,22,222,22,2016,0,0,429,0
Oklahoma City,31,21,19,24,0,0,0,0,Portland,32,36,24,22,0,0,0,0,20161213,95,114,1,16,21,19,19,209,19,2016,0,1,1484,0
New York,25,21,27,28,10,0,0,0,Phoenix,31,23,31,16,12,0,0,0,20161213,111,113,6,8,12,0,2,224,2,2016,1,1,2139,0
Golden State,29,29,37,18,0,0,0,0,New Orleans,35,30,29,15,0,0,0,0,20161213,113,109,-6,-7,1,4,4,222,-4,2016,0,1,1921,0
Minnesota,22,30,26,21,0,0,0,0,Chicago,38,18,19,19,0,0,0,0,20161213,99,94,-16,-4,3,5,5,193,-5,2016,0,1,355,0
Orlando,35,37,27,32,0,0,0,0,Atlanta,34,28,34,24,0,0,0,0,20161213,131,120,1,10,3,11,11,251,-11,2016,0,1,401,0
Memphis,20,23,15,28,0,0,0,0,Cleveland,32,26,15,30,0,0,0,0,20161213,86,103,12,15,15,17,17,189,17,2016,0,1,629,0
Oklahoma City,21,20,27,21,0,0,0,0,Utah,26,29,25,29,0,0,0,0,20161214,89,109,5,14,12,20,20,198,20,2016,0,2,861,0
LA Lakers,30,13,33,21,0,0,0,0,Brooklyn,27,25,23,32,0,0,0,0,20161214,97,107,-3,9,-1,10,10,204,10,2016,0,2,2445,0
Detroit,17,26,17,35,0,0,0,0,Dallas,20,23,21,21,0,0,0,0,20161214,95,85,-3,0,-4,10,10,180,-10,2016,0,2,999,0
Sacramento,25,18,24,31,0,0,0,0,Houston,36,28,38,30,0,0,0,0,20161214,98,132,11,21,35,34,34,230,34,2016,0,2,1606,0
Cleveland,16,20,17,32,0,0,0,0,Memphis,28,19,27,19,0,0,0,0,20161214,85,93,12,11,21,8,8,178,8,2016,0,2,629,0
Indiana,21,31,27,10,0,0,0,0,Miami,20,33,25,17,0,0,0,0,20161214,89,95,-1,1,-1,6,6,184,6,2016,0,2,1026,0
LA Clippers,30,30,27,26,0,0,0,0,Orlando,25,26,36,21,0,0,0,0,20161214,113,108,5,9,0,5,5,221,-5,2016,0,2,2197,0
Toronto,22,38,32,31,0,0,0,0,Philadelphia,25,29,20,40,0,0,0,0,20161214,123,114,-3,6,18,9,9,237,-9,2016,0,2,334,0
Boston,23,24,26,28,0,0,0,0,San Antonio,32,24,21,31,0,0,0,0,20161214,101,108,9,9,4,7,7,209,7,2016,0,2,1765,0
Charlotte,30,24,23,29,0,0,0,0,Washington,26,23,38,22,0,0,0,0,20161214,106,109,-4,-5,10,3,3,215,3,2016,0,2,329,0
San Antonio,23,28,23,33,0,0,0,0,Phoenix,20,23,28,21,0,0,0,0,20161215,107,92,3,8,3,15,15,199,-15,2016,0,3,846,0
Chicago,18,27,21,31,0,0,0,0,Milwaukee,30,34,24,20,0,0,0,0,20161215,97,108,12,19,22,11,11,205,11,2016,0,3,83,0
Indiana,20,30,24,21,0,0,0,0,New Orleans,24,22,25,31,0,0,0,0,20161215,95,102,4,-4,-3,7,7,197,7,2016,0,3,713,0
Portland,28,28,29,35,0,0,0,0,Denver,38,36,26,32,0,0,0,0,20161215,120,132,10,18,15,12,12,252,12,2016,0,3,981,0
New York,25,20,21,24,0,0,0,0,Golden State,32,27,29,15,0,0,0,0,20161215,90,103,7,14,22,13,13,193,13,2016,0,3,2565,0
Dallas,29,29,19,23,0,0,0,0,Utah,33,31,26,13,0,0,0,0,20161216,100,103,4,6,13,3,3,203,3,2016,0,4,998,0
Detroit,27,27,23,31,0,0,0,0,Washington,27,38,30,27,0,0,0,0,20161216,108,122,0,11,18,14,14,230,14,2016,0,4,394,0
LA Lakers,30,23,21,26,0,0,0,0,Philadelphia,18,22,24,25,0,0,0,0,20161216,100,89,12,13,10,11,11,189,-11,2016,0,4,2388,0
Brooklyn,28,24,30,29,0,0,0,0,Orlando,25,28,30,35,0,0,0,0,20161216,111,118,-3,1,1,7,7,229,7,2016,0,4,939,0
Atlanta,35,34,26,30,0,0,0,0,Toronto,27,25,30,39,0,0,0,0,20161216,125,121,8,17,13,4,4,246,-4,2016,0,4,733,0
Sacramento,24,28,24,20,0,0,0,0,Memphis,19,23,23,27,0,0,0,0,20161216,96,92,5,10,11,4,4,188,-4,2016,0,4,1745,0
New Orleans,24,26,29,21,0,0,0,0,Houston,35,37,25,25,0,0,0,0,20161216,100,122,11,22,18,22,22,222,22,2016,0,4,317,0
Milwaukee,34,22,18,21,0,0,0,0,Chicago,15,22,15,17,0,0,0,0,20161216,95,69,19,19,22,26,26,164,-26,2016,0,4,83,0
Charlotte,22,28,19,19,0,0,0,0,Boston,23,18,28,27,0,0,0,0,20161216,88,96,1,-9,0,8,8,184,8,2016,0,4,720,0
LA Clippers,31,29,19,23,0,0,0,0,Miami,27,19,23,29,0,0,0,0,20161216,102,98,4,14,10,4,4,200,-4,2016,0,4,2335,0
Houston,28,16,23,28,16,0,0,0,Minnesota,24,33,23,15,14,0,0,0,20161217,111,109,4,-13,-13,0,2,220,-2,2016,1,5,1057,0
Charlotte,22,31,27,27,0,0,0,0,Atlanta,22,20,32,25,0,0,0,0,20161217,107,99,0,11,6,8,8,206,-8,2016,0,5,226,0
LA Lakers,31,28,24,25,0,0,0,0,Cleveland,26,36,27,30,0,0,0,0,20161217,108,119,-5,3,6,11,11,227,11,2016,0,5,2044,0
New York,22,32,26,34,0,0,0,0,Denver,33,29,34,31,0,0,0,0,20161217,114,127,11,8,16,13,13,241,13,2016,0,5,1627,0
Indiana,27,28,28,22,0,0,0,0,Detroit,26,18,25,21,0,0,0,0,20161217,105,90,1,11,14,15,15,195,-15,2016,0,5,240,0
Portland,21,24,27,18,0,0,0,0,Golden State,39,31,38,27,0,0,0,0,20161217,90,135,18,25,36,45,45,225,45,2016,0,5,535,0
Phoenix,20,19,30,32,0,0,0,0,Oklahoma City,30,24,35,25,0,0,0,0,20161217,101,114,10,15,20,13,13,215,13,2016,0,5,840,0
LA Clippers,27,28,32,23,0,0,0,0,Washington,28,24,33,32,0,0,0,0,20161218,110,117,1,-3,-2,7,7,227,7,2016,0,6,2294,0
Brooklyn,32,25,29,21,0,0,0,0,Philadelphia,30,24,29,25,0,0,0,0,20161218,107,108,-2,-3,-3,1,1,215,1,2016,0,6,80,0
Toronto,23,32,29,25,0,0,0,0,Orlando,30,21,13,15,0,0,0,0,20161218,109,79,-7,4,20,30,30,188,-30,2016,0,6,1048,0
New Orleans,26,23,22,29,0,0,0,0,San Antonio,30,31,31,21,0,0,0,0,20161218,100,113,4,12,21,13,13,213,13,2016,0,6,506,0
Utah,18,16,27,21,0,0,0,0,Memphis,18,17,23,15,0,0,0,0,20161218,82,73,0,-1,3,9,9,155,-9,2016,0,6,1247,0
Sacramento,21,23,14,21,0,0,0,0,Dallas,28,27,21,23,0,0,0,0,20161218,79,99,7,11,18,20,20,178,20,2016,0,6,1437,0
Boston,37,21,19,28,0,0,0,0,Miami,19,22,30,24,0,0,0,0,20161218,105,95,18,17,6,10,10,200,-10,2016,0,6,1257,0
Detroit,19,15,29,19,0,0,0,0,Chicago,35,34,28,16,0,0,0,0,20161219,82,113,16,35,34,31,31,195,31,2016,0,0,238,0
Dallas,31,27,27,22,0,0,0,0,Denver,28,32,33,24,0,0,0,0,20161219,107,117,-3,2,8,10,10,224,10,2016,0,0,661,0
Washington,36,21,22,26,0,0,0,0,Indiana,29,28,31,19,0,0,0,0,20161219,105,107,-7,0,9,2,2,212,2,2016,0,0,490,0
Phoenix,23,31,33,21,0,0,0,0,Minnesota,29,33,29,24,0,0,0,0,20161219,108,115,6,8,4,7,7,223,7,2016,0,0,1278,0
Atlanta,22,26,33,29,0,0,0,0,Oklahoma City,16,37,25,30,0,0,0,0,20161219,110,108,6,-5,3,2,2,218,-2,2016,0,0,755,0
Brooklyn,23,23,26,32,0,0,0,0,Toronto,29,35,27,25,0,0,0,0,20161220,104,116,6,18,19,12,12,220,12,2016,0,1,341,0
Portland,35,37,27,22,0,0,0,0,Sacramento,27,33,33,33,0,0,0,0,20161220,121,126,-8,-12,-6,5,5,247,5,2016,0,1,483,0
New Orleans,15,42,27,24,0,0,0,0,Philadelphia,23,21,25,24,0,0,0,0,20161220,108,93,-8,13,15,15,15,201,-15,2016,0,1,1088,0
Indiana,24,35,28,24,0,0,0,0,New York,20,34,30,34,0,0,0,0,20161220,111,118,-4,-5,-3,7,7,229,7,2016,0,1,643,0
Cleveland,35,22,27,16,14,0,0,0,Milwaukee,27,26,25,22,8,0,0,0,20161220,114,108,8,4,6,0,6,222,-6,2016,1,1,334,0
Orlando,27,30,28,24,9,18,0,0,Miami,28,36,25,20,9,12,0,0,20161220,136,130,-1,-7,-4,0,6,266,-6,2016,2,1,204,0
Denver,26,27,19,30,0,0,0,0,LA Clippers,36,32,27,24,0,0,0,0,20161220,102,119,10,15,23,17,17,221,17,2016,0,1,830,0
San Antonio,26,26,19,31,0,0,0,0,Houston,24,21,33,22,0,0,0,0,20161220,102,100,2,7,-7,2,2,202,-2,2016,0,1,189,0
Utah,15,18,21,20,0,0,0,0,Golden State,19,36,27,22,0,0,0,0,20161220,74,104,4,22,28,30,30,178,30,2016,0,1,599,0
LA Lakers,41,32,23,17,0,0,0,0,Charlotte,35,24,35,23,0,0,0,0,20161220,113,117,-6,-14,-2,4,4,230,4,2016,0,1,2115,0
Boston,15,16,31,35,15,0,0,0,Memphis,22,23,26,26,12,0,0,0,20161220,112,109,-7,-14,-9,0,3,221,-3,2016,1,1,1134,0
Dallas,30,32,19,15,0,0,0,0,Portland,20,18,33,24,0,0,0,0,20161221,96,95,10,24,10,1,1,191,-1,2016,0,2,1630,0
Minnesota,28,21,18,25,0,0,0,0,Atlanta,26,18,25,15,0,0,0,0,20161221,92,84,2,5,-2,8,8,176,-8,2016,0,2,908,0
Washington,22,33,22,30,0,0,0,0,Chicago,33,23,21,20,0,0,0,0,20161221,107,97,-11,-1,0,10,10,204,-10,2016,0,2,594,0
Milwaukee,22,32,23,25,0,0,0,0,Cleveland,31,28,33,21,0,0,0,0,20161221,102,113,9,5,15,11,11,215,11,2016,0,2,334,0
Memphis,29,24,26,19,0,0,0,0,Detroit,19,25,19,23,0,0,0,0,20161221,98,86,10,9,16,12,12,184,-12,2016,0,2,622,0
Oklahoma City,34,29,24,34,0,0,0,0,New Orleans,28,30,26,26,0,0,0,0,20161221,121,110,6,5,3,11,11,231,-11,2016,0,2,576,0
Houston,30,31,30,34,0,0,0,0,Phoenix,26,29,29,27,0,0,0,0,20161221,125,111,4,6,7,14,14,236,-14,2016,0,2,1014,0
Sacramento,17,21,24,32,0,0,0,0,Utah,24,24,25,20,0,0,0,0,20161221,94,93,-7,-10,-11,1,1,187,-1,2016,0,2,532,0
Orlando,19,28,25,23,0,0,0,0,New York,27,30,24,25,0,0,0,0,20161222,95,106,8,10,9,11,11,201,11,2016,0,3,939,0
LA Lakers,25,35,20,27,0,0,0,0,Miami,17,36,29,33,0,0,0,0,20161222,107,115,-8,-7,2,8,8,222,8,2016,0,3,2335,0
San Antonio,22,23,28,28,0,0,0,0,LA Clippers,27,30,24,25,0,0,0,0,20161222,101,106,5,12,8,5,5,207,5,2016,0,3,1201,0
Boston,22,29,26,32,0,0,0,0,Indiana,31,9,27,35,0,0,0,0,20161222,109,102,-9,11,10,7,7,211,-7,2016,0,3,805,0
Golden State,33,16,39,29,0,0,0,0,Brooklyn,34,31,19,17,0,0,0,0,20161222,117,101,-1,-16,4,16,16,218,-16,2016,0,3,2565,0
Toronto,28,28,16,32,0,0,0,0,Utah,29,22,23,24,0,0,0,0,20161223,104,98,-1,5,-2,6,6,202,-6,2016,0,4,1664,0
San Antonio,27,30,30,23,0,0,0,0,Portland,27,18,27,18,0,0,0,0,20161223,110,90,0,12,15,20,20,200,-20,2016,0,4,1718,0
Philadelphia,31,35,19,31,0,0,0,0,Phoenix,24,29,28,42,0,0,0,0,20161223,116,123,-7,-13,-4,7,7,239,7,2016,0,4,2078,0
Miami,28,21,19,19,0,0,0,0,New Orleans,25,19,20,27,0,0,0,0,20161223,87,91,-3,-5,-4,4,4,178,4,2016,0,4,668,0
Sacramento,25,26,27,31,0,0,0,0,Minnesota,26,29,30,20,0,0,0,0,20161223,109,105,-1,-4,-7,4,4,214,-4,2016,0,4,1511,0
Washington,29,29,20,18,0,0,0,0,Milwaukee,37,36,27,23,0,0,0,0,20161223,96,123,8,15,22,27,27,219,27,2016,0,4,634,0
LA Lakers,14,26,29,21,0,0,0,0,Orlando,30,27,29,23,0,0,0,0,20161223,90,109,16,17,17,19,19,199,19,2016,0,4,2197,0
Dallas,21,29,18,22,0,0,0,0,LA Clippers,24,27,21,16,0,0,0,0,20161223,90,88,-3,-1,-4,2,2,178,-2,2016,0,4,1237,0
Golden State,33,24,31,31,0,0,0,0,Detroit,32,27,25,29,0,0,0,0,20161223,119,113,1,-2,4,6,6,232,-6,2016,0,4,2087,0
Atlanta,29,22,31,27,0,0,0,0,Denver,29,26,27,26,0,0,0,0,20161223,109,108,0,-4,0,1,1,217,-1,2016,0,4,1209,0
Brooklyn,15,25,17,42,0,0,0,0,Cleveland,29,37,32,21,0,0,0,0,20161223,99,119,14,26,41,20,20,218,20,2016,0,4,403,0
Chicago,26,14,27,24,0,0,0,0,Charlotte,22,26,27,28,0,0,0,0,20161223,91,103,-4,8,8,12,12,194,12,2016,0,4,586,0
Oklahoma City,25,33,30,29,0,0,0,0,Boston,28,26,25,33,0,0,0,0,20161223,117,112,-3,4,9,5,5,229,-5,2016,0,4,1492,0
Houston,31,18,26,34,0,0,0,0,Memphis,25,29,23,38,0,0,0,0,20161223,109,115,-6,5,2,6,6,224,6,2016,0,4,484,0
Chicago,25,25,26,24,0,0,0,0,San Antonio,36,19,32,32,0,0,0,0,20161225,100,119,11,5,11,19,19,219,19,2016,0,6,1050,0
Minnesota,27,26,22,25,0,0,0,0,Oklahoma City,23,34,29,26,0,0,0,0,20161225,100,112,-4,4,11,12,12,212,12,2016,0,6,694,0
LA Clippers,31,27,16,28,0,0,0,0,LA Lakers,27,28,34,22,0,0,0,0,20161225,102,111,-4,-3,15,9,9,213,9,2016,0,6,0,0
Golden State,27,28,32,21,0,0,0,0,Cleveland,25,27,28,29,0,0,0,0,20161225,108,109,-2,-3,-7,1,1,217,1,2016,0,6,2161,0
Boston,22,34,32,31,0,0,0,0,New York,28,20,34,32,0,0,0,0,20161225,119,114,-6,8,6,5,5,233,-5,2016,0,6,190,0
Memphis,18,25,28,31,0,0,0,0,Orlando,36,32,28,16,0,0,0,0,20161226,102,112,18,25,25,10,10,214,10,2016,0,0,683,0
Milwaukee,27,30,27,18,0,0,0,0,Washington,28,25,29,25,0,0,0,0,20161226,102,107,1,-4,-2,5,5,209,5,2016,0,0,634,0
Philadelphia,23,24,30,23,0,0,0,0,Sacramento,24,27,19,32,0,0,0,0,20161226,100,102,1,4,-7,2,2,202,2,2016,0,0,2451,0
Toronto,21,22,30,22,0,0,0,0,Portland,24,18,26,23,0,0,0,0,20161226,95,91,-3,1,5,4,4,186,-4,2016,0,0,2108,0
Dallas,20,33,24,27,0,0,0,0,New Orleans,25,30,30,26,0,0,0,0,20161226,104,111,5,2,8,7,7,215,7,2016,0,0,442,0
Atlanta,25,20,20,25,0,0,0,0,Minnesota,23,31,35,15,0,0,0,0,20161226,90,104,-2,9,24,14,14,194,14,2016,0,0,908,0
Denver,23,40,16,27,0,0,0,0,LA Clippers,23,23,31,25,0,0,0,0,20161226,106,102,0,17,2,4,4,208,-4,2016,0,0,830,0
Phoenix,23,20,37,35,0,0,0,0,Houston,39,30,38,24,0,0,0,0,20161226,115,131,16,26,27,16,16,246,16,2016,0,0,1014,0
Cleveland,19,25,20,26,0,0,0,0,Detroit,22,28,26,30,0,0,0,0,20161226,90,106,3,6,12,16,16,196,16,2016,0,0,90,0
Indiana,19,22,20,24,0,0,0,0,Chicago,28,23,12,27,0,0,0,0,20161226,85,90,9,10,2,5,5,175,5,2016,0,0,163,0
Charlotte,40,23,25,30,0,0,0,0,Brooklyn,31,23,29,37,0,0,0,0,20161226,118,120,-9,-9,-5,2,2,238,2,2016,0,0,531,0
Memphis,24,24,29,26,0,0,0,0,Boston,28,28,28,29,0,0,0,0,20161227,103,113,4,8,7,10,10,216,10,2016,0,1,1134,0
Houston,31,35,32,25,0,0,0,0,Dallas,31,16,27,33,0,0,0,0,20161227,123,107,0,19,24,16,16,230,-16,2016,0,1,225,0
Utah,28,20,24,30,0,0,0,0,LA Lakers,25,27,22,26,0,0,0,0,20161227,102,100,3,-4,-2,2,2,202,-2,2016,0,1,579,0
Oklahoma City,33,28,26,19,0,0,0,0,Miami,19,29,21,25,0,0,0,0,20161227,106,94,14,13,18,12,12,200,-12,2016,0,1,1225,0
Indiana,25,23,26,31,0,0,0,0,Washington,23,35,27,26,0,0,0,0,20161228,105,111,-2,10,11,6,6,216,6,2016,0,2,490,0
Phoenix,27,37,18,16,0,0,0,0,San Antonio,30,28,31,30,0,0,0,0,20161228,98,119,3,-6,7,21,21,217,21,2016,0,2,846,0
Sacramento,21,23,19,26,0,0,0,0,Portland,30,30,15,27,0,0,0,0,20161228,89,102,9,16,12,13,13,191,13,2016,0,2,483,0
Charlotte,32,30,35,23,0,0,0,0,Orlando,28,27,13,33,0,0,0,0,20161228,120,101,4,7,29,19,19,221,-19,2016,0,2,463,0
LA Clippers,27,29,21,21,0,0,0,0,New Orleans,19,30,27,26,0,0,0,0,20161228,98,102,-8,-7,-1,4,4,200,4,2016,0,2,1669,0
Milwaukee,31,31,28,29,0,0,0,0,Detroit,28,26,21,19,0,0,0,0,20161228,119,94,3,8,15,25,25,213,-25,2016,0,2,251,0
Minnesota,31,18,24,30,0,0,0,0,Denver,22,27,32,24,0,0,0,0,20161228,103,105,-9,0,8,2,2,208,2,2016,0,2,698,0
Brooklyn,20,29,29,21,0,0,0,0,Chicago,23,23,30,25,0,0,0,0,20161228,99,101,3,-3,-2,2,2,200,2,2016,0,2,711,0
New York,25,22,19,19,13,0,0,0,Atlanta,22,23,20,20,17,0,0,0,20161228,98,102,-3,-2,-1,0,4,200,4,2016,1,2,745,0
Toronto,17,38,32,24,0,0,0,0,Golden State,42,30,32,17,0,0,0,0,20161228,111,121,25,17,17,10,10,232,10,2016,0,2,2263,0
Philadelphia,24,27,23,9,0,0,0,0,Utah,22,27,21,30,0,0,0,0,20161229,83,100,-2,-2,-4,17,17,183,17,2016,0,3,1920,0
Miami,19,30,17,16,0,0,0,0,Charlotte,21,21,31,18,0,0,0,0,20161229,82,91,2,-7,7,9,9,173,9,2016,0,3,654,0
Boston,25,34,24,35,0,0,0,0,Cleveland,32,34,35,23,0,0,0,0,20161229,118,124,7,7,18,6,6,242,6,2016,0,3,549,0
Dallas,26,24,31,20,0,0,0,0,LA Lakers,27,30,13,19,0,0,0,0,20161229,101,89,-1,-7,11,12,12,190,-12,2016,0,3,1237,0
Oklahoma City,21,18,22,19,0,0,0,0,Memphis,27,28,23,36,0,0,0,0,20161229,80,114,6,16,17,34,34,194,34,2016,0,3,421,0
Toronto,18,22,22,29,0,0,0,0,Phoenix,16,26,34,23,0,0,0,0,20161229,91,99,-2,2,14,8,8,190,8,2016,0,3,1885,0
Portland,32,20,21,21,0,0,0,0,San Antonio,22,25,33,30,0,0,0,0,20161230,94,110,-10,-5,7,16,16,204,16,2016,0,4,1718,0
Philadelphia,30,30,31,33,0,0,0,0,Denver,28,32,27,35,0,0,0,0,20161230,124,122,2,0,4,2,2,246,-2,2016,0,4,1574,0
New York,21,30,18,23,0,0,0,0,New Orleans,31,24,24,25,0,0,0,0,20161230,92,104,10,4,10,12,12,196,12,2016,0,4,1168,0
Brooklyn,23,27,27,18,0,0,0,0,Washington,31,35,25,27,0,0,0,0,20161230,95,118,8,16,14,23,23,213,23,2016,0,4,204,0
Milwaukee,21,27,23,28,0,0,0,0,Minnesota,34,21,30,31,0,0,0,0,20161230,99,116,13,7,14,17,17,215,17,2016,0,4,298,0
Miami,25,23,30,36,0,0,0,0,Boston,25,27,30,35,0,0,0,0,20161230,114,117,0,4,4,3,3,231,3,2016,0,4,1257,0
LA Clippers,23,34,41,18,0,0,0,0,Houston,37,37,34,32,0,0,0,0,20161230,116,140,14,17,10,24,24,256,24,2016,0,4,1371,0
Dallas,29,19,21,30,0,0,0,0,Golden State,29,30,32,17,0,0,0,0,20161230,99,108,0,11,22,9,9,207,9,2016,0,4,1480,0
Chicago,22,28,23,28,0,0,0,0,Indiana,28,34,22,27,0,0,0,0,20161230,101,111,6,12,11,10,10,212,10,2016,0,4,163,0
Detroit,19,22,21,36,0,0,0,0,Atlanta,19,32,23,31,0,0,0,0,20161230,98,105,0,10,12,7,7,203,7,2016,0,4,597,0
Milwaukee,22,27,31,36,0,0,0,0,Chicago,27,24,25,20,0,0,0,0,20161231,116,96,-5,-2,4,20,20,212,-20,2016,0,5,83,0
Cleveland,35,36,28,22,0,0,0,0,Charlotte,28,31,23,27,0,0,0,0,20161231,121,109,7,12,17,12,12,230,-12,2016,0,5,435,0
New York,32,23,37,30,0,0,0,0,Houston,27,42,30,30,0,0,0,0,20161231,122,129,-5,14,7,7,7,251,7,2016,0,5,1417,0
LA Clippers,12,28,28,20,0,0,0,0,Oklahoma City,33,36,27,18,0,0,0,0,20161231,88,114,21,29,28,26,26,202,26,2016,0,5,1178,0
Memphis,21,29,32,30,0,0,0,0,Sacramento,20,25,22,31,0,0,0,0,20161231,112,98,1,5,15,14,14,210,-14,2016,0,5,1745,0
Phoenix,29,22,20,15,0,0,0,0,Utah,29,26,21,15,0,0,0,0,20161231,86,91,0,4,5,5,5,177,5,2016,0,5,505,0
Portland,24,13,32,26,0,0,0,0,Minnesota,23,26,15,25,0,0,0,0,20170101,95,89,1,-12,5,6,6,184,-6,2016,0,6,1423,0
Toronto,27,31,27,38,0,0,0,0,LA Lakers,33,24,26,31,0,0,0,0,20170101,123,114,-6,1,2,9,9,237,-9,2016,0,6,2170,0
Detroit,33,25,27,22,0,0,0,0,Miami,37,29,15,17,0,0,0,0,20170101,107,98,-4,-8,4,9,9,205,-9,2016,0,6,1155,0
San Antonio,27,19,28,26,12,0,0,0,Atlanta,25,19,25,31,14,0,0,0,20170101,112,114,-2,-2,-5,0,2,226,2,2016,1,6,881,0
Orlando,17,34,22,31,0,0,0,0,Indiana,27,35,27,28,0,0,0,0,20170101,104,117,10,11,16,13,13,221,13,2016,0,6,822,0
Utah,24,26,20,31,0,0,0,0,Brooklyn,26,26,18,19,0,0,0,0,20170102,101,89,-2,-2,0,12,12,190,-12,2016,0,0,1967,0
Charlotte,23,34,28,26,0,0,0,0,Chicago,25,33,24,36,0,0,0,0,20170102,111,118,2,1,-3,7,7,229,7,2016,0,0,586,0
New Orleans,22,21,26,13,0,0,0,0,Cleveland,15,29,23,23,0,0,0,0,20170102,82,90,-7,1,-2,8,8,172,8,2016,0,0,924,0
Denver,33,31,21,34,0,0,0,0,Golden State,35,33,26,33,0,0,0,0,20170102,119,127,2,4,9,8,8,246,8,2016,0,0,947,0
Washington,29,24,17,21,0,0,0,0,Houston,14,27,37,23,0,0,0,0,20170102,91,101,-15,-12,8,10,10,192,10,2016,0,0,1217,0
Phoenix,26,32,18,22,0,0,0,0,LA Clippers,27,37,25,20,0,0,0,0,20170102,98,109,1,6,13,11,11,207,11,2016,0,0,356,0
Oklahoma City,30,26,16,22,0,0,0,0,Milwaukee,22,28,29,19,0,0,0,0,20170102,94,98,-8,-6,7,4,4,192,4,2016,0,0,732,0
Orlando,33,34,25,23,0,0,0,0,New York,32,27,21,23,0,0,0,0,20170102,115,103,1,8,12,12,12,218,-12,2016,0,0,939,0
Minnesota,16,26,26,23,0,0,0,0,Philadelphia,29,28,22,14,0,0,0,0,20170103,91,93,13,15,11,2,2,184,2,2016,0,1,983,0
Miami,29,23,14,24,0,0,0,0,Phoenix,28,28,27,16,0,0,0,0,20170103,90,99,-1,4,17,9,9,189,9,2016,0,1,1978,0
Toronto,18,23,17,24,0,0,0,0,San Antonio,29,31,28,22,0,0,0,0,20170103,82,110,11,19,30,28,28,192,28,2016,0,1,1438,0
Memphis,20,28,29,25,0,0,0,0,LA Lakers,22,35,34,25,0,0,0,0,20170103,102,116,2,9,14,14,14,218,14,2016,0,1,1599,0
Washington,29,38,21,17,0,0,0,0,Dallas,28,33,26,26,0,0,0,0,20170103,105,113,-1,-6,-1,8,8,218,8,2016,0,1,1181,0
Sacramento,29,31,34,26,0,0,0,0,Denver,28,23,37,25,0,0,0,0,20170103,120,113,1,9,6,7,7,233,-7,2016,0,1,886,0
Utah,29,16,29,30,0,0,0,0,Boston,28,26,31,30,0,0,0,0,20170103,104,115,-1,9,11,11,11,219,11,2016,0,1,2093,0
Indiana,36,30,26,29,0,0,0,0,Detroit,28,32,32,24,0,0,0,0,20170103,121,116,8,6,0,5,5,237,-5,2016,0,1,240,0
Oklahoma City,22,33,33,24,0,0,0,0,Charlotte,27,33,27,36,0,0,0,0,20170104,112,123,5,5,-1,11,11,235,11,2016,0,2,938,0
Chicago,16,36,31,23,0,0,0,0,Cleveland,23,23,28,20,0,0,0,0,20170104,106,94,-7,6,9,12,12,200,-12,2016,0,2,308,0
Portland,34,37,21,25,0,0,0,0,Golden State,40,29,30,26,0,0,0,0,20170104,117,125,6,-2,7,8,8,242,8,2016,0,2,535,0
Memphis,29,34,22,21,0,0,0,0,LA Clippers,30,23,36,26,0,0,0,0,20170104,106,115,1,-10,4,9,9,221,9,2016,0,2,1599,0
Milwaukee,27,25,21,32,0,0,0,0,New York,25,27,35,17,0,0,0,0,20170104,105,104,2,0,-14,1,1,209,-1,2016,0,2,732,0
Atlanta,23,29,26,33,0,0,0,0,Orlando,26,21,18,27,0,0,0,0,20170104,111,92,-3,5,13,19,19,203,-19,2016,0,2,401,0
Miami,30,34,23,20,0,0,0,0,Sacramento,25,34,22,21,0,0,0,0,20170104,107,102,5,5,6,5,5,209,-5,2016,0,2,2547,0
Utah,27,25,21,20,0,0,0,0,Toronto,18,30,23,30,0,0,0,0,20170105,93,101,-9,-4,-2,8,8,194,8,2016,0,3,1664,0
LA Lakers,24,38,22,25,0,0,0,0,Portland,29,24,31,34,0,0,0,0,20170105,109,118,5,-9,0,9,9,227,9,2016,0,3,826,0
Atlanta,23,19,33,24,0,0,0,0,New Orleans,28,19,25,22,0,0,0,0,20170105,99,94,-5,-5,3,5,5,193,-5,2016,0,3,424,0
Brooklyn,27,25,32,25,0,0,0,0,Indiana,34,25,38,24,0,0,0,0,20170105,109,121,7,7,13,12,12,230,12,2016,0,3,643,0
Phoenix,19,22,29,32,0,0,0,0,Dallas,22,23,27,23,0,0,0,0,20170105,102,95,-3,-4,-2,7,7,197,-7,2016,0,3,884,0
Charlotte,26,22,22,44,0,0,0,0,Detroit,37,21,27,30,0,0,0,0,20170105,114,115,11,10,15,1,1,229,1,2016,0,3,504,0
San Antonio,29,29,32,37,0,0,0,0,Denver,33,20,24,22,0,0,0,0,20170105,127,99,-4,5,13,28,28,226,-28,2016,0,3,802,0
Oklahoma City,38,18,27,33,0,0,0,0,Houston,33,34,30,21,0,0,0,0,20170105,116,118,-5,11,14,2,2,234,2,2016,0,3,413,0
Minnesota,29,19,37,20,0,0,0,0,Washington,32,24,24,32,0,0,0,0,20170106,105,112,3,8,-5,7,7,217,7,2016,0,4,931,0
LA Clippers,19,34,22,31,0,0,0,0,Sacramento,29,12,32,25,0,0,0,0,20170106,106,98,-10,12,2,8,8,204,-8,2016,0,4,361,0
New York,32,21,30,33,0,0,0,0,Milwaukee,33,32,31,15,0,0,0,0,20170106,116,111,-1,-12,-13,5,5,227,-5,2016,0,4,732,0
Houston,19,25,35,21,0,0,0,0,Orlando,22,30,23,18,0,0,0,0,20170106,100,93,-3,-8,4,7,7,193,-7,2016,0,4,847,0
Memphis,27,28,24,32,17,0,0,0,Golden State,34,33,31,13,8,0,0,0,20170106,128,119,-7,-12,-19,0,9,247,-9,2016,1,4,1798,0
Philadelphia,23,39,18,26,0,0,0,0,Boston,25,26,27,32,0,0,0,0,20170106,106,110,2,-11,-2,4,4,216,4,2016,0,4,270,0
Miami,23,33,23,21,0,0,0,0,LA Lakers,32,26,32,37,0,0,0,0,20170106,100,127,9,2,11,27,27,227,27,2016,0,4,2335,0
Cleveland,24,26,36,30,0,0,0,0,Brooklyn,20,19,29,40,0,0,0,0,20170106,116,108,4,11,18,8,8,224,-8,2016,0,4,403,0
New Orleans,31,22,20,35,0,0,0,0,Boston,28,29,36,24,0,0,0,0,20170107,108,117,-3,4,20,9,9,225,9,2016,0,5,1358,0
Toronto,28,33,25,21,11,0,0,0,Chicago,29,19,26,33,16,0,0,0,20170107,118,123,1,-13,-12,0,5,241,5,2016,1,5,436,0
Atlanta,22,23,21,31,0,0,0,0,Dallas,20,22,17,23,0,0,0,0,20170107,97,82,2,3,7,15,15,179,-15,2016,0,5,719,0
New York,29,14,27,39,0,0,0,0,Indiana,33,29,34,27,0,0,0,0,20170107,109,123,4,19,26,14,14,232,14,2016,0,5,643,0
Utah,25,22,22,25,0,0,0,0,Minnesota,24,24,32,12,0,0,0,0,20170107,94,92,1,-1,-11,2,2,186,-2,2016,0,5,984,0
Denver,22,38,20,26,0,0,0,0,Oklahoma City,24,36,28,33,0,0,0,0,20170107,106,121,2,0,8,15,15,227,15,2016,0,5,503,0
Charlotte,24,26,14,21,0,0,0,0,San Antonio,24,23,26,29,0,0,0,0,20170107,85,102,0,-3,9,17,17,187,17,2016,0,5,1103,0
Utah,18,17,16,28,0,0,0,0,Memphis,19,23,21,25,0,0,0,0,20170108,79,88,1,7,12,9,9,167,9,2016,0,6,1247,0
Houston,27,34,34,34,0,0,0,0,Toronto,37,26,36,23,0,0,0,0,20170108,129,122,-10,-2,-4,7,7,251,-7,2016,0,6,1299,0
Golden State,24,27,39,27,0,0,0,0,Sacramento,33,25,22,26,0,0,0,0,20170108,117,106,-9,-7,10,11,11,223,-11,2016,0,6,75,0
Detroit,31,22,27,26,8,11,0,0,Portland,30,26,31,19,8,10,0,0,20170108,125,124,1,-3,-7,0,1,249,-1,2016,2,6,1964,0
Cleveland,41,28,24,27,0,0,0,0,Phoenix,28,25,37,26,0,0,0,0,20170108,120,116,13,16,3,4,4,236,-4,2016,0,6,1745,0
Orlando,34,26,9,26,0,0,0,0,LA Lakers,40,22,19,30,0,0,0,0,20170108,95,111,6,2,12,16,16,206,16,2016,0,6,2197,0
Miami,19,20,27,20,0,0,0,0,LA Clippers,20,32,28,18,0,0,0,0,20170108,86,98,1,13,14,12,12,184,12,2016,0,6,2335,0
Philadelphia,24,22,32,27,0,0,0,0,Brooklyn,27,30,16,22,0,0,0,0,20170108,105,95,-3,-11,5,10,10,200,-10,2016,0,6,80,0
Washington,24,25,33,25,0,0,0,0,Milwaukee,31,26,21,23,0,0,0,0,20170108,107,101,-7,-8,4,6,6,208,-6,2016,0,6,634,0
Oklahoma City,26,35,28,20,0,0,0,0,Chicago,20,26,21,27,0,0,0,0,20170109,109,94,6,15,22,15,15,203,-15,2016,0,0,690,0
Dallas,19,27,24,22,0,0,0,0,Minnesota,33,21,23,24,0,0,0,0,20170109,92,101,14,8,7,9,9,193,9,2016,0,0,863,0
New Orleans,29,31,31,19,0,0,0,0,New York,26,25,15,30,0,0,0,0,20170109,110,96,3,9,25,14,14,206,-14,2016,0,0,1168,0
Milwaukee,23,30,30,26,0,0,0,0,San Antonio,23,36,30,18,0,0,0,0,20170110,109,107,0,-6,-6,2,2,216,-2,2016,0,1,1108,0
Cleveland,29,12,25,26,0,0,0,0,Utah,29,27,19,25,0,0,0,0,20170110,92,100,0,15,9,8,8,192,8,2016,0,1,1564,0
Boston,18,37,29,22,0,0,0,0,Toronto,23,23,34,34,0,0,0,0,20170110,106,114,5,-9,-4,8,8,220,8,2016,0,1,430,0
Chicago,36,25,16,22,0,0,0,0,Washington,26,23,32,20,0,0,0,0,20170110,99,101,-10,-12,4,2,2,200,2,2016,0,1,594,0
Portland,25,30,23,30,0,0,0,0,LA Lakers,26,31,12,18,0,0,0,0,20170110,108,87,-1,-2,9,21,21,195,-21,2016,0,1,826,0
Charlotte,26,21,32,35,0,0,0,0,Houston,32,35,29,25,0,0,0,0,20170110,114,121,6,20,17,7,7,235,7,2016,0,1,925,0
Miami,29,25,14,27,0,0,0,0,Golden State,27,26,26,28,0,0,0,0,20170110,95,107,-2,-1,11,12,12,202,12,2016,0,1,2590,0
Atlanta,35,26,25,31,0,0,0,0,Brooklyn,29,14,27,27,0,0,0,0,20170110,117,97,6,18,16,20,20,214,-20,2016,0,1,745,0
Detroit,29,27,21,17,0,0,0,0,Sacramento,21,22,25,32,0,0,0,0,20170110,94,100,-8,-13,-9,6,6,194,6,2016,0,1,2020,0
Washington,35,24,26,23,0,0,0,0,Boston,36,19,28,34,0,0,0,0,20170111,108,117,1,-4,-2,9,9,225,9,2016,0,2,394,0
Orlando,33,18,24,21,0,0,0,0,LA Clippers,28,28,17,32,0,0,0,0,20170111,96,105,-5,5,-2,9,9,201,9,2016,0,2,2197,0
Houston,23,31,23,28,0,0,0,0,Minnesota,30,25,34,30,0,0,0,0,20170111,105,119,7,1,12,14,14,224,14,2016,0,2,1057,0
Memphis,22,22,23,28,0,0,0,0,Oklahoma City,28,27,20,28,0,0,0,0,20170111,95,103,6,11,8,8,8,198,8,2016,0,2,421,0
New York,32,20,23,22,0,0,0,0,Philadelphia,27,20,24,27,0,0,0,0,20170111,97,98,-5,-5,-4,1,1,195,1,2016,0,2,80,0
Cleveland,20,21,20,25,0,0,0,0,Portland,27,22,24,29,0,0,0,0,20170111,86,102,7,8,12,16,16,188,16,2016,0,2,2049,0
LA Lakers,24,30,21,19,0,0,0,0,San Antonio,36,36,34,28,0,0,0,0,20170112,94,134,12,18,31,40,40,228,40,2016,0,3,1201,0
Dallas,32,25,31,25,0,0,0,0,Phoenix,29,30,17,32,0,0,0,0,20170112,113,108,3,-2,12,5,5,221,-5,2016,0,3,884,0
Chicago,22,29,14,24,0,0,0,0,New York,24,30,22,28,0,0,0,0,20170112,89,104,2,3,11,15,15,193,15,2016,0,3,711,0
Detroit,30,28,19,30,0,0,0,0,Golden State,37,23,41,26,0,0,0,0,20170112,107,127,7,2,24,20,20,234,20,2016,0,3,2087,0
New Orleans,35,16,22,31,0,0,0,0,Brooklyn,31,26,22,16,0,0,0,0,20170112,104,95,4,-6,-6,9,9,199,-9,2016,0,3,1168,0
Indiana,29,27,20,36,0,0,0,0,Denver,30,37,39,34,0,0,0,0,20170112,112,140,1,11,30,28,28,252,28,2016,0,3,998,0
Brooklyn,27,26,36,24,0,0,0,0,Toronto,30,24,36,42,0,0,0,0,20170113,113,132,3,1,1,19,19,245,19,2016,0,4,341,0
Boston,28,20,30,25,0,0,0,0,Atlanta,18,26,21,36,0,0,0,0,20170113,103,101,10,4,13,2,2,204,-2,2016,0,4,935,0
Memphis,25,26,32,27,0,0,0,0,Houston,31,33,21,20,0,0,0,0,20170113,110,105,-6,-13,-2,5,5,215,-5,2016,0,4,484,0
Miami,30,18,26,34,0,0,0,0,Milwaukee,42,23,26,25,0,0,0,0,20170113,108,116,12,17,17,8,8,224,8,2016,0,4,1269,0
Oklahoma City,28,22,18,18,0,0,0,0,Minnesota,30,15,29,22,0,0,0,0,20170113,86,96,2,-5,6,10,10,182,10,2016,0,4,694,0
Charlotte,21,24,26,22,0,0,0,0,Philadelphia,26,26,24,26,0,0,0,0,20170113,93,102,5,7,5,9,9,195,9,2016,0,4,450,0
Orlando,36,18,28,33,0,0,0,0,Portland,23,26,29,31,0,0,0,0,20170113,115,109,13,5,4,6,6,224,-6,2016,0,4,2525,0
Cleveland,32,29,23,36,0,0,0,0,Sacramento,15,28,31,34,0,0,0,0,20170113,120,108,17,18,10,12,12,228,-12,2016,0,4,2096,0
Detroit,19,24,20,14,0,0,0,0,Utah,14,31,33,32,0,0,0,0,20170113,77,110,-5,2,15,33,33,187,33,2016,0,4,1488,0
Orlando,42,23,18,24,0,0,0,0,Utah,29,35,20,30,0,0,0,0,20170114,107,114,-13,-1,1,7,7,221,7,2016,0,5,1915,0
San Antonio,25,33,27,20,0,0,0,0,Phoenix,25,26,29,28,0,0,0,0,20170114,105,108,0,-7,-5,3,3,213,3,2016,0,5,846,0
Philadelphia,30,26,15,22,0,0,0,0,Washington,21,35,30,23,0,0,0,0,20170114,93,109,-9,0,15,16,16,202,16,2016,0,5,123,0
New Orleans,22,23,26,28,0,0,0,0,Chicago,21,34,22,30,0,0,0,0,20170114,99,107,-1,10,6,8,8,206,8,2016,0,5,832,0
LA Lakers,15,24,29,29,0,0,0,0,LA Clippers,26,32,26,29,0,0,0,0,20170114,97,113,11,19,16,16,16,210,16,2016,0,5,0,0
Milwaukee,36,17,30,15,0,0,0,0,Atlanta,36,24,28,23,0,0,0,0,20170115,98,111,0,7,5,13,13,209,13,2016,0,6,669,0
Houston,37,37,30,33,0,0,0,0,Brooklyn,36,30,24,22,0,0,0,0,20170115,137,112,1,8,14,25,25,249,-25,2016,0,6,1417,0
Minnesota,25,22,23,17,0,0,0,0,Dallas,27,29,23,19,0,0,0,0,20170115,87,98,2,9,9,11,11,185,11,2016,0,6,863,0
Detroit,23,36,16,27,0,0,0,0,LA Lakers,31,26,15,25,0,0,0,0,20170115,102,97,-8,2,3,5,5,199,-5,2016,0,6,1979,0
Chicago,14,38,26,30,0,0,0,0,Memphis,19,27,31,27,0,0,0,0,20170115,108,104,-5,6,1,4,4,212,-4,2016,0,6,480,0
Oklahoma City,28,31,29,34,0,0,0,0,Sacramento,23,23,33,39,0,0,0,0,20170115,122,118,5,13,9,4,4,240,-4,2016,0,6,1336,0
New York,26,28,8,39,0,0,0,0,Toronto,27,42,27,20,0,0,0,0,20170115,101,116,1,15,34,15,15,217,15,2016,0,6,341,0
Portland,21,29,27,24,0,0,0,0,Washington,37,38,26,19,0,0,0,0,20170116,101,120,16,25,24,19,19,221,19,2016,0,0,2347,0
Utah,24,23,32,27,0,0,0,0,Phoenix,28,25,27,21,0,0,0,0,20170116,106,101,-4,-6,-1,5,5,207,-5,2016,0,0,505,0
Atlanta,26,27,35,20,0,0,0,0,New York,27,27,29,24,0,0,0,0,20170116,108,107,-1,-1,5,1,1,215,-1,2016,0,0,745,0
Philadelphia,24,22,35,32,0,0,0,0,Milwaukee,24,30,24,26,0,0,0,0,20170116,113,104,0,-8,3,9,9,217,-9,2016,0,0,692,0
Oklahoma City,25,22,28,23,0,0,0,0,LA Clippers,34,30,32,24,0,0,0,0,20170116,98,120,9,17,21,22,22,218,22,2016,0,0,1178,0
New Orleans,18,34,18,25,0,0,0,0,Indiana,32,22,22,22,0,0,0,0,20170116,95,98,14,2,6,3,3,193,3,2016,0,0,713,0
Cleveland,22,27,22,20,0,0,0,0,Golden State,37,41,17,31,0,0,0,0,20170116,91,126,15,29,24,35,35,217,35,2016,0,0,2161,0
Orlando,36,25,22,29,0,0,0,0,Denver,39,30,31,25,0,0,0,0,20170116,112,125,3,8,17,13,13,237,13,2016,0,0,1548,0
Charlotte,30,23,18,27,0,0,0,0,Boston,34,25,21,28,0,0,0,0,20170116,98,108,4,6,9,10,10,206,10,2016,0,0,720,0
Toronto,26,32,34,27,0,0,0,0,Brooklyn,29,32,24,24,0,0,0,0,20170117,119,109,-3,-3,7,10,10,228,-10,2016,0,1,341,0
Dallas,24,30,22,23,0,0,0,0,Chicago,28,19,27,24,0,0,0,0,20170117,99,98,-4,7,2,1,1,197,-1,2016,0,1,802,0
Denver,40,26,35,26,0,0,0,0,LA Lakers,26,28,30,37,0,0,0,0,20170117,127,121,14,12,17,6,6,248,-6,2016,0,1,830,0
Houston,32,21,26,24,0,0,0,0,Miami,27,26,26,30,0,0,0,0,20170117,103,109,-5,0,0,6,6,212,6,2016,0,1,966,0
Minnesota,30,41,19,24,0,0,0,0,San Antonio,30,37,25,30,0,0,0,0,20170117,114,122,0,-4,2,8,8,236,8,2016,0,1,1112,0
Memphis,24,27,26,24,0,0,0,0,Washington,30,36,17,21,0,0,0,0,20170118,101,104,6,15,6,3,3,205,3,2016,0,2,762,0
Indiana,21,20,30,35,0,0,0,0,Sacramento,34,26,19,21,0,0,0,0,20170118,106,100,-13,-19,-8,6,6,206,-6,2016,0,2,1882,0
Toronto,21,23,21,24,0,0,0,0,Philadelphia,25,21,22,26,0,0,0,0,20170118,89,94,4,2,3,5,5,183,5,2016,0,2,334,0
Orlando,29,23,21,25,0,0,0,0,New Orleans,32,33,27,26,0,0,0,0,20170118,98,118,3,13,19,20,20,216,20,2016,0,2,533,0
Atlanta,18,27,23,27,0,0,0,0,Detroit,42,27,25,24,0,0,0,0,20170118,95,118,24,24,26,23,23,213,23,2016,0,2,597,0
Oklahoma City,31,25,22,22,0,0,0,0,Golden State,30,26,37,28,0,0,0,0,20170118,100,121,-1,0,15,21,21,221,21,2016,0,2,1386,0
Portland,26,20,26,13,0,0,0,0,Charlotte,23,31,25,28,0,0,0,0,20170118,85,107,-3,8,7,22,22,192,22,2016,0,2,2284,0
New York,31,32,25,29,0,0,0,0,Boston,34,20,29,23,0,0,0,0,20170118,117,106,-3,9,5,11,11,223,-11,2016,0,2,190,0
Milwaukee,27,12,26,27,0,0,0,0,Houston,22,30,27,32,0,0,0,0,20170118,92,111,-5,13,14,19,19,203,19,2016,0,2,1005,0
Phoenix,21,20,35,27,0,0,0,0,Cleveland,29,30,30,29,0,0,0,0,20170119,103,118,8,18,13,15,15,221,15,2016,0,3,1745,0
Minnesota,25,19,33,27,0,0,0,0,LA Clippers,22,29,28,22,0,0,0,0,20170119,104,101,3,-7,-2,3,3,205,-3,2016,0,3,1521,0
Dallas,22,31,20,22,0,0,0,0,Miami,29,15,26,29,0,0,0,0,20170119,95,99,7,-9,-3,4,4,194,4,2016,0,3,1110,0
Washington,38,28,34,13,0,0,0,0,New York,27,40,19,24,0,0,0,0,20170119,113,110,11,-1,14,3,3,223,-3,2016,0,3,204,0
Denver,23,35,23,23,0,0,0,0,San Antonio,28,31,33,26,0,0,0,0,20170119,104,118,5,1,11,14,14,222,14,2016,0,3,802,0
Portland,33,23,15,21,0,0,0,0,Philadelphia,22,21,27,23,0,0,0,0,20170120,92,93,-11,-13,-1,1,1,185,1,2016,0,4,2405,0
Milwaukee,23,32,19,22,0,0,0,0,Orlando,25,34,29,24,0,0,0,0,20170120,96,112,2,4,14,16,16,208,16,2016,0,4,1065,0
Brooklyn,29,37,43,34,0,0,0,0,New Orleans,32,22,30,30,0,0,0,0,20170120,143,114,-3,12,25,29,29,257,-29,2016,0,4,1168,0
Sacramento,23,19,22,27,0,0,0,0,Memphis,15,34,34,24,0,0,0,0,20170120,91,107,-8,7,19,16,16,198,16,2016,0,4,1745,0
Utah,19,27,26,26,14,0,0,0,Dallas,22,19,27,30,9,0,0,0,20170120,112,107,-3,5,4,0,5,219,-5,2016,1,4,998,0
Golden State,32,30,37,26,0,0,0,0,Houston,29,28,22,29,0,0,0,0,20170120,125,108,3,5,20,17,17,233,-17,2016,0,4,1642,0
Toronto,18,30,15,15,0,0,0,0,Charlotte,26,29,33,25,0,0,0,0,20170120,78,113,8,7,25,35,35,191,35,2016,0,4,585,0
Chicago,13,23,21,36,0,0,0,0,Atlanta,35,30,22,15,0,0,0,0,20170120,93,102,22,29,30,9,9,195,9,2016,0,4,587,0
Indiana,24,29,22,20,0,0,0,0,LA Lakers,27,24,35,22,0,0,0,0,20170120,95,108,3,-2,11,13,13,203,13,2016,0,4,1805,0
Washington,26,29,27,30,0,0,0,0,Detroit,30,31,37,15,0,0,0,0,20170121,112,113,4,6,16,1,1,225,1,2016,0,5,394,0
Indiana,21,29,22,28,0,0,0,0,Utah,34,26,25,24,0,0,0,0,20170121,100,109,13,10,13,9,9,209,9,2016,0,5,1353,0
Milwaukee,22,21,28,26,0,0,0,0,Miami,25,28,29,27,0,0,0,0,20170121,97,109,3,10,11,12,12,206,12,2016,0,5,1269,0
Houston,32,26,33,28,0,0,0,0,Memphis,22,27,23,23,0,0,0,0,20170121,119,95,10,9,19,24,24,214,-24,2016,0,5,484,0
LA Clippers,18,27,26,27,0,0,0,0,Denver,27,32,36,28,0,0,0,0,20170121,98,123,9,14,24,25,25,221,25,2016,0,5,830,0
Phoenix,30,31,29,17,0,0,0,0,New York,33,22,35,15,0,0,0,0,20170121,107,105,-3,6,0,2,2,212,-2,2016,0,5,2139,0
Brooklyn,14,32,35,24,0,0,0,0,Charlotte,28,32,21,31,0,0,0,0,20170121,105,112,14,14,0,7,7,217,7,2016,0,5,531,0
Philadelphia,25,29,23,16,0,0,0,0,Atlanta,25,37,28,20,0,0,0,0,20170121,93,110,0,8,13,17,17,203,17,2016,0,5,665,0
San Antonio,22,35,27,23,11,0,0,0,Cleveland,33,25,31,18,8,0,0,0,20170121,118,115,-11,-1,-5,0,3,233,-3,2016,1,5,1256,0
Sacramento,21,31,21,26,0,0,0,0,Chicago,24,31,20,27,0,0,0,0,20170121,99,102,3,3,2,3,3,201,3,2016,0,5,1788,0
Portland,26,30,32,25,14,0,0,0,Boston,28,37,21,27,10,0,0,0,20170121,127,123,-2,-9,2,0,4,250,-4,2016,1,5,2532,0
LA Lakers,22,11,22,18,0,0,0,0,Dallas,29,38,23,32,0,0,0,0,20170122,73,122,7,34,35,49,49,195,49,2016,0,6,1237,0
Denver,29,29,26,24,0,0,0,0,Minnesota,28,34,22,27,0,0,0,0,20170122,108,111,-1,4,0,3,3,219,3,2016,0,6,698,0
Golden State,28,22,42,26,0,0,0,0,Orlando,22,28,24,24,0,0,0,0,20170122,118,98,6,0,18,20,20,216,-20,2016,0,6,2437,0
Phoenix,28,29,25,33,0,0,0,0,Toronto,31,29,25,18,0,0,0,0,20170122,115,103,-3,-3,-3,12,12,218,-12,2016,0,6,1885,0
Houston,33,31,27,23,0,0,0,0,Milwaukee,33,35,25,34,0,0,0,0,20170123,114,127,0,4,2,13,13,241,13,2016,0,0,1005,0
Oklahoma City,27,29,11,30,0,0,0,0,Utah,26,27,19,23,0,0,0,0,20170123,97,95,1,3,-5,2,2,192,-2,2016,0,0,861,0
Cleveland,26,24,36,36,0,0,0,0,New Orleans,35,35,24,30,0,0,0,0,20170123,122,124,9,20,8,2,2,246,2,2016,0,0,924,0
Golden State,30,18,25,29,0,0,0,0,Miami,28,18,31,28,0,0,0,0,20170123,102,105,-2,-2,4,3,3,207,3,2016,0,0,2590,0
New York,22,40,24,23,0,0,0,0,Indiana,34,24,17,28,0,0,0,0,20170123,109,103,-12,4,11,6,6,212,-6,2016,0,0,643,0
Sacramento,28,37,23,21,0,0,0,0,Detroit,38,24,19,23,0,0,0,0,20170123,109,104,-10,3,7,5,5,213,-5,2016,0,0,2020,0
Washington,30,30,20,29,0,0,0,0,Charlotte,22,26,26,25,0,0,0,0,20170123,109,99,8,12,6,10,10,208,-10,2016,0,0,329,0
San Antonio,27,25,39,21,0,0,0,0,Brooklyn,26,16,27,17,0,0,0,0,20170123,112,86,1,10,22,26,26,198,-26,2016,0,0,1581,0
LA Clippers,30,28,27,30,0,0,0,0,Atlanta,21,19,35,30,0,0,0,0,20170123,115,105,9,18,10,10,10,220,-10,2016,0,0,1932,0
Utah,22,17,28,26,0,0,0,0,Denver,18,33,29,23,0,0,0,0,20170124,93,103,-4,12,13,10,10,196,10,2016,0,1,370,0
Chicago,20,32,26,22,0,0,0,0,Orlando,22,27,24,19,0,0,0,0,20170124,100,92,-2,3,5,8,8,192,-8,2016,0,1,984,0
LA Clippers,29,39,21,21,0,0,0,0,Philadelphia,27,32,30,32,0,0,0,0,20170124,110,121,-2,-9,0,11,11,231,11,2016,0,1,2388,0
Minnesota,23,36,28,25,0,0,0,0,Phoenix,27,29,23,32,0,0,0,0,20170124,112,111,-4,3,8,1,1,223,-1,2016,0,1,1278,0
San Antonio,29,32,18,29,0,0,0,0,Toronto,25,29,25,27,0,0,0,0,20170124,108,106,4,7,0,2,2,214,-2,2016,0,1,1438,0
Boston,24,35,21,28,0,0,0,0,Washington,33,33,25,32,0,0,0,0,20170124,108,123,9,7,11,15,15,231,15,2016,0,1,394,0
Oklahoma City,33,31,28,22,0,0,0,0,New Orleans,20,25,37,23,0,0,0,0,20170125,114,105,13,19,10,9,9,219,-9,2016,0,2,576,0
Philadelphia,33,39,16,26,0,0,0,0,Milwaukee,39,19,24,27,0,0,0,0,20170125,114,109,-6,14,6,5,5,223,-5,2016,0,2,692,0
Toronto,34,23,20,22,0,0,0,0,Memphis,32,24,31,14,0,0,0,0,20170125,99,101,-2,-1,10,2,2,200,2,2016,0,2,815,0
LA Lakers,31,27,17,23,0,0,0,0,Portland,30,29,24,22,0,0,0,0,20170125,98,105,-1,1,8,7,7,203,7,2016,0,2,826,0
New York,25,26,22,22,0,0,0,0,Dallas,30,22,26,25,0,0,0,0,20170125,95,103,5,1,5,8,8,198,8,2016,0,2,1370,0
Golden State,29,24,22,38,0,0,0,0,Charlotte,28,19,33,23,0,0,0,0,20170125,113,103,1,6,-5,10,10,216,-10,2016,0,2,2296,0
Atlanta,22,29,27,41,0,0,0,0,Chicago,29,30,24,31,0,0,0,0,20170125,119,114,-7,-8,-5,5,5,233,-5,2016,0,2,587,0
Miami,34,21,16,38,0,0,0,0,Brooklyn,30,36,23,17,0,0,0,0,20170125,109,106,4,-11,-18,3,3,215,-3,2016,0,2,1091,0
Houston,27,31,28,23,0,0,0,0,Boston,24,28,36,32,0,0,0,0,20170125,109,120,-3,-6,2,11,11,229,11,2016,0,2,1603,0
Sacramento,22,31,26,25,12,0,0,0,Cleveland,26,21,35,22,8,0,0,0,20170125,116,112,-4,6,-3,0,4,228,-4,2016,1,2,2096,0
Phoenix,29,32,31,28,0,0,0,0,Denver,35,22,39,31,0,0,0,0,20170126,120,127,6,-4,4,7,7,247,7,2016,0,3,585,0
Indiana,25,27,24,33,0,0,0,0,Minnesota,20,26,24,33,0,0,0,0,20170126,109,103,5,6,6,6,6,212,-6,2016,0,3,510,0
Dallas,26,29,18,25,0,0,0,0,Oklahoma City,23,30,34,22,0,0,0,0,20170126,98,109,-3,-2,14,11,11,207,11,2016,0,3,189,0
LA Lakers,16,25,19,28,0,0,0,0,Utah,23,21,26,26,0,0,0,0,20170126,88,96,7,3,10,8,8,184,8,2016,0,3,579,0
Milwaukee,19,20,31,16,0,0,0,0,Toronto,36,17,24,25,0,0,0,0,20170127,86,102,17,14,7,16,16,188,16,2016,0,4,429,0
Memphis,24,32,28,25,0,0,0,0,Portland,28,34,23,27,0,0,0,0,20170127,109,112,4,6,1,3,3,221,3,2016,0,4,1845,0
Houston,31,30,33,29,0,0,0,0,Philadelphia,28,33,21,36,0,0,0,0,20170127,123,118,3,0,12,5,5,241,-5,2016,0,4,1339,0
Charlotte,23,28,36,20,0,0,0,0,New York,29,25,28,28,0,0,0,0,20170127,107,110,6,3,-5,3,3,217,3,2016,0,4,531,0
San Antonio,20,37,27,19,0,0,0,0,New Orleans,23,25,37,34,0,0,0,0,20170127,103,119,3,-9,1,16,16,222,16,2016,0,4,506,0
Brooklyn,25,22,26,43,0,0,0,0,Cleveland,27,28,39,30,0,0,0,0,20170127,116,124,2,8,21,8,8,240,8,2016,0,4,403,0
Miami,33,20,24,23,0,0,0,0,Chicago,24,29,14,21,0,0,0,0,20170127,100,88,9,0,10,12,12,188,-12,2016,0,4,1189,0
Orlando,24,24,17,33,0,0,0,0,Boston,39,29,36,24,0,0,0,0,20170127,98,128,15,20,39,30,30,226,30,2016,0,4,1115,0
Washington,37,30,26,19,0,0,0,0,Atlanta,25,20,23,18,0,0,0,0,20170127,112,86,12,22,25,26,26,198,-26,2016,0,4,541,0
Sacramento,30,34,23,17,7,0,0,0,Indiana,27,28,26,23,11,0,0,0,20170127,111,115,-3,-9,-6,0,4,226,4,2016,1,4,1882,0
Sacramento,24,28,33,24,0,0,0,0,Charlotte,22,22,33,29,0,0,0,0,20170128,109,106,2,8,8,3,3,215,-3,2016,0,5,2239,0
LA Clippers,22,29,23,24,0,0,0,0,Golden State,31,41,45,27,0,0,0,0,20170128,98,144,9,21,43,46,46,242,46,2016,0,5,347,0
Detroit,33,27,31,12,0,0,0,0,Miami,35,29,26,26,0,0,0,0,20170128,103,116,2,4,-1,13,13,219,13,2016,0,5,1155,0
Boston,42,22,17,21,10,0,0,0,Milwaukee,27,26,20,29,6,0,0,0,20170128,112,108,15,11,8,0,4,220,-4,2016,1,5,855,0
Brooklyn,26,29,23,31,0,0,0,0,Minnesota,33,30,29,37,0,0,0,0,20170128,109,129,7,8,14,20,20,238,20,2016,0,5,1016,0
Denver,21,38,36,28,0,0,0,0,Phoenix,33,28,22,29,0,0,0,0,20170128,123,112,-12,-2,12,11,11,235,-11,2016,0,5,585,0
Memphis,26,26,28,22,0,0,0,0,Utah,27,16,31,21,0,0,0,0,20170128,102,95,-1,9,6,7,7,197,-7,2016,0,5,1247,0
Golden State,33,20,31,29,0,0,0,0,Portland,24,26,24,37,0,0,0,0,20170129,113,111,9,3,10,2,2,224,-2,2016,0,6,535,0
Orlando,27,33,22,32,0,0,0,0,Toronto,36,15,27,35,0,0,0,0,20170129,114,113,-9,9,4,1,1,227,-1,2016,0,6,1048,0
Dallas,27,22,28,28,0,0,0,0,San Antonio,28,31,22,20,0,0,0,0,20170129,105,101,-1,-10,-4,4,4,206,-4,2016,0,6,252,0
Washington,29,28,17,33,0,0,0,0,New Orleans,23,17,33,21,0,0,0,0,20170129,107,94,6,17,1,13,13,201,-13,2016,0,6,964,0
Houston,20,23,27,31,0,0,0,0,Indiana,33,24,33,30,0,0,0,0,20170129,101,120,13,14,20,19,19,221,19,2016,0,6,865,0
Oklahoma City,24,21,20,26,0,0,0,0,Cleveland,21,37,22,27,0,0,0,0,20170129,91,107,-3,13,15,16,16,198,16,2016,0,6,949,0
Philadelphia,23,34,30,21,0,0,0,0,Chicago,37,30,29,25,0,0,0,0,20170129,108,121,14,10,9,13,13,229,13,2016,0,6,664,0
New York,37,28,16,23,9,10,7,9,Atlanta,30,31,22,21,9,10,7,12,20170129,139,142,-7,-4,2,0,3,281,3,2016,4,6,745,0
Detroit,25,21,24,39,0,0,0,0,Boston,26,28,25,34,0,0,0,0,20170130,109,113,1,8,9,4,4,222,4,2016,0,0,611,0
Cleveland,29,21,20,27,0,0,0,0,Dallas,26,29,26,23,0,0,0,0,20170130,97,104,-3,5,11,7,7,201,7,2016,0,0,1024,0
Brooklyn,32,20,25,19,0,0,0,0,Miami,28,28,28,20,0,0,0,0,20170130,96,104,-4,4,7,8,8,200,8,2016,0,0,1091,0
Orlando,23,28,28,19,7,0,0,0,Minnesota,26,26,28,18,13,0,0,0,20170130,105,111,3,1,1,0,6,216,6,2016,1,0,1309,0
Sacramento,35,20,30,34,0,0,0,0,Philadelphia,21,27,42,32,0,0,0,0,20170130,119,122,-14,-7,5,3,3,241,3,2016,0,0,2451,0
Memphis,31,28,29,27,0,0,0,0,Phoenix,28,20,22,26,0,0,0,0,20170130,115,96,3,11,18,19,19,211,-19,2016,0,0,1260,0
New Orleans,25,35,15,21,10,0,0,0,Toronto,23,23,31,19,12,0,0,0,20170131,106,108,-2,-14,2,0,2,214,2,2016,1,1,1112,0
Oklahoma City,17,25,33,19,0,0,0,0,San Antonio,31,21,27,29,0,0,0,0,20170131,94,108,14,10,4,14,14,202,14,2016,0,1,421,0
New York,28,26,22,25,0,0,0,0,Washington,28,31,32,26,0,0,0,0,20170131,101,117,0,5,15,16,16,218,16,2016,0,1,204,0
Denver,30,29,17,40,0,0,0,0,LA Lakers,30,24,27,39,0,0,0,0,20170131,116,120,0,-5,5,4,4,236,4,2016,0,1,830,0
Sacramento,24,11,22,26,0,0,0,0,Houston,29,25,28,23,0,0,0,0,20170131,83,105,5,19,25,22,22,188,22,2016,0,1,1606,0
Charlotte,23,27,18,30,0,0,0,0,Portland,28,28,30,29,0,0,0,0,20170131,98,115,5,6,18,17,17,213,17,2016,0,1,2284,0
Milwaukee,27,16,18,27,0,0,0,0,Utah,30,31,19,24,0,0,0,0,20170201,88,104,3,18,19,16,16,192,16,2016,0,2,1239,0
LA Clippers,38,24,30,32,0,0,0,0,Phoenix,31,28,29,26,0,0,0,0,20170201,124,114,7,3,4,10,10,238,-10,2016,0,2,356,0
Indiana,28,28,24,18,0,0,0,0,Orlando,23,24,27,14,0,0,0,0,20170201,98,88,5,9,6,10,10,186,-10,2016,0,2,822,0
Chicago,21,34,39,34,0,0,0,0,Oklahoma City,20,27,26,27,0,0,0,0,20170201,128,100,1,8,21,28,28,228,-28,2016,0,2,690,0
Atlanta,22,25,24,22,0,0,0,0,Miami,29,33,32,22,0,0,0,0,20170201,93,116,7,15,23,23,23,209,23,2016,0,2,605,0
Charlotte,21,35,27,28,0,0,0,0,Golden State,41,36,31,18,0,0,0,0,20170201,111,126,20,21,25,15,15,237,15,2016,0,2,2296,0
New Orleans,30,24,27,17,0,0,0,0,Detroit,34,26,23,35,0,0,0,0,20170201,98,118,4,6,2,20,20,216,20,2016,0,2,939,0
Philadelphia,23,24,22,26,0,0,0,0,Dallas,20,30,31,32,0,0,0,0,20170201,95,113,-3,3,12,18,18,208,18,2016,0,2,1297,0
Minnesota,32,28,19,18,0,0,0,0,Cleveland,36,27,30,32,0,0,0,0,20170201,97,125,4,3,14,28,28,222,28,2016,0,2,629,0
New York,15,23,26,31,0,0,0,0,Brooklyn,27,18,24,21,0,0,0,0,20170201,95,90,-12,-7,-5,5,5,185,-5,2016,0,2,0,0
Toronto,30,32,23,19,0,0,0,0,Boston,28,23,26,32,0,0,0,0,20170201,104,109,-2,-11,-8,5,5,213,5,2016,0,2,430,0
Memphis,27,35,25,32,0,0,0,0,Denver,18,31,20,30,0,0,0,0,20170201,119,99,9,13,18,20,20,218,-20,2016,0,2,877,0
LA Lakers,29,15,35,29,0,0,0,0,Washington,31,27,32,26,0,0,0,0,20170202,108,116,2,14,11,8,8,224,8,2016,0,3,2294,0
Philadelphia,21,32,20,13,0,0,0,0,San Antonio,24,24,31,23,0,0,0,0,20170202,86,102,3,-5,6,16,16,188,16,2016,0,3,1505,0
Golden State,33,32,39,29,0,0,0,0,LA Clippers,22,33,32,33,0,0,0,0,20170202,133,120,11,10,17,13,13,253,-13,2016,0,3,347,0
Atlanta,26,21,26,40,0,0,0,0,Houston,32,18,36,22,0,0,0,0,20170202,113,108,-6,-3,-13,5,5,221,-5,2016,0,3,700,0
LA Lakers,30,21,23,33,0,0,0,0,Boston,29,33,20,31,0,0,0,0,20170203,107,113,-1,11,8,6,6,220,6,2016,0,4,2590,0
Indiana,27,29,24,26,0,0,0,0,Brooklyn,16,30,28,23,0,0,0,0,20170203,106,97,11,10,6,9,9,203,-9,2016,0,4,643,0
Milwaukee,31,22,36,28,0,0,0,0,Denver,31,39,28,23,0,0,0,0,20170203,117,121,0,17,9,4,4,238,4,2016,0,4,912,0
Minnesota,18,34,24,32,0,0,0,0,Detroit,24,29,30,33,0,0,0,0,20170203,108,116,6,1,7,8,8,224,8,2016,0,4,542,0
Chicago,26,23,32,27,9,0,0,0,Houston,24,36,19,29,13,0,0,0,20170203,117,121,-2,11,-2,0,4,238,4,2016,1,4,939,0
Memphis,23,25,34,20,0,0,0,0,Oklahoma City,21,37,22,34,0,0,0,0,20170203,102,114,-2,10,-2,12,12,216,12,2016,0,4,421,0
Toronto,24,30,12,28,0,0,0,0,Orlando,28,24,21,29,0,0,0,0,20170203,94,102,4,-2,7,8,8,196,8,2016,0,4,1048,0
Dallas,35,25,24,24,0,0,0,0,Portland,22,25,29,28,0,0,0,0,20170203,108,104,13,13,8,4,4,212,-4,2016,0,4,1630,0
Phoenix,15,34,30,26,0,0,0,0,Sacramento,21,28,30,24,0,0,0,0,20170203,105,103,-6,0,0,2,2,208,-2,2016,0,4,634,0
New Orleans,18,31,34,8,0,0,0,0,Washington,24,29,27,25,0,0,0,0,20170204,91,105,6,4,-3,14,14,196,14,2016,0,5,964,0
Charlotte,28,16,38,16,0,0,0,0,Utah,23,29,21,32,0,0,0,0,20170204,98,105,-5,8,-9,7,7,203,7,2016,0,5,1723,0
Denver,27,23,22,25,0,0,0,0,San Antonio,30,26,35,30,0,0,0,0,20170204,97,121,3,6,19,24,24,218,24,2016,0,5,802,0
Golden State,31,25,26,16,8,0,0,0,Sacramento,27,29,26,16,11,0,0,0,20170204,106,109,-4,0,0,0,3,215,3,2016,1,5,75,0
Milwaukee,45,29,27,36,0,0,0,0,Phoenix,25,41,23,23,0,0,0,0,20170204,137,112,20,8,12,25,25,249,-25,2016,0,5,1462,0
Memphis,15,33,21,38,0,0,0,0,Minnesota,31,17,19,32,0,0,0,0,20170204,107,99,-16,0,2,8,8,206,-8,2016,0,5,700,0
Philadelphia,17,35,23,27,0,0,0,0,Miami,32,32,36,25,0,0,0,0,20170204,102,125,15,12,25,23,23,227,23,2016,0,5,1021,0
Detroit,32,26,14,12,0,0,0,0,Indiana,30,26,26,23,0,0,0,0,20170204,84,105,-2,-2,10,21,21,189,21,2016,0,5,240,0
Orlando,24,15,26,21,0,0,0,0,Atlanta,35,30,26,22,0,0,0,0,20170204,86,113,11,26,26,27,27,199,27,2016,0,5,401,0
Cleveland,34,30,20,27,0,0,0,0,New York,25,20,23,36,0,0,0,0,20170204,111,104,9,19,16,7,7,215,-7,2016,0,5,403,0
LA Clippers,19,28,20,35,0,0,0,0,Boston,29,27,25,26,0,0,0,0,20170205,102,107,10,9,14,5,5,209,5,2016,0,6,2590,0
Toronto,26,29,20,28,0,0,0,0,Brooklyn,24,19,20,32,0,0,0,0,20170205,103,95,2,12,12,8,8,198,-8,2016,0,6,341,0
Portland,16,36,21,26,0,0,0,0,Oklahoma City,24,22,25,34,0,0,0,0,20170205,99,105,8,-6,-2,6,6,204,6,2016,0,6,1484,0
LA Lakers,29,32,36,24,0,0,0,0,New York,19,26,28,34,0,0,0,0,20170206,121,107,10,16,24,14,14,228,-14,2016,0,0,2445,0
Cleveland,26,28,32,34,20,0,0,0,Washington,32,25,25,38,15,0,0,0,20170206,140,135,-6,-3,4,0,5,275,-5,2016,1,0,304,0
LA Clippers,31,29,22,27,0,0,0,0,Toronto,35,35,27,21,0,0,0,0,20170206,109,118,4,10,15,9,9,227,9,2016,0,0,2170,0
Chicago,27,33,25,27,0,0,0,0,Sacramento,11,34,24,38,0,0,0,0,20170206,112,107,16,15,16,5,5,219,-5,2016,0,0,1788,0
Phoenix,21,21,32,32,0,0,0,0,New Orleans,29,18,30,34,0,0,0,0,20170206,106,111,8,5,3,5,5,217,5,2016,0,0,1312,0
Dallas,24,13,30,20,0,0,0,0,Denver,29,30,23,28,0,0,0,0,20170206,87,110,5,22,15,23,23,197,23,2016,0,0,661,0
San Antonio,14,26,25,9,0,0,0,0,Memphis,17,23,29,20,0,0,0,0,20170206,74,89,3,0,4,15,15,163,15,2016,0,0,631,0
Oklahoma City,25,27,18,20,0,0,0,0,Indiana,20,21,32,20,0,0,0,0,20170206,90,93,-5,-11,3,3,3,183,3,2016,0,0,688,0
Philadelphia,27,19,21,29,0,0,0,0,Detroit,24,31,34,24,0,0,0,0,20170206,96,113,-3,9,22,17,17,209,17,2016,0,0,441,0
Miami,40,31,22,22,0,0,0,0,Minnesota,33,24,31,25,0,0,0,0,20170206,115,113,7,14,5,2,2,228,-2,2016,0,0,1513,0
Utah,29,25,37,29,0,0,0,0,Atlanta,21,29,23,22,0,0,0,0,20170206,120,95,8,4,18,25,25,215,-25,2016,0,0,1580,0
Brooklyn,16,21,35,35,0,0,0,0,Charlotte,24,30,27,30,0,0,0,0,20170207,107,111,8,17,9,4,4,218,4,2016,0,1,531,0
Portland,32,32,22,28,0,0,0,0,Dallas,27,26,29,31,0,0,0,0,20170207,114,113,5,11,4,1,1,227,-1,2016,0,1,1630,0
Orlando,28,26,30,20,0,0,0,0,Houston,35,35,24,34,0,0,0,0,20170207,104,128,7,16,10,24,24,232,24,2016,0,1,847,0
Boston,28,21,22,21,0,0,0,0,Sacramento,19,30,28,31,0,0,0,0,20170208,92,108,-9,0,6,16,16,200,16,2016,0,2,2624,0
San Antonio,29,29,24,29,0,0,0,0,Philadelphia,23,28,24,28,0,0,0,0,20170208,111,103,6,7,7,8,8,214,-8,2016,0,2,1505,0
LA Clippers,36,32,20,31,0,0,0,0,New York,36,31,28,20,0,0,0,0,20170208,119,115,0,1,-7,4,4,234,-4,2016,0,2,2445,0
Utah,32,30,28,37,0,0,0,0,New Orleans,25,28,16,25,0,0,0,0,20170208,127,94,7,9,21,33,33,221,-33,2016,0,2,1432,0
Toronto,33,30,25,21,0,0,0,0,Minnesota,25,28,30,29,0,0,0,0,20170208,109,112,-8,-10,-5,3,3,221,3,2016,0,2,691,0
Miami,28,27,26,25,0,0,0,0,Milwaukee,15,29,19,25,0,0,0,0,20170208,106,88,13,11,18,18,18,194,-18,2016,0,2,1269,0
Cleveland,25,32,40,35,0,0,0,0,Indiana,36,27,18,36,0,0,0,0,20170208,132,117,-11,-6,16,15,15,249,-15,2016,0,2,262,0
Chicago,17,24,29,22,0,0,0,0,Golden State,30,25,31,37,0,0,0,0,20170208,92,123,13,14,16,31,31,215,31,2016,0,2,1853,0
LA Lakers,25,25,20,32,0,0,0,0,Detroit,25,31,36,29,0,0,0,0,20170208,102,121,0,6,22,19,19,223,19,2016,0,2,1979,0
Washington,31,28,20,21,14,0,0,0,Brooklyn,22,27,23,28,10,0,0,0,20170208,114,110,9,10,7,0,4,224,-4,2016,1,2,204,0
Denver,30,25,32,19,0,0,0,0,Atlanta,39,33,26,19,0,0,0,0,20170208,106,117,9,17,11,11,11,223,11,2016,0,2,1209,0
Phoenix,15,23,27,26,0,0,0,0,Memphis,24,22,33,31,0,0,0,0,20170208,91,110,9,8,14,19,19,201,19,2016,0,2,1260,0
Houston,23,27,36,21,0,0,0,0,Charlotte,29,25,22,19,0,0,0,0,20170209,107,95,-6,-4,10,12,12,202,-12,2016,0,3,925,0
Utah,23,31,24,22,5,0,0,0,Dallas,20,22,26,32,12,0,0,0,20170209,105,112,-3,-12,-10,0,7,217,7,2016,1,3,998,0
Cleveland,21,36,25,27,0,0,0,0,Oklahoma City,29,26,31,32,0,0,0,0,20170209,109,118,8,-2,4,9,9,227,9,2016,0,3,949,0
Philadelphia,20,35,30,27,0,0,0,0,Orlando,25,23,36,27,0,0,0,0,20170209,112,111,-5,7,1,1,1,223,-1,2016,0,3,864,0
Boston,22,27,28,43,0,0,0,0,Portland,32,23,21,35,0,0,0,0,20170209,120,111,-10,-6,1,9,9,231,-9,2016,0,3,2532,0
Chicago,26,17,33,21,0,0,0,0,Phoenix,28,28,30,29,0,0,0,0,20170210,97,115,2,13,10,18,18,212,18,2016,0,4,1450,0
Indiana,27,32,22,26,0,0,0,0,Washington,33,26,27,26,0,0,0,0,20170210,107,112,6,0,5,5,5,219,5,2016,0,4,490,0
Atlanta,28,31,25,23,0,0,0,0,Sacramento,17,26,31,34,0,0,0,0,20170210,107,108,-11,-16,-10,1,1,215,1,2016,0,4,2082,0
Denver,34,30,36,31,0,0,0,0,New York,32,34,22,35,0,0,0,0,20170210,131,123,2,-2,12,8,8,254,-8,2016,0,4,1627,0
Miami,20,29,25,34,0,0,0,0,Brooklyn,22,31,19,27,0,0,0,0,20170210,108,99,-2,-4,2,9,9,207,-9,2016,0,4,1091,0
LA Lakers,47,29,27,19,0,0,0,0,Milwaukee,30,25,29,30,0,0,0,0,20170210,122,114,17,21,19,8,8,236,-8,2016,0,4,1741,0
Golden State,29,33,36,24,0,0,0,0,Memphis,22,27,28,30,0,0,0,0,20170210,122,107,7,13,21,15,15,229,-15,2016,0,4,1798,0
San Antonio,27,33,23,20,0,0,0,0,Detroit,19,22,25,26,0,0,0,0,20170210,103,92,8,19,17,11,11,195,-11,2016,0,4,1238,0
New Orleans,28,33,37,24,0,0,0,0,Minnesota,40,25,24,17,0,0,0,0,20170210,122,106,-12,-4,9,16,16,228,-16,2016,0,4,1052,0
Boston,33,25,19,35,0,0,0,0,Utah,23,21,21,39,0,0,0,0,20170211,112,104,10,14,12,8,8,216,-8,2016,0,5,2093,0
Golden State,30,43,32,25,0,0,0,0,Oklahoma City,24,26,37,27,0,0,0,0,20170211,130,114,6,23,18,16,16,244,-16,2016,0,5,1386,0
Milwaukee,29,33,26,28,0,0,0,0,Indiana,22,30,22,26,0,0,0,0,20170211,116,100,7,10,14,16,16,216,-16,2016,0,5,243,0
Miami,27,21,28,33,0,0,0,0,Philadelphia,27,27,30,33,0,0,0,0,20170211,109,117,0,6,8,8,8,226,8,2016,0,5,1021,0
Orlando,23,12,17,28,0,0,0,0,Dallas,29,32,23,28,0,0,0,0,20170211,80,112,6,26,32,32,32,192,32,2016,0,5,961,0
Denver,33,22,23,31,0,0,0,0,Cleveland,28,31,33,33,0,0,0,0,20170211,109,125,-5,4,14,16,16,234,16,2016,0,5,1223,0
LA Clippers,29,24,24,30,0,0,0,0,Charlotte,27,24,19,32,0,0,0,0,20170211,107,102,2,2,7,5,5,209,-5,2016,0,5,2115,0
Phoenix,24,29,24,25,0,0,0,0,Houston,38,39,34,22,0,0,0,0,20170211,102,133,14,24,34,31,31,235,31,2016,0,5,1014,0
Chicago,17,23,25,24,0,0,0,0,Minnesota,34,23,27,33,0,0,0,0,20170212,89,117,17,17,19,28,28,206,28,2016,0,6,355,0
San Antonio,21,27,17,25,0,0,0,0,New York,18,24,27,25,0,0,0,0,20170212,90,94,-3,-6,4,4,4,184,4,2016,0,6,1581,0
New Orleans,29,27,17,26,0,0,0,0,Sacramento,23,30,23,29,0,0,0,0,20170212,99,105,-6,-3,3,6,6,204,6,2016,0,6,1879,0
Detroit,25,20,21,36,0,0,0,0,Toronto,27,24,31,19,0,0,0,0,20170212,102,101,-2,-6,-16,1,1,203,-1,2016,0,6,205,0
New Orleans,29,24,24,33,0,0,0,0,Phoenix,28,30,22,28,0,0,0,0,20170213,110,108,1,-5,-3,2,2,218,-2,2016,0,0,1312,0
Oklahoma City,32,22,19,25,0,0,0,0,Washington,38,29,34,19,0,0,0,0,20170213,98,120,6,13,28,22,22,218,22,2016,0,0,1149,0
LA Clippers,18,27,31,12,0,0,0,0,Utah,19,15,15,23,0,0,0,0,20170213,88,72,-1,11,27,16,16,160,-16,2016,0,0,579,0
Atlanta,21,21,33,22,12,0,0,0,Portland,28,20,26,23,7,0,0,0,20170213,109,104,-7,-6,1,0,5,213,-5,2016,1,0,2168,0
Detroit,19,15,27,28,0,0,0,0,Milwaukee,23,28,26,25,0,0,0,0,20170213,89,102,4,17,16,13,13,191,13,2016,0,0,251,0
Memphis,27,25,27,33,0,0,0,0,Brooklyn,19,23,30,31,0,0,0,0,20170213,112,103,8,10,7,9,9,215,-9,2016,0,0,953,0
San Antonio,26,23,34,27,0,0,0,0,Indiana,31,18,30,27,0,0,0,0,20170213,110,106,-5,0,4,4,4,216,-4,2016,0,0,999,0
Philadelphia,31,17,32,25,0,0,0,0,Charlotte,22,25,25,27,0,0,0,0,20170213,105,99,9,1,8,6,6,204,-6,2016,0,0,450,0
Orlando,36,24,27,29,0,0,0,0,Miami,28,29,30,20,0,0,0,0,20170213,116,107,8,3,0,9,9,223,-9,2016,0,0,204,0
Golden State,30,24,31,25,0,0,0,0,Denver,42,37,28,25,0,0,0,0,20170213,110,132,12,25,22,22,22,242,22,2016,0,0,947,0
Boston,30,31,22,28,0,0,0,0,Dallas,28,22,32,16,0,0,0,0,20170213,111,98,2,11,1,13,13,209,-13,2016,0,0,1548,0
Toronto,18,21,25,30,0,0,0,0,Chicago,24,34,20,27,0,0,0,0,20170214,94,105,6,19,14,11,11,199,11,2016,0,1,436,0
Sacramento,29,14,27,27,0,0,0,0,LA Lakers,23,18,23,32,0,0,0,0,20170214,97,96,6,2,6,1,1,193,-1,2016,0,1,361,0
Cleveland,26,43,24,23,0,0,0,0,Minnesota,30,31,32,15,0,0,0,0,20170214,116,108,-4,8,0,8,8,224,-8,2016,0,1,629,0
Portland,17,20,25,26,0,0,0,0,Utah,18,22,34,37,0,0,0,0,20170215,88,111,1,3,12,23,23,199,23,2016,0,2,634,0
Charlotte,20,21,34,10,0,0,0,0,Toronto,31,13,14,32,0,0,0,0,20170215,85,90,11,3,-17,5,5,175,5,2016,0,2,585,0
LA Lakers,15,33,28,25,0,0,0,0,Phoenix,32,36,34,35,0,0,0,0,20170215,101,137,17,20,26,36,36,238,36,2016,0,2,356,0
San Antonio,30,24,31,22,0,0,0,0,Orlando,16,21,27,15,0,0,0,0,20170215,107,79,14,17,21,28,28,186,-28,2016,0,2,1035,0
New York,39,21,20,25,0,0,0,0,Oklahoma City,27,35,26,28,0,0,0,0,20170215,105,116,-12,2,8,11,11,221,11,2016,0,2,1324,0
New Orleans,28,22,27,18,0,0,0,0,Memphis,22,21,18,30,0,0,0,0,20170215,95,91,6,7,16,4,4,186,-4,2016,0,2,358,0
Atlanta,22,18,24,20,0,0,0,0,LA Clippers,21,33,29,16,0,0,0,0,20170215,84,99,-1,14,19,15,15,183,15,2016,0,2,1932,0
Sacramento,25,25,15,21,0,0,0,0,Golden State,28,19,42,20,0,0,0,0,20170215,86,109,3,-3,24,23,23,195,23,2016,0,2,75,0
Dallas,17,18,28,28,0,0,0,0,Detroit,27,35,16,20,0,0,0,0,20170215,91,98,10,27,15,7,7,189,7,2016,0,2,999,0
Minnesota,32,30,23,27,0,0,0,0,Denver,31,29,19,20,0,0,0,0,20170215,112,99,1,2,6,13,13,211,-13,2016,0,2,698,0
Indiana,32,22,26,24,0,0,0,0,Cleveland,28,29,26,30,0,0,0,0,20170215,104,113,-4,3,3,9,9,217,9,2016,0,2,262,0
Milwaukee,39,23,33,34,0,0,0,0,Brooklyn,33,27,22,43,0,0,0,0,20170215,129,125,6,2,13,4,4,254,-4,2016,0,2,732,0
Philadelphia,29,32,18,29,0,0,0,0,Boston,29,32,26,29,0,0,0,0,20170215,108,116,0,0,8,8,8,224,8,2016,0,2,270,0
Miami,34,24,30,29,0,0,0,0,Houston,28,17,28,36,0,0,0,0,20170215,117,109,6,13,15,8,8,226,-8,2016,0,2,966,0
Boston,25,33,20,25,0,0,0,0,Chicago,22,30,29,23,0,0,0,0,20170216,103,104,-3,-6,3,1,1,207,1,2016,0,3,849,0
Washington,34,28,28,21,0,0,0,0,Indiana,27,25,25,21,0,0,0,0,20170216,111,98,7,10,13,13,13,209,-13,2016,0,3,490,0
Denver,26,18,26,30,0,0,0,0,Sacramento,29,32,26,29,0,0,0,0,20170223,100,116,3,17,17,16,16,216,16,2016,0,3,886,0
Portland,23,23,31,35,0,0,0,0,Orlando,25,30,30,18,0,0,0,0,20170223,112,103,-2,-9,-8,9,9,215,-9,2016,0,3,2525,0
Houston,30,36,34,29,0,0,0,0,New Orleans,28,22,17,32,0,0,0,0,20170223,129,99,2,16,33,30,30,228,-30,2016,0,3,317,0
Charlotte,28,34,23,15,8,0,0,0,Detroit,23,27,20,30,14,0,0,0,20170223,108,114,-5,-12,-15,0,6,222,6,2016,1,3,504,0
New York,33,18,28,25,0,0,0,0,Cleveland,34,35,18,32,0,0,0,0,20170223,104,119,1,18,8,15,15,223,15,2016,0,3,403,0
LA Clippers,24,37,26,26,0,0,0,0,Golden State,31,18,50,24,0,0,0,0,20170223,113,123,7,-12,12,10,10,236,10,2016,0,3,347,0
Washington,28,21,32,31,0,0,0,0,Philadelphia,26,35,34,25,0,0,0,0,20170224,112,120,-2,12,14,8,8,232,8,2016,0,4,123,0
LA Lakers,23,28,19,23,0,0,0,0,Oklahoma City,29,29,28,24,0,0,0,0,20170224,93,110,6,7,16,17,17,203,17,2016,0,4,1178,0
Dallas,22,18,23,21,0,0,0,0,Minnesota,26,23,22,26,0,0,0,0,20170224,84,97,4,9,8,13,13,181,13,2016,0,4,863,0
Utah,36,23,28,22,0,0,0,0,Milwaukee,27,19,29,20,0,0,0,0,20170224,109,95,9,13,12,14,14,204,-14,2016,0,4,1239,0
Boston,29,26,22,20,0,0,0,0,Toronto,18,27,29,33,0,0,0,0,20170224,97,107,-11,-10,-3,10,10,204,10,2016,0,4,430,0
Memphis,26,23,19,24,0,0,0,0,Indiana,25,36,28,13,0,0,0,0,20170224,92,102,-1,12,21,10,10,194,10,2016,0,4,383,0
Brooklyn,25,28,22,34,0,0,0,0,Denver,30,34,37,28,0,0,0,0,20170224,109,129,5,11,26,20,20,238,20,2016,0,4,1627,0
Phoenix,25,29,25,29,13,0,0,0,Chicago,24,28,28,28,20,0,0,0,20170224,121,128,-1,-2,1,0,7,249,7,2016,1,4,1450,0
Miami,25,38,24,21,0,0,0,0,Atlanta,24,25,17,24,0,0,0,0,20170224,108,90,1,14,21,18,18,198,-18,2016,0,4,605,0
San Antonio,18,29,30,28,0,0,0,0,LA Clippers,13,29,31,24,0,0,0,0,20170224,105,97,5,5,4,8,8,202,-8,2016,0,4,1201,0
Charlotte,24,27,28,20,0,0,0,0,Sacramento,19,21,18,27,0,0,0,0,20170225,99,85,5,11,21,14,14,184,-14,2016,0,5,2239,0
Atlanta,19,27,19,21,0,0,0,0,Orlando,22,27,31,25,0,0,0,0,20170225,86,105,3,3,15,19,19,191,19,2016,0,5,401,0
Philadelphia,25,25,25,34,0,0,0,0,New York,31,29,26,24,0,0,0,0,20170225,109,110,6,10,11,1,1,219,1,2016,0,5,80,0
Indiana,23,31,25,16,0,0,0,0,Miami,18,35,30,30,0,0,0,0,20170225,95,113,-5,-1,4,18,18,208,18,2016,0,5,1026,0
Minnesota,28,30,30,42,0,0,0,0,Houston,35,31,40,36,0,0,0,0,20170225,130,142,7,8,18,12,12,272,12,2016,0,5,1057,0
New Orleans,30,19,14,20,0,0,0,0,Dallas,24,23,20,29,0,0,0,0,20170225,83,96,-6,-2,4,13,13,179,13,2016,0,5,442,0
Chicago,23,32,34,28,0,0,0,0,Cleveland,22,34,20,23,0,0,0,0,20170225,117,99,1,-1,13,18,18,216,-18,2016,0,5,308,0
Brooklyn,28,23,25,19,0,0,0,0,Golden State,32,30,29,21,0,0,0,0,20170225,95,112,4,11,15,17,17,207,17,2016,0,5,2565,0
Utah,24,25,24,29,0,0,0,0,Washington,24,15,21,32,0,0,0,0,20170226,102,92,0,10,13,10,10,194,-10,2016,0,6,1841,0
Portland,28,24,28,26,0,0,0,0,Toronto,25,28,29,30,0,0,0,0,20170226,106,112,-3,1,2,6,6,218,6,2016,0,6,2108,0
New Orleans,35,24,25,26,0,0,0,0,Oklahoma City,32,27,28,31,0,0,0,0,20170226,110,118,-3,0,3,8,8,228,8,2016,0,6,576,0
Phoenix,23,24,26,23,0,0,0,0,Milwaukee,21,21,35,23,0,0,0,0,20170226,96,100,-2,-5,4,4,4,196,4,2016,0,6,1462,0
San Antonio,36,25,35,23,0,0,0,0,LA Lakers,20,21,29,28,0,0,0,0,20170226,119,98,16,20,26,21,21,217,-21,2016,0,6,1201,0
Boston,27,27,25,25,0,0,0,0,Detroit,23,27,24,24,0,0,0,0,20170226,104,98,4,4,5,6,6,202,-6,2016,0,6,611,0
Memphis,22,28,18,37,0,0,0,0,Denver,19,28,21,30,0,0,0,0,20170226,105,98,3,3,0,7,7,203,-7,2016,0,6,877,0
Charlotte,24,27,29,33,8,0,0,0,LA Clippers,32,27,25,29,11,0,0,0,20170226,121,124,8,8,4,0,3,245,3,2016,1,6,2115,0
Atlanta,24,27,33,30,0,0,0,0,Boston,24,23,24,27,0,0,0,0,20170227,114,98,0,4,13,16,16,212,-16,2016,0,0,935,0
Milwaukee,25,25,23,22,0,0,0,0,Cleveland,27,25,25,25,0,0,0,0,20170227,95,102,2,2,4,7,7,197,7,2016,0,0,334,0
Miami,31,23,15,20,0,0,0,0,Dallas,22,33,23,18,0,0,0,0,20170227,89,96,-9,1,9,7,7,185,7,2016,0,0,1110,0
Indiana,20,39,29,29,0,0,0,0,Houston,31,27,22,28,0,0,0,0,20170227,117,108,-11,1,8,9,9,225,-9,2016,0,0,865,0
Toronto,21,19,23,29,0,0,0,0,New York,25,28,14,24,0,0,0,0,20170227,92,91,-4,-13,-4,1,1,183,-1,2016,0,0,341,0
Golden State,32,27,34,26,0,0,0,0,Philadelphia,31,25,24,28,0,0,0,0,20170227,119,108,1,3,13,11,11,227,-11,2016,0,0,2516,0
Minnesota,20,40,17,25,0,0,0,0,Sacramento,25,19,21,23,0,0,0,0,20170227,102,88,-5,16,12,14,14,190,-14,2016,0,0,1511,0
Golden State,26,23,36,23,0,0,0,0,Washington,40,21,24,27,0,0,0,0,20170228,108,112,14,12,0,4,4,220,4,2016,0,1,2435,0
Utah,25,28,22,31,0,0,0,0,Oklahoma City,31,30,25,23,0,0,0,0,20170228,106,109,6,8,11,3,3,215,3,2016,0,1,861,0
Phoenix,27,29,29,27,0,0,0,0,Memphis,25,30,38,37,0,0,0,0,20170228,112,130,-2,-1,8,18,18,242,18,2016,0,1,1260,0
Denver,22,34,35,34,0,0,0,0,Chicago,25,34,24,24,0,0,0,0,20170228,125,107,-3,-3,8,18,18,232,-18,2016,0,1,916,0
Portland,27,22,30,30,4,0,0,0,Detroit,19,25,31,34,11,0,0,0,20170228,113,120,-8,-5,-4,0,7,233,7,2016,1,1,1964,0
Charlotte,27,31,22,29,0,0,0,0,LA Lakers,31,24,27,22,0,0,0,0,20170228,109,104,-4,3,-2,5,5,213,-5,2016,0,1,2115,0
New York,31,29,19,22,0,0,0,0,Orlando,24,27,16,23,0,0,0,0,20170301,101,90,7,9,12,11,11,191,-11,2016,0,2,939,0
Minnesota,21,30,30,26,0,0,0,0,Utah,16,19,18,27,0,0,0,0,20170301,107,80,5,16,28,27,27,187,-27,2016,0,2,984,0
Indiana,28,21,27,23,0,0,0,0,San Antonio,29,18,26,27,0,0,0,0,20170301,99,100,1,-2,-3,1,1,199,1,2016,0,2,999,0
Brooklyn,35,22,24,28,0,0,0,0,Sacramento,31,23,18,28,0,0,0,0,20170301,109,100,4,3,9,9,9,209,-9,2016,0,2,2499,0
Detroit,18,32,20,16,0,0,0,0,New Orleans,31,22,25,31,0,0,0,0,20170301,86,109,13,3,8,23,23,195,23,2016,0,2,939,0
Washington,24,38,20,23,0,0,0,0,Toronto,26,20,14,36,0,0,0,0,20170301,105,96,-2,16,22,9,9,201,-9,2016,0,2,349,0
Philadelphia,27,17,30,24,0,0,0,0,Miami,37,27,24,37,0,0,0,0,20170301,98,125,10,20,14,27,27,223,27,2016,0,2,1021,0
Houston,34,36,38,14,0,0,0,0,LA Clippers,37,21,20,25,0,0,0,0,20170301,122,103,-3,12,30,19,19,225,-19,2016,0,2,1371,0
Cleveland,26,24,21,28,0,0,0,0,Boston,20,29,25,29,0,0,0,0,20170301,99,103,-6,-1,3,4,4,202,4,2016,0,2,549,0
Dallas,22,30,24,19,0,0,0,0,Atlanta,27,36,18,19,0,0,0,0,20170301,95,100,5,11,5,5,5,195,5,2016,0,2,719,0
Denver,32,31,23,24,0,0,0,0,Milwaukee,15,22,29,32,0,0,0,0,20170301,110,98,17,26,20,12,12,208,-12,2016,0,2,912,0
Golden State,26,25,22,14,0,0,0,0,Chicago,19,28,32,15,0,0,0,0,20170302,87,94,-7,-4,6,7,7,181,7,2016,0,3,1853,0
Charlotte,32,26,33,12,0,0,0,0,Phoenix,28,33,33,26,0,0,0,0,20170302,103,120,-4,3,3,17,17,223,17,2016,0,3,1778,0
Oklahoma City,24,36,25,24,0,0,0,0,Portland,26,31,24,33,0,0,0,0,20170302,109,114,2,-3,-4,5,5,223,5,2016,0,3,1484,0
Toronto,35,27,17,35,0,0,0,0,Washington,27,26,25,28,0,0,0,0,20170303,114,106,8,9,1,8,8,220,-8,2016,0,4,349,0
Brooklyn,26,25,19,27,0,0,0,0,Utah,38,22,28,24,0,0,0,0,20170303,97,112,12,9,18,15,15,209,15,2016,0,4,1967,0
Oklahoma City,28,27,24,32,0,0,0,0,Phoenix,23,35,29,31,0,0,0,0,20170303,111,118,-5,3,8,7,7,229,7,2016,0,4,840,0
Miami,25,28,20,26,0,0,0,0,Orlando,33,27,25,25,0,0,0,0,20170303,99,110,8,7,12,11,11,209,11,2016,0,4,204,0
New York,35,18,28,21,0,0,0,0,Philadelphia,29,34,16,26,0,0,0,0,20170303,102,105,-6,10,-2,3,3,207,3,2016,0,4,80,0
LA Clippers,19,28,29,25,0,0,0,0,Milwaukee,34,32,19,27,0,0,0,0,20170303,101,112,15,19,9,11,11,213,11,2016,0,4,1741,0
Boston,35,35,23,22,0,0,0,0,LA Lakers,26,19,33,17,0,0,0,0,20170303,115,95,9,25,15,20,20,210,-20,2016,0,4,2590,0
Memphis,22,28,22,28,0,0,0,0,Dallas,20,31,28,25,0,0,0,0,20170303,100,104,-2,1,7,4,4,204,4,2016,0,4,419,0
Cleveland,39,38,29,29,0,0,0,0,Atlanta,33,27,28,42,0,0,0,0,20170303,135,130,6,17,18,5,5,265,-5,2016,0,4,555,0
San Antonio,27,22,18,22,12,0,0,0,New Orleans,30,18,18,23,9,0,0,0,20170303,101,98,-3,1,1,0,3,199,-3,2016,1,4,506,0
LA Clippers,23,32,27,19,0,0,0,0,Chicago,29,32,12,18,0,0,0,0,20170304,101,91,-6,-6,9,10,10,192,-10,2016,0,5,1741,0
Charlotte,31,30,29,22,0,0,0,0,Denver,23,29,27,23,0,0,0,0,20170304,112,102,8,9,11,10,10,214,-10,2016,0,5,1355,0
Memphis,24,27,27,30,0,0,0,0,Houston,27,28,38,30,0,0,0,0,20170304,108,123,3,4,15,15,15,231,15,2016,0,5,484,0
Cleveland,35,16,24,17,0,0,0,0,Miami,35,32,34,19,0,0,0,0,20170304,92,120,0,16,26,28,28,212,28,2016,0,5,1089,0
Toronto,19,23,25,27,0,0,0,0,Milwaukee,12,41,27,21,0,0,0,0,20170304,94,101,-7,11,13,7,7,195,7,2016,0,5,429,0
Detroit,33,34,39,30,0,0,0,0,Philadelphia,25,27,30,24,0,0,0,0,20170304,136,106,8,15,24,30,30,242,-30,2016,0,5,441,0
Brooklyn,27,30,25,34,0,0,0,0,Portland,37,21,32,40,0,0,0,0,20170304,116,130,10,1,8,14,14,246,14,2016,0,5,2439,0
Minnesota,26,29,15,13,7,0,0,0,San Antonio,14,29,19,21,14,0,0,0,20170304,90,97,-12,-12,-8,0,7,187,7,2016,1,5,1112,0
Orlando,28,33,29,24,0,0,0,0,Washington,25,20,34,36,0,0,0,0,20170305,114,115,-3,-16,-11,1,1,229,1,2016,0,6,757,0
Utah,25,20,24,28,13,0,0,0,Sacramento,31,28,22,16,12,0,0,0,20170305,110,109,-6,-14,-12,0,1,219,-1,2016,1,6,532,0
Golden State,29,20,35,28,0,0,0,0,New York,18,32,26,29,0,0,0,0,20170305,112,105,11,-1,8,7,7,217,-7,2016,0,6,2565,0
Boston,22,20,35,29,0,0,0,0,Phoenix,19,30,32,28,0,0,0,0,20170305,106,109,-3,7,4,3,3,215,3,2016,0,6,2295,0
Oklahoma City,27,23,21,18,0,0,0,0,Dallas,28,32,28,16,0,0,0,0,20170305,89,104,1,10,17,15,15,193,15,2016,0,6,189,0
Indiana,19,31,31,16,0,0,0,0,Atlanta,30,20,24,22,0,0,0,0,20170305,97,96,-11,0,7,1,1,193,-1,2016,0,6,427,0
New Orleans,26,29,28,22,0,0,0,0,LA Lakers,20,39,14,24,0,0,0,0,20170305,105,97,6,-4,10,8,8,202,-8,2016,0,6,1669,0
New Orleans,14,20,18,31,0,0,0,0,Utah,29,14,18,27,0,0,0,0,20170306,83,88,15,9,9,5,5,171,5,2016,0,0,1432,0
Houston,39,15,28,28,0,0,0,0,San Antonio,23,24,34,31,0,0,0,0,20170306,110,112,-16,-7,-1,2,2,222,2,2016,0,0,189,0
Milwaukee,27,33,31,21,0,0,0,0,Philadelphia,19,24,25,30,0,0,0,0,20170306,112,98,8,17,23,14,14,210,-14,2016,0,0,692,0
Brooklyn,36,20,32,34,0,0,0,0,Memphis,34,23,34,18,0,0,0,0,20170306,122,109,2,-1,-3,13,13,231,-13,2016,0,0,953,0
Boston,25,21,25,31,0,0,0,0,LA Clippers,22,21,32,41,0,0,0,0,20170306,102,116,-3,-3,4,14,14,218,14,2016,0,0,2590,0
New York,20,31,34,28,0,0,0,0,Orlando,28,26,38,13,0,0,0,0,20170306,113,105,-8,-3,-7,8,8,218,-8,2016,0,0,939,0
Sacramento,24,26,23,23,0,0,0,0,Denver,25,32,33,18,0,0,0,0,20170306,96,108,1,7,17,12,12,204,12,2016,0,0,886,0
Miami,29,33,27,17,0,0,0,0,Cleveland,22,30,19,27,0,0,0,0,20170306,106,98,7,10,18,8,8,204,-8,2016,0,0,1089,0
Indiana,16,21,29,22,0,0,0,0,Charlotte,27,31,16,26,0,0,0,0,20170306,88,100,11,21,8,12,12,188,12,2016,0,0,428,0
Golden State,35,26,33,25,0,0,0,0,Atlanta,42,24,24,21,0,0,0,0,20170306,119,111,-7,-5,4,8,8,230,-8,2016,0,0,2135,0
Chicago,26,29,24,16,0,0,0,0,Detroit,14,37,28,30,0,0,0,0,20170306,95,109,-12,-4,0,14,14,204,14,2016,0,0,238,0
LA Lakers,29,23,22,37,0,0,0,0,Dallas,38,32,33,19,0,0,0,0,20170307,111,122,9,18,29,11,11,233,11,2016,0,1,1237,0
Portland,29,32,38,27,0,0,0,0,Oklahoma City,40,27,25,29,0,0,0,0,20170307,126,121,-11,-6,7,5,5,247,-5,2016,0,1,1484,0
Washington,38,30,26,37,0,0,0,0,Phoenix,25,36,31,35,0,0,0,0,20170307,131,127,13,7,2,4,4,258,-4,2016,0,1,1977,0
New York,30,26,17,20,0,0,0,0,Milwaukee,32,23,21,28,0,0,0,0,20170308,93,104,2,-1,3,11,11,197,11,2016,0,2,732,0
Chicago,22,31,24,14,0,0,0,0,Orlando,19,24,34,21,0,0,0,0,20170308,91,98,-3,-10,0,7,7,189,7,2016,0,2,984,0
Toronto,22,23,23,26,0,0,0,0,New Orleans,26,20,18,23,0,0,0,0,20170308,94,87,-4,-1,4,7,7,181,-7,2016,0,2,1112,0
LA Clippers,19,36,13,23,0,0,0,0,Minnesota,31,27,24,25,0,0,0,0,20170308,91,107,12,3,14,16,16,198,16,2016,0,2,1521,0
Charlotte,22,32,32,15,0,0,0,0,Miami,18,36,27,27,0,0,0,0,20170308,101,108,-4,0,-5,7,7,209,7,2016,0,2,654,0
Sacramento,37,26,23,18,0,0,0,0,San Antonio,15,33,34,32,0,0,0,0,20170308,104,114,-22,-15,-4,10,10,218,10,2016,0,2,1456,0
Utah,30,34,20,31,0,0,0,0,Houston,22,31,24,31,0,0,0,0,20170308,115,108,8,11,7,7,7,223,-7,2016,0,2,1199,0
Boston,25,21,26,27,0,0,0,0,Golden State,28,22,24,12,0,0,0,0,20170308,99,86,-3,-4,-2,13,13,185,-13,2016,0,2,2692,0
Washington,35,32,30,26,0,0,0,0,Denver,28,22,35,28,0,0,0,0,20170308,123,113,7,17,12,10,10,236,-10,2016,0,2,1489,0
Brooklyn,27,23,30,25,0,0,0,0,Atlanta,23,23,35,29,0,0,0,0,20170308,105,110,-4,-4,1,5,5,215,5,2016,0,2,745,0
Detroit,23,27,23,25,0,0,0,0,Indiana,30,28,32,25,0,0,0,0,20170308,98,115,7,8,17,17,17,213,17,2016,0,2,240,0
Cleveland,29,23,28,21,0,0,0,0,Detroit,22,33,18,33,0,0,0,0,20170309,101,106,-7,3,-7,5,5,207,5,2016,0,3,90,0
LA Clippers,26,28,31,29,0,0,0,0,Memphis,21,24,20,33,0,0,0,0,20170309,114,98,5,9,20,16,16,212,-16,2016,0,3,1599,0
San Antonio,28,21,22,21,0,0,0,0,Oklahoma City,29,27,26,20,0,0,0,0,20170309,92,102,1,7,11,10,10,194,10,2016,0,3,421,0
LA Lakers,32,29,29,32,0,0,0,0,Phoenix,33,30,18,29,0,0,0,0,20170309,122,110,-1,-2,9,12,12,232,-12,2016,0,3,356,0
Philadelphia,17,35,26,19,11,0,0,0,Portland,27,30,19,21,17,0,0,0,20170309,108,114,10,5,-2,0,6,222,6,2016,1,3,2405,0
Washington,28,28,26,34,14,0,0,0,Sacramento,32,36,29,19,6,0,0,0,20170310,130,122,-4,-12,-15,0,8,252,-8,2016,1,4,2371,0
Indiana,27,23,18,17,0,0,0,0,Milwaukee,23,22,29,25,0,0,0,0,20170310,85,99,-4,-5,6,14,14,184,14,2016,0,4,243,0
Boston,25,29,26,19,0,0,0,0,Denver,35,30,29,25,0,0,0,0,20170310,99,119,10,11,14,20,20,218,20,2016,0,4,1765,0
Golden State,24,29,23,26,0,0,0,0,Minnesota,34,28,26,15,0,0,0,0,20170310,102,103,10,9,12,1,1,205,1,2016,0,4,1581,0
Orlando,24,16,22,19,0,0,0,0,Charlotte,37,21,30,33,0,0,0,0,20170310,81,121,13,18,26,40,40,202,40,2016,0,4,463,0
Houston,23,33,36,23,0,0,0,0,Chicago,33,16,14,31,0,0,0,0,20170310,115,94,-10,7,29,21,21,209,-21,2016,0,4,939,0
Toronto,19,29,27,24,0,0,0,0,Atlanta,18,31,25,31,0,0,0,0,20170310,99,105,-1,1,-1,6,6,204,6,2016,0,4,733,0
Brooklyn,26,23,24,23,0,0,0,0,Dallas,23,23,28,31,0,0,0,0,20170310,96,105,-3,-3,1,9,9,201,9,2016,0,4,1370,0
Golden State,22,22,19,22,0,0,0,0,San Antonio,33,31,22,21,0,0,0,0,20170311,85,107,11,20,23,22,22,192,22,2016,0,5,1487,0
Denver,25,29,21,30,0,0,0,0,Sacramento,19,25,25,23,0,0,0,0,20170311,105,92,6,10,6,13,13,197,-13,2016,0,5,886,0
Washington,30,19,33,30,13,0,0,0,Portland,36,34,21,21,12,0,0,0,20170311,125,124,-6,-21,-9,0,1,249,-1,2016,1,5,2347,0
Cleveland,24,35,28,29,0,0,0,0,Orlando,25,26,28,25,0,0,0,0,20170311,116,104,-1,8,8,12,12,220,-12,2016,0,5,895,0
Utah,23,25,28,28,0,0,0,0,Oklahoma City,29,33,29,21,0,0,0,0,20170311,104,112,6,14,15,8,8,216,8,2016,0,5,861,0
Minnesota,19,29,27,20,0,0,0,0,Milwaukee,23,25,28,26,0,0,0,0,20170311,95,102,4,0,1,7,7,197,7,2016,0,5,298,0
Toronto,26,15,22,26,0,0,0,0,Miami,32,27,26,19,0,0,0,0,20170311,89,104,6,18,22,15,15,193,15,2016,0,5,1234,0
Philadelphia,30,27,22,21,0,0,0,0,LA Clippers,32,24,19,37,0,0,0,0,20170311,100,112,2,-1,-4,12,12,212,12,2016,0,5,2388,0
New York,23,30,28,11,0,0,0,0,Detroit,35,31,23,23,0,0,0,0,20170311,92,112,12,13,8,20,20,204,20,2016,0,5,480,0
Phoenix,25,20,27,28,0,0,0,0,Dallas,24,23,22,29,0,0,0,0,20170311,100,98,1,-2,3,2,2,198,-2,2016,0,5,884,0
New Orleans,32,27,24,29,13,0,0,0,Charlotte,27,31,20,34,10,0,0,0,20170311,125,122,5,1,5,0,3,247,-3,2016,1,5,648,0
Atlanta,33,14,30,30,0,0,0,0,Memphis,15,20,22,33,0,0,0,0,20170311,107,90,18,12,20,17,17,197,-17,2016,0,5,336,0
Philadelphia,32,33,28,25,0,0,0,0,LA Lakers,27,38,20,31,0,0,0,0,20170312,118,116,5,0,8,2,2,234,-2,2016,0,6,2388,0
Portland,33,33,16,28,0,0,0,0,Phoenix,18,32,29,22,0,0,0,0,20170312,110,101,15,16,3,9,9,211,-9,2016,0,6,1005,0
Miami,22,31,22,23,0,0,0,0,Indiana,32,28,23,19,0,0,0,0,20170312,98,102,10,7,8,4,4,200,4,2016,0,6,1026,0
Chicago,9,17,31,23,0,0,0,0,Boston,22,24,30,24,0,0,0,0,20170312,80,100,13,20,19,20,20,180,20,2016,0,6,849,0
New York,26,23,31,32,0,0,0,0,Brooklyn,39,28,24,29,0,0,0,0,20170312,112,120,13,18,11,8,8,232,8,2016,0,6,0,0
Cleveland,26,41,19,26,0,0,0,0,Houston,33,25,32,27,0,0,0,0,20170312,112,117,7,-9,4,5,5,229,5,2016,0,6,1113,0
Dallas,26,20,20,12,0,0,0,0,Toronto,25,25,29,21,0,0,0,0,20170313,78,100,-1,4,13,22,22,178,22,2016,0,0,1201,0
Atlanta,18,25,30,26,0,0,0,0,San Antonio,28,26,27,26,0,0,0,0,20170313,99,107,10,11,8,8,8,206,8,2016,0,0,881,0
Orlando,23,35,26,31,0,0,0,0,Sacramento,24,34,35,27,0,0,0,0,20170313,115,120,1,0,9,5,5,235,5,2016,0,0,2390,0
LA Clippers,28,28,30,22,0,0,0,0,Utah,23,26,40,25,0,0,0,0,20170313,108,114,-5,-7,3,6,6,222,6,2016,0,0,579,0
Milwaukee,24,27,23,19,0,0,0,0,Memphis,30,31,24,28,0,0,0,0,20170313,93,113,6,10,11,20,20,206,20,2016,0,0,557,0
LA Lakers,23,20,33,25,0,0,0,0,Denver,35,32,26,36,0,0,0,0,20170313,101,129,12,24,17,28,28,230,28,2016,0,0,830,0
Chicago,36,22,29,28,0,0,0,0,Charlotte,24,24,29,32,0,0,0,0,20170313,115,109,12,10,10,6,6,224,-6,2016,0,0,586,0
Washington,23,33,24,24,0,0,0,0,Minnesota,41,23,25,30,0,0,0,0,20170313,104,119,18,8,9,15,15,223,15,2016,0,0,931,0
Oklahoma City,32,30,29,31,0,0,0,0,Brooklyn,32,30,21,21,0,0,0,0,20170314,122,104,0,0,8,18,18,226,-18,2016,0,1,1324,0
Detroit,26,22,22,26,0,0,0,0,Cleveland,44,30,30,24,0,0,0,0,20170314,96,128,18,26,34,32,32,224,32,2016,0,1,90,0
Philadelphia,34,25,31,14,0,0,0,0,Golden State,35,23,20,28,0,0,0,0,20170314,104,106,1,-1,-12,2,2,210,2,2016,0,1,2516,0
Portland,16,20,18,23,0,0,0,0,New Orleans,23,27,27,23,0,0,0,0,20170314,77,100,7,14,23,23,23,177,23,2016,0,1,2059,0
Indiana,24,28,12,17,0,0,0,0,New York,18,24,20,25,0,0,0,0,20170314,81,87,-6,-10,-2,6,6,168,6,2016,0,1,643,0
New Orleans,21,31,27,33,0,0,0,0,Miami,28,26,31,35,0,0,0,0,20170315,112,120,7,2,6,8,8,232,8,2016,0,2,668,0
Portland,28,26,28,28,0,0,0,0,San Antonio,29,26,25,26,0,0,0,0,20170315,110,106,-1,-1,2,4,4,216,-4,2016,0,2,1718,0
Sacramento,22,26,26,33,0,0,0,0,Phoenix,29,18,28,26,0,0,0,0,20170315,107,101,-7,1,-1,6,6,208,-6,2016,0,2,634,0
Milwaukee,28,18,21,30,0,0,0,0,LA Clippers,20,26,23,27,0,0,0,0,20170315,97,96,8,0,-2,1,1,193,-1,2016,0,2,1741,0
Dallas,32,21,20,39,0,0,0,0,Washington,39,18,23,27,0,0,0,0,20170315,112,107,-7,-4,-7,5,5,219,-5,2016,0,2,1181,0
LA Lakers,26,26,23,25,0,0,0,0,Houston,37,29,27,46,0,0,0,0,20170315,100,139,11,14,18,39,39,239,39,2016,0,2,1371,0
Utah,28,26,23,20,0,0,0,0,Detroit,19,16,27,21,0,0,0,0,20170315,97,83,9,19,15,14,14,180,-14,2016,0,2,1488,0
Memphis,24,30,20,24,0,0,0,0,Chicago,24,26,21,20,0,0,0,0,20170315,98,91,0,4,3,7,7,189,-7,2016,0,2,480,0
Minnesota,32,28,17,27,0,0,0,0,Boston,30,28,27,32,0,0,0,0,20170315,104,117,-2,-2,8,13,13,221,13,2016,0,2,1120,0
Charlotte,22,20,16,19,0,0,0,0,Indiana,24,18,33,23,0,0,0,0,20170315,77,98,2,0,17,21,21,175,21,2016,0,2,428,0
Memphis,26,29,23,25,0,0,0,0,Atlanta,28,24,13,26,0,0,0,0,20170316,103,91,-2,3,13,12,12,194,-12,2016,0,3,336,0
Utah,20,22,25,16,0,0,0,0,Cleveland,29,15,23,24,0,0,0,0,20170316,83,91,9,2,0,8,8,174,8,2016,0,3,1564,0
LA Clippers,19,27,34,34,0,0,0,0,Denver,27,32,44,26,0,0,0,0,20170316,114,129,8,13,23,15,15,243,15,2016,0,3,830,0
Orlando,20,30,21,21,0,0,0,0,Golden State,34,33,36,19,0,0,0,0,20170316,92,122,14,17,32,30,30,214,30,2016,0,3,2437,0
Brooklyn,28,26,38,29,0,0,0,0,New York,33,28,26,23,0,0,0,0,20170316,121,110,-5,-7,5,11,11,231,-11,2016,0,3,0,0
Oklahoma City,29,29,39,26,0,0,0,0,Toronto,24,24,22,32,0,0,0,0,20170316,123,102,5,10,27,21,21,225,-21,2016,0,3,1114,0
Chicago,23,17,32,35,0,0,0,0,Washington,29,30,25,28,0,0,0,0,20170317,107,112,6,19,12,5,5,219,5,2016,0,4,594,0
Orlando,30,30,24,25,0,0,0,0,Phoenix,22,36,27,18,0,0,0,0,20170317,109,103,8,2,-1,6,6,212,-6,2016,0,4,1842,0
Dallas,23,17,16,18,0,0,0,0,Philadelphia,21,30,36,29,0,0,0,0,20170317,74,116,-2,11,31,42,42,190,42,2016,0,4,1297,0
Houston,23,27,31,31,0,0,0,0,New Orleans,36,32,31,29,0,0,0,0,20170317,112,128,13,18,18,16,16,240,16,2016,0,4,317,0
Minnesota,23,26,32,24,0,0,0,0,Miami,27,37,26,33,0,0,0,0,20170317,105,123,4,15,9,18,18,228,18,2016,0,4,1513,0
Toronto,16,24,20,27,0,0,0,0,Detroit,13,25,28,9,0,0,0,0,20170317,87,75,3,2,-6,12,12,162,-12,2016,0,4,205,0
Boston,21,24,26,27,0,0,0,0,Brooklyn,16,21,28,30,0,0,0,0,20170317,98,95,5,8,6,3,3,193,-3,2016,0,4,190,0
Milwaukee,31,30,23,23,0,0,0,0,LA Lakers,24,22,31,26,0,0,0,0,20170317,107,103,7,15,7,4,4,210,-4,2016,0,4,1741,0
Portland,40,23,22,28,0,0,0,0,Atlanta,18,28,27,24,0,0,0,0,20170318,113,97,22,17,12,16,16,210,-16,2016,0,5,2168,0
Utah,23,21,20,22,0,0,0,0,Chicago,16,24,21,34,0,0,0,0,20170318,86,95,-7,-4,-3,9,9,181,9,2016,0,5,1256,0
Washington,20,20,21,32,0,0,0,0,Charlotte,19,20,25,34,0,0,0,0,20170318,93,98,-1,-1,3,5,5,191,5,2016,0,5,329,0
Houston,26,25,29,29,0,0,0,0,Denver,26,30,18,31,0,0,0,0,20170318,109,105,0,-5,6,4,4,214,-4,2016,0,5,878,0
Milwaukee,29,15,26,22,0,0,0,0,Golden State,27,36,31,23,0,0,0,0,20170318,92,117,-2,19,24,25,25,209,25,2016,0,5,1838,0
Cleveland,16,15,27,20,0,0,0,0,LA Clippers,14,33,29,32,0,0,0,0,20170318,78,108,-2,16,18,30,30,186,30,2016,0,5,2044,0
San Antonio,18,25,30,23,0,0,0,0,Memphis,29,15,31,29,0,0,0,0,20170318,96,104,11,1,2,8,8,200,8,2016,0,5,631,0
Sacramento,19,22,24,29,0,0,0,0,Oklahoma City,29,34,22,25,0,0,0,0,20170318,94,110,10,22,20,16,16,204,16,2016,0,5,1336,0
Boston,23,28,28,20,0,0,0,0,Philadelphia,25,21,30,29,0,0,0,0,20170319,99,105,2,-5,-3,6,6,204,6,2016,0,6,270,0
Indiana,24,21,28,18,0,0,0,0,Toronto,32,30,29,25,0,0,0,0,20170319,91,116,8,17,18,25,25,207,25,2016,0,6,438,0
Minnesota,34,20,30,25,0,0,0,0,New Orleans,28,20,40,35,0,0,0,0,20170319,109,123,-6,-6,4,14,14,232,14,2016,0,6,1052,0
Sacramento,27,22,25,28,0,0,0,0,San Antonio,21,37,41,19,0,0,0,0,20170319,102,118,-6,9,25,16,16,220,16,2016,0,6,1456,0
Cleveland,31,24,27,43,0,0,0,0,LA Lakers,28,31,33,28,0,0,0,0,20170319,125,120,3,-4,-10,5,5,245,-5,2016,0,6,2044,0
Dallas,32,25,25,29,0,0,0,0,Brooklyn,26,17,29,32,0,0,0,0,20170319,111,104,6,14,10,7,7,215,-7,2016,0,6,1370,0
Portland,28,24,33,30,0,0,0,0,Miami,29,22,28,25,0,0,0,0,20170319,115,104,-1,1,6,11,11,219,-11,2016,0,6,2704,0
Phoenix,23,26,26,20,0,0,0,0,Detroit,24,23,30,35,0,0,0,0,20170319,95,112,1,-2,2,17,17,207,17,2016,0,6,1687,0
Washington,28,19,28,27,0,0,0,0,Boston,30,28,34,18,0,0,0,0,20170320,102,110,2,11,17,8,8,212,8,2016,0,0,394,0
Atlanta,19,23,26,22,0,0,0,0,Charlotte,19,32,32,22,0,0,0,0,20170320,90,105,0,9,15,15,15,195,15,2016,0,0,226,0
Denver,28,37,32,27,0,0,0,0,Houston,35,27,32,31,0,0,0,0,20170320,124,125,7,-3,-3,1,1,249,1,2016,0,0,878,0
Utah,23,23,24,30,0,0,0,0,Indiana,28,23,29,27,0,0,0,0,20170320,100,107,5,5,10,7,7,207,7,2016,0,0,1353,0
New York,23,30,19,33,0,0,0,0,LA Clippers,29,34,34,17,0,0,0,0,20170320,105,114,6,10,25,9,9,219,9,2016,0,0,2445,0
Golden State,25,34,33,19,0,0,0,0,Oklahoma City,22,17,27,29,0,0,0,0,20170320,111,95,3,20,26,16,16,206,-16,2016,0,0,1386,0
Philadelphia,26,30,27,15,11,0,0,0,Orlando,25,16,33,24,14,0,0,0,20170320,109,112,-1,-15,-9,0,3,221,3,2016,1,0,864,0
Chicago,31,28,35,19,7,0,0,0,Toronto,27,27,25,34,9,0,0,0,20170321,120,122,-4,-5,-15,0,2,242,2,2016,1,1,436,0
Milwaukee,18,30,19,26,0,0,0,0,Portland,21,14,28,27,0,0,0,0,20170321,93,90,-3,13,4,3,3,183,-3,2016,0,1,1714,0
Memphis,23,18,13,28,0,0,0,0,New Orleans,21,13,32,29,0,0,0,0,20170321,82,95,-2,-7,12,13,13,177,13,2016,0,1,358,0
San Antonio,25,17,31,27,0,0,0,0,Minnesota,23,28,16,26,0,0,0,0,20170321,100,93,2,-9,6,7,7,193,-7,2016,0,1,1112,0
Golden State,28,34,29,21,0,0,0,0,Dallas,30,20,21,16,0,0,0,0,20170321,112,87,-2,12,20,25,25,199,-25,2016,0,1,1480,0
LA Clippers,33,37,38,25,0,0,0,0,LA Lakers,24,16,34,35,0,0,0,0,20170321,133,109,9,30,34,24,24,242,-24,2016,0,1,0,0
Detroit,31,13,21,31,0,0,0,0,Brooklyn,22,28,24,24,0,0,0,0,20170321,96,98,-9,6,9,2,2,194,2,2016,0,1,480,0
Phoenix,26,20,17,34,0,0,0,0,Miami,23,36,25,28,0,0,0,0,20170321,97,112,-3,13,21,15,15,209,15,2016,0,1,1978,0
Milwaukee,25,44,21,26,0,0,0,0,Sacramento,24,26,25,23,0,0,0,0,20170322,116,98,1,19,15,18,18,214,-18,2016,0,2,1771,0
New York,34,21,20,26,0,0,0,0,Utah,26,25,21,36,0,0,0,0,20170322,101,108,-8,-4,-3,7,7,209,7,2016,0,2,1967,0
Charlotte,21,27,29,32,0,0,0,0,Orlando,27,27,28,20,0,0,0,0,20170322,109,102,-6,-6,-5,7,7,211,-7,2016,0,2,463,0
Atlanta,20,26,21,33,0,0,0,0,Washington,16,24,27,37,0,0,0,0,20170322,100,104,-4,-6,0,4,4,204,4,2016,0,2,541,0
Cleveland,31,28,31,23,0,0,0,0,Denver,34,39,28,25,0,0,0,0,20170322,113,126,3,14,11,13,13,239,13,2016,0,2,1223,0
Detroit,23,30,20,22,0,0,0,0,Chicago,32,27,32,26,0,0,0,0,20170322,95,117,9,6,18,22,22,212,22,2016,0,2,238,0
Indiana,19,23,32,26,0,0,0,0,Boston,21,28,39,21,0,0,0,0,20170322,100,109,2,7,14,9,9,209,9,2016,0,2,805,0
Philadelphia,22,28,20,27,0,0,0,0,Oklahoma City,29,34,32,27,0,0,0,0,20170322,97,122,7,13,25,25,25,219,25,2016,0,2,1256,0
Phoenix,32,18,15,33,0,0,0,0,Brooklyn,22,30,32,42,0,0,0,0,20170323,98,126,-10,2,19,28,28,224,28,2016,0,3,2139,0
LA Clippers,24,30,21,20,0,0,0,0,Dallas,29,19,29,20,0,0,0,0,20170323,95,97,5,-6,2,2,2,192,2,2016,0,3,1237,0
Toronto,23,22,30,26,0,0,0,0,Miami,33,14,21,16,0,0,0,0,20170323,101,84,-10,-2,7,17,17,185,-17,2016,0,3,1234,0
New York,23,23,22,27,0,0,0,0,Portland,37,30,18,25,0,0,0,0,20170323,95,110,14,21,17,15,15,205,15,2016,0,3,2439,0
Memphis,22,20,27,21,0,0,0,0,San Antonio,27,24,23,23,0,0,0,0,20170323,90,97,5,9,5,7,7,187,7,2016,0,3,631,0
Brooklyn,22,20,39,27,0,0,0,0,Washington,31,32,34,32,0,0,0,0,20170324,108,129,9,21,16,21,21,237,21,2016,0,4,204,0
Detroit,18,21,23,25,0,0,0,0,Orlando,22,35,35,23,0,0,0,0,20170324,87,115,4,18,30,28,28,202,28,2016,0,4,957,0
Atlanta,21,22,31,23,0,0,0,0,Milwaukee,29,16,27,28,0,0,0,0,20170324,97,100,8,2,-2,3,3,197,3,2016,0,4,669,0
Minnesota,27,40,21,21,10,0,0,0,LA Lakers,26,28,26,29,21,0,0,0,20170324,119,130,-1,-13,-8,0,11,249,11,2016,1,4,1521,0
Denver,34,30,30,31,0,0,0,0,Indiana,26,27,22,42,0,0,0,0,20170324,125,117,8,11,19,8,8,242,-8,2016,0,4,998,0
New Orleans,33,17,29,28,0,0,0,0,Houston,28,21,31,37,0,0,0,0,20170324,107,117,-5,-1,1,10,10,224,10,2016,0,4,317,0
Cleveland,33,26,31,22,0,0,0,0,Charlotte,31,22,32,20,0,0,0,0,20170324,112,105,2,6,5,7,7,217,-7,2016,0,4,435,0
Philadelphia,24,35,34,24,0,0,0,0,Chicago,28,18,25,36,0,0,0,0,20170324,117,107,-4,13,22,10,10,224,-10,2016,0,4,664,0
Phoenix,16,27,37,40,0,0,0,0,Boston,29,37,31,33,0,0,0,0,20170324,120,130,13,23,17,10,10,250,10,2016,0,4,2295,0
Sacramento,20,30,22,28,0,0,0,0,Golden State,27,30,35,22,0,0,0,0,20170324,100,114,7,7,20,14,14,214,14,2016,0,4,75,0
Washington,40,31,25,31,0,0,0,0,Cleveland,26,35,30,24,0,0,0,0,20170325,127,115,14,10,5,12,12,242,-12,2016,0,5,304,0
Toronto,30,24,20,20,0,0,0,0,Dallas,22,22,20,22,0,0,0,0,20170325,94,86,8,10,10,8,8,180,-8,2016,0,5,1201,0
Utah,14,27,29,25,0,0,0,0,LA Clippers,28,21,23,36,0,0,0,0,20170325,95,108,14,8,2,13,13,203,13,2016,0,5,579,0
Minnesota,21,25,28,26,0,0,0,0,Portland,27,33,34,18,0,0,0,0,20170325,100,112,6,14,20,12,12,212,12,2016,0,5,1423,0
New York,23,20,31,24,0,0,0,0,San Antonio,33,28,17,28,0,0,0,0,20170325,98,106,10,18,4,8,8,204,8,2016,0,5,1581,0
Philadelphia,18,27,24,25,0,0,0,0,Indiana,27,24,30,26,0,0,0,0,20170326,94,107,9,6,12,13,13,201,13,2016,0,6,582,0
Chicago,29,27,35,18,0,0,0,0,Milwaukee,31,24,24,15,0,0,0,0,20170326,109,94,-2,1,12,15,15,203,-15,2016,0,6,83,0
Portland,22,18,37,20,0,0,0,0,LA Lakers,17,15,24,25,0,0,0,0,20170326,97,81,5,8,21,16,16,178,-16,2016,0,6,826,0
Oklahoma City,31,28,29,37,0,0,0,0,Houston,37,42,34,24,0,0,0,0,20170326,125,137,6,20,25,12,12,262,12,2016,0,6,413,0
Sacramento,24,18,23,33,0,0,0,0,LA Clippers,24,20,32,21,0,0,0,0,20170326,98,97,0,-2,-11,1,1,195,-1,2016,0,6,361,0
New Orleans,29,26,32,28,0,0,0,0,Denver,26,14,19,31,0,0,0,0,20170326,115,90,3,15,28,25,25,205,-25,2016,0,6,1079,0
Phoenix,18,29,33,26,0,0,0,0,Charlotte,38,31,29,22,0,0,0,0,20170326,106,120,20,22,18,14,14,226,14,2016,0,6,1778,0
Memphis,28,26,27,13,0,0,0,0,Golden State,25,31,27,23,0,0,0,0,20170326,94,106,-3,2,2,12,12,200,12,2016,0,6,1798,0
Miami,27,31,17,33,0,0,0,0,Boston,22,31,32,27,0,0,0,0,20170326,108,112,-5,-5,10,4,4,220,4,2016,0,6,1257,0
Brooklyn,32,23,23,29,0,0,0,0,Atlanta,20,28,20,24,0,0,0,0,20170326,107,92,12,7,10,15,15,199,-15,2016,0,6,745,0
Oklahoma City,25,10,22,35,0,0,0,0,Dallas,26,24,19,22,0,0,0,0,20170327,92,91,-1,-15,-12,1,1,183,-1,2016,0,0,189,0
Detroit,36,23,15,21,0,0,0,0,New York,34,30,25,20,0,0,0,0,20170327,95,109,-2,5,15,14,14,204,14,2016,0,0,480,0
Memphis,27,22,19,22,0,0,0,0,Sacramento,28,23,23,17,0,0,0,0,20170327,90,91,1,2,6,1,1,181,1,2016,0,0,1745,0
Cleveland,18,22,18,16,0,0,0,0,San Antonio,28,36,17,22,0,0,0,0,20170327,74,103,10,24,23,29,29,177,29,2016,0,0,1256,0
Orlando,34,23,32,23,0,0,0,0,Toronto,35,38,26,32,0,0,0,0,20170327,112,131,1,16,10,19,19,243,19,2016,0,0,1048,0
New Orleans,21,30,20,29,0,0,0,0,Utah,28,28,25,27,0,0,0,0,20170327,100,108,7,5,10,8,8,208,8,2016,0,0,1432,0
Denver,35,29,21,28,0,0,0,0,Portland,32,34,29,27,0,0,0,0,20170328,113,122,-3,2,10,9,9,235,9,2016,0,1,981,0
Washington,27,28,27,37,0,0,0,0,LA Lakers,27,31,37,13,0,0,0,0,20170328,119,108,0,-3,-13,11,11,227,-11,2016,0,1,2294,0
Minnesota,26,33,28,28,0,0,0,0,Indiana,25,32,33,24,0,0,0,0,20170328,115,114,1,2,-3,1,1,229,-1,2016,0,1,510,0
Golden State,37,23,26,27,0,0,0,0,Houston,20,32,23,31,0,0,0,0,20170328,113,106,17,8,11,7,7,219,-7,2016,0,1,1642,0
Phoenix,12,32,24,23,0,0,0,0,Atlanta,27,20,24,24,0,0,0,0,20170328,91,95,15,3,3,4,4,186,4,2016,0,1,1588,0
Milwaukee,35,37,22,24,0,0,0,0,Charlotte,24,26,26,32,0,0,0,0,20170328,118,108,11,22,18,10,10,226,-10,2016,0,1,658,0
Philadelphia,31,27,21,27,0,0,0,0,Brooklyn,24,33,21,23,0,0,0,0,20170328,106,101,7,1,1,5,5,207,-5,2016,0,1,80,0
Miami,24,31,23,19,0,0,0,0,Detroit,24,26,19,27,0,0,0,0,20170328,97,96,0,5,9,1,1,193,-1,2016,0,1,1155,0
Atlanta,25,27,27,20,0,0,0,0,Philadelphia,18,25,27,22,0,0,0,0,20170329,99,92,7,9,9,7,7,191,-7,2016,0,2,665,0
Charlotte,22,28,16,44,0,0,0,0,Toronto,19,28,27,32,0,0,0,0,20170329,110,106,3,3,-8,4,4,216,-4,2016,0,2,585,0
Utah,34,16,28,34,0,0,0,0,Sacramento,14,29,24,15,0,0,0,0,20170329,112,82,20,7,11,30,30,194,-30,2016,0,2,532,0
Oklahoma City,20,24,28,30,12,0,0,0,Orlando,18,31,33,20,4,0,0,0,20170329,114,106,2,-5,-10,0,8,220,-8,2016,1,2,1057,0
Golden State,17,37,30,26,0,0,0,0,San Antonio,33,24,20,21,0,0,0,0,20170329,110,98,-16,-3,7,12,12,208,-12,2016,0,2,1487,0
Dallas,23,28,32,35,0,0,0,0,New Orleans,27,36,26,32,0,0,0,0,20170329,118,121,4,12,6,3,3,239,3,2016,0,2,442,0
Indiana,24,29,26,18,0,0,0,0,Memphis,38,34,24,14,0,0,0,0,20170329,97,110,14,19,17,13,13,207,13,2016,0,2,383,0
Washington,31,32,35,26,0,0,0,0,LA Clippers,39,35,36,23,0,0,0,0,20170329,124,133,8,11,12,9,9,257,9,2016,0,2,2294,0
Milwaukee,24,31,25,23,0,0,0,0,Boston,24,25,28,23,0,0,0,0,20170329,103,100,0,6,3,3,3,203,-3,2016,0,2,855,0
Miami,24,25,28,28,0,0,0,0,New York,22,19,27,20,0,0,0,0,20170329,105,88,2,8,9,17,17,193,-17,2016,0,2,1091,0
Cleveland,28,22,21,22,0,0,0,0,Chicago,22,19,37,21,0,0,0,0,20170330,93,99,-6,-9,7,6,6,192,6,2016,0,3,308,0
Brooklyn,18,21,24,26,0,0,0,0,Detroit,16,19,24,31,0,0,0,0,20170330,89,90,-2,-4,-4,1,1,179,1,2016,0,3,480,0
LA Lakers,37,23,22,22,0,0,0,0,Minnesota,37,30,29,23,0,0,0,0,20170330,104,119,0,7,14,15,15,223,15,2016,0,3,1521,0
LA Clippers,31,36,26,31,0,0,0,0,Phoenix,35,24,33,26,0,0,0,0,20170330,124,118,-4,8,1,6,6,242,-6,2016,0,3,356,0
Houston,31,25,29,22,0,0,0,0,Portland,32,33,31,21,0,0,0,0,20170330,107,117,1,9,11,10,10,224,10,2016,0,3,1833,0
Washington,19,20,22,27,0,0,0,0,Utah,24,18,22,31,0,0,0,0,20170331,88,95,5,3,3,7,7,183,7,2016,0,4,1841,0
Indiana,25,23,20,32,0,0,0,0,Toronto,28,18,34,31,0,0,0,0,20170331,100,111,3,-2,12,11,11,211,11,2016,0,4,438,0
San Antonio,16,25,30,29,0,0,0,0,Oklahoma City,25,29,22,19,0,0,0,0,20170331,100,95,-9,-13,-5,5,5,195,-5,2016,0,4,421,0
Sacramento,19,19,26,25,0,0,0,0,New Orleans,32,26,26,33,0,0,0,0,20170331,89,117,13,20,20,28,28,206,28,2016,0,4,1879,0
Detroit,22,26,25,22,10,0,0,0,Milwaukee,35,21,15,24,13,0,0,0,20170331,105,108,13,8,-2,0,3,213,3,2016,1,4,251,0
New York,33,26,18,21,0,0,0,0,Miami,29,26,20,19,0,0,0,0,20170331,98,94,4,4,2,4,4,192,-4,2016,0,4,1091,0
Houston,25,36,24,13,0,0,0,0,Golden State,23,33,27,24,0,0,0,0,20170331,98,107,-2,-5,-2,9,9,205,9,2016,0,4,1642,0
Philadelphia,29,23,25,28,0,0,0,0,Cleveland,32,38,34,18,0,0,0,0,20170331,105,122,3,18,27,17,17,227,17,2016,0,4,358,0
Denver,32,24,38,20,0,0,0,0,Charlotte,24,32,30,36,0,0,0,0,20170331,114,122,-8,0,-8,8,8,236,8,2016,0,4,1355,0
Orlando,29,35,26,26,0,0,0,0,Boston,31,26,35,25,0,0,0,0,20170331,116,117,2,-7,2,1,1,233,1,2016,0,4,1115,0
Dallas,19,15,28,28,0,0,0,0,Memphis,21,34,18,26,0,0,0,0,20170331,90,99,2,21,11,9,9,189,9,2016,0,4,419,0
Orlando,33,20,36,22,0,0,0,0,Brooklyn,33,27,29,32,0,0,0,0,20170401,111,121,0,7,0,10,10,232,10,2016,0,5,939,0
Atlanta,21,25,38,20,0,0,0,0,Chicago,23,29,27,27,0,0,0,0,20170401,104,106,2,6,-5,2,2,210,2,2016,0,5,587,0
LA Lakers,22,28,22,32,0,0,0,0,LA Clippers,28,27,38,22,0,0,0,0,20170401,104,115,6,5,21,11,11,219,11,2016,0,5,0,0
Sacramento,18,37,36,32,0,0,0,0,Minnesota,31,28,26,32,0,0,0,0,20170401,123,117,-13,-4,6,6,6,240,-6,2016,0,5,1511,0
Phoenix,21,32,34,30,0,0,0,0,Portland,37,26,34,33,0,0,0,0,20170401,117,130,16,10,10,13,13,247,13,2016,0,5,1005,0
Charlotte,31,28,25,29,0,0,0,0,Oklahoma City,22,32,16,31,0,0,0,0,20170402,113,101,9,5,14,12,12,214,-12,2016,0,6,938,0
Philadelphia,29,20,27,29,0,0,0,0,Toronto,28,31,27,27,0,0,0,0,20170402,105,113,-1,10,10,8,8,218,8,2016,0,6,334,0
Utah,28,24,26,25,0,0,0,0,San Antonio,33,21,34,21,0,0,0,0,20170402,103,109,5,2,10,6,6,212,6,2016,0,6,1087,0
Houston,31,28,31,33,0,0,0,0,Phoenix,21,33,29,33,0,0,0,0,20170402,123,116,10,5,7,7,7,239,-7,2016,0,6,1014,0
Boston,34,26,28,22,0,0,0,0,New York,23,24,24,23,0,0,0,0,20170402,110,94,11,13,17,16,16,204,-16,2016,0,6,190,0
Chicago,28,35,24,30,0,0,0,0,New Orleans,21,26,32,31,0,0,0,0,20170402,117,110,7,16,8,7,7,227,-7,2016,0,6,832,0
Dallas,31,22,22,34,0,0,0,0,Milwaukee,28,25,25,27,0,0,0,0,20170402,109,105,3,0,-3,4,4,214,-4,2016,0,6,857,0
Denver,37,31,25,23,0,0,0,0,Miami,30,28,29,26,0,0,0,0,20170402,116,113,7,10,6,3,3,229,-3,2016,0,6,1724,0
Memphis,27,22,31,23,0,0,0,0,LA Lakers,22,28,29,29,0,0,0,0,20170402,103,108,-5,1,-1,5,5,211,5,2016,0,6,1599,0
Washington,30,27,31,27,0,0,0,0,Golden State,35,32,39,33,0,0,0,0,20170402,115,139,5,10,18,24,24,254,24,2016,0,6,2435,0
Indiana,27,26,24,27,10,16,0,0,Cleveland,26,34,23,21,10,21,0,0,20170402,130,135,-1,7,6,0,5,265,5,2016,2,6,262,0
Atlanta,24,19,18,21,0,0,0,0,Brooklyn,29,17,24,21,0,0,0,0,20170402,82,91,5,3,9,9,9,173,9,2016,0,6,745,0
Portland,23,34,26,26,0,0,0,0,Minnesota,29,20,37,24,0,0,0,0,20170403,109,110,6,-8,3,1,1,219,1,2016,0,0,1423,0
Charlotte,24,39,18,30,0,0,0,0,Washington,22,29,36,31,0,0,0,0,20170404,111,118,-2,-12,6,7,7,229,7,2016,0,1,329,0
Portland,17,24,23,23,0,0,0,0,Utah,24,23,28,31,0,0,0,0,20170404,87,106,7,6,11,19,19,193,19,2016,0,1,634,0
Memphis,16,19,16,33,5,0,0,0,San Antonio,14,19,27,24,11,0,0,0,20170404,89,95,-2,-2,9,0,6,184,6,2016,1,1,631,0
Dallas,17,21,31,18,0,0,0,0,Sacramento,22,14,32,30,0,0,0,0,20170404,87,98,5,-2,-1,11,11,185,11,2016,0,1,1437,0
Brooklyn,40,41,30,30,0,0,0,0,Philadelphia,27,26,24,41,0,0,0,0,20170404,141,118,13,28,34,23,23,259,-23,2016,0,1,80,0
Denver,27,42,33,32,0,0,0,0,New Orleans,31,44,30,26,0,0,0,0,20170404,134,131,-4,-6,-3,3,3,265,-3,2016,0,1,1079,0
Chicago,24,16,24,27,0,0,0,0,New York,29,25,26,20,0,0,0,0,20170404,91,100,5,14,16,9,9,191,9,2016,0,1,711,0
Toronto,26,25,24,15,0,0,0,0,Indiana,18,22,37,31,0,0,0,0,20170404,90,108,-8,-11,2,18,18,198,18,2016,0,1,438,0
Minnesota,32,28,26,21,0,0,0,0,Golden State,32,36,36,17,0,0,0,0,20170404,107,121,0,8,18,14,14,228,14,2016,0,1,1581,0
Orlando,31,24,20,27,0,0,0,0,Cleveland,28,25,43,26,0,0,0,0,20170404,102,122,-3,-2,21,20,20,224,20,2016,0,1,895,0
Milwaukee,20,19,20,20,0,0,0,0,Oklahoma City,28,35,26,21,0,0,0,0,20170404,79,110,8,24,30,31,31,189,31,2016,0,1,732,0
Oklahoma City,34,23,22,24,0,0,0,0,Memphis,27,23,24,26,0,0,0,0,20170405,103,100,7,7,5,3,3,203,-3,2016,0,2,421,0
Golden State,41,17,33,29,0,0,0,0,Phoenix,18,34,26,33,0,0,0,0,20170405,120,111,23,6,13,9,9,231,-9,2016,0,2,652,0
Dallas,24,25,24,28,0,0,0,0,LA Clippers,35,27,28,22,0,0,0,0,20170405,101,112,11,13,17,11,11,213,11,2016,0,2,1237,0
LA Lakers,31,22,23,26,0,0,0,0,San Antonio,14,27,29,25,0,0,0,0,20170405,102,95,17,12,6,7,7,197,-7,2016,0,2,1201,0
Toronto,15,31,22,37,0,0,0,0,Detroit,33,23,24,22,0,0,0,0,20170405,105,102,-18,-10,-12,3,3,207,-3,2016,0,2,205,0
Miami,27,25,34,26,0,0,0,0,Charlotte,23,28,22,26,0,0,0,0,20170405,112,99,4,1,13,13,13,211,-13,2016,0,2,654,0
Cleveland,19,38,33,24,0,0,0,0,Boston,20,22,24,25,0,0,0,0,20170405,114,91,-1,15,24,23,23,205,-23,2016,0,2,549,0
Denver,25,25,29,25,0,0,0,0,Houston,36,23,26,25,0,0,0,0,20170405,104,110,11,9,6,6,6,214,6,2016,0,2,878,0
Boston,24,31,34,27,0,0,0,0,Atlanta,32,39,28,24,0,0,0,0,20170406,116,123,8,16,10,7,7,239,7,2016,0,3,935,0
Milwaukee,21,29,23,16,0,0,0,0,Indiana,25,31,29,19,0,0,0,0,20170406,89,104,4,6,12,15,15,193,15,2016,0,3,243,0
Washington,33,26,23,24,0,0,0,0,New York,27,24,24,28,0,0,0,0,20170406,106,103,6,8,7,3,3,209,-3,2016,0,3,204,0
Brooklyn,25,25,21,36,0,0,0,0,Orlando,22,28,36,29,0,0,0,0,20170406,107,115,-3,0,15,8,8,222,8,2016,0,3,939,0
Chicago,27,26,27,22,0,0,0,0,Philadelphia,17,30,20,23,0,0,0,0,20170406,102,90,10,6,13,12,12,192,-12,2016,0,3,664,0
Minnesota,34,27,26,11,0,0,0,0,Portland,20,33,27,25,0,0,0,0,20170406,98,105,-14,-8,-7,7,7,203,7,2016,0,3,1423,0
Minnesota,31,29,28,25,0,0,0,0,Utah,29,26,40,25,0,0,0,0,20170407,113,120,-2,-5,7,7,7,233,7,2016,0,4,984,0
Miami,19,24,22,29,0,0,0,0,Toronto,26,27,17,26,0,0,0,0,20170407,94,96,7,10,5,2,2,190,2,2016,0,4,1234,0
Oklahoma City,19,29,24,27,0,0,0,0,Phoenix,32,39,24,25,0,0,0,0,20170407,99,120,13,23,23,21,21,219,21,2016,0,4,840,0
New York,21,26,25,16,0,0,0,0,Memphis,27,26,17,31,0,0,0,0,20170407,88,101,6,6,-2,13,13,189,13,2016,0,4,953,0
Sacramento,31,14,25,24,0,0,0,0,LA Lakers,18,26,25,29,0,0,0,0,20170407,94,98,-13,-1,-1,4,4,192,4,2016,0,4,361,0
New Orleans,25,25,24,32,0,0,0,0,Denver,30,21,41,30,0,0,0,0,20170407,106,122,5,1,18,16,16,228,16,2016,0,4,1079,0
San Antonio,21,29,25,27,0,0,0,0,Dallas,26,35,8,20,0,0,0,0,20170407,102,89,-5,-11,6,13,13,191,-13,2016,0,4,252,0
Atlanta,21,31,31,31,0,0,0,0,Cleveland,19,31,28,22,0,0,0,0,20170407,114,100,2,2,5,14,14,214,-14,2016,0,4,555,0
Detroit,24,28,23,39,0,0,0,0,Houston,30,24,33,22,0,0,0,0,20170407,114,109,-6,-2,-12,5,5,223,-5,2016,0,4,1105,0
Chicago,25,20,37,24,0,0,0,0,Brooklyn,32,19,24,32,0,0,0,0,20170408,106,107,7,6,-7,1,1,213,1,2016,0,5,711,0
Boston,32,39,21,29,0,0,0,0,Charlotte,28,26,32,28,0,0,0,0,20170408,121,114,4,17,6,7,7,235,-7,2016,0,5,720,0
New Orleans,17,29,22,33,0,0,0,0,Golden State,23,31,39,30,0,0,0,0,20170408,101,123,6,8,25,22,22,224,22,2016,0,5,1921,0
Indiana,39,29,31,28,0,0,0,0,Orlando,38,21,23,30,0,0,0,0,20170408,127,112,1,9,17,15,15,239,-15,2016,0,5,822,0
Milwaukee,23,19,25,23,0,0,0,0,Philadelphia,21,27,12,22,0,0,0,0,20170408,90,82,2,-6,7,8,8,172,-8,2016,0,5,692,0
Utah,20,22,18,26,0,0,0,0,Portland,34,14,29,24,0,0,0,0,20170408,86,101,14,6,17,15,15,187,15,2016,0,5,634,0
LA Clippers,22,30,30,16,0,0,0,0,San Antonio,23,20,27,17,0,0,0,0,20170408,98,87,-1,9,12,11,11,185,-11,2016,0,5,1201,0
Miami,28,24,26,28,0,0,0,0,Washington,29,23,22,29,0,0,0,0,20170408,106,103,-1,0,4,3,3,209,-3,2016,0,5,924,0
Dallas,29,36,20,26,0,0,0,0,Phoenix,40,28,36,20,0,0,0,0,20170409,111,124,11,3,19,13,13,235,13,2016,0,6,884,0
Houston,42,36,29,28,0,0,0,0,Sacramento,27,35,27,39,0,0,0,0,20170409,135,128,15,16,18,7,7,263,-7,2016,0,6,1606,0
Toronto,23,29,24,34,0,0,0,0,New York,29,26,20,22,0,0,0,0,20170409,110,97,-6,-3,1,13,13,207,-13,2016,0,6,341,0
Minnesota,21,30,28,30,0,0,0,0,LA Lakers,29,24,25,32,0,0,0,0,20170409,109,110,8,2,-1,1,1,219,1,2016,0,6,1521,0
Oklahoma City,27,25,29,25,0,0,0,0,Denver,26,27,38,14,0,0,0,0,20170409,106,105,1,-1,-10,1,1,211,-1,2016,0,6,503,0
Cleveland,38,27,28,18,14,0,0,0,Atlanta,21,25,21,44,15,0,0,0,20170409,125,126,-17,-19,-26,0,1,251,1,2016,1,6,555,0
Detroit,24,24,27,28,0,0,0,0,Memphis,28,29,10,23,0,0,0,0,20170409,103,90,-4,-9,8,13,13,193,-13,2016,0,6,622,0
San Antonio,28,15,33,22,0,0,0,0,Portland,31,16,24,28,0,0,0,0,20170410,98,99,3,4,-5,1,1,197,1,2016,0,0,1718,0
Indiana,35,29,26,30,0,0,0,0,Philadelphia,20,34,25,32,0,0,0,0,20170410,120,111,15,10,11,9,9,231,-9,2016,0,0,582,0
Cleveland,37,23,31,17,13,0,0,0,Miami,24,32,24,28,16,0,0,0,20170410,121,124,-13,-4,-11,0,3,245,3,2016,1,0,1089,0
Houston,35,22,12,27,0,0,0,0,LA Clippers,35,26,36,28,0,0,0,0,20170410,96,125,0,4,28,29,29,221,29,2016,0,0,1371,0
Charlotte,24,22,20,13,0,0,0,0,Milwaukee,18,25,18,28,0,0,0,0,20170410,79,89,-6,-3,-5,10,10,168,10,2016,0,0,658,0
Washington,34,21,24,26,0,0,0,0,Detroit,21,21,31,28,0,0,0,0,20170410,105,101,13,13,6,4,4,206,-4,2016,0,0,394,0
Orlando,13,24,22,16,0,0,0,0,Chicago,34,30,28,30,0,0,0,0,20170410,75,122,21,27,33,47,47,197,47,2016,0,0,984,0
Brooklyn,13,27,37,28,0,0,0,0,Boston,28,30,32,24,0,0,0,0,20170410,105,114,15,18,13,9,9,219,9,2016,0,0,190,0
Utah,32,17,25,31,0,0,0,0,Golden State,33,18,23,25,0,0,0,0,20170410,105,99,-1,-2,0,6,6,204,-6,2016,0,0,599,0
Charlotte,26,18,17,15,0,0,0,0,Atlanta,38,25,21,19,0,0,0,0,20170411,76,103,12,19,23,27,27,179,27,2016,0,1,226,0
Denver,23,34,26,26,0,0,0,0,Dallas,26,18,31,16,0,0,0,0,20170411,109,91,-3,13,8,18,18,200,-18,2016,0,1,661,0
New Orleans,25,28,20,23,0,0,0,0,LA Lakers,26,31,28,23,0,0,0,0,20170411,96,108,1,4,12,12,12,204,12,2016,0,1,1669,0
Oklahoma City,33,23,15,29,0,0,0,0,Minnesota,16,27,29,26,0,0,0,0,20170411,100,98,17,13,-1,2,2,198,-2,2016,0,1,694,0
Phoenix,25,14,38,27,0,0,0,0,Sacramento,28,30,39,32,0,0,0,0,20170411,104,129,3,19,20,25,25,233,25,2016,0,1,634,0
Philadelphia,22,37,28,26,0,0,0,0,New York,25,31,22,36,0,0,0,0,20170412,113,114,3,-3,-9,1,1,227,1,2016,0,2,80,0
Denver,25,31,30,25,0,0,0,0,Oklahoma City,26,38,21,20,0,0,0,0,20170412,111,105,-1,-8,1,6,6,216,-6,2016,0,2,503,0
Washington,27,23,27,25,0,0,0,0,Miami,23,33,35,19,0,0,0,0,20170412,102,110,-4,6,14,8,8,212,8,2016,0,2,924,0
New Orleans,22,31,25,25,0,0,0,0,Portland,30,23,32,15,0,0,0,0,20170412,103,100,-8,0,-7,3,3,203,-3,2016,0,2,2059,0
San Antonio,23,23,26,25,0,0,0,0,Utah,32,21,29,19,0,0,0,0,20170412,97,101,9,7,10,4,4,198,4,2016,0,2,1087,0
Detroit,17,32,32,28,0,0,0,0,Orlando,38,21,28,26,0,0,0,0,20170412,109,113,21,10,6,4,4,222,4,2016,0,2,957,0
Dallas,22,24,24,30,0,0,0,0,Memphis,27,28,19,19,0,0,0,0,20170412,100,93,-5,-9,-4,7,7,193,-7,2016,0,2,419,0
Sacramento,23,24,26,22,0,0,0,0,LA Clippers,30,23,34,28,0,0,0,0,20170412,95,115,7,6,14,20,20,210,20,2016,0,2,361,0
Atlanta,15,28,25,18,0,0,0,0,Indiana,22,28,34,20,0,0,0,0,20170412,86,104,7,7,16,18,18,190,18,2016,0,2,427,0
Minnesota,32,28,21,37,0,0,0,0,Houston,33,27,35,28,0,0,0,0,20170412,118,123,1,0,14,5,5,241,5,2016,0,2,1057,0
LA Lakers,28,22,20,24,0,0,0,0,Golden State,43,21,29,16,0,0,0,0,20170412,94,109,15,14,23,15,15,203,15,2016,0,2,347,0
Toronto,26,27,22,23,0,0,0,0,Cleveland,21,13,24,25,0,0,0,0,20170412,98,83,5,19,17,15,15,181,-15,2016,0,2,187,0
Brooklyn,13,19,24,17,0,0,0,0,Chicago,27,23,25,37,0,0,0,0,20170412,73,112,14,18,19,39,39,185,39,2016,0,2,711,0
Milwaukee,36,20,22,16,0,0,0,0,Boston,25,32,23,32,0,0,0,0,20170412,94,112,-11,1,2,18,18,206,18,2016,0,2,855,0
Indiana,29,30,25,24,0,0,0,0,Cleveland,34,32,26,17,0,0,0,0,20170415,108,109,5,7,8,1,1,217,1,2016,0,5,262,1
Utah,22,30,22,23,0,0,0,0,LA Clippers,24,28,18,25,0,0,0,0,20170415,97,95,-2,0,4,2,2,192,-2,2016,0,5,579,1
Memphis,30,19,15,18,0,0,0,0,San Antonio,25,27,32,27,0,0,0,0,20170415,82,111,-5,3,20,29,29,193,29,2016,0,5,631,1
Milwaukee,30,16,29,22,0,0,0,0,Toronto,22,29,19,13,0,0,0,0,20170415,97,83,8,-5,5,14,14,180,-14,2016,0,5,429,1
Atlanta,29,19,28,31,0,0,0,0,Washington,25,20,38,31,0,0,0,0,20170416,107,114,-4,-3,7,7,7,221,7,2016,0,6,541,1
Oklahoma City,29,25,20,13,0,0,0,0,Houston,27,32,30,29,0,0,0,0,20170416,87,118,-2,5,15,31,31,205,31,2016,0,6,413,1
Portland,27,29,32,21,0,0,0,0,Golden State,31,25,32,33,0,0,0,0,20170416,109,121,4,0,0,12,12,230,12,2016,0,6,535,1
Chicago,23,25,26,32,0,0,0,0,Boston,28,18,28,28,0,0,0,0,20170416,106,102,-5,2,0,4,4,208,-4,2016,0,6,849,1
Indiana,29,29,20,33,0,0,0,0,Cleveland,32,31,33,21,0,0,0,0,20170417,111,117,3,5,18,6,6,228,6,2016,0,0,262,1
Memphis,16,21,28,17,0,0,0,0,San Antonio,29,27,19,21,0,0,0,0,20170417,82,96,13,19,10,14,14,178,14,2016,0,0,631,1
Chicago,31,23,32,25,0,0,0,0,Boston,26,20,29,22,0,0,0,0,20170418,111,97,5,8,11,14,14,208,-14,2016,0,1,849,1
Utah,18,24,28,21,0,0,0,0,LA Clippers,29,22,28,20,0,0,0,0,20170418,91,99,11,9,9,8,8,190,8,2016,0,1,579,1
Milwaukee,25,27,31,17,0,0,0,0,Toronto,28,27,29,22,0,0,0,0,20170418,100,106,3,3,1,6,6,206,6,2016,0,1,429,1
Portland,17,29,12,23,0,0,0,0,Golden State,33,22,28,27,0,0,0,0,20170419,81,110,16,9,25,29,29,191,29,2016,0,2,535,1
Oklahoma City,35,33,21,22,0,0,0,0,Houston,26,36,24,29,0,0,0,0,20170419,111,115,-9,-6,-3,4,4,226,4,2016,0,2,413,1
Atlanta,24,19,35,23,0,0,0,0,Washington,23,28,23,35,0,0,0,0,20170419,101,109,-1,8,-4,8,8,210,8,2016,0,2,541,1
San Antonio,21,25,17,31,0,0,0,0,Memphis,21,29,31,24,0,0,0,0,20170420,94,105,0,4,18,11,11,199,11,2016,0,3,631,1
Toronto,12,18,16,31,0,0,0,0,Milwaukee,32,25,21,26,0,0,0,0,20170420,77,104,20,27,32,27,27,181,27,2016,0,3,429,1
Cleveland,27,22,35,35,0,0,0,0,Indiana,37,37,17,23,0,0,0,0,20170420,119,114,-10,-25,-7,5,5,233,-5,2016,0,3,262,1
Houston,25,33,25,30,0,0,0,0,Oklahoma City,34,31,28,22,0,0,0,0,20170421,113,115,9,7,10,2,2,228,2,2016,0,4,413,1
LA Clippers,21,28,33,29,0,0,0,0,Utah,34,24,26,22,0,0,0,0,20170421,111,106,-13,-9,-2,5,5,217,-5,2016,0,4,579,1
Boston,33,11,32,28,0,0,0,0,Chicago,15,26,22,24,0,0,0,0,20170421,104,87,18,3,13,17,17,191,-17,2016,0,4,849,1
Toronto,19,22,23,23,0,0,0,0,Milwaukee,19,22,17,18,0,0,0,0,20170422,87,76,0,0,6,11,11,163,-11,2016,0,5,429,1
Golden State,30,24,33,32,0,0,0,0,Portland,37,30,21,25,0,0,0,0,20170422,119,113,-7,-13,-1,6,6,232,-6,2016,0,5,535,1
Washington,20,26,21,31,0,0,0,0,Atlanta,38,26,26,26,0,0,0,0,20170422,98,116,18,18,23,18,18,214,18,2016,0,5,541,1
San Antonio,26,25,20,25,12,0,0,0,Memphis,23,32,19,22,14,0,0,0,20170422,108,110,-3,4,3,0,2,218,2,2016,1,5,631,1
LA Clippers,26,26,28,18,0,0,0,0,Utah,24,31,22,28,0,0,0,0,20170423,98,105,-2,3,-3,7,7,203,7,2016,0,6,579,1
Houston,22,32,19,40,0,0,0,0,Oklahoma City,26,32,19,32,0,0,0,0,20170423,113,109,-4,-4,-4,4,4,222,-4,2016,0,6,413,1
Cleveland,22,36,30,18,0,0,0,0,Indiana,24,28,25,25,0,0,0,0,20170423,106,102,-2,6,11,4,4,208,-4,2016,0,6,262,1
Boston,30,27,22,25,0,0,0,0,Chicago,18,28,24,25,0,0,0,0,20170423,104,95,12,11,9,9,9,199,-9,2016,0,6,849,1
Washington,35,15,27,24,0,0,0,0,Atlanta,28,31,18,34,0,0,0,0,20170424,101,111,-7,9,0,10,10,212,10,2016,0,0,541,1
Golden State,45,27,34,22,0,0,0,0,Portland,22,26,32,23,0,0,0,0,20170424,128,103,23,24,26,25,25,231,-25,2016,0,0,535,1
Milwaukee,20,28,25,20,0,0,0,0,Toronto,31,26,33,28,0,0,0,0,20170424,93,118,11,9,17,25,25,211,25,2016,0,0,429,1
Oklahoma City,22,22,33,22,0,0,0,0,Houston,16,35,21,33,0,0,0,0,20170425,99,105,-6,7,-5,6,6,204,6,2016,0,1,413,1
Utah,19,27,18,32,0,0,0,0,LA Clippers,21,22,15,34,0,0,0,0,20170425,96,92,-2,3,6,4,4,188,-4,2016,0,1,579,1
Memphis,23,26,27,27,0,0,0,0,San Antonio,23,32,32,29,0,0,0,0,20170425,103,116,0,6,11,13,13,219,13,2016,0,1,631,1
Chicago,20,30,31,16,0,0,0,0,Boston,23,29,27,29,0,0,0,0,20170426,97,108,3,2,-2,11,11,205,11,2016,0,2,849,1
Atlanta,25,24,30,20,0,0,0,0,Washington,23,27,33,20,0,0,0,0,20170426,99,103,-2,1,4,4,4,202,4,2016,0,2,541,1
San Antonio,24,21,30,28,0,0,0,0,Memphis,22,28,24,22,0,0,0,0,20170427,103,96,2,-5,1,7,7,199,-7,2016,0,3,631,1
Toronto,28,23,23,18,0,0,0,0,Milwaukee,24,14,23,28,0,0,0,0,20170427,92,89,4,13,13,3,3,181,-3,2016,0,3,429,1
Boston,30,24,34,17,0,0,0,0,Chicago,23,18,18,24,0,0,0,0,20170428,105,83,7,13,29,22,22,188,-22,2016,0,4,849,1
LA Clippers,20,27,31,20,0,0,0,0,Utah,22,23,25,23,0,0,0,0,20170428,98,93,-2,2,8,5,5,191,-5,2016,0,4,579,1
Washington,30,35,24,26,0,0,0,0,Atlanta,23,23,36,17,0,0,0,0,20170428,115,99,7,19,7,16,16,214,-16,2016,0,4,541,1
Washington,38,26,16,31,0,0,0,0,Boston,24,35,36,28,0,0,0,0,20170430,111,123,-14,-5,15,12,12,234,12,2016,0,6,394,1
Utah,24,22,33,25,0,0,0,0,LA Clippers,24,15,24,28,0,0,0,0,20170430,104,91,0,7,16,13,13,195,-13,2016,0,6,579,1
Toronto,18,30,26,31,0,0,0,0,Cleveland,30,32,34,20,0,0,0,0,20170501,105,116,12,14,22,11,11,221,11,2016,0,0,187,1
Houston,34,35,27,30,0,0,0,0,San Antonio,23,16,28,32,0,0,0,0,20170501,126,99,11,30,29,27,27,225,-27,2016,0,0,189,1
Washington,42,25,22,25,5,0,0,0,Boston,29,35,20,30,15,0,0,0,20170502,119,129,-13,-3,-5,0,10,248,10,2016,1,1,394,1
Utah,21,25,27,21,0,0,0,0,Golden State,27,31,26,22,0,0,0,0,20170502,94,106,6,12,11,12,12,200,12,2016,0,1,599,1
Toronto,22,26,25,30,0,0,0,0,Cleveland,34,28,37,26,0,0,0,0,20170503,103,125,12,14,26,22,22,228,22,2016,0,2,187,1
Houston,30,25,28,13,0,0,0,0,San Antonio,33,32,23,33,0,0,0,0,20170503,96,121,3,10,5,25,25,217,25,2016,0,2,189,1
Utah,15,32,35,22,0,0,0,0,Golden State,33,27,32,23,0,0,0,0,20170504,104,115,18,13,10,11,11,219,11,2016,0,3,599,1
Boston,17,23,29,20,0,0,0,0,Washington,39,24,32,21,0,0,0,0,20170504,89,116,22,23,26,27,27,205,27,2016,0,3,394,1
San Antonio,19,24,29,31,0,0,0,0,Houston,21,18,27,26,0,0,0,0,20170505,103,92,-2,4,6,11,11,195,-11,2016,0,4,189,1
Cleveland,28,21,30,36,0,0,0,0,Toronto,24,28,25,17,0,0,0,0,20170505,115,94,4,-3,2,21,21,209,-21,2016,0,4,187,1
Golden State,27,22,23,30,0,0,0,0,Utah,17,33,20,21,0,0,0,0,20170506,102,91,10,-1,2,11,11,193,-11,2016,0,5,599,1
Boston,24,24,20,34,0,0,0,0,Washington,20,28,42,31,0,0,0,0,20170507,102,121,-4,0,22,19,19,223,19,2016,0,6,394,1
Cleveland,28,33,24,24,0,0,0,0,Toronto,28,21,31,22,0,0,0,0,20170507,109,102,0,12,5,7,7,211,-7,2016,0,6,187,1
San Antonio,22,31,23,28,0,0,0,0,Houston,34,23,34,34,0,0,0,0,20170507,104,125,12,4,15,21,21,229,21,2016,0,6,189,1
Golden State,39,21,33,28,0,0,0,0,Utah,17,35,27,16,0,0,0,0,20170508,121,95,22,8,14,26,26,216,-26,2016,0,0,599,1
Houston,29,31,25,16,6,0,0,0,San Antonio,32,26,28,15,9,0,0,0,20170509,107,110,3,-2,1,0,3,217,3,2016,1,1,189,1
Washington,21,30,25,25,0,0,0,0,Boston,33,34,26,30,0,0,0,0,20170510,101,123,12,16,17,22,22,224,22,2016,0,2,394,1
San Antonio,31,30,26,27,0,0,0,0,Houston,24,18,22,11,0,0,0,0,20170511,114,75,7,19,23,39,39,189,-39,2016,0,3,189,1
Boston,17,25,27,22,0,0,0,0,Washington,22,19,25,26,0,0,0,0,20170512,91,92,5,-1,-3,1,1,183,1,2016,0,4,394,1
San Antonio,30,32,28,21,0,0,0,0,Golden State,16,26,39,32,0,0,0,0,20170514,111,113,-14,-20,-9,2,2,224,2,2016,0,6,1487,1
Washington,23,32,24,26,0,0,0,0,Boston,27,26,32,30,0,0,0,0,20170515,105,115,4,-2,6,10,10,220,10,2016,0,0,394,1
San Antonio,16,28,31,25,0,0,0,0,Golden State,33,39,34,30,0,0,0,0,20170516,100,136,17,28,31,36,36,236,36,2016,0,1,1487,1
Cleveland,30,31,31,25,0,0,0,0,Boston,19,20,36,29,0,0,0,0,20170517,117,104,11,22,17,13,13,221,-13,2016,0,2,549,1
Cleveland,32,40,31,27,0,0,0,0,Boston,18,13,26,29,0,0,0,0,20170519,130,86,14,41,46,44,44,216,-44,2016,0,4,549,1
Golden State,29,35,36,20,0,0,0,0,San Antonio,33,22,33,20,0,0,0,0,20170520,120,108,-4,9,12,12,12,228,-12,2016,0,5,1487,1
Boston,24,26,32,29,0,0,0,0,Cleveland,35,31,21,21,0,0,0,0,20170521,111,108,-11,-16,-5,3,3,219,-3,2016,0,6,549,1
Golden State,31,34,31,33,0,0,0,0,San Antonio,19,32,27,37,0,0,0,0,20170522,129,115,12,14,18,14,14,244,-14,2016,0,0,1487,1
Boston,29,28,23,19,0,0,0,0,Cleveland,19,28,40,25,0,0,0,0,20170523,99,112,-10,-10,7,13,13,211,13,2016,0,1,549,1
Cleveland,43,32,34,26,0,0,0,0,Boston,27,30,17,28,0,0,0,0,20170525,135,102,16,18,35,33,33,237,-33,2016,0,3,549,1
Cleveland,30,22,20,19,0,0,0,0,Golden State,35,25,33,20,0,0,0,0,20170601,91,113,5,8,21,22,22,204,22,2016,0,3,2161,1
Cleveland,34,30,24,25,0,0,0,0,Golden State,40,27,35,30,0,0,0,0,20170604,113,132,6,3,14,19,19,245,19,2016,0,6,2161,1
Golden State,39,28,22,29,0,0,0,0,Cleveland,32,29,33,19,0,0,0,0,20170607,118,113,7,6,-5,5,5,231,-5,2016,0,2,2161,1
Golden State,33,35,28,20,0,0,0,0,Cleveland,49,37,29,22,0,0,0,0,20170609,116,137,16,18,19,21,21,253,21,2016,0,4,2161,1
Cleveland,37,23,33,27,0,0,0,0,Golden State,33,38,27,31,0,0,0,0,20170612,120,129,-4,11,5,9,9,249,9,2016,0,0,2161,1
Boston,19,19,33,28,0,0,0,0,Cleveland,29,25,18,30,0,0,0,0,20171017,99,102,10,16,1,3,3,201,3,2017,0,1,549,0
Houston,34,28,26,34,0,0,0,0,Golden State,35,36,30,20,0,0,0,0,20171017,122,121,-1,-9,-13,1,1,243,-1,2017,0,1,1642,0
Philadelphia,23,36,23,33,0,0,0,0,Washington,32,24,34,30,0,0,0,0,20171018,115,120,9,-3,8,5,5,235,5,2017,0,2,123,0
Denver,30,28,25,13,0,0,0,0,Utah,21,28,29,28,0,0,0,0,20171018,96,106,-9,-9,-5,10,10,202,10,2017,0,2,370,0
Minnesota,25,24,28,22,0,0,0,0,San Antonio,32,21,34,20,0,0,0,0,20171018,99,107,7,4,10,8,8,206,8,2017,0,2,1112,0
Houston,26,26,23,30,0,0,0,0,Sacramento,25,23,24,28,0,0,0,0,20171018,105,100,1,4,3,5,5,205,-5,2017,0,2,1606,0
Portland,29,31,38,26,0,0,0,0,Phoenix,21,14,20,21,0,0,0,0,20171018,124,76,8,25,43,48,48,200,-48,2017,0,2,1005,0
Charlotte,27,18,25,20,0,0,0,0,Detroit,29,27,26,20,0,0,0,0,20171018,90,102,2,11,12,12,12,192,12,2017,0,2,504,0
New Orleans,34,18,18,21,0,0,0,0,Memphis,27,27,25,24,0,0,0,0,20171018,91,103,-7,2,9,12,12,194,12,2017,0,2,358,0
Brooklyn,30,33,35,33,0,0,0,0,Indiana,29,36,41,34,0,0,0,0,20171018,131,140,-1,2,8,9,9,271,9,2017,0,2,643,0
Miami,37,18,23,31,0,0,0,0,Orlando,32,26,30,28,0,0,0,0,20171018,109,116,-5,3,10,7,7,225,7,2017,0,2,204,0
Atlanta,27,31,24,35,0,0,0,0,Dallas,24,23,35,29,0,0,0,0,20171018,117,111,3,11,0,6,6,228,-6,2017,0,2,719,0
Milwaukee,24,34,18,32,0,0,0,0,Boston,26,27,27,20,0,0,0,0,20171018,108,100,-2,5,-4,8,8,208,-8,2017,0,2,855,0
LA Clippers,27,26,34,21,0,0,0,0,LA Lakers,19,23,21,29,0,0,0,0,20171019,108,92,8,11,24,16,16,200,-16,2017,0,3,0,0
New York,24,18,17,25,0,0,0,0,Oklahoma City,27,26,26,26,0,0,0,0,20171019,84,105,3,11,20,21,21,189,21,2017,0,3,1324,0
Chicago,23,14,27,36,0,0,0,0,Toronto,25,33,26,33,0,0,0,0,20171019,100,117,2,21,20,17,17,217,17,2017,0,3,436,0
Detroit,31,34,16,30,0,0,0,0,Washington,29,29,33,24,0,0,0,0,20171020,111,115,-2,-7,10,4,4,226,4,2017,0,4,394,0
LA Lakers,40,30,36,26,0,0,0,0,Phoenix,36,37,26,31,0,0,0,0,20171020,132,130,4,-3,7,2,2,262,-2,2017,0,4,356,0
Boston,24,22,23,33,0,0,0,0,Philadelphia,21,29,22,20,0,0,0,0,20171020,102,92,3,-4,-3,10,10,194,-10,2017,0,4,270,0
Golden State,26,35,37,30,0,0,0,0,New Orleans,39,25,26,30,0,0,0,0,20171020,128,120,-13,-3,8,8,8,248,-8,2017,0,4,1921,0
Utah,16,26,23,32,0,0,0,0,Minnesota,19,27,24,30,0,0,0,0,20171020,97,100,3,4,5,3,3,197,3,2017,0,4,984,0
Portland,31,31,29,23,0,0,0,0,Indiana,25,27,21,23,0,0,0,0,20171020,114,96,6,10,18,18,18,210,-18,2017,0,4,1880,0
Sacramento,19,27,25,22,0,0,0,0,Dallas,23,23,14,28,0,0,0,0,20171020,93,88,-4,0,11,5,5,181,-5,2017,0,4,1437,0
Atlanta,28,28,17,18,0,0,0,0,Charlotte,18,31,35,25,0,0,0,0,20171020,91,109,-10,-7,11,18,18,200,18,2017,0,4,226,0
Orlando,27,28,36,30,0,0,0,0,Brooklyn,29,29,31,37,0,0,0,0,20171020,121,126,2,3,-2,5,5,247,5,2017,0,4,939,0
Cleveland,25,30,31,30,0,0,0,0,Milwaukee,25,24,24,24,0,0,0,0,20171020,116,97,0,6,13,19,19,213,-19,2017,0,4,334,0
Indiana,31,19,26,32,0,0,0,0,Miami,26,37,28,21,0,0,0,0,20171021,108,112,-5,13,15,4,4,220,4,2017,0,5,1026,0
Philadelphia,19,30,22,23,0,0,0,0,Toronto,36,26,40,26,0,0,0,0,20171021,94,128,17,13,31,34,34,222,34,2017,0,5,334,0
Detroit,19,32,28,32,0,0,0,0,New York,28,36,16,27,0,0,0,0,20171021,111,107,-9,-13,-1,4,4,218,-4,2017,0,5,480,0
Oklahoma City,14,20,23,30,0,0,0,0,Utah,21,23,29,23,0,0,0,0,20171021,87,96,7,10,16,9,9,183,9,2017,0,5,861,0
Golden State,26,25,20,30,0,0,0,0,Memphis,31,25,32,23,0,0,0,0,20171021,101,111,5,5,17,10,10,212,10,2017,0,5,1798,0
Portland,26,29,25,30,0,0,0,0,Milwaukee,24,36,24,29,0,0,0,0,20171021,110,113,-2,5,4,3,3,223,3,2017,0,5,1714,0
Dallas,20,19,19,33,0,0,0,0,Houston,33,29,30,15,0,0,0,0,20171021,91,107,13,23,34,16,16,198,16,2017,0,5,225,0
Sacramento,18,16,18,27,0,0,0,0,Denver,17,25,24,30,0,0,0,0,20171021,79,96,-1,8,14,17,17,175,17,2017,0,5,886,0
Orlando,36,20,32,26,0,0,0,0,Cleveland,18,27,20,28,0,0,0,0,20171021,114,93,18,11,23,21,21,207,-21,2017,0,5,895,0
San Antonio,19,22,24,22,0,0,0,0,Chicago,21,17,17,22,0,0,0,0,20171021,87,77,-2,3,10,10,10,164,-10,2017,0,5,1050,0
Phoenix,18,26,20,24,0,0,0,0,LA Clippers,23,35,32,40,0,0,0,0,20171021,88,130,5,14,26,42,42,218,42,2017,0,5,356,0
Atlanta,25,28,24,27,0,0,0,0,Brooklyn,19,37,35,25,0,0,0,0,20171022,104,116,-6,3,14,12,12,220,12,2017,0,6,745,0
New Orleans,34,34,26,25,0,0,0,0,LA Lakers,22,33,28,29,0,0,0,0,20171022,119,112,12,13,11,7,7,231,-7,2017,0,6,1669,0
Minnesota,28,33,27,27,0,0,0,0,Oklahoma City,23,31,21,38,0,0,0,0,20171022,115,113,5,7,13,2,2,228,-2,2017,0,6,694,0
Toronto,23,27,24,23,0,0,0,0,San Antonio,21,29,25,26,0,0,0,0,20171023,97,101,-2,0,1,4,4,198,4,2017,0,0,1438,0
Sacramento,17,34,25,39,0,0,0,0,Phoenix,36,23,28,30,0,0,0,0,20171023,115,117,19,8,11,2,2,232,2,2017,0,0,634,0
Atlanta,23,21,29,20,0,0,0,0,Miami,26,36,15,27,0,0,0,0,20171023,93,104,3,18,4,11,11,197,11,2017,0,0,605,0
Charlotte,25,29,23,17,0,0,0,0,Milwaukee,18,35,30,20,0,0,0,0,20171023,94,103,-7,-1,6,9,9,197,9,2017,0,0,658,0
Philadelphia,31,25,19,22,0,0,0,0,Detroit,22,21,24,19,0,0,0,0,20171023,97,86,9,13,8,11,11,183,-11,2017,0,0,441,0
Washington,29,27,22,31,0,0,0,0,Denver,29,26,22,27,0,0,0,0,20171023,109,104,0,1,1,5,5,213,-5,2017,0,0,1489,0
Golden State,40,25,34,34,0,0,0,0,Dallas,24,38,22,19,0,0,0,0,20171023,133,103,16,3,15,30,30,236,-30,2017,0,0,1480,0
Memphis,24,26,20,28,0,0,0,0,Houston,26,31,19,14,0,0,0,0,20171023,98,90,-2,-7,-6,8,8,188,-8,2017,0,0,484,0
New York,17,16,27,29,0,0,0,0,Boston,30,24,23,33,0,0,0,0,20171024,89,110,13,21,17,21,21,199,21,2017,0,1,190,0
Chicago,38,30,24,20,0,0,0,0,Cleveland,28,37,26,28,0,0,0,0,20171024,112,119,-10,-3,-1,7,7,231,7,2017,0,1,308,0
Utah,20,21,15,28,0,0,0,0,LA Clippers,27,15,33,27,0,0,0,0,20171024,84,102,7,1,19,18,18,186,18,2017,0,1,579,0
Indiana,33,28,37,32,0,0,0,0,Minnesota,20,41,23,23,0,0,0,0,20171024,130,107,13,0,14,23,23,237,-23,2017,0,1,510,0
Brooklyn,30,31,35,25,0,0,0,0,Orlando,30,31,26,38,0,0,0,0,20171024,121,125,0,0,-9,4,4,246,4,2017,0,1,939,0
New Orleans,19,29,25,20,0,0,0,0,Portland,29,18,24,32,0,0,0,0,20171024,93,103,10,-1,-2,10,10,196,10,2017,0,1,2059,0
San Antonio,30,26,32,29,0,0,0,0,Miami,30,21,22,27,0,0,0,0,20171025,117,100,0,5,15,17,17,217,-17,2017,0,2,1147,0
Utah,13,28,18,29,0,0,0,0,Phoenix,23,25,23,26,0,0,0,0,20171025,88,97,10,7,12,9,9,185,9,2017,0,2,505,0
Houston,31,25,23,26,0,0,0,0,Philadelphia,33,21,26,24,0,0,0,0,20171025,105,104,-2,2,-1,1,1,209,-1,2017,0,2,1339,0
Indiana,27,21,26,22,0,0,0,0,Oklahoma City,30,24,32,28,0,0,0,0,20171025,96,114,3,6,12,18,18,210,18,2017,0,2,688,0
Washington,18,31,30,13,7,0,0,0,LA Lakers,23,22,24,23,10,0,0,0,20171025,99,102,5,-4,-10,0,3,201,3,2017,1,2,2294,0
Minnesota,26,18,29,28,0,0,0,0,Detroit,23,40,28,31,0,0,0,0,20171025,101,122,-3,19,18,21,21,223,21,2017,0,2,542,0
Cleveland,23,29,21,34,0,0,0,0,Brooklyn,26,29,29,28,0,0,0,0,20171025,107,112,3,3,11,5,5,219,5,2017,0,2,403,0
Memphis,18,31,23,22,0,0,0,0,Dallas,32,25,22,24,0,0,0,0,20171025,94,103,14,8,7,9,9,197,9,2017,0,2,419,0
Denver,23,16,29,25,0,0,0,0,Charlotte,27,35,23,25,0,0,0,0,20171025,93,110,4,23,17,17,17,203,17,2017,0,2,1355,0
Toronto,26,27,33,26,0,0,0,0,Golden State,29,32,30,26,0,0,0,0,20171025,112,117,3,8,5,5,5,229,5,2017,0,2,2263,0
Atlanta,20,19,20,27,0,0,0,0,Chicago,18,19,28,26,0,0,0,0,20171026,86,91,-2,-2,6,5,5,177,5,2017,0,3,587,0
Dallas,14,21,33,23,0,0,0,0,Memphis,28,26,22,20,0,0,0,0,20171026,91,96,14,19,8,5,5,187,5,2017,0,3,419,0
Boston,28,15,29,24,0,0,0,0,Milwaukee,23,21,25,20,0,0,0,0,20171026,96,89,5,-1,3,7,7,185,-7,2017,0,3,855,0
LA Clippers,30,32,18,24,0,0,0,0,Portland,24,29,26,24,0,0,0,0,20171026,104,103,6,9,1,1,1,207,-1,2017,0,3,826,0
New Orleans,27,29,32,26,0,0,0,0,Sacramento,40,30,17,19,0,0,0,0,20171026,114,106,-13,-14,1,8,8,220,-8,2017,0,3,1879,0
San Antonio,18,16,30,23,0,0,0,0,Orlando,32,29,34,19,0,0,0,0,20171027,87,114,14,27,31,27,27,201,27,2017,0,4,1035,0
Brooklyn,28,14,24,20,0,0,0,0,New York,23,24,36,24,0,0,0,0,20171027,86,107,-5,5,17,21,21,193,21,2017,0,4,0,0
Toronto,19,26,27,29,0,0,0,0,LA Lakers,26,25,20,21,0,0,0,0,20171027,101,92,-7,-6,1,9,9,193,-9,2017,0,4,2170,0
Oklahoma City,33,26,30,27,0,0,0,0,Minnesota,26,33,31,29,0,0,0,0,20171027,116,119,-7,0,1,3,3,235,3,2017,0,4,694,0
Houston,27,29,22,31,0,0,0,0,Charlotte,30,16,28,19,0,0,0,0,20171027,109,93,-3,10,4,16,16,202,-16,2017,0,4,925,0
Denver,26,27,22,30,0,0,0,0,Atlanta,23,29,19,29,0,0,0,0,20171027,105,100,3,1,4,5,5,205,-5,2017,0,4,1209,0
Washington,34,33,30,20,0,0,0,0,Golden State,27,26,34,33,0,0,0,0,20171027,117,120,-7,-14,-10,3,3,237,3,2017,0,4,2435,0
Oklahoma City,26,24,32,19,0,0,0,0,Chicago,23,8,22,16,0,0,0,0,20171028,101,69,3,19,29,32,32,170,-32,2017,0,5,690,0
Philadelphia,32,25,32,23,0,0,0,0,Dallas,23,33,22,32,0,0,0,0,20171028,112,110,9,1,11,2,2,222,-2,2017,0,5,1297,0
Detroit,27,18,22,28,0,0,0,0,LA Clippers,24,31,17,15,0,0,0,0,20171028,95,87,3,-10,-5,8,8,182,-8,2017,0,5,1979,0
Houston,32,17,23,17,0,0,0,0,Memphis,30,24,27,22,0,0,0,0,20171028,89,103,-2,5,9,14,14,192,14,2017,0,5,484,0
Boston,21,26,27,22,0,0,0,0,Miami,26,19,18,27,0,0,0,0,20171028,96,90,-5,2,11,6,6,186,-6,2017,0,5,1257,0
Cleveland,22,30,31,18,0,0,0,0,New Orleans,35,30,24,34,0,0,0,0,20171028,101,123,13,13,6,22,22,224,22,2017,0,5,924,0
Phoenix,24,33,32,18,0,0,0,0,Portland,29,32,31,22,0,0,0,0,20171028,107,114,5,4,3,7,7,221,7,2017,0,5,1005,0
LA Lakers,16,29,19,17,0,0,0,0,Utah,31,25,19,21,0,0,0,0,20171028,81,96,15,11,11,15,15,177,15,2017,0,5,579,0
San Antonio,24,24,16,30,0,0,0,0,Indiana,26,27,15,29,0,0,0,0,20171029,94,97,2,5,4,3,3,191,3,2017,0,6,999,0
Washington,35,28,25,22,0,0,0,0,Sacramento,16,16,28,23,0,0,0,0,20171029,110,83,19,31,28,27,27,193,-27,2017,0,6,2371,0
Detroit,27,25,30,33,0,0,0,0,Golden State,35,22,24,26,0,0,0,0,20171029,115,107,-8,-5,1,8,8,222,-8,2017,0,6,2087,0
Milwaukee,28,33,31,25,0,0,0,0,Atlanta,16,32,25,33,0,0,0,0,20171029,117,106,12,13,19,11,11,223,-11,2017,0,6,669,0
Orlando,24,25,37,27,0,0,0,0,Charlotte,27,34,32,27,0,0,0,0,20171029,113,120,3,12,7,7,7,233,7,2017,0,6,463,0
Denver,29,31,40,24,0,0,0,0,Brooklyn,36,27,21,27,0,0,0,0,20171029,124,111,-7,-3,16,13,13,235,-13,2017,0,6,1627,0
New York,29,33,30,22,0,0,0,0,Cleveland,19,35,21,20,0,0,0,0,20171029,114,95,10,8,17,19,19,209,-19,2017,0,6,403,0
Dallas,27,26,15,21,0,0,0,0,Utah,21,23,32,28,0,0,0,0,20171030,89,104,-6,-9,8,15,15,193,15,2017,0,0,998,0
Denver,25,18,38,29,0,0,0,0,New York,35,30,19,32,0,0,0,0,20171030,110,116,10,22,3,6,6,226,6,2017,0,0,1627,0
Orlando,33,27,27,28,0,0,0,0,New Orleans,24,40,20,15,0,0,0,0,20171030,115,99,9,-4,3,16,16,214,-16,2017,0,0,533,0
Minnesota,23,37,19,31,15,0,0,0,Miami,32,30,20,28,12,0,0,0,20171030,125,122,-9,-2,-3,0,3,247,-3,2017,1,0,1513,0
Toronto,29,25,27,18,0,0,0,0,Portland,29,6,26,24,0,0,0,0,20171030,99,85,0,19,20,14,14,184,-14,2017,0,0,2108,0
Golden State,34,40,33,34,0,0,0,0,LA Clippers,28,29,29,27,0,0,0,0,20171030,141,113,6,17,21,28,28,254,-28,2017,0,0,347,0
Philadelphia,37,21,34,23,0,0,0,0,Houston,27,29,24,27,0,0,0,0,20171030,115,107,10,2,12,8,8,222,-8,2017,0,0,1339,0
San Antonio,26,23,18,27,0,0,0,0,Boston,30,24,26,28,0,0,0,0,20171030,94,108,4,5,13,14,14,202,14,2017,0,0,1765,0
Charlotte,31,20,22,31,0,0,0,0,Memphis,31,26,25,17,0,0,0,0,20171030,104,99,0,-6,-9,5,5,203,-5,2017,0,0,519,0
Phoenix,30,29,28,35,0,0,0,0,Brooklyn,24,29,35,26,0,0,0,0,20171031,122,114,6,6,-1,8,8,236,-8,2017,0,1,2139,0
Sacramento,13,17,18,35,0,0,0,0,Indiana,24,31,14,32,0,0,0,0,20171031,83,101,11,25,21,18,18,184,18,2017,0,1,1882,0
Detroit,22,23,27,21,0,0,0,0,LA Lakers,25,33,29,26,0,0,0,0,20171031,93,113,3,13,15,20,20,206,20,2017,0,1,1979,0
Oklahoma City,31,29,25,25,0,0,0,0,Milwaukee,23,19,22,27,0,0,0,0,20171031,110,91,8,18,21,19,19,201,-19,2017,0,1,732,0
Minnesota,31,34,18,21,0,0,0,0,New Orleans,28,26,23,21,0,0,0,0,20171101,104,98,3,11,6,6,6,202,-6,2017,0,2,1052,0
Portland,20,19,30,25,9,0,0,0,Utah,22,17,25,30,18,0,0,0,20171101,103,112,2,0,-5,0,9,215,9,2017,1,2,634,0
Atlanta,25,32,36,16,0,0,0,0,Philadelphia,34,25,34,26,0,0,0,0,20171101,109,119,9,2,0,10,10,228,10,2017,0,2,665,0
Phoenix,15,37,35,35,0,0,0,0,Washington,32,32,26,26,0,0,0,0,20171101,122,116,-17,-12,-3,6,6,238,-6,2017,0,2,1977,0
Chicago,17,30,17,27,0,0,0,0,Miami,27,22,18,30,0,0,0,0,20171101,91,97,10,2,3,6,6,188,6,2017,0,2,1189,0
Houston,24,36,40,19,0,0,0,0,New York,27,21,26,23,0,0,0,0,20171101,119,97,-3,12,26,22,22,216,-22,2017,0,2,1417,0
Dallas,29,19,29,21,0,0,0,0,LA Clippers,32,34,29,24,0,0,0,0,20171101,98,119,3,18,18,21,21,217,21,2017,0,2,1237,0
Toronto,19,27,25,40,0,0,0,0,Denver,34,26,43,26,0,0,0,0,20171101,111,129,15,14,32,18,18,240,18,2017,0,2,1341,0
Indiana,30,32,30,32,0,0,0,0,Cleveland,28,33,24,22,0,0,0,0,20171101,124,107,2,1,7,17,17,231,-17,2017,0,2,262,0
Milwaukee,32,25,31,33,0,0,0,0,Charlotte,25,35,28,38,0,0,0,0,20171101,121,126,-7,3,0,5,5,247,5,2017,0,2,658,0
Sacramento,24,21,15,26,0,0,0,0,Boston,27,31,31,24,0,0,0,0,20171101,86,113,3,13,29,27,27,199,27,2017,0,2,2624,0
Orlando,23,31,27,20,0,0,0,0,Memphis,26,28,21,24,0,0,0,0,20171101,101,99,-3,0,6,2,2,200,-2,2017,0,2,683,0
LA Lakers,25,37,23,25,0,0,0,0,Portland,41,25,21,26,0,0,0,0,20171102,110,113,16,4,2,3,3,223,3,2017,0,3,826,0
Golden State,24,26,34,28,0,0,0,0,San Antonio,33,22,23,14,0,0,0,0,20171102,112,92,-9,-5,6,20,20,204,-20,2017,0,3,1487,0
Cleveland,42,32,30,26,0,0,0,0,Washington,36,30,27,29,0,0,0,0,20171103,130,122,6,8,11,8,8,252,-8,2017,0,4,304,0
Toronto,29,24,36,20,0,0,0,0,Utah,26,28,28,18,0,0,0,0,20171103,109,100,3,-1,7,9,9,209,-9,2017,0,4,1664,0
Charlotte,19,26,26,30,0,0,0,0,San Antonio,25,24,31,28,0,0,0,0,20171103,101,108,6,4,9,7,7,209,7,2017,0,4,1103,0
Indiana,28,35,26,21,0,0,0,0,Philadelphia,30,26,36,29,0,0,0,0,20171103,110,121,2,-7,3,11,11,231,11,2017,0,4,582,0
Chicago,28,16,29,32,0,0,0,0,Orlando,26,19,15,23,0,0,0,0,20171103,105,83,2,-1,13,22,22,188,-22,2017,0,4,984,0
Boston,18,19,30,34,0,0,0,0,Oklahoma City,31,24,16,23,0,0,0,0,20171103,101,94,-13,-18,-4,7,7,195,-7,2017,0,4,1492,0
Brooklyn,29,26,29,28,0,0,0,0,LA Lakers,30,34,31,29,0,0,0,0,20171103,112,124,1,9,11,12,12,236,12,2017,0,4,2445,0
Milwaukee,26,22,24,24,0,0,0,0,Detroit,28,31,23,23,0,0,0,0,20171103,96,105,2,11,10,9,9,201,9,2017,0,4,251,0
Miami,37,21,13,23,0,0,0,0,Denver,28,23,25,19,0,0,0,0,20171103,94,95,-9,-7,5,1,1,189,1,2017,0,4,1724,0
New Orleans,28,27,20,24,0,0,0,0,Dallas,25,21,17,31,0,0,0,0,20171103,99,94,3,9,12,5,5,193,-5,2017,0,4,442,0
Houston,36,33,28,22,0,0,0,0,Atlanta,25,26,25,28,0,0,0,0,20171103,119,104,11,18,21,15,15,223,-15,2017,0,4,700,0
Phoenix,19,31,26,31,0,0,0,0,New York,32,33,27,28,0,0,0,0,20171103,107,120,13,15,16,13,13,227,13,2017,0,4,2139,0
New Orleans,17,21,19,26,13,0,0,0,Chicago,19,19,26,19,7,0,0,0,20171104,96,90,-2,0,-7,0,6,186,-6,2017,1,5,832,0
Golden State,36,24,43,24,0,0,0,0,Denver,23,32,21,32,0,0,0,0,20171104,127,108,13,5,27,19,19,235,-19,2017,0,5,947,0
Sacramento,26,23,25,25,0,0,0,0,Detroit,29,23,33,23,0,0,0,0,20171104,99,108,3,3,11,9,9,207,9,2017,0,5,2020,0
Memphis,27,33,27,26,0,0,0,0,LA Clippers,25,31,24,24,0,0,0,0,20171104,113,104,2,4,7,9,9,217,-9,2017,0,5,1599,0
Dallas,18,31,20,30,0,0,0,0,Minnesota,27,32,34,19,0,0,0,0,20171104,99,112,9,10,24,13,13,211,13,2017,0,5,863,0
Boston,22,27,28,27,0,0,0,0,Orlando,20,18,31,19,0,0,0,0,20171105,104,88,2,11,8,16,16,192,-16,2017,0,6,1115,0
Phoenix,20,35,13,27,0,0,0,0,San Antonio,28,23,34,27,0,0,0,0,20171105,95,112,8,-4,17,17,17,207,17,2017,0,6,846,0
Oklahoma City,20,26,21,32,0,0,0,0,Portland,28,22,28,25,0,0,0,0,20171105,99,103,8,4,11,4,4,202,4,2017,0,6,1484,0
Washington,32,30,22,23,0,0,0,0,Toronto,17,29,30,20,0,0,0,0,20171105,107,96,15,16,8,11,11,203,-11,2017,0,6,349,0
Indiana,33,29,22,17,0,0,0,0,New York,25,24,23,36,0,0,0,0,20171105,101,108,-8,-13,-12,7,7,209,7,2017,0,6,643,0
Miami,34,28,27,15,0,0,0,0,LA Clippers,20,29,17,35,0,0,0,0,20171105,104,101,14,13,23,3,3,205,-3,2017,0,6,2335,0
Memphis,24,30,16,32,0,0,0,0,LA Lakers,27,35,26,19,0,0,0,0,20171105,102,107,3,8,18,5,5,209,5,2017,0,6,1599,0
Utah,28,21,36,25,0,0,0,0,Houston,39,28,48,22,0,0,0,0,20171105,110,137,11,18,30,27,27,247,27,2017,0,6,1199,0
Atlanta,37,17,37,26,0,0,0,0,Cleveland,28,17,33,37,0,0,0,0,20171105,117,115,9,9,13,2,2,232,-2,2017,0,6,555,0
Charlotte,28,23,28,15,0,0,0,0,Minnesota,28,40,29,15,0,0,0,0,20171105,94,112,0,17,18,18,18,206,18,2017,0,6,938,0
Boston,26,28,28,28,0,0,0,0,Atlanta,25,29,21,32,0,0,0,0,20171106,110,107,1,0,7,3,3,217,-3,2017,0,0,935,0
Miami,21,16,20,23,0,0,0,0,Golden State,22,28,25,22,0,0,0,0,20171106,80,97,1,13,18,17,17,177,17,2017,0,0,2590,0
Brooklyn,28,19,25,26,0,0,0,0,Phoenix,19,22,27,24,0,0,0,0,20171106,98,92,9,6,4,6,6,190,-6,2017,0,0,2139,0
Dallas,36,28,26,23,0,0,0,0,Washington,34,19,23,23,0,0,0,0,20171107,113,99,2,11,14,14,14,212,-14,2017,0,1,1181,0
Philadelphia,32,14,34,24,0,0,0,0,Utah,21,23,27,26,0,0,0,0,20171107,104,97,11,2,9,7,7,201,-7,2017,0,1,1920,0
Chicago,26,19,36,33,0,0,0,0,Toronto,29,36,33,21,0,0,0,0,20171107,114,119,3,20,17,5,5,233,5,2017,0,1,436,0
LA Clippers,26,29,21,31,0,0,0,0,San Antonio,32,20,40,28,0,0,0,0,20171107,107,120,6,-3,16,13,13,227,13,2017,0,1,1201,0
Oklahoma City,25,16,16,29,0,0,0,0,Sacramento,10,32,25,27,0,0,0,0,20171107,86,94,-15,1,10,8,8,180,8,2017,0,1,1336,0
Memphis,23,24,27,24,0,0,0,0,Portland,21,29,21,26,0,0,0,0,20171107,98,97,2,-3,3,1,1,195,-1,2017,0,1,1845,0
New Orleans,34,27,35,21,0,0,0,0,Indiana,37,38,19,18,0,0,0,0,20171107,117,112,-3,-14,2,5,5,229,-5,2017,0,1,713,0
Brooklyn,21,25,27,31,0,0,0,0,Denver,28,29,36,19,0,0,0,0,20171107,104,112,7,11,20,8,8,216,8,2017,0,1,1627,0
Milwaukee,28,39,23,29,0,0,0,0,Cleveland,39,26,29,30,0,0,0,0,20171107,119,124,11,-2,4,5,5,243,5,2017,0,1,334,0
Charlotte,41,28,25,19,0,0,0,0,New York,32,26,25,35,0,0,0,0,20171107,113,118,-9,-11,-11,5,5,231,5,2017,0,1,531,0
LA Lakers,16,36,29,15,0,0,0,0,Boston,33,28,26,20,0,0,0,0,20171108,96,107,17,9,6,11,11,203,11,2017,0,2,2590,0
Indiana,30,22,23,22,0,0,0,0,Detroit,22,37,23,32,0,0,0,0,20171108,97,114,-8,7,7,17,17,211,17,2017,0,2,240,0
Minnesota,22,28,26,25,0,0,0,0,Golden State,22,29,44,30,0,0,0,0,20171108,101,125,0,1,19,24,24,226,24,2017,0,2,1581,0
New York,28,22,26,23,0,0,0,0,Orlando,27,27,30,28,0,0,0,0,20171108,99,112,-1,4,8,13,13,211,13,2017,0,2,939,0
Miami,36,33,25,32,0,0,0,0,Phoenix,27,27,32,29,0,0,0,0,20171108,126,115,9,15,8,11,11,241,-11,2017,0,2,1978,0
New Orleans,32,28,32,26,0,0,0,0,Toronto,34,32,26,30,0,0,0,0,20171109,118,122,2,6,0,4,4,240,4,2017,0,3,1112,0
LA Lakers,34,22,21,18,0,0,0,0,Washington,37,32,22,20,0,0,0,0,20171109,95,111,3,13,14,16,16,206,16,2017,0,3,2294,0
Cleveland,25,42,26,20,0,0,0,0,Houston,36,29,35,17,0,0,0,0,20171109,113,117,11,-2,7,4,4,230,4,2017,0,3,1113,0
Oklahoma City,28,25,22,19,0,0,0,0,Denver,22,29,24,27,0,0,0,0,20171109,94,102,-6,-2,0,8,8,196,8,2017,0,3,503,0
Philadelphia,26,31,24,27,0,0,0,0,Sacramento,26,38,20,25,0,0,0,0,20171109,108,109,0,7,3,1,1,217,1,2017,0,3,2451,0
Charlotte,26,31,19,11,0,0,0,0,Boston,11,30,23,26,0,0,0,0,20171110,87,90,-15,-16,-12,3,3,177,3,2017,0,4,720,0
Indiana,27,18,35,25,0,0,0,0,Chicago,16,19,26,26,0,0,0,0,20171110,105,87,11,10,19,18,18,192,-18,2017,0,4,163,0
Atlanta,22,19,28,35,0,0,0,0,Detroit,26,31,19,35,0,0,0,0,20171110,104,111,4,16,7,7,7,215,7,2017,0,4,597,0
LA Clippers,31,24,31,25,0,0,0,0,Oklahoma City,30,33,31,26,0,0,0,0,20171110,111,120,-1,8,8,9,9,231,9,2017,0,4,1178,0
Orlando,36,28,33,31,0,0,0,0,Phoenix,32,31,20,29,0,0,0,0,20171110,128,112,4,1,14,16,16,240,-16,2017,0,4,1842,0
Brooklyn,21,25,31,24,0,0,0,0,Portland,28,24,18,27,0,0,0,0,20171110,101,97,-7,-6,7,4,4,198,-4,2017,0,4,2439,0
Milwaukee,25,21,30,18,0,0,0,0,San Antonio,27,20,23,17,0,0,0,0,20171110,94,87,-2,-1,6,7,7,181,-7,2017,0,4,1108,0
Miami,25,12,20,27,0,0,0,0,Utah,22,27,8,17,0,0,0,0,20171110,84,74,3,-12,0,10,10,158,-10,2017,0,4,2086,0
Atlanta,19,23,25,27,0,0,0,0,Washington,20,29,27,37,0,0,0,0,20171111,94,113,1,7,9,19,19,207,19,2017,0,5,541,0
Brooklyn,25,20,30,31,0,0,0,0,Utah,25,36,24,29,0,0,0,0,20171111,106,114,0,16,10,8,8,220,8,2017,0,5,1967,0
Chicago,15,32,23,24,0,0,0,0,San Antonio,37,26,34,36,0,0,0,0,20171111,94,133,22,16,27,39,39,227,39,2017,0,5,1050,0
Minnesota,28,32,28,22,0,0,0,0,Phoenix,19,37,29,33,0,0,0,0,20171111,110,118,-9,-4,-3,8,8,228,8,2017,0,5,1278,0
Sacramento,23,26,17,25,0,0,0,0,New York,32,32,26,28,0,0,0,0,20171111,91,118,9,15,24,27,27,209,27,2017,0,5,2499,0
LA Lakers,17,32,18,23,0,0,0,0,Milwaukee,24,27,26,21,0,0,0,0,20171111,90,98,7,2,10,8,8,188,8,2017,0,5,1741,0
Memphis,22,28,20,26,0,0,0,0,Houston,33,29,31,18,0,0,0,0,20171111,96,111,11,12,23,15,15,207,15,2017,0,5,484,0
Philadelphia,28,36,21,29,0,0,0,0,Golden State,32,33,36,34,0,0,0,0,20171111,114,135,4,1,16,21,21,249,21,2017,0,5,2516,0
Orlando,23,24,30,30,0,0,0,0,Denver,39,31,28,27,0,0,0,0,20171111,107,125,16,23,21,18,18,232,18,2017,0,5,1548,0
Cleveland,29,20,34,28,0,0,0,0,Dallas,23,29,22,30,0,0,0,0,20171111,111,104,6,-3,9,7,7,215,-7,2017,0,5,1024,0
LA Clippers,26,32,24,21,0,0,0,0,New Orleans,31,32,25,23,0,0,0,0,20171111,103,111,5,5,6,8,8,214,8,2017,0,5,1669,0
Toronto,24,25,27,18,0,0,0,0,Boston,24,20,33,18,0,0,0,0,20171112,94,95,0,-5,1,1,1,189,1,2017,0,6,430,0
Miami,29,29,23,22,0,0,0,0,Detroit,31,24,28,29,0,0,0,0,20171112,103,112,2,-3,2,9,9,215,9,2017,0,6,1155,0
Houston,35,28,24,31,0,0,0,0,Indiana,18,33,20,24,0,0,0,0,20171112,118,95,17,12,16,23,23,213,-23,2017,0,6,865,0
Dallas,20,22,25,32,0,0,0,0,Oklahoma City,18,26,39,29,0,0,0,0,20171112,99,112,-2,2,16,13,13,211,13,2017,0,6,189,0
Denver,21,28,17,16,0,0,0,0,Portland,25,29,30,15,0,0,0,0,20171113,82,99,4,5,18,17,17,181,17,2017,0,0,981,0
Sacramento,32,19,20,21,0,0,0,0,Washington,25,32,29,24,0,0,0,0,20171113,92,110,-7,6,15,18,18,202,18,2017,0,0,2371,0
Minnesota,33,24,31,21,0,0,0,0,Utah,14,28,23,33,0,0,0,0,20171113,109,98,19,15,23,11,11,207,-11,2017,0,0,984,0
LA Lakers,21,22,31,26,0,0,0,0,Phoenix,20,24,29,20,0,0,0,0,20171113,100,93,1,-1,1,7,7,193,-7,2017,0,0,356,0
Memphis,29,36,12,26,0,0,0,0,Milwaukee,34,26,24,26,0,0,0,0,20171113,103,110,5,-5,7,7,7,213,7,2017,0,0,557,0
Atlanta,32,18,30,25,0,0,0,0,New Orleans,23,22,33,28,0,0,0,0,20171113,105,106,-9,-5,-2,1,1,211,1,2017,0,0,424,0
Philadelphia,36,19,22,32,0,0,0,0,LA Clippers,28,25,26,26,0,0,0,0,20171113,109,105,8,2,-2,4,4,214,-4,2017,0,0,2388,0
Orlando,29,27,19,25,0,0,0,0,Golden State,27,29,32,22,0,0,0,0,20171113,100,110,-2,0,13,10,10,210,10,2017,0,0,2437,0
Cleveland,25,13,23,43,0,0,0,0,New York,22,29,25,25,0,0,0,0,20171113,104,101,3,-13,-15,3,3,205,-3,2017,0,0,403,0
Boston,30,22,28,29,0,0,0,0,Brooklyn,21,31,19,31,0,0,0,0,20171114,109,102,9,0,9,7,7,211,-7,2017,0,1,190,0
San Antonio,17,27,18,35,0,0,0,0,Dallas,16,23,21,31,0,0,0,0,20171114,97,91,1,5,2,6,6,188,-6,2017,0,1,252,0
Toronto,31,45,27,26,0,0,0,0,Houston,33,31,30,19,0,0,0,0,20171114,129,113,-2,12,9,16,16,242,-16,2017,0,1,1299,0
Orlando,33,14,24,23,0,0,0,0,Portland,24,27,24,24,0,0,0,0,20171115,94,99,-9,4,4,5,5,193,5,2017,0,2,2525,0
Chicago,7,27,22,23,0,0,0,0,Oklahoma City,27,31,19,15,0,0,0,0,20171115,79,92,20,24,21,13,13,171,13,2017,0,2,690,0
Utah,30,30,22,19,0,0,0,0,New York,27,23,27,29,0,0,0,0,20171115,101,106,-3,-10,-5,5,5,207,5,2017,0,2,1967,0
Toronto,29,35,34,27,0,0,0,0,New Orleans,34,29,23,30,0,0,0,0,20171115,125,116,-5,1,12,9,9,241,-9,2017,0,2,1112,0
San Antonio,24,19,22,21,0,0,0,0,Minnesota,18,39,18,23,0,0,0,0,20171115,86,98,-6,14,10,12,12,184,12,2017,0,2,1112,0
Detroit,23,18,21,33,0,0,0,0,Milwaukee,26,15,34,24,0,0,0,0,20171115,95,99,3,0,13,4,4,194,4,2017,0,2,251,0
Indiana,34,33,30,19,0,0,0,0,Memphis,25,28,31,29,0,0,0,0,20171115,116,113,9,14,13,3,3,229,-3,2017,0,2,383,0
Philadelphia,29,29,25,32,0,0,0,0,LA Lakers,26,28,30,25,0,0,0,0,20171115,115,109,3,4,-1,6,6,224,-6,2017,0,2,2388,0
Cleveland,36,25,27,27,0,0,0,0,Charlotte,30,37,17,23,0,0,0,0,20171115,115,107,6,-6,4,8,8,222,-8,2017,0,2,435,0
Sacramento,16,19,26,19,0,0,0,0,Atlanta,24,40,28,34,0,0,0,0,20171115,80,126,8,29,31,46,46,206,46,2017,0,2,2082,0
Washington,30,31,10,31,0,0,0,0,Miami,19,30,25,19,0,0,0,0,20171115,102,93,11,12,-3,9,9,195,-9,2017,0,2,924,0
Golden State,28,19,21,20,0,0,0,0,Boston,18,24,26,24,0,0,0,0,20171116,88,92,-10,-5,0,4,4,180,4,2017,0,3,2692,0
Houston,45,45,30,22,0,0,0,0,Phoenix,23,42,26,25,0,0,0,0,20171116,142,116,22,25,29,26,26,258,-26,2017,0,3,1014,0
Portland,20,21,19,22,0,0,0,0,Sacramento,19,23,18,26,0,0,0,0,20171117,82,86,-1,1,0,4,4,168,4,2017,0,4,483,0
Miami,26,24,16,25,0,0,0,0,Washington,17,12,28,31,0,0,0,0,20171117,91,88,9,21,9,3,3,179,-3,2017,0,4,924,0
New York,18,18,28,20,0,0,0,0,Toronto,30,24,24,29,0,0,0,0,20171117,84,107,12,18,14,23,23,191,23,2017,0,4,341,0
Oklahoma City,32,23,23,23,0,0,0,0,San Antonio,15,33,30,26,0,0,0,0,20171117,101,104,-17,-7,0,3,3,205,3,2017,0,4,421,0
Phoenix,29,36,24,33,0,0,0,0,LA Lakers,28,25,29,31,0,0,0,0,20171117,122,113,1,12,7,9,9,235,-9,2017,0,4,356,0
Charlotte,27,33,32,28,0,0,0,0,Chicago,26,34,23,40,0,0,0,0,20171117,120,123,-1,0,-9,3,3,243,3,2017,0,4,586,0
New Orleans,19,37,24,34,0,0,0,0,Denver,37,27,42,40,0,0,0,0,20171117,114,146,18,8,26,32,32,260,32,2017,0,4,1079,0
Utah,25,24,31,27,0,0,0,0,Brooklyn,39,26,24,29,0,0,0,0,20171117,107,118,14,16,9,11,11,225,11,2017,0,4,1967,0
Detroit,32,26,23,19,0,0,0,0,Indiana,23,24,24,36,0,0,0,0,20171117,100,107,-9,-11,-10,7,7,207,7,2017,0,4,240,0
Minnesota,24,19,31,37,0,0,0,0,Dallas,29,26,17,15,0,0,0,0,20171117,111,87,-5,-12,2,24,24,198,-24,2017,0,4,863,0
LA Clippers,27,29,25,24,8,0,0,0,Cleveland,24,32,22,27,13,0,0,0,20171117,113,118,-3,0,-3,0,5,231,5,2017,1,4,2044,0
Sacramento,20,21,22,27,0,0,0,0,Portland,21,32,27,22,0,0,0,0,20171118,90,102,1,12,17,12,12,192,12,2017,0,5,483,0
Boston,20,24,36,30,0,0,0,0,Atlanta,35,15,27,22,0,0,0,0,20171118,110,99,-15,-6,3,11,11,209,-11,2017,0,5,935,0
LA Clippers,24,22,25,16,0,0,0,0,Charlotte,25,30,18,29,0,0,0,0,20171118,87,102,1,9,2,15,15,189,15,2017,0,5,2115,0
Milwaukee,24,20,17,18,0,0,0,0,Dallas,33,23,26,29,0,0,0,0,20171118,79,111,9,12,21,32,32,190,32,2017,0,5,857,0
Houston,33,26,23,23,0,0,0,0,Memphis,25,25,17,16,0,0,0,0,20171118,105,83,8,9,15,22,22,188,-22,2017,0,5,484,0
Utah,29,34,34,28,0,0,0,0,Orlando,26,22,19,18,0,0,0,0,20171118,125,85,3,15,30,40,40,210,-40,2017,0,5,1915,0
Golden State,28,24,47,25,0,0,0,0,Philadelphia,47,27,15,27,0,0,0,0,20171118,124,116,-19,-22,10,8,8,240,-8,2017,0,5,2516,0
Washington,28,27,21,15,0,0,0,0,Toronto,28,32,19,21,0,0,0,0,20171119,91,100,0,5,3,9,9,191,9,2017,0,6,349,0
Chicago,37,19,28,21,0,0,0,0,Phoenix,30,31,24,28,0,0,0,0,20171119,105,113,-7,5,1,8,8,218,8,2017,0,6,1450,0
Detroit,22,27,22,29,0,0,0,0,Minnesota,24,29,27,17,0,0,0,0,20171119,100,97,-2,-4,-9,3,3,197,-3,2017,0,6,542,0
Golden State,32,32,34,20,0,0,0,0,Brooklyn,20,22,42,27,0,0,0,0,20171119,118,111,12,22,14,7,7,229,-7,2017,0,6,2565,0
Denver,26,22,36,25,0,0,0,0,LA Lakers,32,38,29,28,0,0,0,0,20171119,109,127,6,22,15,18,18,236,18,2017,0,6,830,0
Indiana,29,29,32,30,0,0,0,0,Miami,27,28,13,27,0,0,0,0,20171119,120,95,2,3,22,25,25,215,-25,2017,0,6,1026,0
LA Clippers,20,24,24,17,0,0,0,0,New York,20,36,27,24,0,0,0,0,20171120,85,107,0,12,15,22,22,192,22,2017,0,0,2445,0
Denver,22,25,34,33,0,0,0,0,Sacramento,22,25,23,28,0,0,0,0,20171120,114,98,0,0,11,16,16,212,-16,2017,0,0,886,0
Utah,15,21,27,23,0,0,0,0,Philadelphia,25,22,28,32,0,0,0,0,20171120,86,107,10,11,12,21,21,193,21,2017,0,0,1920,0
Indiana,34,16,28,27,0,0,0,0,Orlando,31,24,17,25,0,0,0,0,20171120,105,97,3,-5,6,8,8,202,-8,2017,0,0,822,0
Atlanta,22,16,27,20,0,0,0,0,San Antonio,24,22,24,26,0,0,0,0,20171120,85,96,2,8,5,11,11,181,11,2017,0,0,881,0
Oklahoma City,33,32,21,21,0,0,0,0,New Orleans,24,33,30,27,0,0,0,0,20171120,107,114,-9,-8,1,7,7,221,7,2017,0,0,576,0
Portland,23,32,17,28,0,0,0,0,Memphis,24,22,25,21,0,0,0,0,20171120,100,92,-1,9,1,8,8,192,-8,2017,0,0,1845,0
Cleveland,36,37,28,15,0,0,0,0,Detroit,23,23,16,26,0,0,0,0,20171120,116,88,13,27,39,28,28,204,-28,2017,0,0,90,0
Boston,34,19,16,27,14,0,0,0,Dallas,22,27,28,19,6,0,0,0,20171120,110,102,12,4,-8,0,8,212,-8,2017,1,0,1548,0
Minnesota,24,28,28,22,0,0,0,0,Charlotte,26,29,29,34,0,0,0,0,20171120,102,118,2,3,4,16,16,220,16,2017,0,0,938,0
Washington,27,20,26,26,0,0,0,0,Milwaukee,19,27,20,22,0,0,0,0,20171120,99,88,8,1,7,11,11,187,-11,2017,0,0,634,0
Chicago,27,29,19,19,0,0,0,0,LA Lakers,23,19,30,31,0,0,0,0,20171121,94,103,-4,-14,-3,9,9,197,9,2017,0,1,1741,0
Chicago,24,22,23,11,0,0,0,0,Utah,25,30,32,23,0,0,0,0,20171122,80,110,1,9,18,30,30,190,30,2017,0,2,1256,0
LA Lakers,19,22,26,35,0,0,0,0,Sacramento,31,23,22,37,0,0,0,0,20171122,102,113,12,13,9,11,11,215,11,2017,0,2,361,0
Milwaukee,33,21,30,21,8,0,0,0,Phoenix,23,21,31,30,2,0,0,0,20171122,113,107,10,10,9,0,6,220,-6,2017,1,2,1462,0
Portland,14,23,20,24,0,0,0,0,Philadelphia,26,24,20,31,0,0,0,0,20171122,81,101,12,13,13,20,20,182,20,2017,0,2,2405,0
Golden State,26,22,23,20,0,0,0,0,Oklahoma City,33,32,29,14,0,0,0,0,20171122,91,108,7,17,23,17,17,199,17,2017,0,2,1386,0
Toronto,34,25,10,31,0,0,0,0,New York,26,22,41,19,0,0,0,0,20171122,100,108,-8,-11,20,8,8,208,8,2017,0,2,341,0
San Antonio,29,13,17,31,0,0,0,0,New Orleans,19,31,37,20,0,0,0,0,20171122,90,107,-10,8,28,17,17,197,17,2017,0,2,506,0
Boston,16,25,22,35,0,0,0,0,Miami,27,27,25,25,0,0,0,0,20171122,98,104,11,13,16,6,6,202,6,2017,0,2,1257,0
Dallas,12,27,35,21,0,0,0,0,Memphis,27,29,16,22,0,0,0,0,20171122,95,94,-15,-17,2,1,1,189,-1,2017,0,2,419,0
Denver,17,23,27,28,0,0,0,0,Houston,36,39,26,24,0,0,0,0,20171122,95,125,19,35,34,30,30,220,30,2017,0,2,878,0
Brooklyn,17,29,31,32,0,0,0,0,Cleveland,20,25,32,42,0,0,0,0,20171122,109,119,3,-1,0,10,10,228,10,2017,0,2,403,0
Washington,26,33,29,26,10,0,0,0,Charlotte,25,30,29,30,15,0,0,0,20171122,124,129,-1,-4,-4,0,5,253,5,2017,1,2,329,0
LA Clippers,29,33,26,28,0,0,0,0,Atlanta,30,33,21,19,0,0,0,0,20171122,116,103,-1,-1,4,13,13,219,-13,2017,0,2,1932,0
Orlando,35,27,18,38,0,0,0,0,Minnesota,30,35,41,18,0,0,0,0,20171122,118,124,-5,3,26,6,6,242,6,2017,0,2,1309,0
Miami,28,30,23,28,0,0,0,0,Minnesota,24,24,22,27,0,0,0,0,20171124,109,97,4,10,11,12,12,206,-12,2017,0,4,1513,0
New Orleans,33,39,22,21,0,0,0,0,Phoenix,21,21,20,29,0,0,0,0,20171124,115,91,12,30,32,24,24,206,-24,2017,0,4,1312,0
Detroit,25,24,24,26,0,0,0,0,Oklahoma City,29,30,18,21,0,0,0,0,20171124,99,98,-4,-10,-4,1,1,197,-1,2017,0,4,909,0
Toronto,25,35,20,24,0,0,0,0,Indiana,29,21,31,26,0,0,0,0,20171124,104,107,4,-10,1,3,3,211,3,2017,0,4,438,0
Chicago,32,21,13,28,0,0,0,0,Golden State,29,45,36,33,0,0,0,0,20171124,94,143,-3,21,44,49,49,237,49,2017,0,4,1853,0
Charlotte,28,29,25,17,0,0,0,0,Cleveland,27,27,29,17,0,0,0,0,20171124,99,100,-1,-3,1,1,1,199,1,2017,0,4,435,0
Portland,23,28,41,35,0,0,0,0,Brooklyn,32,21,39,33,0,0,0,0,20171124,127,125,-9,-2,0,2,2,252,-2,2017,0,4,2439,0
Orlando,26,21,22,34,0,0,0,0,Boston,40,33,26,19,0,0,0,0,20171124,103,118,14,26,30,15,15,221,15,2017,0,4,1115,0
New York,39,28,19,18,0,0,0,0,Atlanta,24,35,30,27,0,0,0,0,20171124,104,116,-15,-8,3,12,12,220,12,2017,0,4,745,0
Memphis,18,27,29,18,0,0,0,0,Denver,27,34,15,28,0,0,0,0,20171124,92,104,9,16,2,12,12,196,12,2017,0,4,877,0
Boston,27,18,37,26,0,0,0,0,Indiana,32,22,16,28,0,0,0,0,20171125,108,98,-5,-9,12,10,10,206,-10,2017,0,5,805,0
Portland,27,14,32,35,0,0,0,0,Washington,30,22,31,22,0,0,0,0,20171125,108,105,-3,-11,-10,3,3,213,-3,2017,0,5,2347,0
Milwaukee,30,27,28,23,0,0,0,0,Utah,31,33,31,26,0,0,0,0,20171125,108,121,1,7,10,13,13,229,13,2017,0,5,1239,0
LA Clippers,25,22,29,21,0,0,0,0,Sacramento,31,30,10,24,0,0,0,0,20171125,97,95,-6,-14,5,2,2,192,-2,2017,0,5,361,0
Orlando,28,27,30,26,0,0,0,0,Philadelphia,31,39,31,29,0,0,0,0,20171125,111,130,3,15,16,19,19,241,19,2017,0,5,864,0
New Orleans,31,22,22,20,0,0,0,0,Golden State,17,36,31,26,0,0,0,0,20171125,95,110,-14,0,9,15,15,205,15,2017,0,5,1921,0
Oklahoma City,24,13,18,26,0,0,0,0,Dallas,25,27,26,19,0,0,0,0,20171125,81,97,1,15,23,16,16,178,16,2017,0,5,189,0
San Antonio,14,26,32,34,0,0,0,0,Charlotte,15,14,29,28,0,0,0,0,20171125,106,86,-1,11,14,20,20,192,-20,2017,0,5,1103,0
Toronto,28,39,32,13,0,0,0,0,Atlanta,25,14,19,20,0,0,0,0,20171125,112,78,3,28,41,34,34,190,-34,2017,0,5,733,0
New York,39,22,13,28,0,0,0,0,Houston,29,29,37,22,0,0,0,0,20171125,102,117,-10,-3,21,15,15,219,15,2017,0,5,1417,0
Brooklyn,19,28,32,19,0,0,0,0,Memphis,22,25,18,23,0,0,0,0,20171126,98,88,-3,0,14,10,10,186,-10,2017,0,6,953,0
Miami,7,38,19,36,0,0,0,0,Chicago,13,29,19,32,0,0,0,0,20171126,100,93,-6,3,3,7,7,193,-7,2017,0,6,1189,0
Phoenix,27,31,22,28,0,0,0,0,Minnesota,33,30,30,26,0,0,0,0,20171126,108,119,6,5,13,11,11,227,11,2017,0,6,1278,0
Cleveland,29,24,33,27,0,0,0,0,Philadelphia,22,23,28,18,0,0,0,0,20171127,113,91,7,8,13,22,22,204,-22,2017,0,0,358,0
Dallas,23,30,22,33,0,0,0,0,San Antonio,21,25,31,38,0,0,0,0,20171127,108,115,-2,-7,2,7,7,223,7,2017,0,0,252,0
Portland,30,23,37,13,0,0,0,0,New York,23,14,27,27,0,0,0,0,20171127,103,91,7,16,26,12,12,194,-12,2017,0,0,2439,0
LA Lakers,32,30,27,26,0,0,0,0,LA Clippers,34,26,27,33,0,0,0,0,20171127,115,120,2,-2,-2,5,5,235,5,2017,0,0,0,0
Brooklyn,26,29,25,23,0,0,0,0,Houston,43,23,30,21,0,0,0,0,20171127,103,117,17,11,16,14,14,220,14,2017,0,0,1417,0
Sacramento,27,26,30,27,0,0,0,0,Golden State,27,28,27,24,0,0,0,0,20171127,110,106,0,-2,1,4,4,216,-4,2017,0,0,75,0
Detroit,31,29,26,32,0,0,0,0,Boston,23,34,29,22,0,0,0,0,20171127,118,108,8,3,0,10,10,226,-10,2017,0,0,611,0
Orlando,25,25,34,25,0,0,0,0,Indiana,33,24,28,36,0,0,0,0,20171127,109,121,8,7,1,12,12,230,12,2017,0,0,822,0
Phoenix,28,18,27,31,0,0,0,0,Chicago,29,14,27,29,0,0,0,0,20171128,104,99,-1,3,3,5,5,203,-5,2017,0,1,1450,0
Miami,24,25,25,23,0,0,0,0,Cleveland,35,40,18,15,0,0,0,0,20171128,97,108,11,26,19,11,11,205,11,2017,0,1,1089,0
Washington,23,20,25,24,0,0,0,0,Minnesota,30,21,20,18,0,0,0,0,20171128,92,89,-7,-8,-3,3,3,181,-3,2017,0,1,931,0
Milwaukee,32,29,31,20,0,0,0,0,Sacramento,26,11,22,28,0,0,0,0,20171128,112,87,6,24,33,25,25,199,-25,2017,0,1,1771,0
Denver,24,25,17,11,0,0,0,0,Utah,26,22,28,30,0,0,0,0,20171128,77,106,2,-1,10,29,29,183,29,2017,0,1,370,0
Indiana,27,22,22,26,0,0,0,0,Houston,22,32,35,29,0,0,0,0,20171129,97,118,-5,5,18,21,21,215,21,2017,0,2,865,0
Memphis,21,28,24,22,0,0,0,0,San Antonio,28,30,21,25,0,0,0,0,20171129,95,104,7,9,6,9,9,199,9,2017,0,2,631,0
Washington,18,22,25,48,0,0,0,0,Philadelphia,28,30,26,34,0,0,0,0,20171129,113,118,10,18,19,5,5,231,5,2017,0,2,123,0
Oklahoma City,25,32,23,28,0,0,0,0,Orlando,31,28,28,34,0,0,0,0,20171129,108,121,6,2,7,13,13,229,13,2017,0,2,1057,0
Miami,22,22,20,22,0,0,0,0,New York,33,32,23,27,0,0,0,0,20171129,86,115,11,21,24,29,29,201,29,2017,0,2,1091,0
Brooklyn,21,27,32,29,0,0,0,0,Dallas,27,20,29,28,0,0,0,0,20171129,109,104,-6,1,4,5,5,213,-5,2017,0,2,1370,0
Golden State,30,20,34,25,18,0,0,0,LA Lakers,20,34,30,25,14,0,0,0,20171129,127,123,10,-4,0,0,4,250,-4,2017,1,2,347,0
Phoenix,19,22,29,37,0,0,0,0,Detroit,36,33,35,27,0,0,0,0,20171129,107,131,17,28,34,24,24,238,24,2017,0,2,1687,0
Charlotte,25,27,33,28,0,0,0,0,Toronto,32,39,22,33,0,0,0,0,20171129,113,126,7,19,8,13,13,239,13,2017,0,2,585,0
Minnesota,28,34,31,27,0,0,0,0,New Orleans,29,20,27,26,0,0,0,0,20171129,120,102,-1,13,17,18,18,222,-18,2017,0,2,1052,0
Chicago,39,29,24,18,0,0,0,0,Denver,30,32,29,20,0,0,0,0,20171130,110,111,-9,-6,-1,1,1,221,1,2017,0,3,916,0
Utah,26,35,33,32,0,0,0,0,LA Clippers,27,34,26,20,0,0,0,0,20171130,126,107,-1,0,7,19,19,233,-19,2017,0,3,579,0
Cleveland,42,21,36,22,0,0,0,0,Atlanta,35,32,23,24,0,0,0,0,20171130,121,114,7,-4,9,7,7,235,-7,2017,0,3,555,0
Philadelphia,22,22,27,26,0,0,0,0,Boston,28,26,22,32,0,0,0,0,20171130,97,108,6,10,5,11,11,205,11,2017,0,3,270,0
Milwaukee,33,27,27,16,0,0,0,0,Portland,21,24,21,25,0,0,0,0,20171130,103,91,12,15,21,12,12,194,-12,2017,0,3,1714,0
Detroit,26,26,15,24,0,0,0,0,Washington,26,20,35,28,0,0,0,0,20171201,91,109,0,-6,14,18,18,200,18,2017,0,4,394,0
New Orleans,29,26,29,24,0,0,0,0,Utah,27,16,37,34,0,0,0,0,20171201,108,114,-2,-12,-4,6,6,222,6,2017,0,4,1432,0
Golden State,41,37,24,31,0,0,0,0,Orlando,34,29,28,21,0,0,0,0,20171201,133,112,7,15,11,21,21,245,-21,2017,0,4,2437,0
Indiana,32,26,31,26,0,0,0,0,Toronto,27,38,29,26,0,0,0,0,20171201,115,120,-5,7,5,5,5,235,5,2017,0,4,438,0
Charlotte,30,19,26,25,0,0,0,0,Miami,22,28,29,26,0,0,0,0,20171201,100,105,-8,1,4,5,5,205,5,2017,0,4,654,0
Minnesota,33,21,25,28,0,0,0,0,Oklahoma City,42,22,21,26,0,0,0,0,20171201,107,111,9,10,6,4,4,218,4,2017,0,4,694,0
San Antonio,24,23,21,27,0,0,0,0,Memphis,18,20,21,20,0,0,0,0,20171201,95,79,6,9,9,16,16,174,-16,2017,0,4,631,0
Sacramento,29,32,21,25,0,0,0,0,Chicago,31,29,21,25,0,0,0,0,20171201,107,106,-2,1,1,1,1,213,-1,2017,0,4,1788,0
New Orleans,26,34,38,25,0,0,0,0,Portland,33,24,25,34,0,0,0,0,20171202,123,116,-7,3,16,7,7,239,-7,2017,0,5,2059,0
Sacramento,25,27,24,28,0,0,0,0,Milwaukee,33,30,25,21,0,0,0,0,20171202,104,109,8,11,12,5,5,213,5,2017,0,5,1771,0
LA Lakers,29,30,21,20,0,0,0,0,Denver,34,21,23,37,0,0,0,0,20171202,100,115,5,-4,-2,15,15,215,15,2017,0,5,830,0
Detroit,25,22,33,23,0,0,0,0,Philadelphia,32,31,17,28,0,0,0,0,20171202,103,108,7,16,0,5,5,211,5,2017,0,5,441,0
Memphis,32,20,30,29,0,0,0,0,Cleveland,28,38,27,23,0,0,0,0,20171202,111,116,-4,14,11,5,5,227,5,2017,0,5,629,0
Atlanta,25,29,27,33,0,0,0,0,Brooklyn,22,23,30,27,0,0,0,0,20171202,114,102,3,9,6,12,12,216,-12,2017,0,5,745,0
Phoenix,22,32,25,32,0,0,0,0,Boston,31,29,29,27,0,0,0,0,20171202,111,116,9,6,10,5,5,227,5,2017,0,5,2295,0
LA Clippers,17,21,28,16,0,0,0,0,Dallas,24,35,27,22,0,0,0,0,20171202,82,108,7,21,20,26,26,190,26,2017,0,5,1237,0
Houston,27,34,24,33,0,0,0,0,LA Lakers,27,19,27,22,0,0,0,0,20171203,118,95,0,15,12,23,23,213,-23,2017,0,6,1371,0
Golden State,33,29,37,24,0,0,0,0,Miami,36,24,17,18,0,0,0,0,20171203,123,95,-3,2,22,28,28,218,-28,2017,0,6,2590,0
LA Clippers,27,28,21,30,0,0,0,0,Minnesota,31,29,18,34,0,0,0,0,20171203,106,112,4,5,2,6,6,218,6,2017,0,6,1521,0
Orlando,36,18,24,27,0,0,0,0,New York,25,26,25,24,0,0,0,0,20171203,105,100,11,3,2,5,5,205,-5,2017,0,6,939,0
San Antonio,18,25,30,14,0,0,0,0,Oklahoma City,25,29,22,14,0,0,0,0,20171203,87,90,7,11,3,3,3,177,3,2017,0,6,421,0
Minnesota,26,27,22,17,0,0,0,0,Memphis,29,27,20,19,0,0,0,0,20171204,92,95,3,3,1,3,3,187,3,2017,0,0,700,0
Washington,15,15,22,17,0,0,0,0,Utah,29,35,24,28,0,0,0,0,20171204,69,116,14,34,36,47,47,185,47,2017,0,0,1841,0
Phoenix,28,32,29,26,0,0,0,0,Philadelphia,28,19,32,22,0,0,0,0,20171204,115,101,0,13,10,14,14,216,-14,2017,0,0,2078,0
Golden State,26,23,39,37,0,0,0,0,New Orleans,33,36,22,24,0,0,0,0,20171204,125,115,-7,-20,-3,10,10,240,-10,2017,0,0,1921,0
New York,19,21,25,32,0,0,0,0,Indiana,31,35,29,20,0,0,0,0,20171204,97,115,12,26,30,18,18,212,18,2017,0,0,643,0
Detroit,29,24,20,20,0,0,0,0,San Antonio,28,22,19,27,0,0,0,0,20171204,93,96,-1,-3,-4,3,3,189,3,2017,0,0,1238,0
Orlando,23,22,29,20,0,0,0,0,Charlotte,26,28,21,29,0,0,0,0,20171204,94,104,3,9,1,10,10,198,10,2017,0,0,463,0
Cleveland,29,32,25,27,0,0,0,0,Chicago,22,23,26,20,0,0,0,0,20171204,113,91,7,16,15,22,22,204,-22,2017,0,0,308,0
Milwaukee,26,23,32,19,0,0,0,0,Boston,34,28,26,23,0,0,0,0,20171204,100,111,8,13,7,11,11,211,11,2017,0,0,855,0
Brooklyn,33,20,31,26,0,0,0,0,Atlanta,32,22,15,21,0,0,0,0,20171204,110,90,1,-1,15,20,20,200,-20,2017,0,0,745,0
Denver,23,24,35,23,0,0,0,0,Dallas,39,25,29,29,0,0,0,0,20171204,105,122,16,17,11,17,17,227,17,2017,0,0,661,0
Utah,28,19,33,14,0,0,0,0,Oklahoma City,19,20,29,32,0,0,0,0,20171205,94,100,-9,-8,-12,6,6,194,6,2017,0,1,861,0
Washington,24,27,28,27,0,0,0,0,Portland,22,15,29,26,0,0,0,0,20171205,106,92,2,14,13,14,14,198,-14,2017,0,1,2347,0
Phoenix,23,23,33,34,0,0,0,0,Toronto,36,19,42,29,0,0,0,0,20171205,113,126,13,9,18,13,13,239,13,2017,0,1,1885,0
Miami,35,23,24,23,0,0,0,0,San Antonio,27,30,29,31,0,0,0,0,20171206,105,117,-8,-1,4,12,12,222,12,2017,0,2,1147,0
Atlanta,23,29,27,17,10,0,0,0,Orlando,31,13,30,22,14,0,0,0,20171206,106,110,8,-8,-5,0,4,216,4,2017,1,2,401,0
Denver,33,33,25,23,0,0,0,0,New Orleans,33,34,30,26,0,0,0,0,20171206,114,123,0,1,6,9,9,237,9,2017,0,2,1079,0
Detroit,27,24,25,24,0,0,0,0,Milwaukee,30,30,16,28,0,0,0,0,20171206,100,104,3,9,0,4,4,204,4,2017,0,2,251,0
Memphis,32,17,18,21,0,0,0,0,New York,23,26,27,23,0,0,0,0,20171206,88,99,-9,0,9,11,11,187,11,2017,0,2,953,0
Chicago,30,25,28,13,0,0,0,0,Indiana,20,19,30,29,0,0,0,0,20171206,96,98,-10,-16,-14,2,2,194,2,2017,0,2,163,0
Sacramento,22,35,21,17,0,0,0,0,Cleveland,19,29,25,28,0,0,0,0,20171206,95,101,-3,-9,-5,6,6,196,6,2017,0,2,2096,0
Golden State,26,27,26,22,0,0,0,0,Charlotte,18,20,30,19,0,0,0,0,20171206,101,87,8,15,11,14,14,188,-14,2017,0,2,2296,0
Dallas,26,31,16,17,0,0,0,0,Boston,24,23,23,27,0,0,0,0,20171206,90,97,-2,-10,-3,7,7,187,7,2017,0,2,1548,0
Minnesota,29,33,26,25,0,0,0,0,LA Clippers,22,27,31,27,0,0,0,0,20171206,113,107,7,13,8,6,6,220,-6,2017,0,2,1521,0
Washington,26,31,28,24,0,0,0,0,Phoenix,28,24,32,15,0,0,0,0,20171207,109,99,-2,5,1,10,10,208,-10,2017,0,3,1977,0
Houston,25,26,37,24,0,0,0,0,Utah,20,26,20,35,0,0,0,0,20171207,112,101,5,5,22,11,11,213,-11,2017,0,3,1199,0
Oklahoma City,33,25,21,16,0,0,0,0,Brooklyn,20,29,25,26,0,0,0,0,20171207,95,100,-13,-9,-5,5,5,195,5,2017,0,3,1324,0
LA Lakers,32,25,22,28,0,0,0,0,Philadelphia,25,24,21,34,0,0,0,0,20171207,107,104,7,8,9,3,3,211,-3,2017,0,3,2388,0
Boston,31,24,27,20,0,0,0,0,San Antonio,26,30,21,28,0,0,0,0,20171208,102,105,-5,1,-5,3,3,207,3,2017,0,4,1765,0
Chicago,31,21,23,31,13,0,0,0,Charlotte,25,27,27,27,5,0,0,0,20171208,119,111,6,0,-4,0,8,230,-8,2017,1,4,586,0
Golden State,30,16,31,25,0,0,0,0,Detroit,24,26,17,31,0,0,0,0,20171208,102,98,6,-4,10,4,4,200,-4,2017,0,4,2087,0
Cleveland,33,30,23,16,0,0,0,0,Indiana,32,25,32,17,0,0,0,0,20171208,102,106,-1,-6,3,4,4,208,4,2017,0,4,262,0
Toronto,25,32,35,24,0,0,0,0,Memphis,34,28,31,14,0,0,0,0,20171208,116,107,-9,-5,-1,9,9,223,-9,2017,0,4,815,0
Dallas,25,29,24,24,0,0,0,0,Milwaukee,22,27,28,32,0,0,0,0,20171208,102,109,-3,-5,-1,7,7,211,7,2017,0,4,857,0
Sacramento,24,23,30,25,14,0,0,0,New Orleans,25,28,29,20,7,0,0,0,20171208,116,109,-1,-6,-5,0,7,225,-7,2017,1,4,1879,0
Denver,14,35,32,22,0,0,0,0,Orlando,25,23,22,19,0,0,0,0,20171208,103,89,-11,1,11,14,14,192,-14,2017,0,4,1548,0
Utah,19,23,24,34,0,0,0,0,Milwaukee,29,22,32,34,0,0,0,0,20171209,100,117,10,9,17,17,17,217,17,2017,0,5,1239,0
Oklahoma City,19,27,21,25,10,0,0,0,Memphis,34,23,9,26,9,0,0,0,20171209,102,101,-15,-11,1,0,1,203,-1,2017,1,5,421,0
Houston,31,31,22,40,0,0,0,0,Portland,37,25,36,19,0,0,0,0,20171209,124,117,-6,0,-14,7,7,241,-7,2017,0,5,1833,0
Washington,27,22,32,31,0,0,0,0,LA Clippers,30,32,23,28,0,0,0,0,20171209,112,113,3,13,4,1,1,225,1,2017,0,5,2294,0
San Antonio,28,24,27,25,0,0,0,0,Phoenix,17,22,32,30,0,0,0,0,20171209,104,101,11,13,8,3,3,205,-3,2017,0,5,846,0
LA Lakers,28,24,24,34,0,0,0,0,Charlotte,29,27,19,24,0,0,0,0,20171209,110,99,-1,-4,1,11,11,209,-11,2017,0,5,2115,0
New York,18,26,26,32,0,0,0,0,Chicago,27,22,19,36,0,0,0,0,20171209,102,104,9,5,-2,2,2,206,2,2017,0,5,711,0
Miami,24,26,25,26,0,0,0,0,Brooklyn,26,27,19,17,0,0,0,0,20171209,101,89,-2,-3,3,12,12,190,-12,2017,0,5,1091,0
Orlando,22,32,33,23,0,0,0,0,Atlanta,32,25,32,28,0,0,0,0,20171209,110,117,10,3,2,7,7,227,7,2017,0,5,401,0
Philadelphia,24,22,27,25,0,0,0,0,Cleveland,23,29,26,27,0,0,0,0,20171209,98,105,-1,6,5,7,7,203,7,2017,0,5,358,0
Boston,29,15,29,18,0,0,0,0,Detroit,21,16,22,22,0,0,0,0,20171210,91,81,8,7,14,10,10,172,-10,2017,0,6,611,0
Denver,35,31,22,26,2,0,0,0,Indiana,22,37,31,24,12,0,0,0,20171210,116,126,-13,-7,2,0,10,242,10,2017,1,6,998,0
Dallas,24,24,21,23,0,0,0,0,Minnesota,23,24,24,26,0,0,0,0,20171210,92,97,-1,-1,2,5,5,189,5,2017,0,6,863,0
Philadelphia,26,29,40,29,0,0,0,0,New Orleans,32,34,21,44,0,0,0,0,20171210,124,131,6,11,-8,7,7,255,7,2017,0,6,1088,0
Atlanta,21,31,23,32,0,0,0,0,New York,24,27,25,35,0,0,0,0,20171210,107,111,3,-1,1,4,4,218,4,2017,0,6,745,0
Toronto,22,32,25,23,0,0,0,0,Sacramento,17,29,21,20,0,0,0,0,20171210,102,87,5,8,12,15,15,189,-15,2017,0,6,2195,0
Charlotte,34,18,40,24,0,0,0,0,Oklahoma City,26,26,22,29,0,0,0,0,20171211,116,103,8,0,18,13,13,219,-13,2017,0,0,938,0
Miami,21,24,25,37,0,0,0,0,Memphis,23,19,18,22,0,0,0,0,20171211,107,82,-2,3,10,25,25,189,-25,2017,0,0,873,0
Toronto,30,23,21,17,0,0,0,0,LA Clippers,19,32,19,26,0,0,0,0,20171211,91,96,-11,-2,-4,5,5,187,5,2017,0,0,2170,0
New Orleans,41,35,27,20,0,0,0,0,Houston,35,43,18,34,0,0,0,0,20171211,123,130,-6,2,-7,7,7,253,7,2017,0,0,317,0
Portland,28,19,28,29,0,0,0,0,Golden State,27,33,33,18,0,0,0,0,20171211,104,111,-1,13,18,7,7,215,7,2017,0,0,535,0
Boston,29,13,21,22,0,0,0,0,Chicago,28,28,22,30,0,0,0,0,20171211,85,108,-1,14,15,23,23,193,23,2017,0,0,849,0
Washington,22,29,27,20,0,0,0,0,Brooklyn,30,21,28,24,0,0,0,0,20171212,98,103,8,0,1,5,5,201,5,2017,0,1,204,0
Atlanta,31,17,29,37,0,0,0,0,Cleveland,31,31,32,29,0,0,0,0,20171212,114,123,0,14,17,9,9,237,9,2017,0,1,555,0
San Antonio,23,21,25,20,0,0,0,0,Dallas,30,16,21,28,0,0,0,0,20171212,89,95,7,2,-2,6,6,184,6,2017,0,1,252,0
Denver,26,23,31,23,0,0,0,0,Detroit,18,22,20,24,0,0,0,0,20171212,103,84,8,9,20,19,19,187,-19,2017,0,1,1154,0
Philadelphia,20,28,26,26,18,0,0,0,Minnesota,27,24,25,24,12,0,0,0,20171212,118,112,-7,-3,-2,0,6,230,-6,2017,1,1,983,0
LA Lakers,29,22,28,20,10,0,0,0,New York,25,25,26,23,14,0,0,0,20171212,109,113,-4,-1,-3,0,4,222,4,2017,1,1,2445,0
Phoenix,23,28,23,18,0,0,0,0,Sacramento,21,28,25,25,0,0,0,0,20171212,92,99,-2,-2,0,7,7,191,7,2017,0,1,634,0
Memphis,12,17,28,30,0,0,0,0,Washington,22,19,19,33,0,0,0,0,20171213,87,93,10,12,3,6,6,180,6,2017,0,2,762,0
Toronto,37,21,34,23,0,0,0,0,Phoenix,31,21,27,30,0,0,0,0,20171213,115,109,6,6,13,6,6,224,-6,2017,0,2,1885,0
LA Clippers,13,32,29,32,0,0,0,0,Orlando,24,16,28,27,0,0,0,0,20171213,106,95,-11,5,6,11,11,201,-11,2017,0,2,2197,0
Milwaukee,37,26,22,23,0,0,0,0,New Orleans,32,30,25,28,0,0,0,0,20171213,108,115,-5,-1,2,7,7,223,7,2017,0,2,911,0
Charlotte,23,26,20,27,0,0,0,0,Houston,38,25,28,17,0,0,0,0,20171213,96,108,15,14,22,12,12,204,12,2017,0,2,925,0
Oklahoma City,22,29,22,27,0,0,0,0,Indiana,27,19,23,26,0,0,0,0,20171213,100,95,-5,5,4,5,5,195,-5,2017,0,2,688,0
Utah,24,24,26,26,0,0,0,0,Chicago,30,19,28,26,0,0,0,0,20171213,100,103,6,1,3,3,3,203,3,2017,0,2,1256,0
Denver,31,28,33,26,0,0,0,0,Boston,30,38,29,27,0,0,0,0,20171213,118,124,-1,9,5,6,6,242,6,2017,0,2,1765,0
Portland,21,29,20,32,0,0,0,0,Miami,33,27,19,16,0,0,0,0,20171213,102,95,-12,-10,-9,7,7,197,-7,2017,0,2,2704,0
Detroit,30,29,26,20,0,0,0,0,Atlanta,31,15,18,27,0,0,0,0,20171214,105,91,-1,13,21,14,14,196,-14,2017,0,3,597,0
New York,32,31,24,24,0,0,0,0,Brooklyn,26,24,32,22,0,0,0,0,20171214,111,104,6,13,5,7,7,215,-7,2017,0,3,0,0
LA Lakers,26,34,26,26,0,0,0,0,Cleveland,24,39,31,27,0,0,0,0,20171214,112,121,-2,3,8,9,9,233,9,2017,0,3,2044,0
Dallas,28,20,25,24,0,0,0,0,Golden State,24,24,32,32,0,0,0,0,20171214,97,112,-4,0,7,15,15,209,15,2017,0,3,1480,0
Sacramento,22,33,16,25,0,0,0,0,Minnesota,32,32,31,24,0,0,0,0,20171214,96,119,10,9,24,23,23,215,23,2017,0,3,1511,0
LA Clippers,18,25,21,27,0,0,0,0,Washington,25,23,27,25,0,0,0,0,20171215,91,100,7,5,11,9,9,191,9,2017,0,4,2294,0
Brooklyn,20,24,20,23,0,0,0,0,Toronto,30,28,33,29,0,0,0,0,20171215,87,120,10,14,27,33,33,207,33,2017,0,4,341,0
Oklahoma City,28,27,26,13,8,9,8,0,Philadelphia,23,24,30,17,8,9,6,0,20171215,119,117,5,8,4,0,2,236,-2,2017,3,4,1256,0
Portland,24,26,25,20,0,0,0,0,Orlando,20,23,23,22,0,0,0,0,20171215,95,88,4,7,9,7,7,183,-7,2017,0,4,2525,0
Chicago,33,26,23,33,0,0,0,0,Milwaukee,30,28,24,27,0,0,0,0,20171215,115,109,3,1,0,6,6,224,-6,2017,0,4,83,0
New Orleans,33,25,28,18,7,0,0,0,Denver,20,26,30,28,13,0,0,0,20171215,111,117,-13,-12,-10,0,6,228,6,2017,1,4,1079,0
Detroit,27,25,34,18,0,0,0,0,Indiana,19,35,20,24,0,0,0,0,20171215,104,98,8,-2,12,6,6,202,-6,2017,0,4,240,0
San Antonio,16,27,29,37,0,0,0,0,Houston,31,29,32,32,0,0,0,0,20171215,109,124,15,17,20,15,15,233,15,2017,0,4,189,0
Miami,24,29,26,25,0,0,0,0,Charlotte,19,28,24,27,0,0,0,0,20171215,104,98,5,6,8,6,6,202,-6,2017,0,4,654,0
Utah,21,25,33,28,0,0,0,0,Boston,26,13,28,28,0,0,0,0,20171215,107,95,-5,7,12,12,12,202,-12,2017,0,4,2093,0
Atlanta,21,26,26,21,0,0,0,0,Memphis,17,23,32,24,0,0,0,0,20171215,94,96,-4,-7,-1,2,2,190,2,2017,0,4,336,0
Phoenix,22,20,35,31,0,0,0,0,Minnesota,25,25,31,25,0,0,0,0,20171216,108,106,-3,-8,-4,2,2,214,-2,2017,0,5,1278,0
Dallas,31,22,27,16,0,0,0,0,San Antonio,18,25,28,27,0,0,0,0,20171216,96,98,-13,-10,-9,2,2,194,2,2017,0,5,252,0
Oklahoma City,26,18,29,23,0,0,0,0,New York,23,27,30,31,0,0,0,0,20171216,96,111,-3,6,7,15,15,207,15,2017,0,5,1324,0
LA Clippers,17,23,25,20,0,0,0,0,Miami,24,22,23,21,0,0,0,0,20171216,85,90,7,6,4,5,5,175,5,2017,0,5,2335,0
Boston,31,17,23,31,0,0,0,0,Memphis,12,28,33,20,0,0,0,0,20171216,102,93,19,8,-2,9,9,195,-9,2017,0,5,1134,0
Milwaukee,25,30,24,32,0,0,0,0,Houston,28,27,29,31,0,0,0,0,20171216,111,115,3,0,5,4,4,226,4,2017,0,5,1005,0
Utah,24,24,25,27,0,0,0,0,Cleveland,23,28,29,29,0,0,0,0,20171216,100,109,-1,3,7,9,9,209,9,2017,0,5,1564,0
Portland,24,25,25,19,0,0,0,0,Charlotte,20,17,30,24,0,0,0,0,20171216,93,91,4,12,7,2,2,184,-2,2017,0,5,2284,0
Indiana,28,31,21,29,0,0,0,0,Brooklyn,29,19,24,25,0,0,0,0,20171217,109,97,-1,11,8,12,12,206,-12,2017,0,6,643,0
Orlando,23,20,36,31,0,0,0,0,Detroit,36,24,36,18,0,0,0,0,20171217,110,114,13,17,17,4,4,224,4,2017,0,6,957,0
Sacramento,30,33,14,16,0,0,0,0,Toronto,35,26,22,25,0,0,0,0,20171217,93,108,5,-2,6,15,15,201,15,2017,0,6,2195,0
Cleveland,27,33,23,23,0,0,0,0,Washington,23,37,23,16,0,0,0,0,20171217,106,99,4,0,0,7,7,205,-7,2017,0,6,304,0
LA Clippers,17,32,21,21,0,0,0,0,San Antonio,31,26,28,24,0,0,0,0,20171218,91,109,14,8,15,18,18,200,18,2017,0,0,1201,0
Denver,18,26,32,18,0,0,0,0,Oklahoma City,32,20,18,25,0,0,0,0,20171218,94,95,14,8,-6,1,1,189,1,2017,0,0,503,0
Portland,24,30,31,22,0,0,0,0,Minnesota,24,27,25,32,0,0,0,0,20171218,107,108,0,-3,-9,1,1,215,1,2017,0,0,1423,0
Golden State,32,25,26,19,14,0,0,0,LA Lakers,24,29,29,20,12,0,0,0,20171218,116,114,8,4,1,0,2,230,-2,2017,1,0,347,0
Boston,38,24,23,27,0,0,0,0,Indiana,21,26,31,33,0,0,0,0,20171218,112,111,17,15,7,1,1,223,-1,2017,0,0,805,0
Phoenix,25,24,19,29,0,0,0,0,Dallas,22,28,25,16,0,0,0,0,20171218,97,91,3,-1,-7,6,6,188,-6,2017,0,0,884,0
New York,23,19,22,27,0,0,0,0,Charlotte,29,31,28,21,0,0,0,0,20171218,91,109,6,18,24,18,18,200,18,2017,0,0,531,0
Philadelphia,25,34,28,28,0,0,0,0,Chicago,30,37,22,28,0,0,0,0,20171218,115,117,5,8,2,2,2,232,2,2017,0,0,664,0
Miami,30,27,19,28,0,0,0,0,Atlanta,29,29,29,23,0,0,0,0,20171218,104,110,-1,1,11,6,6,214,6,2017,0,0,605,0
Utah,26,24,34,15,0,0,0,0,Houston,25,26,28,41,0,0,0,0,20171218,99,120,-1,1,-5,21,21,219,21,2017,0,0,1199,0
Cleveland,34,24,25,33,0,0,0,0,Milwaukee,30,39,29,21,0,0,0,0,20171219,116,119,-4,11,15,3,3,235,3,2017,0,1,334,0
Sacramento,30,18,23,30,0,0,0,0,Philadelphia,27,30,21,17,0,0,0,0,20171219,101,95,3,-9,-7,6,6,196,-6,2017,0,1,2451,0
New Orleans,19,36,15,36,0,0,0,0,Washington,36,25,32,23,0,0,0,0,20171219,106,116,17,6,23,10,10,222,10,2017,0,1,964,0
Memphis,28,23,14,19,0,0,0,0,Golden State,24,32,18,23,0,0,0,0,20171220,84,97,-4,5,9,13,13,181,13,2017,0,2,1798,0
San Antonio,25,29,20,19,0,0,0,0,Portland,22,24,26,19,0,0,0,0,20171220,93,91,3,8,2,2,2,184,-2,2017,0,2,1718,0
Utah,9,28,23,19,0,0,0,0,Oklahoma City,25,28,34,20,0,0,0,0,20171220,79,107,16,16,27,28,28,186,28,2017,0,2,861,0
Phoenix,15,20,31,29,0,0,0,0,LA Clippers,23,30,28,27,0,0,0,0,20171220,95,108,8,18,15,13,13,203,13,2017,0,2,356,0
LA Lakers,37,26,31,28,0,0,0,0,Houston,22,37,30,27,0,0,0,0,20171220,122,116,15,4,5,6,6,238,-6,2017,0,2,1371,0
Minnesota,17,33,30,32,0,0,0,0,Denver,24,28,32,20,0,0,0,0,20171220,112,104,-7,-2,-4,8,8,216,-8,2017,0,2,698,0
Detroit,25,28,13,27,0,0,0,0,Dallas,22,43,24,21,0,0,0,0,20171220,93,110,-3,12,23,17,17,203,17,2017,0,2,999,0
Toronto,22,41,36,30,0,0,0,0,Charlotte,26,21,32,32,0,0,0,0,20171220,129,111,-4,16,20,18,18,240,-18,2017,0,2,585,0
Orlando,24,24,18,28,0,0,0,0,Chicago,31,28,31,22,0,0,0,0,20171220,94,112,7,11,24,18,18,206,18,2017,0,2,984,0
Sacramento,36,28,22,18,0,0,0,0,Brooklyn,20,28,27,24,0,0,0,0,20171220,104,99,16,16,11,5,5,203,-5,2017,0,2,2499,0
Miami,15,21,26,28,0,0,0,0,Boston,24,20,15,30,0,0,0,0,20171220,90,89,-9,-8,3,1,1,179,-1,2017,0,2,1257,0
Indiana,28,25,25,27,0,0,0,0,Atlanta,27,24,20,24,0,0,0,0,20171220,105,95,1,2,7,10,10,200,-10,2017,0,2,427,0
Chicago,27,29,23,33,0,0,0,0,Cleveland,29,29,24,33,0,0,0,0,20171221,112,115,2,2,3,3,3,227,3,2017,0,3,308,0
Boston,15,25,28,25,0,0,0,0,New York,25,19,24,34,0,0,0,0,20171221,93,102,10,4,0,9,9,195,9,2017,0,3,190,0
Toronto,30,22,34,28,0,0,0,0,Philadelphia,31,34,23,21,0,0,0,0,20171221,114,109,-1,-13,-2,5,5,223,-5,2017,0,3,334,0
Memphis,25,26,30,14,0,0,0,0,Phoenix,26,34,19,18,0,0,0,0,20171221,95,97,1,9,-2,2,2,192,2,2017,0,3,1260,0
San Antonio,17,21,32,19,0,0,0,0,Utah,24,26,22,28,0,0,0,0,20171221,89,100,7,12,2,11,11,189,11,2017,0,3,1087,0
Denver,28,24,28,22,0,0,0,0,Portland,22,19,25,19,0,0,0,0,20171222,102,85,6,11,14,17,17,187,-17,2017,0,4,981,0
New Orleans,32,28,28,23,0,0,0,0,Orlando,20,30,22,25,0,0,0,0,20171222,111,97,12,10,16,14,14,208,-14,2017,0,4,533,0
Atlanta,28,22,31,36,0,0,0,0,Oklahoma City,28,36,18,38,0,0,0,0,20171222,117,120,0,14,1,3,3,237,3,2017,0,4,755,0
Charlotte,23,36,26,19,0,0,0,0,Milwaukee,26,26,31,26,0,0,0,0,20171222,104,109,3,-7,-2,5,5,213,5,2017,0,4,658,0
LA Lakers,24,20,28,34,0,0,0,0,Golden State,27,34,23,29,0,0,0,0,20171222,106,113,3,17,12,7,7,219,7,2017,0,4,347,0
LA Clippers,23,29,35,41,0,0,0,0,Houston,33,32,20,33,0,0,0,0,20171222,128,118,-10,-13,2,10,10,246,-10,2017,0,4,1371,0
New York,21,23,31,26,0,0,0,0,Detroit,25,27,22,30,0,0,0,0,20171222,101,104,4,8,-1,3,3,205,3,2017,0,4,480,0
Washington,23,20,18,23,0,0,0,0,Brooklyn,26,27,35,31,0,0,0,0,20171222,84,119,3,10,27,35,35,203,35,2017,0,4,204,0
Dallas,23,30,20,28,0,0,0,0,Miami,32,21,29,31,0,0,0,0,20171222,101,113,9,0,9,12,12,214,12,2017,0,4,1110,0
New Orleans,27,29,27,26,0,0,0,0,Miami,28,25,16,25,0,0,0,0,20171223,109,94,-1,3,14,15,15,203,-15,2017,0,5,668,0
Oklahoma City,28,19,29,27,0,0,0,0,Utah,22,21,21,25,0,0,0,0,20171223,103,89,6,4,12,14,14,192,-14,2017,0,5,861,0
Orlando,29,19,35,20,0,0,0,0,Washington,37,35,28,30,0,0,0,0,20171223,103,130,8,24,17,27,27,233,27,2017,0,5,757,0
San Antonio,33,29,22,24,0,0,0,0,Sacramento,33,16,27,23,0,0,0,0,20171223,108,99,0,13,8,9,9,207,-9,2017,0,5,1456,0
Minnesota,33,31,22,29,0,0,0,0,Phoenix,24,19,37,26,0,0,0,0,20171223,115,106,9,21,6,9,9,221,-9,2017,0,5,1278,0
LA Clippers,33,26,22,31,0,0,0,0,Memphis,30,33,27,25,0,0,0,0,20171223,112,115,-3,4,9,3,3,227,3,2017,0,5,1599,0
Philadelphia,27,19,17,23,0,0,0,0,Toronto,27,28,26,21,0,0,0,0,20171223,86,102,0,9,18,16,16,188,16,2017,0,5,334,0
Brooklyn,28,29,24,30,8,0,0,0,Indiana,21,20,39,31,12,0,0,0,20171223,119,123,-7,-16,-1,0,4,242,4,2017,1,5,643,0
Denver,22,31,20,23,0,0,0,0,Golden State,20,21,21,19,0,0,0,0,20171223,96,81,2,12,11,15,15,177,-15,2017,0,5,947,0
Milwaukee,23,31,31,21,0,0,0,0,Charlotte,24,29,28,30,0,0,0,0,20171223,106,111,1,-1,-4,5,5,217,5,2017,0,5,658,0
Chicago,31,27,18,16,0,0,0,0,Boston,33,27,38,19,0,0,0,0,20171223,92,117,2,2,22,25,25,209,25,2017,0,5,849,0
Dallas,25,28,27,27,0,0,0,0,Atlanta,25,23,31,33,0,0,0,0,20171223,107,112,0,-5,-1,5,5,219,5,2017,0,5,719,0
Portland,17,27,26,25,0,0,0,0,LA Lakers,24,25,21,22,0,0,0,0,20171223,95,92,-7,-5,0,3,3,187,-3,2017,0,5,826,0
Washington,30,22,28,31,0,0,0,0,Boston,24,26,26,27,0,0,0,0,20171225,111,103,6,2,4,8,8,214,-8,2017,0,0,394,0
Cleveland,28,16,23,25,0,0,0,0,Golden State,24,22,25,28,0,0,0,0,20171225,92,99,-4,2,4,7,7,191,7,2017,0,0,2161,0
Minnesota,29,24,30,38,0,0,0,0,LA Lakers,20,32,28,24,0,0,0,0,20171225,121,104,9,1,3,17,17,225,-17,2017,0,0,1521,0
Philadelphia,21,29,29,26,0,0,0,0,New York,24,24,27,23,0,0,0,0,20171225,105,98,-3,2,4,7,7,203,-7,2017,0,0,80,0
Houston,31,26,31,19,0,0,0,0,Oklahoma City,28,30,30,24,0,0,0,0,20171225,107,112,-3,1,0,5,5,219,5,2017,0,0,413,0
Brooklyn,16,28,25,28,0,0,0,0,San Antonio,19,31,30,29,0,0,0,0,20171226,97,109,3,6,11,12,12,206,12,2017,0,1,1581,0
Memphis,19,34,23,21,0,0,0,0,Phoenix,29,28,19,23,0,0,0,0,20171226,97,99,10,4,0,2,2,196,2,2017,0,1,1260,0
Chicago,22,34,27,32,0,0,0,0,Milwaukee,31,22,30,23,0,0,0,0,20171226,115,106,-9,3,0,9,9,221,-9,2017,0,1,83,0
Orlando,18,31,19,21,0,0,0,0,Miami,21,22,25,39,0,0,0,0,20171226,89,107,3,-6,0,18,18,196,18,2017,0,1,204,0
Toronto,23,30,24,16,0,0,0,0,Dallas,31,26,28,13,0,0,0,0,20171226,93,98,8,4,8,5,5,191,5,2017,0,1,1201,0
Indiana,19,26,21,17,0,0,0,0,Detroit,40,18,24,25,0,0,0,0,20171226,83,107,21,13,16,24,24,190,24,2017,0,1,240,0
Utah,20,14,25,24,0,0,0,0,Denver,28,22,26,31,0,0,0,0,20171226,83,107,8,16,17,24,24,190,24,2017,0,1,370,0
Sacramento,30,23,20,22,0,0,0,0,LA Clippers,30,41,24,27,0,0,0,0,20171226,95,122,0,18,22,27,27,217,27,2017,0,1,361,0
Denver,23,35,24,32,11,0,0,0,Minnesota,35,36,17,26,14,0,0,0,20171227,125,128,12,13,6,0,3,253,3,2017,1,2,698,0
Cleveland,27,28,25,15,0,0,0,0,Sacramento,28,34,23,24,0,0,0,0,20171227,95,109,1,7,5,14,14,204,14,2017,0,2,2096,0
Toronto,38,25,25,19,0,0,0,0,Oklahoma City,32,34,36,22,0,0,0,0,20171227,107,124,-6,3,14,17,17,231,17,2017,0,2,1114,0
Memphis,24,30,22,33,0,0,0,0,LA Lakers,18,29,29,23,0,0,0,0,20171227,109,99,6,7,0,10,10,208,-10,2017,0,2,1599,0
Brooklyn,23,23,29,38,0,0,0,0,New Orleans,31,38,22,37,0,0,0,0,20171227,113,128,8,23,16,15,15,241,15,2017,0,2,1168,0
Utah,24,23,22,32,0,0,0,0,Golden State,23,25,42,36,0,0,0,0,20171227,101,126,-1,1,21,25,25,227,25,2017,0,2,599,0
Boston,28,32,16,26,0,0,0,0,Charlotte,16,28,31,16,0,0,0,0,20171227,102,91,12,16,1,11,11,193,-11,2017,0,2,720,0
New York,28,24,21,14,0,0,0,0,Chicago,17,32,22,21,0,0,0,0,20171227,87,92,-11,-3,-2,5,5,179,5,2017,0,2,711,0
Washington,29,28,19,23,0,0,0,0,Atlanta,29,26,23,35,0,0,0,0,20171227,99,113,0,-2,2,14,14,212,14,2017,0,2,541,0
Dallas,22,31,18,27,0,0,0,0,Indiana,29,25,20,20,0,0,0,0,20171227,98,94,-7,-1,-3,4,4,192,-4,2017,0,2,763,0
Houston,32,30,16,20,0,0,0,0,Boston,12,26,31,30,0,0,0,0,20171228,98,99,-20,-24,-9,1,1,197,1,2017,0,3,1603,0
Minnesota,26,30,28,12,0,0,0,0,Milwaukee,16,30,29,27,0,0,0,0,20171228,96,102,-10,-10,-9,6,6,198,6,2017,0,3,298,0
Detroit,28,22,23,16,0,0,0,0,Orlando,33,17,27,25,0,0,0,0,20171228,89,102,5,0,4,13,13,191,13,2017,0,3,957,0
Philadelphia,30,21,34,25,0,0,0,0,Portland,27,25,20,42,0,0,0,0,20171228,110,114,-3,1,-13,4,4,224,4,2017,0,3,2405,0
New York,24,29,26,28,0,0,0,0,San Antonio,32,22,32,33,0,0,0,0,20171228,107,119,8,1,7,12,12,226,12,2017,0,3,1581,0
Houston,23,25,30,25,0,0,0,0,Washington,27,32,28,34,0,0,0,0,20171229,103,121,4,11,9,18,18,224,18,2017,0,4,1217,0
Atlanta,22,25,22,29,0,0,0,0,Toronto,30,32,26,23,0,0,0,0,20171229,98,111,8,15,19,13,13,209,13,2017,0,4,733,0
Phoenix,35,20,33,23,0,0,0,0,Sacramento,25,21,37,18,0,0,0,0,20171229,111,101,10,9,5,10,10,212,-10,2017,0,4,634,0
Milwaukee,38,20,15,24,0,0,0,0,Oklahoma City,18,26,23,28,0,0,0,0,20171229,97,95,20,14,6,2,2,192,-2,2017,0,4,732,0
Dallas,36,41,32,19,0,0,0,0,New Orleans,21,39,41,19,0,0,0,0,20171229,128,120,15,17,8,8,8,248,-8,2017,0,4,442,0
LA Clippers,35,27,29,30,0,0,0,0,LA Lakers,22,26,28,30,0,0,0,0,20171229,121,106,13,14,15,15,15,227,-15,2017,0,4,0,0
Charlotte,32,21,26,32,0,0,0,0,Golden State,29,24,22,25,0,0,0,0,20171229,111,100,3,0,4,11,11,211,-11,2017,0,4,2296,0
Indiana,27,25,25,30,0,0,0,0,Chicago,37,27,22,33,0,0,0,0,20171229,107,119,10,12,9,12,12,226,12,2017,0,4,163,0
Brooklyn,24,35,36,16,0,0,0,0,Miami,20,19,21,27,0,0,0,0,20171229,111,87,4,20,35,24,24,198,-24,2017,0,4,1091,0
Portland,23,29,17,20,0,0,0,0,Atlanta,24,22,26,32,0,0,0,0,20171230,89,104,1,-6,3,15,15,193,15,2017,0,5,2168,0
Philadelphia,31,27,25,24,0,0,0,0,Denver,29,32,19,22,0,0,0,0,20171230,107,102,2,-3,3,5,5,209,-5,2017,0,5,1574,0
San Antonio,13,23,21,22,0,0,0,0,Detroit,24,15,24,30,0,0,0,0,20171230,79,93,11,3,6,14,14,172,14,2017,0,5,1238,0
Memphis,38,29,31,30,0,0,0,0,Golden State,40,38,38,25,0,0,0,0,20171230,128,141,2,11,18,13,13,269,13,2017,0,5,1798,0
New York,28,28,23,26,0,0,0,0,New Orleans,21,24,33,25,0,0,0,0,20171230,105,103,7,11,1,2,2,208,-2,2017,0,5,1168,0
Miami,21,29,36,31,0,0,0,0,Orlando,32,34,26,19,0,0,0,0,20171230,117,111,-11,-16,-6,6,6,228,-6,2017,0,5,204,0
Cleveland,32,21,16,32,0,0,0,0,Utah,22,26,28,28,0,0,0,0,20171230,101,104,-10,-5,7,3,3,205,3,2017,0,5,1564,0
Philadelphia,38,25,29,31,0,0,0,0,Phoenix,32,17,40,21,0,0,0,0,20171231,123,110,6,14,3,13,13,233,-13,2017,0,6,2078,0
Chicago,38,25,26,21,0,0,0,0,Washington,30,29,24,31,0,0,0,0,20171231,110,114,-8,-4,-6,4,4,224,4,2017,0,6,594,0
Dallas,35,22,27,32,0,0,0,0,Oklahoma City,32,31,22,28,0,0,0,0,20171231,116,113,3,-6,-1,3,3,229,-3,2017,0,6,189,0
Memphis,36,28,26,24,0,0,0,0,Sacramento,22,24,17,33,0,0,0,0,20171231,114,96,14,18,27,18,18,210,-18,2017,0,6,1745,0
Minnesota,23,26,38,20,0,0,0,0,Indiana,13,25,20,32,0,0,0,0,20171231,107,90,10,11,29,17,17,197,-17,2017,0,6,510,0
LA Lakers,37,35,29,21,11,9,0,0,Houston,44,21,25,32,11,15,0,0,20171231,142,148,7,-7,-11,0,6,290,6,2017,2,6,1371,0
Brooklyn,28,31,17,29,0,0,0,0,Boston,38,23,21,26,0,0,0,0,20171231,105,108,10,2,6,3,3,213,3,2017,0,6,190,0
Charlotte,22,30,14,32,0,0,0,0,LA Clippers,29,13,33,31,0,0,0,0,20171231,98,106,7,-10,9,8,8,204,8,2017,0,6,2115,0
Orlando,27,21,22,25,0,0,0,0,Brooklyn,22,25,24,27,0,0,0,0,20180101,95,98,-5,-1,1,3,3,193,3,2017,0,0,939,0
Portland,31,21,31,29,12,0,0,0,Chicago,23,30,34,25,8,0,0,0,20180101,124,120,8,-1,-4,0,4,244,-4,2017,1,0,1754,0
LA Lakers,18,30,28,20,0,0,0,0,Minnesota,30,30,31,23,0,0,0,0,20180101,96,114,12,12,15,18,18,210,18,2017,0,0,1521,0
Milwaukee,30,26,28,30,13,0,0,0,Toronto,35,25,28,26,17,0,0,0,20180101,127,131,5,4,4,0,4,258,4,2017,1,0,429,0
Charlotte,32,40,28,31,0,0,0,0,Sacramento,25,27,29,30,0,0,0,0,20180102,131,111,7,20,19,20,20,242,-20,2017,0,1,2239,0
Atlanta,27,21,32,23,0,0,0,0,Phoenix,19,30,24,31,0,0,0,0,20180102,103,104,-8,1,-7,1,1,207,1,2017,0,1,1588,0
Memphis,31,31,22,21,0,0,0,0,LA Clippers,34,33,19,27,0,0,0,0,20180102,105,113,3,5,2,8,8,218,8,2017,0,1,1599,0
Portland,28,28,31,23,0,0,0,0,Cleveland,28,25,38,36,0,0,0,0,20180102,110,127,0,-3,4,17,17,237,17,2017,0,1,2049,0
San Antonio,25,27,29,19,0,0,0,0,New York,29,20,18,24,0,0,0,0,20180102,100,91,-4,3,14,9,9,191,-9,2017,0,1,1581,0
Indiana,26,26,24,25,0,0,0,0,Milwaukee,34,28,31,29,0,0,0,0,20180103,101,122,8,10,17,21,21,223,21,2017,0,2,243,0
New York,32,31,14,26,0,0,0,0,Washington,33,31,26,31,0,0,0,0,20180103,103,121,1,1,13,18,18,224,18,2017,0,2,204,0
New Orleans,27,31,23,27,0,0,0,0,Utah,28,27,17,26,0,0,0,0,20180103,108,98,-1,3,9,10,10,206,-10,2017,0,2,1432,0
San Antonio,22,27,35,22,0,0,0,0,Philadelphia,27,33,28,24,0,0,0,0,20180103,106,112,5,11,4,6,6,218,6,2017,0,2,1505,0
Houston,25,30,34,27,0,0,0,0,Orlando,12,29,25,32,0,0,0,0,20180103,116,98,13,14,23,18,18,214,-18,2017,0,2,847,0
Detroit,29,23,29,23,0,0,0,0,Miami,24,32,25,30,0,0,0,0,20180103,104,111,-5,4,0,7,7,215,7,2017,0,2,1155,0
Toronto,21,35,34,34,0,0,0,0,Chicago,31,28,31,25,0,0,0,0,20180103,124,115,-10,-3,0,9,9,239,-9,2017,0,2,436,0
Phoenix,26,41,18,26,0,0,0,0,Denver,34,27,37,36,0,0,0,0,20180103,111,134,8,-6,13,23,23,245,23,2017,0,2,585,0
Golden State,35,32,24,34,0,0,0,0,Dallas,26,35,28,33,0,0,0,0,20180103,125,122,9,6,2,3,3,247,-3,2017,0,2,1480,0
Minnesota,22,21,30,24,0,0,0,0,Brooklyn,24,24,23,27,0,0,0,0,20180103,97,98,2,5,-2,1,1,195,1,2017,0,2,1016,0
Cleveland,21,26,21,20,0,0,0,0,Boston,32,23,26,21,0,0,0,0,20180103,88,102,11,8,13,14,14,190,14,2017,0,2,549,0
Oklahoma City,26,37,33,37,0,0,0,0,LA Lakers,26,18,26,26,0,0,0,0,20180103,133,96,0,19,26,37,37,229,-37,2017,0,2,1178,0
Golden State,33,29,31,31,0,0,0,0,Houston,37,26,27,24,0,0,0,0,20180104,124,114,-4,-1,3,10,10,238,-10,2017,0,3,1642,0
Oklahoma City,30,34,30,33,0,0,0,0,LA Clippers,33,31,33,20,0,0,0,0,20180104,127,117,-3,0,-3,10,10,244,-10,2017,0,3,1178,0
Toronto,33,28,43,25,0,0,0,0,Milwaukee,24,35,19,32,0,0,0,0,20180105,129,110,9,2,26,19,19,239,-19,2017,0,4,429,0
Atlanta,22,24,22,21,0,0,0,0,Portland,30,22,30,28,0,0,0,0,20180105,89,110,8,6,14,21,21,199,21,2017,0,4,2168,0
Detroit,15,17,29,17,0,0,0,0,Philadelphia,32,30,35,17,0,0,0,0,20180105,78,114,17,30,36,36,36,192,36,2017,0,4,441,0
Phoenix,26,16,30,17,0,0,0,0,San Antonio,26,23,31,23,0,0,0,0,20180105,89,103,0,7,8,14,14,192,14,2017,0,4,846,0
New York,25,20,26,26,6,0,0,0,Miami,26,25,24,22,10,0,0,0,20180105,103,107,1,6,4,0,4,210,4,2017,1,4,1091,0
Utah,26,23,16,26,0,0,0,0,Denver,23,23,38,15,0,0,0,0,20180105,91,99,-3,-3,19,8,8,190,8,2017,0,4,370,0
Charlotte,28,35,30,15,0,0,0,0,LA Lakers,24,24,28,18,0,0,0,0,20180105,108,94,4,15,17,14,14,202,-14,2017,0,4,2115,0
Chicago,34,23,23,47,0,0,0,0,Dallas,28,25,35,36,0,0,0,0,20180105,127,124,6,4,-8,3,3,251,-3,2017,0,4,802,0
Minnesota,19,19,24,22,0,0,0,0,Boston,19,22,25,25,0,0,0,0,20180105,84,91,0,3,4,7,7,175,7,2017,0,4,1120,0
Washington,33,25,29,15,0,0,0,0,Memphis,24,26,22,28,0,0,0,0,20180105,102,100,9,8,15,2,2,202,-2,2017,0,4,762,0
Boston,16,23,25,23,0,0,0,0,Brooklyn,22,19,20,24,0,0,0,0,20180106,87,85,-6,-2,3,2,2,172,-2,2017,0,5,190,0
Houston,37,21,19,24,0,0,0,0,Detroit,31,26,31,20,0,0,0,0,20180106,101,108,-6,-1,11,7,7,209,7,2017,0,5,1105,0
Chicago,26,11,30,19,0,0,0,0,Indiana,31,33,37,24,0,0,0,0,20180106,86,125,5,27,34,39,39,211,39,2017,0,5,163,0
Golden State,31,33,39,18,0,0,0,0,LA Clippers,28,27,21,29,0,0,0,0,20180106,121,105,3,9,27,16,16,226,-16,2017,0,5,347,0
New Orleans,24,24,23,27,0,0,0,0,Minnesota,36,33,29,18,0,0,0,0,20180106,98,116,12,21,27,18,18,214,18,2017,0,5,1052,0
Cleveland,31,36,40,24,0,0,0,0,Orlando,30,34,23,40,0,0,0,0,20180106,131,127,1,3,20,4,4,258,-4,2017,0,5,895,0
Denver,27,14,30,27,0,0,0,0,Sacramento,29,17,33,27,0,0,0,0,20180106,98,106,2,5,8,8,8,204,8,2017,0,5,886,0
Milwaukee,24,29,29,28,0,0,0,0,Washington,32,21,32,18,0,0,0,0,20180106,110,103,-8,0,-3,7,7,213,-7,2017,0,5,634,0
San Antonio,27,26,27,30,0,0,0,0,Portland,27,21,32,31,0,0,0,0,20180107,110,111,0,-5,0,1,1,221,1,2017,0,6,1718,0
Oklahoma City,23,30,29,18,0,0,0,0,Phoenix,28,34,28,24,0,0,0,0,20180107,100,114,5,9,8,14,14,214,14,2017,0,6,840,0
Atlanta,27,21,32,33,0,0,0,0,LA Lakers,29,37,30,36,0,0,0,0,20180107,113,132,2,18,16,19,19,245,19,2017,0,6,1932,0
New York,33,23,19,25,0,0,0,0,Dallas,25,27,19,25,0,0,0,0,20180107,100,96,8,4,4,4,4,196,-4,2017,0,6,1370,0
Utah,22,25,28,27,0,0,0,0,Miami,27,22,25,29,0,0,0,0,20180107,102,103,5,2,-1,1,1,205,1,2017,0,6,2086,0
Toronto,26,19,33,29,7,0,0,0,Brooklyn,19,25,27,36,6,0,0,0,20180108,114,113,7,1,7,0,1,227,-1,2017,1,0,341,0
Houston,35,25,27,29,0,0,0,0,Chicago,22,33,21,31,0,0,0,0,20180108,116,107,13,5,11,9,9,223,-9,2017,0,0,939,0
Denver,28,29,24,33,0,0,0,0,Golden State,37,27,29,31,0,0,0,0,20180108,114,124,9,7,12,10,10,238,10,2017,0,0,947,0
Milwaukee,16,22,27,31,0,0,0,0,Indiana,37,27,24,21,0,0,0,0,20180108,96,109,21,26,23,13,13,205,13,2017,0,0,243,0
Atlanta,25,22,30,30,0,0,0,0,LA Clippers,32,26,22,28,0,0,0,0,20180108,107,108,7,11,3,1,1,215,1,2017,0,0,1932,0
Cleveland,18,24,25,32,0,0,0,0,Minnesota,32,37,33,25,0,0,0,0,20180108,99,127,14,27,35,28,28,226,28,2017,0,0,629,0
Detroit,34,22,28,25,0,0,0,0,New Orleans,37,22,27,26,0,0,0,0,20180108,109,112,3,3,2,3,3,221,3,2017,0,0,939,0
San Antonio,21,25,27,34,0,0,0,0,Sacramento,25,31,20,24,0,0,0,0,20180108,107,100,-4,-10,-3,7,7,207,-7,2017,0,0,1456,0
Miami,22,29,21,18,0,0,0,0,Toronto,21,20,23,25,0,0,0,0,20180109,90,89,1,10,8,1,1,179,-1,2017,0,1,1234,0
Portland,24,30,34,29,0,0,0,0,Oklahoma City,26,24,26,30,0,0,0,0,20180109,117,106,-2,4,12,11,11,223,-11,2017,0,1,1484,0
Orlando,19,29,27,24,0,0,0,0,Dallas,25,18,39,32,0,0,0,0,20180109,99,114,6,-5,7,15,15,213,15,2017,0,1,961,0
Sacramento,27,25,22,12,0,0,0,0,LA Lakers,31,22,31,15,0,0,0,0,20180109,86,99,4,1,10,13,13,185,13,2017,0,1,361,0
Detroit,34,29,27,24,0,0,0,0,Brooklyn,26,15,20,19,0,0,0,0,20180110,114,80,8,22,29,34,34,194,-34,2017,0,2,480,0
Dallas,20,39,24,32,0,0,0,0,Charlotte,28,24,25,34,0,0,0,0,20180110,115,111,-8,7,6,4,4,226,-4,2017,0,2,928,0
Atlanta,29,25,28,28,0,0,0,0,Denver,21,25,32,19,0,0,0,0,20180110,110,97,8,8,4,13,13,207,-13,2017,0,2,1209,0
LA Clippers,32,26,39,28,0,0,0,0,Golden State,35,27,28,16,0,0,0,0,20180110,125,106,-3,-4,7,19,19,231,-19,2017,0,2,347,0
Portland,19,26,32,35,0,0,0,0,Houston,25,30,31,35,0,0,0,0,20180110,112,121,6,10,9,9,9,233,9,2017,0,2,1833,0
Miami,38,20,26,30,0,0,0,0,Indiana,26,21,31,28,0,0,0,0,20180110,114,106,12,11,6,8,8,220,-8,2017,0,2,1026,0
New Orleans,38,23,9,32,0,0,0,0,Memphis,29,31,17,28,0,0,0,0,20180110,102,105,-9,-1,7,3,3,207,3,2017,0,2,358,0
Orlando,29,17,23,34,0,0,0,0,Milwaukee,30,23,36,21,0,0,0,0,20180110,103,110,1,7,20,7,7,213,7,2017,0,2,1065,0
Oklahoma City,23,24,18,23,0,0,0,0,Minnesota,23,24,29,28,0,0,0,0,20180110,88,104,0,0,11,16,16,192,16,2017,0,2,694,0
Chicago,26,22,30,27,7,10,0,0,New York,25,27,30,23,7,7,0,0,20180110,122,119,1,-4,-4,0,3,241,-3,2017,2,2,711,0
Utah,25,21,37,24,0,0,0,0,Washington,32,18,27,27,0,0,0,0,20180110,107,104,-7,-4,6,3,3,211,-3,2017,0,2,1841,0
Cleveland,24,16,32,27,0,0,0,0,Toronto,30,35,35,33,0,0,0,0,20180111,99,133,6,25,28,34,34,232,34,2017,0,3,187,0
LA Clippers,29,43,28,21,0,0,0,0,Sacramento,21,39,29,26,0,0,0,0,20180111,121,115,8,12,11,6,6,236,-6,2017,0,3,361,0
Boston,23,25,37,29,0,0,0,0,Philadelphia,28,29,22,24,0,0,0,0,20180111,114,103,-5,-9,6,11,11,217,-11,2017,0,3,270,0
San Antonio,15,23,24,19,0,0,0,0,LA Lakers,20,29,19,25,0,0,0,0,20180111,81,93,5,11,6,12,12,174,12,2017,0,3,1201,0
Brooklyn,25,28,21,36,0,0,0,0,Atlanta,25,25,24,31,0,0,0,0,20180112,110,105,0,3,0,5,5,215,-5,2017,0,4,745,0
Utah,25,21,26,16,0,0,0,0,Charlotte,25,27,22,25,0,0,0,0,20180112,88,99,0,6,2,11,11,187,11,2017,0,4,1723,0
Memphis,26,21,13,18,0,0,0,0,Denver,16,27,24,20,0,0,0,0,20180112,78,87,-10,-4,7,9,9,165,9,2017,0,4,877,0
Cleveland,34,24,16,21,0,0,0,0,Indiana,12,32,32,21,0,0,0,0,20180112,95,97,-22,-14,2,2,2,192,2,2017,0,4,262,0
Golden State,36,27,17,28,0,0,0,0,Milwaukee,27,22,33,12,0,0,0,0,20180112,108,94,9,14,-2,14,14,202,-14,2017,0,4,1838,0
New York,27,30,29,22,0,0,0,0,Minnesota,24,31,32,31,0,0,0,0,20180112,108,118,-3,-2,1,10,10,226,10,2017,0,4,1016,0
Portland,25,36,25,27,0,0,0,0,New Orleans,31,30,27,31,0,0,0,0,20180112,113,119,6,0,2,6,6,232,6,2017,0,4,2059,0
Houston,27,30,33,22,0,0,0,0,Phoenix,23,21,24,27,0,0,0,0,20180112,112,95,4,13,22,17,17,207,-17,2017,0,4,1014,0
Orlando,33,30,35,21,0,0,0,0,Washington,34,31,33,27,0,0,0,0,20180112,119,125,1,2,0,6,6,244,6,2017,0,4,757,0
Brooklyn,18,21,35,33,6,0,0,0,Washington,33,26,24,24,12,0,0,0,20180113,113,119,15,20,9,0,6,232,6,2017,1,5,204,0
Golden State,43,38,27,19,0,0,0,0,Toronto,35,19,35,36,0,0,0,0,20180113,127,125,8,27,19,2,2,252,-2,2017,0,5,2263,0
Denver,16,28,25,11,0,0,0,0,San Antonio,32,24,26,30,0,0,0,0,20180113,80,112,16,12,13,32,32,192,32,2017,0,5,802,0
LA Lakers,31,15,24,25,12,0,0,0,Dallas,20,32,21,22,6,0,0,0,20180113,107,101,11,-6,-3,0,6,208,-6,2017,1,5,1237,0
Oklahoma City,31,24,18,28,0,0,0,0,Charlotte,28,31,17,15,0,0,0,0,20180113,101,91,3,-4,-3,10,10,192,-10,2017,0,5,938,0
Detroit,31,30,23,21,0,0,0,0,Chicago,36,24,27,20,0,0,0,0,20180113,105,107,5,-1,3,2,2,212,2,2017,0,5,238,0
Sacramento,17,28,23,37,0,0,0,0,LA Clippers,30,34,27,35,0,0,0,0,20180113,105,126,13,19,23,21,21,231,21,2017,0,5,361,0
Milwaukee,23,20,16,20,0,0,0,0,Miami,21,20,30,26,0,0,0,0,20180114,79,97,-2,-2,12,18,18,176,18,2017,0,6,1269,0
Portland,33,10,31,29,0,0,0,0,Minnesota,31,26,34,29,0,0,0,0,20180114,103,120,-2,14,17,17,17,223,17,2017,0,6,1423,0
New Orleans,13,35,34,27,14,0,0,0,New York,29,28,39,13,9,0,0,0,20180114,123,118,-16,-9,-14,0,5,241,-5,2017,1,6,1168,0
Indiana,30,34,32,24,0,0,0,0,Phoenix,16,28,22,31,0,0,0,0,20180114,120,97,14,20,30,23,23,217,-23,2017,0,6,1496,0
LA Lakers,27,23,27,37,0,0,0,0,Memphis,34,26,37,26,0,0,0,0,20180115,114,123,7,10,20,9,9,237,9,2017,0,0,1599,0
Milwaukee,28,25,25,26,0,0,0,0,Washington,30,21,21,23,0,0,0,0,20180115,104,95,-2,2,6,9,9,199,-9,2017,0,0,634,0
Indiana,31,27,27,24,0,0,0,0,Utah,21,26,18,29,0,0,0,0,20180115,109,94,10,11,20,15,15,203,-15,2017,0,0,1353,0
Toronto,23,26,26,36,0,0,0,0,Philadelphia,32,27,34,24,0,0,0,0,20180115,111,117,9,10,18,6,6,228,6,2017,0,0,334,0
Sacramento,24,28,16,20,0,0,0,0,Oklahoma City,20,26,31,18,0,0,0,0,20180115,88,95,-4,-6,9,7,7,183,7,2017,0,0,1336,0
Charlotte,27,23,34,34,0,0,0,0,Detroit,27,29,24,27,0,0,0,0,20180115,118,107,0,-6,4,11,11,225,-11,2017,0,0,504,0
Golden State,35,22,36,25,0,0,0,0,Cleveland,37,27,27,17,0,0,0,0,20180115,118,108,-2,-7,2,10,10,226,-10,2017,0,0,2161,0
Miami,25,23,24,39,0,0,0,0,Chicago,32,23,29,35,0,0,0,0,20180115,111,119,7,7,12,8,8,230,8,2017,0,0,1189,0
New York,26,26,31,36,0,0,0,0,Brooklyn,24,18,39,23,0,0,0,0,20180115,119,104,2,10,2,15,15,223,-15,2017,0,0,0,0
San Antonio,23,25,25,26,0,0,0,0,Atlanta,21,23,28,30,0,0,0,0,20180115,99,102,-2,-4,-1,3,3,201,3,2017,0,0,881,0
Houston,31,25,28,18,0,0,0,0,LA Clippers,30,29,33,21,0,0,0,0,20180115,102,113,-1,3,8,11,11,215,11,2017,0,0,1371,0
Phoenix,31,20,21,39,0,0,0,0,Portland,36,30,26,26,0,0,0,0,20180116,111,118,5,15,20,7,7,229,7,2017,0,1,1005,0
New Orleans,32,26,29,17,12,0,0,0,Boston,25,23,32,24,9,0,0,0,20180116,116,113,7,10,7,0,3,229,-3,2017,1,1,1358,0
Dallas,27,21,21,33,0,0,0,0,Denver,30,31,25,19,0,0,0,0,20180116,102,105,3,13,17,3,3,207,3,2017,0,1,661,0
Minnesota,25,23,27,27,0,0,0,0,Orlando,25,22,26,35,0,0,0,0,20180116,102,108,0,-1,-2,6,6,210,6,2017,0,1,1309,0
LA Lakers,25,29,18,18,0,0,0,0,Oklahoma City,33,27,33,21,0,0,0,0,20180117,90,114,8,6,21,24,24,204,24,2017,0,2,1178,0
Miami,30,22,26,28,0,0,0,0,Milwaukee,25,32,22,22,0,0,0,0,20180117,106,101,5,-5,-1,5,5,207,-5,2017,0,2,1269,0
Detroit,18,33,22,18,0,0,0,0,Toronto,31,23,19,23,0,0,0,0,20180117,91,96,13,3,0,5,5,187,5,2017,0,2,205,0
Utah,23,29,36,32,0,0,0,0,Sacramento,21,21,31,32,0,0,0,0,20180117,120,105,2,10,15,15,15,225,-15,2017,0,2,532,0
New York,31,22,20,26,0,0,0,0,Memphis,32,29,27,17,0,0,0,0,20180117,99,105,1,8,15,6,6,204,6,2017,0,2,953,0
Washington,36,25,18,30,0,0,0,0,Charlotte,38,39,25,31,0,0,0,0,20180117,109,133,2,16,23,24,24,242,24,2017,0,2,329,0
Denver,27,32,22,23,0,0,0,0,LA Clippers,29,21,30,29,0,0,0,0,20180117,104,109,2,-9,-1,5,5,213,5,2017,0,2,830,0
Golden State,38,25,32,24,0,0,0,0,Chicago,40,26,12,34,0,0,0,0,20180117,119,112,-2,-3,17,7,7,231,-7,2017,0,2,1853,0
San Antonio,31,20,25,24,0,0,0,0,Brooklyn,26,20,18,31,0,0,0,0,20180117,100,95,5,5,12,5,5,195,-5,2017,0,2,1581,0
New Orleans,32,28,10,23,0,0,0,0,Atlanta,25,20,26,23,0,0,0,0,20180117,93,94,-7,-15,1,1,1,187,1,2017,0,2,424,0
Philadelphia,21,18,32,18,0,0,0,0,Boston,19,13,21,27,0,0,0,0,20180118,89,80,2,7,18,9,9,169,-9,2017,0,3,270,0
Orlando,20,27,33,23,0,0,0,0,Cleveland,36,31,17,20,0,0,0,0,20180118,103,104,16,20,4,1,1,207,1,2017,0,3,895,0
Minnesota,17,33,20,28,0,0,0,0,Houston,26,37,26,27,0,0,0,0,20180118,98,116,9,13,19,18,18,214,18,2017,0,3,1057,0
Indiana,28,19,27,12,0,0,0,0,Portland,29,23,22,26,0,0,0,0,20180118,86,100,1,5,0,14,14,186,14,2017,0,3,1880,0
New York,22,27,36,32,0,0,0,0,Utah,25,30,23,37,0,0,0,0,20180119,117,115,-3,-6,7,2,2,232,-2,2017,0,4,1967,0
San Antonio,18,19,23,23,0,0,0,0,Toronto,17,27,19,23,0,0,0,0,20180119,83,86,-1,7,3,3,3,169,3,2017,0,4,1438,0
Indiana,25,14,27,20,0,0,0,0,LA Lakers,18,29,27,25,0,0,0,0,20180119,86,99,-7,8,8,13,13,185,13,2017,0,4,1805,0
Sacramento,17,23,19,29,0,0,0,0,Memphis,30,10,27,39,0,0,0,0,20180119,88,106,13,0,8,18,18,194,18,2017,0,4,1745,0
Phoenix,29,31,25,23,0,0,0,0,Denver,31,19,23,27,0,0,0,0,20180119,108,100,-2,10,12,8,8,208,-8,2017,0,4,585,0
Miami,24,29,16,26,0,0,0,0,Brooklyn,21,22,24,34,0,0,0,0,20180119,95,101,-3,-10,-2,6,6,196,6,2017,0,4,1091,0
Washington,19,27,45,31,0,0,0,0,Detroit,29,17,28,38,0,0,0,0,20180119,122,112,-10,0,17,10,10,234,-10,2017,0,4,394,0
Chicago,29,26,22,36,0,0,0,0,Atlanta,21,17,25,34,0,0,0,0,20180120,113,97,8,17,14,16,16,210,-16,2017,0,5,587,0
Miami,31,26,16,33,0,0,0,0,Charlotte,27,21,35,22,0,0,0,0,20180120,106,105,4,9,-10,1,1,211,-1,2017,0,5,654,0
Oklahoma City,43,33,38,34,0,0,0,0,Cleveland,24,36,34,30,0,0,0,0,20180120,148,124,19,16,20,24,24,272,-24,2017,0,5,949,0
Golden State,28,30,33,17,0,0,0,0,Houston,40,25,27,24,0,0,0,0,20180120,108,116,12,7,1,8,8,224,8,2017,0,5,1642,0
Toronto,28,34,21,26,0,0,0,0,Minnesota,26,28,33,28,0,0,0,0,20180120,109,115,-2,-8,4,6,6,224,6,2017,0,5,691,0
Memphis,18,26,37,23,0,0,0,0,New Orleans,34,25,24,28,0,0,0,0,20180120,104,111,16,15,2,7,7,215,7,2017,0,5,358,0
Milwaukee,29,26,25,14,0,0,0,0,Philadelphia,37,24,23,32,0,0,0,0,20180120,94,116,8,6,4,22,22,210,22,2017,0,5,692,0
Dallas,20,25,34,29,0,0,0,0,Portland,33,29,29,26,0,0,0,0,20180120,108,117,13,17,12,9,9,225,9,2017,0,5,1630,0
LA Clippers,29,30,28,26,0,0,0,0,Utah,39,37,28,21,0,0,0,0,20180120,113,125,10,17,17,12,12,238,12,2017,0,5,579,0
Indiana,22,24,25,23,0,0,0,0,San Antonio,23,20,16,27,0,0,0,0,20180121,94,86,-1,3,12,8,8,180,-8,2017,0,6,999,0
New York,29,34,26,18,0,0,0,0,LA Lakers,30,37,30,30,0,0,0,0,20180121,107,127,1,4,8,20,20,234,20,2017,0,6,2445,0
Brooklyn,30,23,24,24,0,0,0,0,Detroit,20,28,20,32,0,0,0,0,20180121,101,100,10,5,9,1,1,201,-1,2017,0,6,480,0
Orlando,28,30,32,13,0,0,0,0,Boston,29,30,12,24,0,0,0,0,20180121,103,95,-1,-1,19,8,8,198,-8,2017,0,6,1115,0
Utah,20,21,22,27,0,0,0,0,Atlanta,19,23,32,30,0,0,0,0,20180122,90,104,-1,1,11,14,14,194,14,2017,0,0,1580,0
Sacramento,33,22,20,32,0,0,0,0,Charlotte,35,32,25,20,0,0,0,0,20180122,107,112,2,12,17,5,5,219,5,2017,0,0,2239,0
Washington,22,15,17,21,0,0,0,0,Dallas,22,31,18,27,0,0,0,0,20180122,75,98,0,16,17,23,23,173,23,2017,0,0,1181,0
Portland,19,30,29,23,0,0,0,0,Denver,20,25,31,28,0,0,0,0,20180122,101,104,1,-4,-2,3,3,205,3,2017,0,0,981,0
Miami,33,17,18,22,0,0,0,0,Houston,25,21,25,28,0,0,0,0,20180122,90,99,-8,-4,3,9,9,189,9,2017,0,0,966,0
Minnesota,30,31,31,34,0,0,0,0,LA Clippers,26,31,33,28,0,0,0,0,20180122,126,118,4,4,2,8,8,244,-8,2017,0,0,1521,0
Philadelphia,30,25,28,18,0,0,0,0,Memphis,19,30,25,31,0,0,0,0,20180122,101,105,-11,-6,-9,4,4,206,4,2017,0,0,878,0
Phoenix,26,27,26,26,0,0,0,0,Milwaukee,30,23,23,33,0,0,0,0,20180122,105,109,4,0,-3,4,4,214,4,2017,0,0,1462,0
Chicago,21,27,33,33,8,6,0,0,New Orleans,25,29,27,33,8,10,0,0,20180122,128,132,4,6,0,0,4,260,4,2017,2,0,832,0
Cleveland,29,26,26,21,0,0,0,0,San Antonio,25,38,26,25,0,0,0,0,20180123,102,114,-4,8,8,12,12,216,12,2017,0,1,1256,0
Sacramento,28,24,25,28,0,0,0,0,Orlando,27,26,29,17,0,0,0,0,20180123,105,99,1,-1,-5,6,6,204,-6,2017,0,1,2390,0
Boston,21,32,21,33,0,0,0,0,LA Lakers,15,30,31,32,0,0,0,0,20180123,107,108,-6,-8,2,1,1,215,1,2017,0,1,2590,0
New York,31,29,26,26,0,0,0,0,Golden State,21,37,37,28,0,0,0,0,20180123,112,123,-10,-2,9,11,11,235,11,2017,0,1,2565,0
Brooklyn,26,33,26,23,0,0,0,0,Oklahoma City,30,17,27,35,0,0,0,0,20180123,108,109,4,-12,-11,1,1,217,1,2017,0,1,1324,0
Chicago,16,25,26,34,0,0,0,0,Philadelphia,25,30,30,30,0,0,0,0,20180124,101,115,9,14,18,14,14,216,14,2017,0,2,664,0
Toronto,28,30,27,23,0,0,0,0,Atlanta,16,24,25,28,0,0,0,0,20180124,108,93,12,18,20,15,15,201,-15,2017,0,2,733,0
New Orleans,32,24,20,25,0,0,0,0,Charlotte,21,32,20,23,0,0,0,0,20180124,101,96,11,3,3,5,5,197,-5,2017,0,2,648,0
Houston,38,13,34,19,0,0,0,0,Dallas,28,17,22,30,0,0,0,0,20180124,104,97,10,6,18,7,7,201,-7,2017,0,2,225,0
Utah,24,19,22,24,9,0,0,0,Detroit,24,25,15,25,6,0,0,0,20180124,98,95,0,-6,1,0,3,193,-3,2017,1,2,1488,0
Phoenix,18,26,21,36,0,0,0,0,Indiana,32,31,36,17,0,0,0,0,20180124,101,116,14,19,34,15,15,217,15,2017,0,2,1496,0
Boston,25,37,29,22,0,0,0,0,LA Clippers,22,33,22,25,0,0,0,0,20180124,113,102,3,7,14,11,11,215,-11,2017,0,2,2590,0
San Antonio,22,29,26,31,0,0,0,0,Memphis,21,19,24,21,0,0,0,0,20180124,108,85,1,11,13,23,23,193,-23,2017,0,2,631,0
Minnesota,29,25,30,30,0,0,0,0,Portland,25,29,43,26,0,0,0,0,20180124,114,123,-4,0,13,9,9,237,9,2017,0,2,1423,0
Washington,20,20,34,38,0,0,0,0,Oklahoma City,25,29,28,39,0,0,0,0,20180125,112,121,5,14,8,9,9,233,9,2017,0,3,1149,0
Sacramento,19,28,24,18,0,0,0,0,Miami,17,30,25,16,0,0,0,0,20180125,89,88,2,0,-1,1,1,177,-1,2017,0,3,2547,0
New York,28,32,32,26,0,0,0,0,Denver,39,34,26,31,0,0,0,0,20180125,118,130,11,13,7,12,12,248,12,2017,0,3,1627,0
Minnesota,29,33,31,20,0,0,0,0,Golden State,38,36,32,20,0,0,0,0,20180125,113,126,9,12,13,13,13,239,13,2017,0,3,1581,0
LA Lakers,32,30,22,24,0,0,0,0,Chicago,25,32,15,31,0,0,0,0,20180126,108,103,7,5,12,5,5,211,-5,2017,0,4,1741,0
Atlanta,26,26,34,24,0,0,0,0,Charlotte,30,31,29,31,0,0,0,0,20180126,110,121,4,9,4,11,11,231,11,2017,0,4,226,0
Indiana,31,29,20,28,0,0,0,0,Cleveland,38,35,24,18,0,0,0,0,20180126,108,115,7,13,17,7,7,223,7,2017,0,4,262,0
Portland,17,35,23,32,0,0,0,0,Dallas,25,19,24,25,0,0,0,0,20180126,107,93,-8,8,7,14,14,200,-14,2017,0,4,1630,0
LA Clippers,24,34,25,26,0,0,0,0,Memphis,20,30,26,24,0,0,0,0,20180126,109,100,4,8,7,9,9,209,-9,2017,0,4,1599,0
Brooklyn,15,20,37,19,0,0,0,0,Milwaukee,33,25,23,35,0,0,0,0,20180126,91,116,18,23,9,25,25,207,25,2017,0,4,732,0
Houston,30,23,27,33,0,0,0,0,New Orleans,29,37,24,25,0,0,0,0,20180126,113,115,-1,13,10,2,2,228,2,2017,0,4,317,0
New York,33,20,28,26,0,0,0,0,Phoenix,23,26,18,18,0,0,0,0,20180126,107,85,10,4,14,22,22,192,-22,2017,0,4,2139,0
Philadelphia,25,25,31,16,0,0,0,0,San Antonio,13,18,30,17,0,0,0,0,20180126,97,78,12,19,20,19,19,175,-19,2017,0,4,1505,0
Utah,30,15,30,22,0,0,0,0,Toronto,24,24,21,24,0,0,0,0,20180126,97,93,6,-3,6,4,4,190,-4,2017,0,4,1664,0
Brooklyn,11,31,23,32,0,0,0,0,Minnesota,30,24,24,33,0,0,0,0,20180127,97,111,19,12,13,14,14,208,14,2017,0,5,1016,0
Charlotte,26,22,30,13,0,0,0,0,Miami,22,32,17,24,0,0,0,0,20180127,91,95,-4,6,-7,4,4,186,4,2017,0,5,654,0
Orlando,32,38,22,20,0,0,0,0,Indiana,22,31,31,30,0,0,0,0,20180127,112,114,-10,-17,-8,2,2,226,2,2017,0,5,822,0
Oklahoma City,36,33,29,23,0,0,0,0,Detroit,24,33,24,27,0,0,0,0,20180127,121,108,12,12,17,13,13,229,-13,2017,0,5,909,0
Dallas,26,16,32,15,0,0,0,0,Denver,30,20,16,25,0,0,0,0,20180127,89,91,4,8,-8,2,2,180,2,2017,0,5,661,0
Washington,27,34,31,37,0,0,0,0,Atlanta,18,27,26,33,0,0,0,0,20180127,129,104,9,16,21,25,25,233,-25,2017,0,5,541,0
Boston,37,17,19,32,0,0,0,0,Golden State,27,23,30,29,0,0,0,0,20180127,105,109,-10,-4,7,4,4,214,4,2017,0,5,2692,0
Milwaukee,26,35,25,24,0,0,0,0,Chicago,20,22,30,24,0,0,0,0,20180128,110,96,6,19,14,14,14,206,-14,2017,0,6,83,0
Detroit,28,33,26,17,0,0,0,0,Cleveland,33,25,32,31,0,0,0,0,20180128,104,121,5,-3,3,17,17,225,17,2017,0,6,90,0
Phoenix,24,29,24,25,0,0,0,0,Houston,28,32,32,21,0,0,0,0,20180128,102,113,4,7,15,11,11,215,11,2017,0,6,1014,0
LA Clippers,26,25,29,32,0,0,0,0,New Orleans,34,28,15,26,0,0,0,0,20180128,112,103,-8,-11,3,9,9,215,-9,2017,0,6,1669,0
Philadelphia,29,29,25,29,0,0,0,0,Oklahoma City,31,26,35,30,0,0,0,0,20180128,112,122,2,-1,9,10,10,234,10,2017,0,6,1256,0
Sacramento,22,28,19,29,0,0,0,0,San Antonio,29,20,30,34,0,0,0,0,20180128,98,113,7,-1,10,15,15,211,15,2017,0,6,1456,0
LA Lakers,21,28,28,34,0,0,0,0,Toronto,28,31,32,32,0,0,0,0,20180128,111,123,7,10,14,12,12,234,12,2017,0,6,2170,0
Phoenix,26,21,27,35,0,0,0,0,Memphis,22,42,26,30,0,0,0,0,20180129,109,120,-4,17,16,11,11,229,11,2017,0,0,1260,0
Philadelphia,30,23,22,20,0,0,0,0,Milwaukee,28,27,28,24,0,0,0,0,20180129,95,107,-2,2,8,12,12,202,12,2017,0,0,692,0
Charlotte,23,28,27,18,0,0,0,0,Indiana,23,29,29,24,0,0,0,0,20180129,96,105,0,1,3,9,9,201,9,2017,0,0,428,0
Miami,22,29,24,20,0,0,0,0,Dallas,26,20,15,27,0,0,0,0,20180129,95,88,-4,5,14,7,7,183,-7,2017,0,0,1110,0
Minnesota,32,26,21,21,0,0,0,0,Atlanta,27,28,21,29,0,0,0,0,20180129,100,105,-5,-3,-3,5,5,205,5,2017,0,0,908,0
Boston,32,24,24,31,0,0,0,0,Denver,21,24,37,28,0,0,0,0,20180129,111,110,11,11,-2,1,1,221,-1,2017,0,0,1765,0
Oklahoma City,25,29,22,20,0,0,0,0,Washington,30,23,22,27,0,0,0,0,20180130,96,102,5,-1,-1,6,6,198,6,2017,0,1,1149,0
Minnesota,27,30,23,24,0,0,0,0,Toronto,19,32,27,31,0,0,0,0,20180130,104,109,-8,-6,-2,5,5,213,5,2017,0,1,691,0
Denver,30,25,26,23,0,0,0,0,San Antonio,30,30,20,26,0,0,0,0,20180130,104,106,0,5,-1,2,2,210,2,2017,0,1,802,0
Brooklyn,22,19,28,26,0,0,0,0,New York,30,31,25,25,0,0,0,0,20180130,95,111,8,20,17,16,16,206,16,2017,0,1,0,0
Golden State,30,26,29,14,0,0,0,0,Utah,35,34,34,26,0,0,0,0,20180130,99,129,5,13,18,30,30,228,30,2017,0,1,599,0
Portland,30,26,30,18,0,0,0,0,LA Clippers,27,24,16,29,0,0,0,0,20180130,104,96,3,5,19,8,8,200,-8,2017,0,1,826,0
Orlando,30,25,33,19,0,0,0,0,Houston,27,27,36,24,0,0,0,0,20180130,107,114,-3,-1,2,7,7,221,7,2017,0,1,847,0
Cleveland,27,36,21,30,0,0,0,0,Detroit,33,26,30,36,0,0,0,0,20180130,114,125,6,-4,5,11,11,239,11,2017,0,1,90,0
Sacramento,25,36,29,24,0,0,0,0,New Orleans,29,33,23,18,0,0,0,0,20180130,114,103,-4,-1,5,11,11,217,-11,2017,0,1,1879,0
Charlotte,35,29,33,26,0,0,0,0,Atlanta,28,24,32,26,0,0,0,0,20180131,123,110,7,12,13,13,13,233,-13,2017,0,2,226,0
New York,24,21,20,8,0,0,0,0,Boston,27,23,31,22,0,0,0,0,20180131,73,103,3,5,16,30,30,176,30,2017,0,2,190,0
Philadelphia,34,31,23,20,0,0,0,0,Brooklyn,30,34,27,25,0,0,0,0,20180131,108,116,-4,-1,3,8,8,224,8,2017,0,2,80,0
Miami,21,29,22,17,0,0,0,0,Cleveland,27,21,24,19,0,0,0,0,20180131,89,91,6,-2,0,2,2,180,2,2017,0,2,1089,0
Memphis,25,28,22,26,0,0,0,0,Indiana,21,34,29,21,0,0,0,0,20180131,101,105,-4,2,9,4,4,206,4,2017,0,2,383,0
LA Lakers,25,26,30,24,0,0,0,0,Orlando,29,29,43,26,0,0,0,0,20180131,105,127,4,7,20,22,22,232,22,2017,0,2,2197,0
Dallas,17,29,15,27,0,0,0,0,Phoenix,36,21,24,21,0,0,0,0,20180131,88,102,19,11,20,14,14,190,14,2017,0,2,884,0
Chicago,19,25,31,33,0,0,0,0,Portland,43,24,35,22,0,0,0,0,20180131,108,124,24,23,27,16,16,232,16,2017,0,2,1754,0
Toronto,34,28,25,32,0,0,0,0,Washington,27,28,33,34,0,0,0,0,20180201,119,122,-7,-7,1,3,3,241,3,2017,0,3,349,0
Houston,27,27,28,20,0,0,0,0,San Antonio,14,24,32,21,0,0,0,0,20180201,102,91,13,16,12,11,11,193,-11,2017,0,3,189,0
Memphis,25,26,25,26,0,0,0,0,Detroit,27,24,31,22,0,0,0,0,20180201,102,104,2,0,6,2,2,206,2,2017,0,3,622,0
Oklahoma City,33,24,32,35,0,0,0,0,Denver,40,32,32,23,0,0,0,0,20180201,124,127,7,15,15,3,3,251,3,2017,0,3,503,0
Milwaukee,17,22,22,28,0,0,0,0,Minnesota,23,37,19,29,0,0,0,0,20180201,89,108,6,21,18,19,19,197,19,2017,0,3,298,0
Portland,18,34,28,25,0,0,0,0,Toronto,37,37,27,29,0,0,0,0,20180202,105,130,19,22,21,25,25,235,25,2017,0,4,2108,0
Utah,28,34,32,35,0,0,0,0,Phoenix,23,17,33,24,0,0,0,0,20180202,129,97,5,22,21,32,32,226,-32,2017,0,4,505,0
Golden State,29,29,26,35,0,0,0,0,Sacramento,27,25,23,29,0,0,0,0,20180202,119,104,2,6,9,15,15,223,-15,2017,0,4,75,0
Miami,23,18,19,37,0,0,0,0,Philadelphia,24,27,35,17,0,0,0,0,20180202,97,103,1,10,26,6,6,200,6,2017,0,4,1021,0
Atlanta,32,23,20,35,0,0,0,0,Boston,26,27,41,25,0,0,0,0,20180202,110,119,-6,-2,19,9,9,229,9,2017,0,4,935,0
New York,29,26,19,16,0,0,0,0,Milwaukee,28,27,19,18,0,0,0,0,20180202,90,92,-1,0,0,2,2,182,2,2017,0,4,732,0
Indiana,37,20,34,35,0,0,0,0,Charlotte,49,22,25,37,0,0,0,0,20180202,126,133,12,14,5,7,7,259,7,2017,0,4,428,0
LA Lakers,24,35,26,17,0,0,0,0,Brooklyn,26,31,28,14,0,0,0,0,20180202,102,99,-2,2,0,3,3,201,-3,2017,0,4,2445,0
New Orleans,22,32,36,24,0,0,0,0,Oklahoma City,32,26,25,17,0,0,0,0,20180202,114,100,-10,-4,7,14,14,214,-14,2017,0,4,576,0
Utah,33,28,26,33,0,0,0,0,San Antonio,24,25,29,33,0,0,0,0,20180203,120,111,9,12,9,9,9,231,-9,2017,0,5,1087,0
Dallas,27,29,25,25,0,0,0,0,Sacramento,28,26,31,14,0,0,0,0,20180203,106,99,-1,2,-4,7,7,205,-7,2017,0,5,1437,0
New Orleans,29,24,28,26,0,0,0,0,Minnesota,37,29,29,23,0,0,0,0,20180203,107,118,8,13,14,11,11,225,11,2017,0,5,1052,0
Chicago,17,35,29,22,0,0,0,0,LA Clippers,22,35,30,26,0,0,0,0,20180203,103,113,5,5,6,10,10,216,10,2017,0,5,1741,0
Washington,31,25,31,28,0,0,0,0,Orlando,25,22,22,29,0,0,0,0,20180203,115,98,6,9,18,17,17,213,-17,2017,0,5,757,0
Miami,26,24,27,30,0,0,0,0,Detroit,27,27,22,35,0,0,0,0,20180203,107,111,1,4,-1,4,4,218,4,2017,0,5,1155,0
Golden State,32,24,27,25,0,0,0,0,Denver,29,26,22,38,0,0,0,0,20180203,108,115,-3,-1,-6,7,7,223,7,2017,0,5,947,0
Houston,32,33,32,23,0,0,0,0,Cleveland,20,19,30,19,0,0,0,0,20180203,120,88,12,26,28,32,32,208,-32,2017,0,5,1113,0
Philadelphia,27,30,18,17,0,0,0,0,Indiana,33,29,14,24,0,0,0,0,20180203,92,100,6,5,1,8,8,192,8,2017,0,5,582,0
Portland,26,28,19,23,0,0,0,0,Boston,19,19,31,28,0,0,0,0,20180204,96,97,-7,-16,-4,1,1,193,1,2017,0,6,2532,0
Milwaukee,36,26,21,26,0,0,0,0,Brooklyn,22,19,31,22,0,0,0,0,20180204,109,94,14,21,11,15,15,203,-15,2017,0,6,732,0
Atlanta,21,23,25,30,0,0,0,0,New York,22,16,33,25,0,0,0,0,20180204,99,96,-1,6,-2,3,3,195,-3,2017,0,6,745,0
LA Lakers,25,26,31,26,0,0,0,0,Oklahoma City,22,27,30,25,0,0,0,0,20180204,108,104,3,2,3,4,4,212,-4,2017,0,6,1178,0
Charlotte,25,23,38,29,0,0,0,0,Phoenix,31,28,35,16,0,0,0,0,20180204,115,110,-6,-11,-8,5,5,225,-5,2017,0,6,1778,0
Memphis,24,20,30,12,0,0,0,0,Toronto,25,31,20,25,0,0,0,0,20180204,86,101,1,12,2,15,15,187,15,2017,0,6,815,0
Chicago,28,27,24,19,0,0,0,0,Sacramento,9,32,36,27,0,0,0,0,20180205,98,104,-19,-14,-2,6,6,202,6,2017,0,0,1788,0
Utah,34,36,29,34,0,0,0,0,New Orleans,23,41,22,23,0,0,0,0,20180205,133,109,11,6,13,24,24,242,-24,2017,0,0,1432,0
Orlando,26,33,34,18,0,0,0,0,Miami,35,25,27,22,0,0,0,0,20180205,111,109,-9,-1,6,2,2,220,-2,2017,0,0,204,0
Portland,20,23,24,24,0,0,0,0,Detroit,22,27,30,32,0,0,0,0,20180205,91,111,2,6,12,20,20,202,20,2017,0,0,1964,0
Washington,28,30,28,25,0,0,0,0,Indiana,23,26,25,28,0,0,0,0,20180205,111,102,5,9,12,9,9,213,-9,2017,0,0,490,0
Charlotte,25,37,22,20,0,0,0,0,Denver,36,27,34,24,0,0,0,0,20180205,104,121,11,1,13,17,17,225,17,2017,0,0,1355,0
Dallas,28,27,27,19,0,0,0,0,LA Clippers,32,26,20,26,0,0,0,0,20180205,101,104,4,3,-4,3,3,205,3,2017,0,0,1237,0
Boston,18,19,23,31,0,0,0,0,Toronto,22,36,25,28,0,0,0,0,20180206,91,111,4,21,23,20,20,202,20,2017,0,1,430,0
Washington,20,35,29,18,0,0,0,0,Philadelphia,37,28,29,21,0,0,0,0,20180206,102,115,17,10,10,13,13,217,13,2017,0,1,123,0
Milwaukee,25,25,26,27,0,0,0,0,New York,26,20,17,26,0,0,0,0,20180206,103,89,-1,4,13,14,14,192,-14,2017,0,1,732,0
Cleveland,43,24,22,9,0,0,0,0,Orlando,31,20,41,24,0,0,0,0,20180206,98,116,-12,-16,3,18,18,214,18,2017,0,1,895,0
Oklahoma City,42,28,29,26,0,0,0,0,Golden State,30,27,20,28,0,0,0,0,20180206,125,105,12,13,22,20,20,230,-20,2017,0,1,1386,0
Houston,38,27,31,27,0,0,0,0,Brooklyn,31,32,23,27,0,0,0,0,20180206,123,113,7,2,10,10,10,236,-10,2017,0,1,1417,0
Memphis,15,20,19,28,0,0,0,0,Atlanta,22,29,28,29,0,0,0,0,20180206,82,108,7,16,25,26,26,190,26,2017,0,1,336,0
Phoenix,28,29,22,14,0,0,0,0,LA Lakers,33,24,31,24,0,0,0,0,20180206,93,112,5,0,9,19,19,205,19,2017,0,1,356,0
Minnesota,29,37,33,30,9,0,0,0,Cleveland,31,33,37,28,11,0,0,0,20180207,138,140,2,-2,2,0,2,278,2,2017,1,2,629,0
Brooklyn,21,29,23,33,0,0,0,0,Detroit,26,27,26,36,0,0,0,0,20180207,106,115,5,3,6,9,9,221,9,2017,0,2,480,0
Utah,21,23,24,24,0,0,0,0,Memphis,16,23,24,25,0,0,0,0,20180207,92,88,5,5,5,4,4,180,-4,2017,0,2,1247,0
Houston,35,26,22,26,0,0,0,0,Miami,24,33,23,21,0,0,0,0,20180207,109,101,11,4,3,8,8,210,-8,2017,0,2,966,0
San Antonio,28,41,28,32,0,0,0,0,Phoenix,9,22,19,31,0,0,0,0,20180207,129,81,19,38,47,48,48,210,-48,2017,0,2,846,0
New York,18,23,25,22,0,0,0,0,Toronto,23,29,30,31,0,0,0,0,20180208,88,113,5,11,16,25,25,201,25,2017,0,3,341,0
Charlotte,18,27,20,32,6,0,0,0,Portland,29,20,30,18,12,0,0,0,20180208,103,109,11,4,14,0,6,212,6,2017,1,3,2284,0
Boston,26,23,26,23,12,0,0,0,Washington,27,24,19,28,6,0,0,0,20180208,110,104,-1,-2,5,0,6,214,-6,2017,1,3,394,0
Oklahoma City,27,19,20,15,0,0,0,0,LA Lakers,30,22,31,23,0,0,0,0,20180208,81,106,3,6,17,25,25,187,25,2017,0,3,1178,0
Dallas,33,27,25,18,0,0,0,0,Golden State,23,37,33,28,0,0,0,0,20180208,103,121,-10,0,8,18,18,224,18,2017,0,3,1480,0
Atlanta,23,16,31,28,0,0,0,0,Orlando,26,13,30,31,0,0,0,0,20180208,98,100,3,0,-1,2,2,198,2,2017,0,3,401,0
Charlotte,24,22,31,17,0,0,0,0,Utah,28,27,29,22,0,0,0,0,20180209,94,106,4,9,7,12,12,200,12,2017,0,4,1723,0
Portland,33,29,30,26,0,0,0,0,Sacramento,31,21,22,26,0,0,0,0,20180209,118,100,2,10,18,18,18,218,-18,2017,0,4,483,0
New Orleans,14,27,11,30,0,0,0,0,Philadelphia,32,24,28,16,0,0,0,0,20180209,82,100,18,15,32,18,18,182,18,2017,0,4,1088,0
Milwaukee,23,23,8,31,0,0,0,0,Miami,19,23,30,19,0,0,0,0,20180209,85,91,-4,-4,18,6,6,176,6,2017,0,4,1269,0
Denver,23,23,24,34,0,0,0,0,Houston,35,28,34,33,0,0,0,0,20180209,104,130,12,17,27,26,26,234,26,2017,0,4,878,0
Minnesota,27,40,19,27,0,0,0,0,Chicago,30,26,33,25,0,0,0,0,20180209,113,114,3,-11,3,1,1,227,1,2017,0,4,355,0
Indiana,30,29,17,21,0,0,0,0,Boston,16,22,34,19,0,0,0,0,20180209,97,91,14,21,4,6,6,188,-6,2017,0,4,805,0
Cleveland,31,30,36,26,0,0,0,0,Atlanta,27,29,26,25,0,0,0,0,20180209,123,107,4,5,15,16,16,230,-16,2017,0,4,555,0
LA Clippers,31,21,25,31,0,0,0,0,Detroit,30,26,24,15,0,0,0,0,20180209,108,95,1,-4,-3,13,13,203,-13,2017,0,4,1979,0
New Orleans,34,38,28,16,8,14,0,0,Brooklyn,22,30,33,31,8,4,0,0,20180210,138,128,12,20,15,0,10,266,-10,2017,2,5,1168,0
Washington,30,26,26,19,0,0,0,0,Chicago,22,24,24,20,0,0,0,0,20180210,101,90,8,10,12,11,11,191,-11,2017,0,5,594,0
LA Lakers,36,30,29,28,0,0,0,0,Dallas,34,31,35,30,0,0,0,0,20180210,123,130,-2,-1,5,7,7,253,7,2017,0,5,1237,0
San Antonio,37,18,20,30,0,0,0,0,Golden State,27,31,33,31,0,0,0,0,20180210,105,122,-10,3,16,17,17,227,17,2017,0,5,1487,0
Milwaukee,24,26,28,33,0,0,0,0,Orlando,29,25,20,30,0,0,0,0,20180210,111,104,-5,-4,4,7,7,215,-7,2017,0,5,1065,0
LA Clippers,28,27,23,20,0,0,0,0,Philadelphia,37,32,16,27,0,0,0,0,20180210,98,112,9,14,7,14,14,210,14,2017,0,5,2388,0
Denver,28,34,32,29,0,0,0,0,Phoenix,23,37,29,24,0,0,0,0,20180210,123,113,5,2,5,10,10,236,-10,2017,0,5,585,0
Utah,19,24,38,34,0,0,0,0,Portland,26,18,19,33,0,0,0,0,20180211,115,96,-7,-1,18,19,19,211,-19,2017,0,6,634,0
Memphis,18,36,26,12,0,0,0,0,Oklahoma City,35,39,21,15,0,0,0,0,20180211,92,110,17,20,15,18,18,202,18,2017,0,6,421,0
Sacramento,29,25,26,26,0,0,0,0,Minnesota,23,33,19,36,0,0,0,0,20180211,106,111,-6,2,-5,5,5,217,5,2017,0,6,1511,0
New York,37,25,22,29,0,0,0,0,Indiana,36,32,26,27,0,0,0,0,20180211,113,121,-1,6,10,8,8,234,8,2017,0,6,643,0
Toronto,30,32,28,33,0,0,0,0,Charlotte,26,29,19,29,0,0,0,0,20180211,123,103,4,7,16,20,20,226,-20,2017,0,6,585,0
Cleveland,31,33,31,26,0,0,0,0,Boston,32,20,22,25,0,0,0,0,20180211,121,99,-1,12,21,22,22,220,-22,2017,0,6,549,0
Detroit,23,33,24,35,0,0,0,0,Atlanta,28,27,27,36,0,0,0,0,20180211,115,118,5,-1,2,3,3,233,3,2017,0,6,597,0
Dallas,19,36,20,22,0,0,0,0,Houston,27,30,30,17,0,0,0,0,20180211,97,104,8,2,12,7,7,201,7,2017,0,6,225,0
LA Clippers,34,32,24,24,0,0,0,0,Brooklyn,22,29,16,34,0,0,0,0,20180212,114,101,12,15,23,13,13,215,-13,2017,0,0,2445,0
Orlando,27,24,20,30,0,0,0,0,Chicago,30,23,24,28,0,0,0,0,20180212,101,105,3,2,6,4,4,206,4,2017,0,0,984,0
New Orleans,32,28,35,23,0,0,0,0,Detroit,31,21,28,23,0,0,0,0,20180212,118,103,1,8,15,15,15,221,-15,2017,0,0,939,0
Phoenix,24,21,26,12,0,0,0,0,Golden State,25,37,37,30,0,0,0,0,20180212,83,129,1,17,28,46,46,212,46,2017,0,0,652,0
New York,21,34,24,13,0,0,0,0,Philadelphia,31,26,29,22,0,0,0,0,20180212,92,108,10,2,7,16,16,200,16,2017,0,0,80,0
San Antonio,22,26,29,22,0,0,0,0,Utah,25,29,15,32,0,0,0,0,20180212,99,101,3,6,-8,2,2,200,2,2017,0,0,1087,0
Cleveland,29,33,29,29,0,0,0,0,Oklahoma City,28,29,30,25,0,0,0,0,20180213,120,112,1,5,4,8,8,232,-8,2017,0,1,949,0
Miami,24,31,26,31,0,0,0,0,Toronto,28,29,41,17,0,0,0,0,20180213,112,115,4,2,17,3,3,227,3,2017,0,1,1234,0
Houston,23,31,30,42,0,0,0,0,Minnesota,31,19,30,28,0,0,0,0,20180213,126,108,-8,4,4,18,18,234,-18,2017,0,1,1057,0
Atlanta,24,19,18,31,0,0,0,0,Milwaukee,21,20,33,23,0,0,0,0,20180213,92,97,-3,-2,13,5,5,189,5,2017,0,1,669,0
San Antonio,32,29,29,19,0,0,0,0,Denver,30,28,29,30,0,0,0,0,20180213,109,117,-2,-3,-3,8,8,226,8,2017,0,1,802,0
Sacramento,29,36,23,26,0,0,0,0,Dallas,16,28,27,38,0,0,0,0,20180213,114,109,13,21,17,5,5,223,-5,2017,0,1,1437,0
Golden State,27,24,36,30,0,0,0,0,Portland,40,23,29,31,0,0,0,0,20180214,117,123,13,12,5,6,6,240,6,2017,0,2,535,0
Miami,29,33,19,21,0,0,0,0,Philadelphia,20,19,34,31,0,0,0,0,20180214,102,104,-9,-23,-8,2,2,206,2,2017,0,2,1021,0
Charlotte,20,34,31,19,0,0,0,0,Orlando,26,27,25,24,0,0,0,0,20180214,104,102,-6,1,7,2,2,206,-2,2017,0,2,463,0
Washington,26,25,39,28,0,0,0,0,New York,39,33,15,26,0,0,0,0,20180214,118,113,-13,-21,3,5,5,231,-5,2017,0,2,204,0
LA Lakers,33,33,25,26,0,0,0,0,New Orleans,46,33,24,36,0,0,0,0,20180214,117,139,13,13,12,22,22,256,22,2017,0,2,1669,0
Phoenix,23,18,30,26,0,0,0,0,Utah,27,23,22,35,0,0,0,0,20180214,97,107,4,9,1,10,10,204,10,2017,0,2,505,0
Sacramento,25,20,18,28,0,0,0,0,Houston,20,35,17,28,0,0,0,0,20180214,91,100,-5,10,9,9,9,191,9,2017,0,2,1606,0
Atlanta,14,19,28,37,0,0,0,0,Detroit,22,23,37,22,0,0,0,0,20180214,98,104,8,12,21,6,6,202,6,2017,0,2,597,0
Toronto,27,34,34,27,0,0,0,0,Chicago,33,16,27,22,0,0,0,0,20180214,122,98,-6,12,19,24,24,220,-24,2017,0,2,436,0
Indiana,22,32,19,35,0,0,0,0,Brooklyn,23,31,25,24,0,0,0,0,20180214,108,103,-1,0,-6,5,5,211,-5,2017,0,2,643,0
LA Clippers,34,27,32,36,0,0,0,0,Boston,25,32,34,28,0,0,0,0,20180214,129,119,9,4,2,10,10,248,-10,2017,0,2,2590,0
Oklahoma City,34,39,19,29,0,0,0,0,Memphis,33,20,31,30,0,0,0,0,20180214,121,114,1,20,8,7,7,235,-7,2017,0,2,421,0
Denver,35,39,33,27,0,0,0,0,Milwaukee,28,34,26,35,0,0,0,0,20180215,134,123,7,12,19,11,11,257,-11,2017,0,3,912,0
LA Lakers,39,26,26,20,0,0,0,0,Minnesota,35,27,22,35,0,0,0,0,20180215,111,119,-4,-3,-7,8,8,230,8,2017,0,3,1521,0
Oklahoma City,44,23,18,25,0,0,0,0,Sacramento,21,39,30,17,0,0,0,0,20180222,110,107,23,7,-5,3,3,217,-3,2017,0,3,1336,0
New York,31,32,30,27,0,0,0,0,Orlando,41,28,21,23,0,0,0,0,20180222,120,113,-10,-6,3,7,7,233,-7,2017,0,3,939,0
LA Clippers,23,35,34,35,0,0,0,0,Golden State,34,36,32,32,0,0,0,0,20180222,127,134,11,12,10,7,7,261,7,2017,0,3,347,0
Brooklyn,28,25,21,22,0,0,0,0,Charlotte,32,23,25,31,0,0,0,0,20180222,96,111,4,2,6,15,15,207,15,2017,0,3,531,0
Philadelphia,33,34,26,23,0,0,0,0,Chicago,29,40,22,24,0,0,0,0,20180222,116,115,4,-2,2,1,1,231,-1,2017,0,3,664,0
Washington,22,35,25,28,0,0,0,0,Cleveland,31,23,25,24,0,0,0,0,20180222,110,103,-9,3,3,7,7,213,-7,2017,0,3,304,0
LA Clippers,40,39,16,33,0,0,0,0,Phoenix,18,32,28,39,0,0,0,0,20180223,128,117,22,29,17,11,11,245,-11,2017,0,4,356,0
Charlotte,36,31,27,28,0,0,0,0,Washington,26,29,27,23,0,0,0,0,20180223,122,105,10,12,12,17,17,227,-17,2017,0,4,329,0
Portland,31,22,27,20,0,0,0,0,Utah,30,17,17,17,0,0,0,0,20180223,100,81,1,6,16,19,19,181,-19,2017,0,4,634,0
Milwaukee,23,42,31,14,12,0,0,0,Toronto,29,28,31,22,9,0,0,0,20180223,122,119,-6,8,8,0,3,241,-3,2017,1,4,429,0
Miami,27,32,30,19,15,0,0,0,New Orleans,22,35,27,24,16,0,0,0,20180223,123,124,-5,-2,-5,0,1,247,1,2017,1,4,668,0
Atlanta,22,22,22,27,0,0,0,0,Indiana,27,34,22,33,0,0,0,0,20180223,93,116,5,17,17,23,23,209,23,2017,0,4,427,0
Dallas,17,24,35,26,0,0,0,0,LA Lakers,32,31,32,29,0,0,0,0,20180223,102,124,15,22,19,22,22,226,22,2017,0,4,1237,0
Cleveland,20,34,31,27,0,0,0,0,Memphis,27,22,22,18,0,0,0,0,20180223,112,89,-7,5,14,23,23,201,-23,2017,0,4,629,0
Minnesota,32,22,21,27,0,0,0,0,Houston,26,29,33,32,0,0,0,0,20180223,102,120,-6,1,13,18,18,222,18,2017,0,4,1057,0
Boston,23,38,25,24,0,0,0,0,Detroit,28,21,28,21,0,0,0,0,20180223,110,98,-5,12,9,12,12,208,-12,2017,0,4,611,0
San Antonio,30,31,28,30,0,0,0,0,Denver,32,31,33,26,0,0,0,0,20180223,119,122,2,2,7,3,3,241,3,2017,0,4,802,0
Dallas,23,27,21,19,0,0,0,0,Utah,35,18,21,23,0,0,0,0,20180224,90,97,12,3,3,7,7,187,7,2017,0,5,998,0
LA Lakers,25,25,37,26,0,0,0,0,Sacramento,29,29,25,25,0,0,0,0,20180224,113,108,-4,-8,4,5,5,221,-5,2017,0,5,361,0
Orlando,18,22,31,34,0,0,0,0,Philadelphia,27,31,29,29,0,0,0,0,20180224,105,116,9,18,16,11,11,221,11,2017,0,5,864,0
Portland,28,27,16,35,0,0,0,0,Phoenix,24,26,31,23,0,0,0,0,20180224,106,104,4,5,-10,2,2,210,-2,2017,0,5,1005,0
Chicago,24,38,20,22,0,0,0,0,Minnesota,31,29,26,36,0,0,0,0,20180224,104,122,7,-2,4,18,18,226,18,2017,0,5,355,0
Memphis,31,21,18,19,0,0,0,0,Miami,34,26,32,23,0,0,0,0,20180224,89,115,3,8,22,26,26,204,26,2017,0,5,873,0
Oklahoma City,19,26,21,14,0,0,0,0,Golden State,24,28,32,28,0,0,0,0,20180224,80,112,5,7,18,32,32,192,32,2017,0,5,1386,0
Boston,23,36,29,33,0,0,0,0,New York,24,32,25,31,0,0,0,0,20180224,121,112,-1,3,7,9,9,233,-9,2017,0,5,190,0
Detroit,19,27,25,27,0,0,0,0,Charlotte,32,38,26,18,0,0,0,0,20180225,98,114,13,24,25,16,16,212,16,2017,0,6,504,0
San Antonio,25,25,26,34,0,0,0,0,Cleveland,20,33,21,20,0,0,0,0,20180225,110,94,5,-3,2,16,16,204,-16,2017,0,6,1256,0
Houston,38,28,26,27,0,0,0,0,Denver,25,27,27,35,0,0,0,0,20180225,119,114,13,14,13,5,5,233,-5,2017,0,6,878,0
New Orleans,21,28,38,27,9,0,0,0,Milwaukee,32,34,19,29,7,0,0,0,20180225,123,121,-11,-17,2,0,2,244,-2,2017,1,6,911,0
Philadelphia,28,20,25,21,0,0,0,0,Washington,30,37,20,22,0,0,0,0,20180225,94,109,2,19,14,15,15,203,15,2017,0,6,123,0
Orlando,38,24,15,28,0,0,0,0,Oklahoma City,31,30,23,28,0,0,0,0,20180226,105,112,-7,-1,7,7,7,217,7,2017,0,0,1057,0
Detroit,26,27,22,19,0,0,0,0,Toronto,30,29,34,30,0,0,0,0,20180226,94,123,4,6,18,29,29,217,29,2017,0,0,205,0
Houston,19,20,31,26,0,0,0,0,Utah,21,23,19,22,0,0,0,0,20180226,96,85,-2,-5,7,11,11,181,-11,2017,0,0,1199,0
Golden State,37,26,39,23,0,0,0,0,New York,39,25,18,29,0,0,0,0,20180226,125,111,-2,-1,20,14,14,236,-14,2017,0,0,2565,0
Minnesota,29,34,34,21,0,0,0,0,Sacramento,29,31,17,23,0,0,0,0,20180226,118,100,0,3,20,18,18,218,-18,2017,0,0,1511,0
Indiana,23,20,22,38,0,0,0,0,Dallas,23,26,19,41,0,0,0,0,20180226,103,109,0,6,3,6,6,212,6,2017,0,0,763,0
Chicago,19,32,19,17,0,0,0,0,Brooklyn,28,21,35,20,0,0,0,0,20180226,87,104,9,-2,14,17,17,191,17,2017,0,0,711,0
Memphis,24,17,28,29,0,0,0,0,Boston,33,34,19,23,0,0,0,0,20180226,98,109,9,26,17,11,11,207,11,2017,0,0,1134,0
LA Lakers,28,36,32,27,0,0,0,0,Atlanta,22,24,29,29,0,0,0,0,20180226,123,104,6,18,21,19,19,227,-19,2017,0,0,1932,0
Phoenix,36,29,24,27,0,0,0,0,New Orleans,26,32,38,29,0,0,0,0,20180226,116,125,-10,-7,7,9,9,241,9,2017,0,0,1312,0
Chicago,29,22,27,25,0,0,0,0,Charlotte,26,25,36,31,0,0,0,0,20180227,103,118,-3,0,9,15,15,221,15,2017,0,1,586,0
Brooklyn,29,32,30,32,0,0,0,0,Cleveland,25,35,34,35,0,0,0,0,20180227,123,129,-4,-1,3,6,6,252,6,2017,0,1,403,0
LA Clippers,24,28,29,41,0,0,0,0,Denver,33,25,30,32,0,0,0,0,20180227,122,120,-9,-6,-7,2,2,242,-2,2017,0,1,830,0
Philadelphia,24,24,27,26,0,0,0,0,Miami,17,28,28,29,0,0,0,0,20180227,101,102,-7,-3,-2,1,1,203,1,2017,0,1,1021,0
Washington,40,24,20,23,0,0,0,0,Milwaukee,22,28,31,23,0,0,0,0,20180227,107,104,18,14,3,3,3,211,-3,2017,0,1,634,0
Sacramento,26,27,27,19,0,0,0,0,Portland,36,30,22,28,0,0,0,0,20180227,99,116,10,13,8,17,17,215,17,2017,0,1,483,0
Golden State,36,22,27,24,0,0,0,0,Washington,21,35,14,31,0,0,0,0,20180228,109,101,15,2,15,8,8,210,-8,2017,0,2,2435,0
New Orleans,24,27,36,34,0,0,0,0,San Antonio,29,31,35,21,0,0,0,0,20180228,121,116,-5,-9,-8,5,5,237,-5,2017,0,2,506,0
Toronto,42,27,21,27,0,0,0,0,Orlando,37,26,26,15,0,0,0,0,20180228,117,104,5,6,1,13,13,221,-13,2017,0,2,1048,0
Phoenix,21,36,25,28,0,0,0,0,Memphis,27,27,18,30,0,0,0,0,20180228,110,102,-6,3,10,8,8,212,-8,2017,0,2,1260,0
Milwaukee,32,12,26,17,0,0,0,0,Detroit,32,21,32,25,0,0,0,0,20180228,87,110,0,9,15,23,23,197,23,2017,0,2,251,0
Oklahoma City,32,22,23,23,11,0,0,0,Dallas,21,22,33,24,10,0,0,0,20180228,111,110,11,11,1,0,1,221,-1,2017,1,2,189,0
Charlotte,31,28,20,27,0,0,0,0,Boston,37,30,36,31,0,0,0,0,20180228,106,134,6,8,24,28,28,240,28,2017,0,2,720,0
Indiana,27,23,15,37,0,0,0,0,Atlanta,28,27,30,22,0,0,0,0,20180228,102,107,1,5,20,5,5,209,5,2017,0,2,427,0
Houston,34,27,22,22,0,0,0,0,LA Clippers,12,31,29,20,0,0,0,0,20180228,105,92,22,18,11,13,13,197,-13,2017,0,2,1371,0
Philadelphia,32,27,18,31,0,0,0,0,Cleveland,29,27,15,26,0,0,0,0,20180301,108,97,3,3,6,11,11,205,-11,2017,0,3,358,0
LA Lakers,33,40,31,27,0,0,0,0,Miami,36,26,32,19,0,0,0,0,20180301,131,113,-3,11,10,18,18,244,-18,2017,0,3,2335,0
Minnesota,24,25,29,21,0,0,0,0,Portland,19,25,31,33,0,0,0,0,20180301,99,108,-5,-5,-3,9,9,207,9,2017,0,3,1423,0
Brooklyn,31,20,28,21,11,0,0,0,Sacramento,22,31,20,27,16,0,0,0,20180301,111,116,-9,2,-6,0,5,227,5,2017,1,3,2499,0
Charlotte,30,26,24,19,0,0,0,0,Philadelphia,27,21,26,36,0,0,0,0,20180302,99,110,-3,-8,-6,11,11,209,11,2017,0,4,450,0
Toronto,19,32,26,25,0,0,0,0,Washington,27,20,27,21,0,0,0,0,20180302,102,95,-8,4,3,7,7,197,-7,2017,0,4,349,0
Minnesota,24,21,32,31,0,0,0,0,Utah,23,33,29,31,0,0,0,0,20180302,108,116,-1,11,8,8,8,224,8,2017,0,4,984,0
Oklahoma City,32,28,37,27,0,0,0,0,Phoenix,37,30,32,17,0,0,0,0,20180302,124,116,-5,-7,-2,8,8,240,-8,2017,0,4,840,0
Detroit,29,23,30,22,2,0,0,0,Orlando,31,22,29,22,11,0,0,0,20180302,106,115,2,1,0,0,9,221,9,2017,1,4,957,0
Golden State,33,29,28,24,0,0,0,0,Atlanta,31,19,34,25,0,0,0,0,20180302,114,109,2,12,6,5,5,223,-5,2017,0,4,2135,0
Denver,35,28,28,17,0,0,0,0,Memphis,29,25,26,22,0,0,0,0,20180302,108,102,6,9,11,6,6,210,-6,2017,0,4,877,0
Dallas,32,17,36,15,0,0,0,0,Chicago,24,23,31,30,0,0,0,0,20180302,100,108,-8,-2,-7,8,8,208,8,2017,0,4,802,0
Indiana,18,27,33,25,0,0,0,0,Milwaukee,21,25,21,29,0,0,0,0,20180302,103,96,-3,-1,11,7,7,199,-7,2017,0,4,243,0
New York,25,35,18,27,0,0,0,0,LA Clippers,32,25,35,36,0,0,0,0,20180302,105,128,7,-3,14,23,23,233,23,2017,0,4,2445,0
Denver,37,36,30,23,0,0,0,0,Cleveland,31,31,35,20,0,0,0,0,20180303,126,117,6,11,6,9,9,243,-9,2017,0,5,1223,0
Boston,32,32,25,31,0,0,0,0,Houston,30,28,28,37,0,0,0,0,20180303,120,123,-2,-6,-3,3,3,243,3,2017,0,5,1603,0
Detroit,28,18,24,26,0,0,0,0,Miami,27,32,15,31,0,0,0,0,20180303,96,105,-1,13,4,9,9,201,9,2017,0,5,1155,0
Memphis,27,25,27,21,0,0,0,0,Orlando,31,21,25,30,0,0,0,0,20180303,100,107,4,0,-2,7,7,207,7,2017,0,5,683,0
Oklahoma City,28,22,25,25,0,0,0,0,Portland,25,28,30,25,0,0,0,0,20180303,100,108,-3,3,8,8,8,208,8,2017,0,5,1484,0
Utah,25,27,23,23,0,0,0,0,Sacramento,17,26,23,25,0,0,0,0,20180303,98,91,8,9,9,7,7,189,-7,2017,0,5,532,0
LA Lakers,23,30,27,36,0,0,0,0,San Antonio,30,30,31,21,0,0,0,0,20180303,116,112,-7,-7,-11,4,4,228,-4,2017,0,5,1201,0
New York,20,26,26,27,0,0,0,0,Sacramento,32,19,32,19,0,0,0,0,20180304,99,102,12,5,11,3,3,201,3,2017,0,6,2499,0
Indiana,30,25,25,18,0,0,0,0,Washington,20,25,20,30,0,0,0,0,20180304,98,95,10,10,15,3,3,193,-3,2017,0,6,490,0
Charlotte,21,22,26,29,0,0,0,0,Toronto,26,26,30,21,0,0,0,0,20180304,98,103,5,9,13,5,5,201,5,2017,0,6,585,0
Phoenix,23,33,31,25,0,0,0,0,Atlanta,29,27,30,27,0,0,0,0,20180304,112,113,6,0,-1,1,1,225,1,2017,0,6,1588,0
Brooklyn,27,26,33,34,0,0,0,0,LA Clippers,32,33,26,32,0,0,0,0,20180304,120,123,5,12,5,3,3,243,3,2017,0,6,2445,0
New Orleans,33,32,26,35,0,0,0,0,Dallas,25,24,29,31,0,0,0,0,20180304,126,109,8,16,13,17,17,235,-17,2017,0,6,442,0
Philadelphia,43,29,14,24,0,0,0,0,Milwaukee,31,29,33,25,0,0,0,0,20180304,110,118,-12,-12,7,8,8,228,8,2017,0,6,692,0
Phoenix,27,21,32,23,0,0,0,0,Miami,30,31,32,32,0,0,0,0,20180305,103,125,3,13,13,22,22,228,22,2017,0,0,1978,0
Memphis,23,22,27,26,0,0,0,0,San Antonio,21,26,23,30,0,0,0,0,20180305,98,100,-2,2,-2,2,2,198,2,2017,0,0,631,0
Portland,27,31,15,35,0,0,0,0,LA Lakers,24,31,25,23,0,0,0,0,20180305,108,103,3,3,-7,5,5,211,-5,2017,0,0,826,0
Orlando,29,15,23,13,0,0,0,0,Utah,25,29,20,20,0,0,0,0,20180305,80,94,-4,10,7,14,14,174,14,2017,0,0,1915,0
Detroit,28,21,21,20,0,0,0,0,Cleveland,26,28,36,22,0,0,0,0,20180305,90,112,-2,5,20,22,22,202,22,2017,0,0,90,0
Boston,35,20,31,19,0,0,0,0,Chicago,16,13,24,36,0,0,0,0,20180305,105,89,19,26,33,16,16,194,-16,2017,0,0,849,0
Milwaukee,17,29,23,20,0,0,0,0,Indiana,20,24,29,19,0,0,0,0,20180305,89,92,3,-2,4,3,3,181,3,2017,0,0,243,0
Miami,26,24,30,25,8,0,0,0,Washington,31,28,27,19,12,0,0,0,20180306,113,117,5,9,6,0,4,230,4,2017,1,1,924,0
Atlanta,28,23,26,13,0,0,0,0,Toronto,27,23,26,30,0,0,0,0,20180306,90,106,-1,-1,-1,16,16,196,16,2017,0,1,733,0
New York,28,24,19,16,0,0,0,0,Portland,35,22,30,24,0,0,0,0,20180306,87,111,7,5,16,24,24,198,24,2017,0,1,2439,0
Houston,26,28,33,35,0,0,0,0,Oklahoma City,24,21,29,38,0,0,0,0,20180306,122,112,2,9,13,10,10,234,-10,2017,0,1,413,0
Denver,25,37,23,22,0,0,0,0,Dallas,29,29,38,22,0,0,0,0,20180306,107,118,4,-4,11,11,11,225,11,2017,0,1,661,0
Brooklyn,19,34,27,21,0,0,0,0,Golden State,35,13,38,28,0,0,0,0,20180306,101,114,16,-5,6,13,13,215,13,2017,0,1,2565,0
Philadelphia,32,39,30,27,0,0,0,0,Charlotte,29,30,32,23,0,0,0,0,20180306,128,114,3,12,10,14,14,242,-14,2017,0,1,450,0
New Orleans,35,32,30,24,0,0,0,0,LA Clippers,27,25,30,34,0,0,0,0,20180306,121,116,8,15,15,5,5,237,-5,2017,0,1,1669,0
Houston,24,34,29,23,0,0,0,0,Milwaukee,22,24,30,23,0,0,0,0,20180307,110,99,2,12,11,11,11,209,-11,2017,0,2,1005,0
Orlando,32,19,28,28,0,0,0,0,LA Lakers,23,33,25,27,0,0,0,0,20180307,107,108,-9,5,2,1,1,215,1,2017,0,2,2197,0
Utah,32,22,25,25,0,0,0,0,Indiana,20,24,25,15,0,0,0,0,20180307,104,84,12,10,10,20,20,188,-20,2017,0,2,1353,0
New Orleans,32,30,23,29,0,0,0,0,Sacramento,21,23,23,34,0,0,0,0,20180307,114,101,11,18,18,13,13,215,-13,2017,0,2,1879,0
Cleveland,38,32,19,24,0,0,0,0,Denver,23,35,29,21,0,0,0,0,20180307,113,108,15,12,2,5,5,221,-5,2017,0,2,1223,0
Memphis,22,29,24,35,0,0,0,0,Chicago,30,34,26,29,0,0,0,0,20180307,110,119,8,13,15,9,9,229,9,2017,0,2,480,0
Toronto,27,18,40,29,7,0,0,0,Detroit,23,36,25,30,5,0,0,0,20180307,121,119,4,-14,1,0,2,240,-2,2017,1,2,205,0
Brooklyn,35,30,31,29,0,0,0,0,Charlotte,29,30,26,26,0,0,0,0,20180308,125,111,6,6,11,14,14,236,-14,2017,0,3,531,0
San Antonio,21,29,37,20,0,0,0,0,Golden State,28,18,32,32,0,0,0,0,20180308,107,110,7,-4,-9,3,3,217,3,2017,0,3,1487,0
Philadelphia,28,21,25,25,0,0,0,0,Miami,29,24,20,35,0,0,0,0,20180308,99,108,1,4,-1,9,9,207,9,2017,0,3,1021,0
Boston,35,25,26,31,0,0,0,0,Minnesota,28,18,28,35,0,0,0,0,20180308,117,109,7,14,12,8,8,226,-8,2017,0,3,1120,0
Phoenix,23,15,29,20,0,0,0,0,Oklahoma City,26,23,39,27,0,0,0,0,20180308,87,115,3,11,21,28,28,202,28,2017,0,3,840,0
New York,22,33,34,23,0,0,0,0,Milwaukee,26,34,31,29,0,0,0,0,20180309,112,120,4,5,2,8,8,232,8,2017,0,4,732,0
Orlando,14,22,26,26,0,0,0,0,Sacramento,22,19,33,20,0,0,0,0,20180309,88,94,8,5,12,6,6,182,6,2017,0,4,2390,0
Golden State,27,25,31,25,0,0,0,0,Portland,33,28,26,38,0,0,0,0,20180309,108,125,6,9,4,17,17,233,17,2017,0,4,535,0
Washington,22,31,30,33,0,0,0,0,New Orleans,19,19,24,35,0,0,0,0,20180309,116,97,3,15,21,19,19,213,-19,2017,0,4,964,0
Houston,16,27,32,30,0,0,0,0,Toronto,32,26,25,25,0,0,0,0,20180309,105,108,16,15,8,3,3,213,3,2017,0,4,1299,0
Utah,24,26,21,24,0,0,0,0,Memphis,23,15,20,20,0,0,0,0,20180309,95,78,1,12,13,17,17,173,-17,2017,0,4,1247,0
Atlanta,15,22,26,24,0,0,0,0,Indiana,34,19,34,25,0,0,0,0,20180309,87,112,19,16,24,25,25,199,25,2017,0,4,427,0
Chicago,26,21,15,21,0,0,0,0,Detroit,21,28,24,26,0,0,0,0,20180309,83,99,-5,2,11,16,16,182,16,2017,0,4,238,0
LA Lakers,28,34,34,20,0,0,0,0,Denver,37,28,29,31,0,0,0,0,20180309,116,125,9,3,-2,9,9,241,9,2017,0,4,830,0
Cleveland,17,30,30,25,0,0,0,0,LA Clippers,35,26,24,31,0,0,0,0,20180309,102,116,18,14,8,14,14,218,14,2017,0,4,2044,0
Phoenix,25,26,21,43,0,0,0,0,Charlotte,32,27,35,28,0,0,0,0,20180310,115,122,7,8,22,7,7,237,7,2017,0,5,1778,0
Memphis,13,17,33,17,0,0,0,0,Dallas,31,25,28,30,0,0,0,0,20180310,80,114,18,26,21,34,34,194,34,2017,0,5,419,0
Orlando,27,31,31,16,0,0,0,0,LA Clippers,30,26,31,26,0,0,0,0,20180310,105,113,3,-2,-2,8,8,218,8,2017,0,5,2197,0
Washington,20,28,28,26,0,0,0,0,Miami,26,34,43,26,0,0,0,0,20180310,102,129,6,12,27,27,27,231,27,2017,0,5,924,0
San Antonio,19,24,25,26,0,0,0,0,Oklahoma City,24,28,25,27,0,0,0,0,20180310,94,104,5,9,9,10,10,198,10,2017,0,5,421,0
Toronto,32,33,37,30,0,0,0,0,New York,27,30,29,20,0,0,0,0,20180311,132,106,5,8,16,26,26,238,-26,2017,0,6,341,0
Utah,29,19,30,38,0,0,0,0,New Orleans,23,28,23,25,0,0,0,0,20180311,116,99,6,-3,4,17,17,215,-17,2017,0,6,1432,0
Golden State,24,38,22,19,0,0,0,0,Minnesota,34,21,29,25,0,0,0,0,20180311,103,109,10,-7,0,6,6,212,6,2017,0,6,1581,0
Cleveland,29,31,22,31,0,0,0,0,LA Lakers,33,32,33,29,0,0,0,0,20180311,113,127,4,5,16,14,14,240,14,2017,0,6,2044,0
Sacramento,25,24,19,36,0,0,0,0,Denver,32,34,35,29,0,0,0,0,20180311,104,130,7,17,33,26,26,234,26,2017,0,6,886,0
Houston,25,23,32,25,0,0,0,0,Dallas,14,33,16,19,0,0,0,0,20180311,105,82,11,1,17,23,23,187,-23,2017,0,6,225,0
Philadelphia,37,33,26,24,0,0,0,0,Brooklyn,25,35,23,14,0,0,0,0,20180311,120,97,12,10,13,23,23,217,-23,2017,0,6,80,0
Indiana,24,16,34,25,0,0,0,0,Boston,25,25,20,27,0,0,0,0,20180311,99,97,-1,-10,4,2,2,196,-2,2017,0,6,805,0
Chicago,20,33,38,38,0,0,0,0,Atlanta,34,16,35,37,0,0,0,0,20180311,129,122,-14,3,6,7,7,251,-7,2017,0,6,587,0
San Antonio,21,22,24,26,0,0,0,0,Houston,25,29,34,21,0,0,0,0,20180312,93,109,4,11,21,16,16,202,16,2017,0,0,189,0
Milwaukee,32,32,26,31,0,0,0,0,Memphis,24,26,23,30,0,0,0,0,20180312,121,103,8,14,17,18,18,224,-18,2017,0,0,557,0
Sacramento,16,24,39,22,0,0,0,0,Oklahoma City,19,27,32,28,0,0,0,0,20180312,101,106,3,6,-1,5,5,207,5,2017,0,0,1336,0
Miami,25,22,25,27,0,0,0,0,Portland,34,25,29,27,0,0,0,0,20180312,99,115,9,12,16,16,16,214,16,2017,0,0,2704,0
Detroit,21,18,20,20,0,0,0,0,Utah,42,22,22,24,0,0,0,0,20180313,79,110,21,25,27,31,31,189,31,2017,0,1,1488,0
Minnesota,25,28,29,34,0,0,0,0,Washington,26,33,31,21,0,0,0,0,20180313,116,111,-1,-6,-8,5,5,227,-5,2017,0,1,931,0
Orlando,18,19,20,15,0,0,0,0,San Antonio,24,38,34,12,0,0,0,0,20180313,72,108,6,25,39,36,36,180,36,2017,0,1,1035,0
Cleveland,38,30,34,27,0,0,0,0,Phoenix,18,34,28,27,0,0,0,0,20180313,129,107,20,16,22,22,22,236,-22,2017,0,1,1745,0
Indiana,33,24,26,18,0,0,0,0,Philadelphia,23,30,26,19,0,0,0,0,20180313,101,98,10,4,4,3,3,199,-3,2017,0,1,582,0
Toronto,32,25,30,29,0,0,0,0,Brooklyn,40,27,18,17,0,0,0,0,20180313,116,102,-8,-10,2,14,14,218,-14,2017,0,1,341,0
Charlotte,32,33,27,23,0,0,0,0,New Orleans,37,35,20,27,0,0,0,0,20180313,115,119,5,7,0,4,4,234,4,2017,0,1,648,0
Denver,22,25,35,21,0,0,0,0,LA Lakers,35,13,29,35,0,0,0,0,20180313,103,112,13,1,-5,9,9,215,9,2017,0,1,830,0
LA Clippers,31,31,28,22,0,0,0,0,Chicago,27,33,18,28,0,0,0,0,20180313,112,106,4,2,12,6,6,218,-6,2017,0,1,1741,0
Oklahoma City,31,23,36,29,0,0,0,0,Atlanta,28,38,22,19,0,0,0,0,20180313,119,107,3,-12,2,12,12,226,-12,2017,0,1,755,0
Dallas,29,28,26,27,0,0,0,0,New York,31,29,12,25,0,0,0,0,20180313,110,97,-2,-3,11,13,13,207,-13,2017,0,1,1370,0
Washington,23,29,29,25,9,10,0,0,Boston,37,22,21,26,9,9,0,0,20180314,125,124,-14,-7,1,0,1,249,-1,2017,2,2,394,0
LA Lakers,23,32,27,24,0,0,0,0,Golden State,26,29,34,28,0,0,0,0,20180314,106,117,3,0,7,11,11,223,11,2017,0,2,347,0
Milwaukee,20,32,28,37,0,0,0,0,Orlando,36,25,30,35,0,0,0,0,20180314,117,126,16,9,11,9,9,243,9,2017,0,2,1065,0
Miami,31,21,27,32,8,0,0,0,Sacramento,24,35,32,20,12,0,0,0,20180314,119,123,-7,7,12,0,4,242,4,2017,1,2,2547,0
Phoenix,23,20,23,22,0,0,0,0,Utah,20,36,25,35,0,0,0,0,20180315,88,116,-3,13,15,28,28,204,28,2017,0,3,505,0
New Orleans,26,32,15,20,0,0,0,0,San Antonio,37,23,18,20,0,0,0,0,20180315,93,98,11,2,5,5,5,191,5,2017,0,3,506,0
Cleveland,29,25,23,28,0,0,0,0,Portland,29,30,29,25,0,0,0,0,20180315,105,113,0,5,11,8,8,218,8,2017,0,3,2049,0
Philadelphia,32,28,23,35,0,0,0,0,New York,32,36,23,19,0,0,0,0,20180315,118,110,0,-8,-8,8,8,228,-8,2017,0,3,80,0
Charlotte,33,30,34,32,0,0,0,0,Atlanta,23,32,24,38,0,0,0,0,20180315,129,117,10,8,18,12,12,246,-12,2017,0,3,226,0
Toronto,25,24,28,29,0,0,0,0,Indiana,27,30,22,20,0,0,0,0,20180315,106,99,-2,-8,-2,7,7,205,-7,2017,0,3,438,0
LA Clippers,26,25,23,22,0,0,0,0,Houston,28,19,31,23,0,0,0,0,20180315,96,101,2,-4,4,5,5,197,5,2017,0,3,1371,0
Detroit,29,22,33,29,0,0,0,0,Denver,33,32,33,22,0,0,0,0,20180315,113,120,4,14,14,7,7,233,7,2017,0,3,1154,0
Chicago,22,30,26,33,0,0,0,0,Memphis,29,23,23,35,0,0,0,0,20180315,111,110,-7,0,3,1,1,221,-1,2017,0,3,480,0
Brooklyn,33,25,23,35,0,0,0,0,Philadelphia,30,25,31,34,0,0,0,0,20180316,116,120,-3,-3,5,4,4,236,4,2017,0,4,80,0
Boston,25,23,27,17,0,0,0,0,Orlando,16,15,21,31,0,0,0,0,20180316,92,83,9,17,23,9,9,175,-9,2017,0,4,1115,0
Dallas,27,33,24,22,9,0,0,0,Toronto,29,25,24,28,16,0,0,0,20180316,115,122,2,-6,-6,0,7,237,7,2017,1,4,1201,0
Miami,25,25,24,18,0,0,0,0,LA Lakers,24,26,21,20,0,0,0,0,20180316,92,91,1,0,3,1,1,183,-1,2017,0,4,2335,0
Sacramento,29,28,18,23,0,0,0,0,Golden State,36,23,16,18,0,0,0,0,20180316,98,93,-7,-2,0,5,5,191,-5,2017,0,4,75,0
LA Clippers,30,26,28,29,0,0,0,0,Oklahoma City,27,36,26,32,0,0,0,0,20180316,113,121,-3,7,5,8,8,234,8,2017,0,4,1178,0
Indiana,20,25,26,31,0,0,0,0,Washington,25,32,29,23,0,0,0,0,20180317,102,109,5,12,15,7,7,211,7,2017,0,5,490,0
Sacramento,27,27,25,18,0,0,0,0,Utah,32,18,30,23,0,0,0,0,20180317,97,103,5,-4,1,6,6,200,6,2017,0,5,532,0
Detroit,20,25,18,24,0,0,0,0,Portland,31,29,20,20,0,0,0,0,20180317,87,100,11,15,17,13,13,187,13,2017,0,5,1964,0
Minnesota,24,26,31,20,0,0,0,0,San Antonio,23,38,29,27,0,0,0,0,20180317,101,117,-1,11,9,16,16,218,16,2017,0,5,1112,0
Golden State,30,22,42,30,0,0,0,0,Phoenix,34,26,25,24,0,0,0,0,20180317,124,109,-4,-8,9,15,15,233,-15,2017,0,5,652,0
Cleveland,32,37,16,29,0,0,0,0,Chicago,31,21,29,28,0,0,0,0,20180317,114,109,1,17,4,5,5,223,-5,2017,0,5,308,0
Houston,32,28,24,23,0,0,0,0,New Orleans,29,25,18,29,0,0,0,0,20180317,107,101,3,6,12,6,6,208,-6,2017,0,5,317,0
Atlanta,31,19,37,30,0,0,0,0,Milwaukee,26,30,39,27,0,0,0,0,20180317,117,122,-5,6,8,5,5,239,5,2017,0,5,669,0
Denver,17,31,27,19,0,0,0,0,Memphis,34,19,31,17,0,0,0,0,20180317,94,101,17,5,9,7,7,195,7,2017,0,5,877,0
Dallas,24,32,33,17,0,0,0,0,Brooklyn,30,29,29,26,0,0,0,0,20180317,106,114,6,3,-1,8,8,220,8,2017,0,5,1370,0
Charlotte,24,26,17,34,0,0,0,0,New York,22,35,42,25,0,0,0,0,20180317,101,124,-2,7,32,23,23,225,23,2017,0,5,531,0
Portland,24,34,33,31,0,0,0,0,LA Clippers,18,34,29,28,0,0,0,0,20180318,122,109,6,6,10,13,13,231,-13,2017,0,6,826,0
Houston,38,39,30,22,0,0,0,0,Minnesota,23,33,35,29,0,0,0,0,20180318,129,120,15,21,16,9,9,249,-9,2017,0,6,1057,0
Boston,28,21,27,13,0,0,0,0,New Orleans,20,27,35,26,0,0,0,0,20180318,89,108,-8,-2,6,19,19,197,19,2017,0,6,1358,0
Oklahoma City,40,26,31,35,0,0,0,0,Toronto,34,30,34,27,0,0,0,0,20180318,132,125,6,2,-1,7,7,257,-7,2017,0,6,1114,0
Golden State,21,20,22,12,0,0,0,0,San Antonio,30,19,12,28,0,0,0,0,20180319,75,89,9,8,-2,14,14,164,14,2017,0,0,1487,0
Detroit,25,19,29,33,0,0,0,0,Sacramento,21,23,22,24,0,0,0,0,20180319,106,90,4,0,7,16,16,196,-16,2017,0,0,2020,0
Charlotte,18,38,14,24,0,0,0,0,Philadelphia,21,28,32,27,0,0,0,0,20180319,94,108,3,-7,11,14,14,202,14,2017,0,0,450,0
Chicago,18,19,30,25,0,0,0,0,New York,19,28,36,27,0,0,0,0,20180319,92,110,1,10,16,18,18,202,18,2017,0,0,711,0
LA Lakers,37,22,21,20,0,0,0,0,Indiana,29,28,35,18,0,0,0,0,20180319,100,110,-8,-2,12,10,10,210,10,2017,0,0,1805,0
Milwaukee,25,32,28,32,0,0,0,0,Cleveland,26,38,29,31,0,0,0,0,20180319,117,124,1,7,8,7,7,241,7,2017,0,0,334,0
Memphis,31,32,31,21,0,0,0,0,Brooklyn,32,33,22,31,0,0,0,0,20180319,115,118,1,2,-7,3,3,233,3,2017,0,0,953,0
Denver,37,26,28,27,13,10,0,0,Miami,36,28,28,26,13,18,0,0,20180319,141,149,-1,1,1,0,8,290,8,2017,2,0,1724,0
Oklahoma City,26,22,27,24,0,0,0,0,Boston,18,27,28,27,0,0,0,0,20180320,99,100,-8,-3,-2,1,1,199,1,2017,0,1,1492,0
LA Clippers,32,26,25,26,0,0,0,0,Minnesota,28,31,36,28,0,0,0,0,20180320,109,123,-4,1,12,14,14,232,14,2017,0,1,1521,0
Dallas,30,22,28,25,0,0,0,0,New Orleans,29,25,26,35,0,0,0,0,20180320,105,115,-1,2,0,10,10,220,10,2017,0,1,442,0
Toronto,24,28,16,25,0,0,0,0,Orlando,25,26,25,10,0,0,0,0,20180320,93,86,-1,1,-8,7,7,179,-7,2017,0,1,1048,0
Detroit,19,25,36,35,0,0,0,0,Phoenix,19,19,26,24,0,0,0,0,20180320,115,88,0,6,16,27,27,203,-27,2017,0,1,1687,0
Houston,27,28,31,29,0,0,0,0,Portland,31,24,32,24,0,0,0,0,20180320,115,111,-4,0,-1,4,4,226,-4,2017,0,1,1833,0
Atlanta,21,20,22,36,0,0,0,0,Utah,27,15,25,27,0,0,0,0,20180320,99,94,-6,-1,-4,5,5,193,-5,2017,0,1,1580,0
Memphis,19,25,25,36,0,0,0,0,Philadelphia,26,32,41,20,0,0,0,0,20180321,105,119,7,14,30,14,14,224,14,2017,0,2,878,0
Washington,18,26,16,30,0,0,0,0,San Antonio,18,32,27,21,0,0,0,0,20180321,90,98,0,6,17,8,8,188,8,2017,0,2,1385,0
Indiana,25,25,19,23,0,0,0,0,New Orleans,24,27,16,29,0,0,0,0,20180321,92,96,-1,1,-2,4,4,188,4,2017,0,2,713,0
LA Clippers,38,26,33,30,0,0,0,0,Milwaukee,24,33,26,37,0,0,0,0,20180321,127,120,14,7,14,7,7,247,-7,2017,0,2,1741,0
Toronto,38,41,20,30,0,0,0,0,Cleveland,42,22,34,34,0,0,0,0,20180321,129,132,4,-15,-1,3,3,261,3,2017,0,2,187,0
Denver,39,38,36,22,0,0,0,0,Chicago,25,21,24,32,0,0,0,0,20180321,135,102,14,31,43,33,33,237,-33,2017,0,2,916,0
Charlotte,22,21,32,36,0,0,0,0,Brooklyn,34,28,25,18,0,0,0,0,20180321,111,105,-12,-19,-12,6,6,216,-6,2017,0,2,531,0
New York,26,21,30,21,0,0,0,0,Miami,27,37,35,20,0,0,0,0,20180321,98,119,1,17,22,21,21,217,21,2017,0,2,1091,0
Memphis,14,28,15,22,0,0,0,0,Charlotte,37,38,37,28,0,0,0,0,20180322,79,140,23,33,55,61,61,219,61,2017,0,3,519,0
Utah,37,28,31,23,0,0,0,0,Dallas,34,24,23,31,0,0,0,0,20180322,119,112,3,7,15,7,7,231,-7,2017,0,3,998,0
Detroit,27,23,18,20,8,0,0,0,Houston,21,27,23,17,12,0,0,0,20180322,96,100,-6,-2,3,0,4,196,4,2017,1,3,1105,0
LA Lakers,44,29,35,17,0,0,0,0,New Orleans,40,31,26,31,0,0,0,0,20180322,125,128,-4,-2,-11,3,3,253,3,2017,0,3,1669,0
Philadelphia,32,38,25,23,0,0,0,0,Orlando,23,26,16,33,0,0,0,0,20180322,118,98,9,21,30,20,20,216,-20,2017,0,3,864,0
Atlanta,28,16,27,19,0,0,0,0,Sacramento,25,24,31,25,0,0,0,0,20180322,90,105,-3,5,9,15,15,195,15,2017,0,3,2082,0
Minnesota,31,26,27,24,0,0,0,0,New York,22,26,34,22,0,0,0,0,20180323,108,104,9,9,2,4,4,212,-4,2017,0,4,1016,0
Denver,23,32,23,30,0,0,0,0,Washington,16,27,33,24,0,0,0,0,20180323,108,100,7,12,2,8,8,208,-8,2017,0,4,1489,0
Brooklyn,32,32,27,21,0,0,0,0,Toronto,31,28,25,32,0,0,0,0,20180323,112,116,-1,-5,-7,4,4,228,4,2017,0,4,341,0
Utah,21,30,22,41,6,0,0,0,San Antonio,29,27,21,37,10,0,0,0,20180323,120,124,8,5,4,0,4,244,4,2017,1,4,1087,0
Boston,23,24,20,38,0,0,0,0,Portland,26,26,25,23,0,0,0,0,20180323,105,100,-3,-5,-10,5,5,205,-5,2017,0,4,2532,0
LA Clippers,28,25,23,28,0,0,0,0,Indiana,27,31,24,27,0,0,0,0,20180323,104,109,-1,5,6,5,5,213,5,2017,0,4,1805,0
Atlanta,18,33,23,20,0,0,0,0,Golden State,16,27,36,27,0,0,0,0,20180323,94,106,-2,-8,5,12,12,200,12,2017,0,4,2135,0
Phoenix,27,18,26,24,0,0,0,0,Cleveland,23,39,31,27,0,0,0,0,20180323,95,120,-4,17,22,25,25,215,25,2017,0,4,1745,0
Milwaukee,24,37,29,28,0,0,0,0,Chicago,34,27,21,23,0,0,0,0,20180323,118,105,-10,0,8,13,13,223,-13,2017,0,4,83,0
Miami,18,22,26,33,0,0,0,0,Oklahoma City,24,20,20,41,0,0,0,0,20180323,99,105,6,4,-2,6,6,204,6,2017,0,4,1225,0
Minnesota,24,28,19,37,0,0,0,0,Philadelphia,32,27,39,22,0,0,0,0,20180324,108,120,8,7,27,12,12,228,12,2017,0,5,983,0
Charlotte,22,32,25,23,0,0,0,0,Dallas,27,21,22,28,0,0,0,0,20180324,102,98,-5,6,9,4,4,200,-4,2017,0,5,928,0
Chicago,22,25,29,19,0,0,0,0,Detroit,36,30,29,22,0,0,0,0,20180324,95,117,14,19,19,22,22,212,22,2017,0,5,238,0
New Orleans,16,21,24,30,0,0,0,0,Houston,29,35,19,31,0,0,0,0,20180324,91,114,13,27,22,23,23,205,23,2017,0,5,317,0
LA Lakers,17,35,19,29,0,0,0,0,Memphis,28,29,14,22,0,0,0,0,20180324,100,93,-11,-5,0,7,7,193,-7,2017,0,5,1599,0
Phoenix,23,23,28,25,0,0,0,0,Orlando,26,12,39,28,0,0,0,0,20180324,99,105,3,-8,3,6,6,204,6,2017,0,5,1842,0
LA Clippers,28,25,27,37,0,0,0,0,Toronto,35,25,20,26,0,0,0,0,20180325,117,106,-7,-7,0,11,11,223,-11,2017,0,6,2170,0
Boston,24,28,28,24,0,0,0,0,Sacramento,27,33,18,15,0,0,0,0,20180325,104,93,-3,-8,2,11,11,197,-11,2017,0,6,2624,0
New York,19,42,16,24,0,0,0,0,Washington,21,32,18,26,0,0,0,0,20180325,101,97,-2,8,6,4,4,198,-4,2017,0,6,204,0
Portland,34,23,25,26,0,0,0,0,Oklahoma City,17,35,28,25,0,0,0,0,20180325,108,105,17,5,2,3,3,213,-3,2017,0,6,1484,0
Cleveland,28,32,27,34,0,0,0,0,Brooklyn,30,32,27,25,0,0,0,0,20180325,121,114,-2,-2,-2,7,7,235,-7,2017,0,6,403,0
Miami,30,23,21,22,11,0,0,0,Indiana,21,31,30,14,17,0,0,0,20180325,107,113,-9,-1,8,0,6,220,6,2017,1,6,1026,0
Atlanta,20,25,29,25,0,0,0,0,Houston,33,36,25,24,0,0,0,0,20180325,99,118,13,24,20,19,19,217,19,2017,0,6,700,0
Utah,18,35,36,21,0,0,0,0,Golden State,22,25,18,26,0,0,0,0,20180325,110,91,-4,6,24,19,19,201,-19,2017,0,6,599,0
San Antonio,15,32,28,28,0,0,0,0,Milwaukee,27,20,41,18,0,0,0,0,20180325,103,106,12,0,13,3,3,209,3,2017,0,6,1108,0
New York,22,27,33,35,11,0,0,0,Charlotte,27,35,25,30,20,0,0,0,20180326,128,137,5,13,5,0,9,265,9,2017,1,0,531,0
LA Lakers,29,26,21,30,0,0,0,0,Detroit,26,27,28,31,0,0,0,0,20180326,106,112,-3,-2,5,6,6,218,6,2017,0,0,1979,0
Memphis,26,33,19,23,0,0,0,0,Minnesota,25,34,23,11,0,0,0,0,20180326,101,93,1,0,-4,8,8,194,-8,2017,0,0,700,0
Denver,27,32,15,30,0,0,0,0,Philadelphia,23,28,34,38,0,0,0,0,20180326,104,123,-4,-8,11,19,19,227,19,2017,0,0,1574,0
Boston,31,17,29,25,0,0,0,0,Phoenix,15,30,20,29,0,0,0,0,20180326,102,94,16,3,12,8,8,196,-8,2017,0,0,2295,0
San Antonio,24,21,21,40,0,0,0,0,Washington,21,38,29,28,0,0,0,0,20180327,106,116,-3,14,22,10,10,222,10,2017,0,1,1385,0
Denver,23,35,27,25,0,0,0,0,Toronto,25,33,24,32,0,0,0,0,20180327,110,114,2,0,-3,4,4,224,4,2017,0,1,1341,0
Dallas,25,28,22,28,0,0,0,0,Sacramento,20,25,25,27,0,0,0,0,20180327,103,97,5,8,5,6,6,200,-6,2017,0,1,1437,0
Portland,20,26,25,36,0,0,0,0,New Orleans,24,25,26,28,0,0,0,0,20180327,107,103,-4,-3,-4,4,4,210,-4,2017,0,1,2059,0
Indiana,18,21,29,24,0,0,0,0,Golden State,27,21,22,11,0,0,0,0,20180327,92,81,-9,-9,-2,11,11,173,-11,2017,0,1,1944,0
Milwaukee,29,27,26,16,0,0,0,0,LA Clippers,35,27,16,27,0,0,0,0,20180327,98,105,6,6,-4,7,7,203,7,2017,0,1,1741,0
Chicago,23,16,18,29,0,0,0,0,Houston,31,29,27,31,0,0,0,0,20180327,86,118,8,21,30,32,32,204,32,2017,0,1,939,0
Cleveland,18,16,25,20,0,0,0,0,Miami,29,25,21,23,0,0,0,0,20180327,79,98,11,20,16,19,19,177,19,2017,0,1,1089,0
New York,28,35,17,21,0,0,0,0,Philadelphia,37,30,26,25,0,0,0,0,20180328,101,118,9,4,13,17,17,219,17,2017,0,2,80,0
LA Clippers,27,31,27,26,0,0,0,0,Phoenix,32,24,26,17,0,0,0,0,20180328,111,99,-5,2,3,12,12,210,-12,2017,0,2,356,0
Brooklyn,36,22,27,26,0,0,0,0,Orlando,33,18,30,23,0,0,0,0,20180328,111,104,3,7,4,7,7,215,-7,2017,0,2,939,0
Boston,18,30,19,30,0,0,0,0,Utah,24,15,32,23,0,0,0,0,20180328,97,94,-6,9,-4,3,3,191,-3,2017,0,2,2093,0
Portland,28,30,23,22,0,0,0,0,Memphis,20,33,23,32,0,0,0,0,20180328,103,108,-8,-5,-5,5,5,211,5,2017,0,2,1845,0
Dallas,34,22,25,12,0,0,0,0,LA Lakers,32,23,27,21,0,0,0,0,20180328,93,103,-2,-1,1,10,10,196,10,2017,0,2,1237,0
Cleveland,22,42,31,23,0,0,0,0,Charlotte,26,28,24,27,0,0,0,0,20180328,118,105,-4,10,17,13,13,223,-13,2017,0,2,435,0
Atlanta,32,25,31,26,0,0,0,0,Minnesota,34,31,33,28,0,0,0,0,20180328,114,126,2,8,10,12,12,240,12,2017,0,2,908,0
Washington,24,25,17,26,0,0,0,0,Detroit,23,26,32,22,0,0,0,0,20180329,92,103,-1,0,15,11,11,195,11,2017,0,3,394,0
Milwaukee,29,29,34,24,0,0,0,0,Golden State,27,22,23,35,0,0,0,0,20180329,116,107,2,9,20,9,9,223,-9,2017,0,3,1838,0
Chicago,21,25,22,24,0,0,0,0,Miami,29,22,27,25,0,0,0,0,20180329,92,103,8,5,10,11,11,195,11,2017,0,3,1189,0
Indiana,28,33,18,27,0,0,0,0,Sacramento,28,28,23,24,0,0,0,0,20180329,106,103,0,5,0,3,3,209,-3,2017,0,3,1882,0
Oklahoma City,29,27,25,18,0,0,0,0,San Antonio,24,35,18,26,0,0,0,0,20180329,99,103,-5,3,-4,4,4,202,4,2017,0,3,421,0
Memphis,14,33,29,21,0,0,0,0,Utah,29,23,28,27,0,0,0,0,20180330,97,107,15,5,4,10,10,204,10,2017,0,4,1247,0
LA Clippers,23,26,17,30,0,0,0,0,Portland,26,38,23,18,0,0,0,0,20180330,96,105,3,15,21,9,9,201,9,2017,0,4,826,0
Chicago,30,27,9,24,0,0,0,0,Orlando,24,20,25,13,0,0,0,0,20180330,90,82,6,13,-3,8,8,172,-8,2017,0,4,984,0
Milwaukee,39,29,29,15,12,0,0,0,LA Lakers,34,23,26,29,10,0,0,0,20180330,124,122,5,11,14,0,2,246,-2,2017,1,4,1741,0
Denver,27,35,30,22,12,0,0,0,Oklahoma City,28,30,21,35,11,0,0,0,20180330,126,125,-1,4,13,0,1,251,-1,2017,1,4,503,0
Minnesota,16,28,23,26,0,0,0,0,Dallas,20,26,18,28,0,0,0,0,20180330,93,92,-4,-2,3,1,1,185,-1,2017,0,4,863,0
New Orleans,29,28,22,23,0,0,0,0,Cleveland,29,18,33,27,0,0,0,0,20180330,102,107,0,-10,1,5,5,209,5,2017,0,4,924,0
Philadelphia,30,17,39,15,0,0,0,0,Atlanta,27,14,18,32,0,0,0,0,20180330,101,91,3,6,27,10,10,192,-10,2017,0,4,665,0
Phoenix,25,32,29,17,0,0,0,0,Houston,22,18,35,29,0,0,0,0,20180330,103,104,-3,-17,-11,1,1,207,1,2017,0,4,1014,0
Toronto,33,22,29,15,0,0,0,0,Boston,31,22,29,28,0,0,0,0,20180331,99,110,-2,-2,-2,11,11,209,11,2017,0,5,430,0
Brooklyn,22,26,32,21,9,0,0,0,Miami,32,23,21,25,8,0,0,0,20180331,110,109,-10,-7,4,0,1,219,-1,2017,1,5,1091,0
Detroit,30,26,29,30,0,0,0,0,New York,27,27,30,25,0,0,0,0,20180331,115,109,3,2,1,6,6,224,-6,2017,0,5,480,0
Golden State,28,29,36,19,0,0,0,0,Sacramento,25,24,20,27,0,0,0,0,20180331,112,96,3,8,24,16,16,208,-16,2017,0,5,75,0
Charlotte,27,24,23,19,0,0,0,0,Washington,30,20,37,20,0,0,0,0,20180331,93,107,3,-1,13,14,14,200,14,2017,0,5,329,0
Sacramento,19,24,17,24,0,0,0,0,LA Lakers,22,21,21,19,0,0,0,0,20180401,84,83,-3,0,-4,1,1,167,-1,2017,0,6,361,0
Houston,17,21,28,17,0,0,0,0,San Antonio,26,20,29,25,0,0,0,0,20180401,83,100,9,8,9,17,17,183,17,2017,0,6,189,0
Memphis,24,27,24,23,0,0,0,0,Portland,32,23,43,15,0,0,0,0,20180401,98,113,8,4,23,15,15,211,15,2017,0,6,1845,0
Oklahoma City,20,33,27,29,0,0,0,0,New Orleans,28,22,25,29,0,0,0,0,20180401,109,104,-8,3,5,5,5,213,-5,2017,0,6,576,0
Utah,28,33,26,34,0,0,0,0,Minnesota,26,24,21,26,0,0,0,0,20180401,121,97,2,11,16,24,24,218,-24,2017,0,6,984,0
Indiana,22,28,26,35,0,0,0,0,LA Clippers,30,21,27,26,0,0,0,0,20180401,111,104,-8,-1,-2,7,7,215,-7,2017,0,6,1805,0
Washington,27,32,16,19,0,0,0,0,Chicago,36,32,19,26,0,0,0,0,20180401,94,113,9,9,12,19,19,207,19,2017,0,6,594,0
Milwaukee,34,20,38,19,14,0,0,0,Denver,22,41,16,32,17,0,0,0,20180401,125,128,-12,9,-13,0,3,253,3,2017,1,6,912,0
Orlando,18,25,21,24,0,0,0,0,Atlanta,21,35,13,25,0,0,0,0,20180401,88,94,3,13,5,6,6,182,6,2017,0,6,401,0
Detroit,33,29,21,25,0,0,0,0,Brooklyn,28,20,22,26,0,0,0,0,20180401,108,96,5,14,13,12,12,204,-12,2017,0,6,480,0
Phoenix,24,35,18,30,0,0,0,0,Golden State,22,36,36,23,0,0,0,0,20180401,107,117,-2,-1,17,10,10,224,10,2017,0,6,652,0
Philadelphia,28,32,31,28,0,0,0,0,Charlotte,29,22,27,24,0,0,0,0,20180401,119,102,-1,9,13,17,17,221,-17,2017,0,6,450,0
Dallas,25,22,30,10,0,0,0,0,Cleveland,18,30,25,25,0,0,0,0,20180401,87,98,-7,1,-4,11,11,185,11,2017,0,6,1024,0
LA Lakers,31,29,29,21,0,0,0,0,Utah,24,41,30,22,0,0,0,0,20180403,110,117,-7,5,6,7,7,227,7,2017,0,1,579,0
Sacramento,22,18,29,25,0,0,0,0,Phoenix,22,24,27,24,0,0,0,0,20180403,94,97,0,6,4,3,3,191,3,2017,0,1,634,0
Brooklyn,22,27,22,24,0,0,0,0,Philadelphia,28,33,32,28,0,0,0,0,20180403,95,121,6,12,22,26,26,216,26,2017,0,1,80,0
Golden State,24,33,27,27,0,0,0,0,Oklahoma City,27,20,34,26,0,0,0,0,20180403,111,107,-3,10,3,4,4,218,-4,2017,0,1,1386,0
Orlando,27,19,22,29,0,0,0,0,New York,25,20,16,12,0,0,0,0,20180403,97,73,2,1,7,24,24,170,-24,2017,0,1,939,0
Boston,31,25,15,31,0,0,0,0,Milwaukee,26,32,21,27,0,0,0,0,20180403,102,106,-5,2,8,4,4,208,4,2017,0,1,855,0
Atlanta,25,31,22,20,0,0,0,0,Miami,30,22,26,23,0,0,0,0,20180403,98,101,5,-4,0,3,3,199,3,2017,0,1,605,0
San Antonio,31,25,27,27,0,0,0,0,LA Clippers,17,32,23,41,0,0,0,0,20180403,110,113,-14,-7,-11,3,3,223,3,2017,0,1,1201,0
Washington,24,25,26,29,0,0,0,0,Houston,35,36,24,25,0,0,0,0,20180403,104,120,11,22,20,16,16,224,16,2017,0,1,1217,0
Indiana,26,20,27,31,0,0,0,0,Denver,27,22,28,30,0,0,0,0,20180403,104,107,1,3,4,3,3,211,3,2017,0,1,998,0
Portland,22,27,29,31,0,0,0,0,Dallas,22,28,32,33,0,0,0,0,20180403,109,115,0,1,4,6,6,224,6,2017,0,1,1630,0
Toronto,24,28,26,28,0,0,0,0,Cleveland,28,32,26,26,0,0,0,0,20180403,106,112,4,8,8,6,6,218,6,2017,0,1,187,0
Charlotte,22,25,32,35,0,0,0,0,Chicago,19,34,33,34,0,0,0,0,20180403,114,120,-3,6,7,6,6,234,6,2017,0,1,586,0
Dallas,22,29,23,26,0,0,0,0,Orlando,33,23,21,28,0,0,0,0,20180404,100,105,11,5,3,5,5,205,5,2017,0,2,961,0
Memphis,23,30,20,22,0,0,0,0,New Orleans,32,33,32,26,0,0,0,0,20180404,95,123,9,12,24,28,28,218,28,2017,0,2,358,0
Boston,20,13,20,25,0,0,0,0,Toronto,14,29,24,29,0,0,0,0,20180404,78,96,-6,10,14,18,18,174,18,2017,0,2,430,0
Philadelphia,36,29,23,27,0,0,0,0,Detroit,28,21,22,37,0,0,0,0,20180404,115,108,8,16,17,7,7,223,-7,2017,0,2,441,0
Miami,23,30,31,31,0,0,0,0,Atlanta,29,18,21,18,0,0,0,0,20180404,115,86,-6,6,16,29,29,201,-29,2017,0,2,605,0
San Antonio,30,31,26,21,4,0,0,0,LA Lakers,29,29,23,27,14,0,0,0,20180404,112,122,-1,-3,-6,0,10,234,10,2017,1,2,1201,0
LA Clippers,26,23,18,28,0,0,0,0,Utah,36,29,29,23,0,0,0,0,20180405,95,117,10,16,27,22,22,212,22,2017,0,3,579,0
Brooklyn,30,22,31,36,0,0,0,0,Milwaukee,24,21,36,30,0,0,0,0,20180405,119,111,6,7,2,8,8,230,-8,2017,0,3,732,0
Golden State,26,25,26,29,0,0,0,0,Indiana,27,35,35,29,0,0,0,0,20180405,106,126,1,11,20,20,20,232,20,2017,0,3,1944,0
Minnesota,24,30,18,24,0,0,0,0,Denver,27,24,28,21,0,0,0,0,20180405,96,100,3,-3,7,4,4,196,4,2017,0,3,698,0
Washington,26,28,36,25,0,0,0,0,Cleveland,39,20,23,37,0,0,0,0,20180405,115,119,13,5,-8,4,4,234,4,2017,0,3,304,0
Portland,17,27,27,23,0,0,0,0,Houston,36,30,18,12,0,0,0,0,20180405,94,96,19,22,13,2,2,190,2,2017,0,3,1833,0
Indiana,14,19,16,24,0,0,0,0,Toronto,26,19,27,20,0,0,0,0,20180406,73,92,12,12,23,19,19,165,19,2017,0,4,438,0
Atlanta,21,31,29,22,0,0,0,0,Washington,22,26,29,20,0,0,0,0,20180406,103,97,-1,4,4,6,6,200,-6,2017,0,4,541,0
New Orleans,39,24,23,36,0,0,0,0,Phoenix,21,25,24,33,0,0,0,0,20180406,122,103,18,17,16,19,19,225,-19,2017,0,4,1312,0
Cleveland,28,27,43,32,0,0,0,0,Philadelphia,41,37,27,27,0,0,0,0,20180406,130,132,13,23,7,2,2,262,2,2017,0,4,358,0
Charlotte,43,29,31,34,0,0,0,0,Orlando,25,24,26,25,0,0,0,0,20180406,137,100,18,23,28,37,37,237,-37,2017,0,4,463,0
Miami,23,27,28,20,0,0,0,0,New York,34,29,33,26,0,0,0,0,20180406,98,122,11,13,18,24,24,220,24,2017,0,4,1091,0
Sacramento,25,19,24,26,0,0,0,0,Memphis,22,26,15,30,0,0,0,0,20180406,94,93,3,-4,5,1,1,187,-1,2017,0,4,1745,0
Minnesota,30,21,29,33,0,0,0,0,LA Lakers,26,32,15,23,0,0,0,0,20180406,113,96,4,-7,7,17,17,209,-17,2017,0,4,1521,0
Dallas,24,30,21,26,5,0,0,0,Detroit,22,31,25,23,12,0,0,0,20180406,106,113,-2,-1,3,0,7,219,7,2017,1,4,999,0
Chicago,30,28,18,28,0,0,0,0,Boston,30,25,24,32,0,0,0,0,20180406,104,111,0,-3,3,7,7,215,7,2017,0,4,849,0
Brooklyn,28,35,33,28,0,0,0,0,Chicago,23,28,26,19,0,0,0,0,20180407,124,96,5,12,19,28,28,220,-28,2017,0,5,711,0
New Orleans,40,27,21,38,0,0,0,0,Golden State,32,33,27,28,0,0,0,0,20180407,126,120,8,2,-4,6,6,246,-6,2017,0,5,1921,0
Oklahoma City,36,25,19,28,0,0,0,0,Houston,30,32,21,19,0,0,0,0,20180407,108,102,6,-1,-3,6,6,210,-6,2017,0,5,413,0
Denver,33,33,35,33,0,0,0,0,LA Clippers,26,32,31,26,0,0,0,0,20180407,134,115,7,8,12,19,19,249,-19,2017,0,5,830,0
Milwaukee,31,22,27,35,0,0,0,0,New York,28,27,22,25,0,0,0,0,20180407,115,102,3,-2,3,13,13,217,-13,2017,0,5,732,0
Portland,33,23,21,28,0,0,0,0,San Antonio,32,22,27,35,0,0,0,0,20180407,105,116,-1,-2,4,11,11,221,11,2017,0,5,1718,0
Golden State,33,31,27,26,0,0,0,0,Phoenix,29,21,22,28,0,0,0,0,20180408,117,100,4,14,19,17,17,217,-17,2017,0,6,652,0
Dallas,20,28,28,21,0,0,0,0,Philadelphia,28,33,24,24,0,0,0,0,20180408,97,109,8,13,9,12,12,206,12,2017,0,6,1297,0
Orlando,24,26,24,27,0,0,0,0,Toronto,35,26,28,23,0,0,0,0,20180408,101,112,11,11,15,11,11,213,11,2017,0,6,1048,0
Detroit,22,34,28,33,0,0,0,0,Memphis,30,32,34,34,0,0,0,0,20180408,117,130,8,6,12,13,13,247,13,2017,0,6,622,0
Indiana,31,39,25,28,0,0,0,0,Charlotte,25,32,24,36,0,0,0,0,20180408,123,117,6,13,14,6,6,240,-6,2017,0,6,428,0
Utah,30,20,32,30,0,0,0,0,LA Lakers,21,23,23,30,0,0,0,0,20180408,112,97,9,6,15,15,15,209,-15,2017,0,6,579,0
Atlanta,24,25,27,36,0,0,0,0,Boston,31,27,24,24,0,0,0,0,20180408,112,106,-7,-9,-6,6,6,218,-6,2017,0,6,935,0
Sacramento,25,25,16,19,0,0,0,0,San Antonio,17,26,17,38,0,0,0,0,20180409,85,98,-8,-7,-6,13,13,183,13,2017,0,0,1456,0
Chicago,26,29,28,22,0,0,0,0,Brooklyn,29,33,24,28,0,0,0,0,20180409,105,114,3,7,3,9,9,219,9,2017,0,0,711,0
Portland,23,26,20,13,0,0,0,0,Denver,28,14,24,22,0,0,0,0,20180409,82,88,5,-7,-3,6,6,170,6,2017,0,0,981,0
Toronto,32,25,28,23,0,0,0,0,Detroit,32,28,20,18,0,0,0,0,20180409,108,98,0,-3,5,10,10,206,-10,2017,0,0,205,0
New Orleans,31,28,34,20,0,0,0,0,LA Clippers,23,26,22,29,0,0,0,0,20180409,113,100,8,10,22,13,13,213,-13,2017,0,0,1669,0
Oklahoma City,21,28,27,39,0,0,0,0,Miami,27,25,29,12,0,0,0,0,20180409,115,93,-6,-3,-5,22,22,208,-22,2017,0,0,1225,0
Orlando,21,21,25,19,0,0,0,0,Milwaukee,31,14,29,28,0,0,0,0,20180409,86,102,10,3,7,16,16,188,16,2017,0,0,1065,0
Memphis,26,27,22,19,0,0,0,0,Minnesota,20,36,27,30,0,0,0,0,20180409,94,113,-6,3,8,19,19,207,19,2017,0,0,700,0
Cleveland,26,35,29,33,0,0,0,0,New York,25,24,28,32,0,0,0,0,20180409,123,109,1,12,13,14,14,232,-14,2017,0,0,403,0
Boston,30,24,18,29,0,0,0,0,Washington,22,30,27,34,0,0,0,0,20180410,101,113,-8,-2,7,12,12,214,12,2017,0,1,394,0
Golden State,16,17,23,23,0,0,0,0,Utah,33,29,31,26,0,0,0,0,20180410,79,119,17,29,37,40,40,198,40,2017,0,1,599,0
Houston,23,33,26,23,0,0,0,0,LA Lakers,16,32,27,24,0,0,0,0,20180410,105,99,7,8,7,6,6,204,-6,2017,0,1,1371,0
Philadelphia,27,34,28,32,0,0,0,0,Atlanta,32,23,24,34,0,0,0,0,20180410,121,113,-5,6,10,8,8,234,-8,2017,0,1,665,0
Phoenix,29,15,39,41,0,0,0,0,Dallas,26,28,22,21,0,0,0,0,20180410,124,97,3,-10,7,27,27,221,-27,2017,0,1,884,0
Charlotte,37,26,24,32,0,0,0,0,Indiana,25,30,16,22,0,0,0,0,20180410,119,93,12,8,16,26,26,212,-26,2017,0,1,428,0
Memphis,28,29,39,27,0,0,0,0,Oklahoma City,38,39,28,32,0,0,0,0,20180411,123,137,10,20,9,14,14,260,14,2017,0,2,421,0
Utah,21,20,18,34,0,0,0,0,Portland,28,27,25,22,0,0,0,0,20180411,93,102,7,14,21,9,9,195,9,2017,0,2,634,0
Milwaukee,18,26,31,20,0,0,0,0,Philadelphia,46,34,25,25,0,0,0,0,20180411,95,130,28,36,30,35,35,225,35,2017,0,2,692,0
Washington,23,22,30,17,0,0,0,0,Orlando,26,29,21,25,0,0,0,0,20180411,92,101,3,10,1,9,9,193,9,2017,0,2,757,0
Houston,22,22,19,20,0,0,0,0,Sacramento,28,24,27,17,0,0,0,0,20180411,83,96,6,8,16,13,13,179,13,2017,0,2,1606,0
San Antonio,26,17,29,26,0,0,0,0,New Orleans,27,34,29,32,0,0,0,0,20180411,98,122,1,18,18,24,24,220,24,2017,0,2,506,0
Toronto,29,24,25,27,4,0,0,0,Miami,27,20,24,34,11,0,0,0,20180411,109,116,-2,-6,-7,0,7,225,7,2017,1,2,1234,0
LA Lakers,39,25,28,23,0,0,0,0,LA Clippers,32,21,21,26,0,0,0,0,20180411,115,100,7,11,18,15,15,215,-15,2017,0,2,0,0
New York,20,37,27,26,0,0,0,0,Cleveland,20,17,34,27,0,0,0,0,20180411,110,98,0,20,13,12,12,208,-12,2017,0,2,403,0
Detroit,35,31,28,25,0,0,0,0,Chicago,21,29,24,13,0,0,0,0,20180411,119,87,14,16,20,32,32,206,-32,2017,0,2,238,0
Brooklyn,22,21,27,27,0,0,0,0,Boston,27,26,30,27,0,0,0,0,20180411,97,110,5,10,13,13,13,207,13,2017,0,2,190,0
Denver,26,28,27,20,5,0,0,0,Minnesota,29,33,24,15,11,0,0,0,20180411,106,112,3,8,5,0,6,218,6,2017,1,2,698,0
San Antonio,17,24,22,29,0,0,0,0,Golden State,28,29,29,27,0,0,0,0,20180414,92,113,11,16,23,21,21,205,21,2017,0,5,1487,1
Miami,35,25,18,25,0,0,0,0,Philadelphia,29,27,34,40,0,0,0,0,20180414,103,130,-6,-4,12,27,27,233,27,2017,0,5,1021,1
New Orleans,21,24,30,22,0,0,0,0,Portland,18,18,27,32,0,0,0,0,20180414,97,95,3,9,12,2,2,192,-2,2017,0,5,2059,1
Washington,23,36,26,21,0,0,0,0,Toronto,28,27,31,28,0,0,0,0,20180414,106,114,5,-4,1,8,8,220,8,2017,0,5,349,1
Utah,25,23,24,36,0,0,0,0,Oklahoma City,25,29,27,35,0,0,0,0,20180415,108,116,0,6,9,8,8,224,8,2017,0,6,861,1
Minnesota,21,26,25,29,0,0,0,0,Houston,27,27,22,28,0,0,0,0,20180415,101,104,6,7,4,3,3,205,3,2017,0,6,1057,1
Milwaukee,17,30,19,33,8,0,0,0,Boston,29,15,26,29,14,0,0,0,20180415,107,113,12,-3,4,0,6,220,6,2017,1,6,855,1
Indiana,33,22,18,25,0,0,0,0,Cleveland,14,24,27,15,0,0,0,0,20180415,98,80,19,17,8,18,18,178,-18,2017,0,6,262,1
San Antonio,25,28,22,26,0,0,0,0,Golden State,23,24,33,36,0,0,0,0,20180416,101,116,-2,-6,5,15,15,217,15,2017,0,0,1487,1
Miami,22,34,30,27,0,0,0,0,Philadelphia,29,13,33,28,0,0,0,0,20180416,113,103,-7,14,11,10,10,216,-10,2017,0,0,1021,1
Milwaukee,22,29,24,31,0,0,0,0,Boston,33,27,30,30,0,0,0,0,20180417,106,120,11,9,15,14,14,226,14,2017,0,1,855,1
New Orleans,25,29,33,24,0,0,0,0,Portland,23,36,19,24,0,0,0,0,20180417,111,102,2,-5,9,9,9,213,-9,2017,0,1,2059,1
Washington,27,31,32,29,0,0,0,0,Toronto,44,32,24,30,0,0,0,0,20180417,119,130,17,18,10,11,11,249,11,2017,0,1,349,1
Indiana,18,28,21,30,0,0,0,0,Cleveland,33,25,16,26,0,0,0,0,20180418,97,100,15,12,7,3,3,197,3,2017,0,2,262,1
Minnesota,23,17,18,24,0,0,0,0,Houston,18,37,25,22,0,0,0,0,20180418,82,102,-5,15,22,20,20,184,20,2017,0,2,1057,1
Utah,26,27,21,28,0,0,0,0,Oklahoma City,25,21,33,16,0,0,0,0,20180418,102,95,1,7,-5,7,7,197,-7,2017,0,2,861,1
Golden State,26,26,32,26,0,0,0,0,San Antonio,23,23,26,25,0,0,0,0,20180419,110,97,3,6,12,13,13,207,-13,2017,0,3,1487,1
Philadelphia,37,26,33,32,0,0,0,0,Miami,33,31,30,14,0,0,0,0,20180419,128,108,4,-1,2,20,20,236,-20,2017,0,3,1021,1
Portland,20,25,25,32,0,0,0,0,New Orleans,36,28,27,28,0,0,0,0,20180419,102,119,16,19,21,17,17,221,17,2017,0,3,2059,1
Boston,12,23,32,25,0,0,0,0,Milwaukee,27,31,27,31,0,0,0,0,20180420,92,116,15,23,18,24,24,208,24,2017,0,4,855,1
Toronto,29,32,21,21,0,0,0,0,Washington,30,39,32,21,0,0,0,0,20180420,103,122,1,8,19,19,19,225,19,2017,0,4,349,1
Cleveland,31,26,12,21,0,0,0,0,Indiana,20,20,23,29,0,0,0,0,20180420,90,92,-11,-17,-6,2,2,182,2,2017,0,4,262,1
Philadelphia,26,30,23,27,0,0,0,0,Miami,26,35,22,19,0,0,0,0,20180421,106,102,0,-5,-4,4,4,208,-4,2017,0,5,1021,1
Houston,28,23,24,30,0,0,0,0,Minnesota,27,25,35,34,0,0,0,0,20180421,105,121,-1,1,12,16,16,226,16,2017,0,5,1057,1
Portland,25,31,31,36,0,0,0,0,New Orleans,26,32,42,31,0,0,0,0,20180421,123,131,1,2,13,8,8,254,8,2017,0,5,2059,1
Oklahoma City,30,23,22,27,0,0,0,0,Utah,22,36,31,26,0,0,0,0,20180421,102,115,-8,5,14,13,13,217,13,2017,0,5,861,1
Cleveland,30,30,20,24,0,0,0,0,Indiana,24,26,28,22,0,0,0,0,20180422,104,100,6,10,2,4,4,204,-4,2017,0,6,262,1
Boston,17,18,32,35,0,0,0,0,Milwaukee,24,27,24,29,0,0,0,0,20180422,102,104,7,16,8,2,2,206,2,2017,0,6,855,1
Golden State,22,20,29,19,0,0,0,0,San Antonio,30,26,21,26,0,0,0,0,20180422,90,103,8,14,6,13,13,193,13,2017,0,6,1487,1
Toronto,30,21,29,18,0,0,0,0,Washington,22,18,40,26,0,0,0,0,20180422,98,106,-8,-11,0,8,8,204,8,2017,0,6,349,1
Houston,21,29,50,19,0,0,0,0,Minnesota,21,28,20,31,0,0,0,0,20180423,119,100,0,1,31,19,19,219,-19,2017,0,0,1057,1
Oklahoma City,30,22,21,23,0,0,0,0,Utah,24,34,32,23,0,0,0,0,20180423,96,113,-6,6,17,17,17,209,17,2017,0,0,861,1
Miami,21,25,20,25,0,0,0,0,Philadelphia,23,23,34,24,0,0,0,0,20180424,91,104,2,0,14,13,13,195,13,2017,0,1,1021,1
Milwaukee,15,22,24,26,0,0,0,0,Boston,23,25,24,20,0,0,0,0,20180424,87,92,8,11,11,5,5,179,5,2017,0,1,855,1
San Antonio,20,18,27,26,0,0,0,0,Golden State,22,27,30,20,0,0,0,0,20180424,91,99,2,11,14,8,8,190,8,2017,0,1,1487,1
Indiana,25,31,17,22,0,0,0,0,Cleveland,23,26,32,17,0,0,0,0,20180425,95,98,-2,-7,8,3,3,193,3,2017,0,2,262,1
Minnesota,26,33,15,30,0,0,0,0,Houston,25,30,30,37,0,0,0,0,20180425,104,122,-1,-4,11,18,18,226,18,2017,0,2,1057,1
Utah,34,22,22,21,0,0,0,0,Oklahoma City,29,12,37,29,0,0,0,0,20180425,99,107,-5,-15,0,8,8,206,8,2017,0,2,861,1
Washington,24,23,31,20,0,0,0,0,Toronto,23,25,31,29,0,0,0,0,20180425,98,108,-1,1,1,10,10,206,10,2017,0,2,349,1
Boston,24,15,26,21,0,0,0,0,Milwaukee,22,26,26,23,0,0,0,0,20180426,86,97,-2,9,9,11,11,183,11,2017,0,3,855,1
Cleveland,26,21,20,20,0,0,0,0,Indiana,29,28,35,29,0,0,0,0,20180427,87,121,3,10,25,34,34,208,34,2017,0,4,262,1
Oklahoma City,22,19,29,21,0,0,0,0,Utah,18,23,37,18,0,0,0,0,20180427,91,96,-4,0,8,5,5,187,5,2017,0,4,861,1
Toronto,20,30,23,29,0,0,0,0,Washington,30,23,25,14,0,0,0,0,20180427,102,92,-10,-3,-5,10,10,194,-10,2017,0,4,349,1
Milwaukee,17,25,25,29,0,0,0,0,Boston,30,20,31,31,0,0,0,0,20180428,96,112,13,8,14,16,16,208,16,2017,0,5,855,1
New Orleans,34,21,19,27,0,0,0,0,Golden State,35,41,27,20,0,0,0,0,20180428,101,123,1,21,29,22,22,224,22,2017,0,5,1921,1
Utah,21,18,29,28,0,0,0,0,Houston,34,30,22,24,0,0,0,0,20180429,96,110,13,25,18,14,14,206,14,2017,0,6,1199,1
Indiana,19,24,31,27,0,0,0,0,Cleveland,31,23,22,29,0,0,0,0,20180429,101,105,12,11,2,4,4,206,4,2017,0,6,262,1
Philadelphia,22,23,30,26,0,0,0,0,Boston,25,31,31,30,0,0,0,0,20180430,101,117,3,11,12,16,16,218,16,2017,0,0,270,1
New Orleans,29,26,31,30,0,0,0,0,Golden State,27,31,30,33,0,0,0,0,20180501,116,121,-2,3,2,5,5,237,5,2017,0,1,1921,1
Cleveland,19,38,25,23,8,0,0,0,Toronto,33,27,27,18,7,0,0,0,20180501,113,112,-14,-3,-5,0,1,225,-1,2017,1,1,187,1
Utah,36,28,22,30,0,0,0,0,Houston,28,27,30,23,0,0,0,0,20180502,116,108,8,9,1,8,8,224,-8,2017,0,2,1199,1
Philadelphia,31,25,19,28,0,0,0,0,Boston,22,29,28,29,0,0,0,0,20180503,103,108,-9,-5,4,5,5,211,5,2017,0,3,270,1
Cleveland,26,35,37,30,0,0,0,0,Toronto,29,34,24,23,0,0,0,0,20180503,128,110,-3,-2,11,18,18,238,-18,2017,0,3,187,1
Golden State,21,35,19,25,0,0,0,0,New Orleans,30,32,30,27,0,0,0,0,20180504,100,119,9,6,17,19,19,219,19,2017,0,4,1921,1
Houston,39,31,23,20,0,0,0,0,Utah,22,18,25,27,0,0,0,0,20180504,113,92,17,30,28,21,21,205,-21,2017,0,4,1199,1
Toronto,19,21,25,38,0,0,0,0,Cleveland,24,31,24,26,0,0,0,0,20180505,103,105,5,15,14,2,2,208,2,2017,0,5,187,1
Boston,19,29,21,20,12,0,0,0,Philadelphia,20,31,17,21,9,0,0,0,20180505,101,98,-1,-3,1,0,3,199,-3,2017,1,5,270,1
Houston,30,28,21,21,0,0,0,0,Utah,23,25,17,22,0,0,0,0,20180506,100,87,7,10,14,13,13,187,-13,2017,0,6,1199,1
Golden State,37,24,33,24,0,0,0,0,New Orleans,22,32,19,19,0,0,0,0,20180506,118,92,15,7,21,26,26,210,-26,2017,0,6,1921,1
Toronto,26,21,25,21,0,0,0,0,Cleveland,30,33,37,28,0,0,0,0,20180507,93,128,4,16,28,35,35,221,35,2017,0,0,187,1
Boston,22,21,22,27,0,0,0,0,Philadelphia,21,26,29,27,0,0,0,0,20180507,92,103,-1,4,11,11,11,195,11,2017,0,0,270,1
New Orleans,26,30,19,29,0,0,0,0,Golden State,32,27,36,18,0,0,0,0,20180508,104,113,6,3,20,9,9,217,9,2017,0,1,1921,1
Utah,16,30,32,24,0,0,0,0,Houston,21,33,21,37,0,0,0,0,20180508,102,112,5,8,-3,10,10,214,10,2017,0,1,1199,1
Philadelphia,24,28,30,30,0,0,0,0,Boston,25,36,22,31,0,0,0,0,20180509,112,114,1,9,1,2,2,226,2,2017,0,2,270,1
Cleveland,18,17,29,19,0,0,0,0,Boston,36,25,17,30,0,0,0,0,20180513,83,108,18,26,14,25,25,191,25,2017,0,6,549,1
Golden State,29,27,31,32,0,0,0,0,Houston,30,26,24,26,0,0,0,0,20180514,119,106,-1,0,7,13,13,225,-13,2017,0,0,1642,1
Cleveland,27,28,22,17,0,0,0,0,Boston,23,25,36,23,0,0,0,0,20180515,94,107,-4,-7,7,13,13,201,13,2017,0,1,549,1
Golden State,21,29,29,26,0,0,0,0,Houston,26,38,31,32,0,0,0,0,20180516,105,127,5,14,16,22,22,232,22,2017,0,2,1642,1
Boston,17,24,22,23,0,0,0,0,Cleveland,32,29,26,29,0,0,0,0,20180519,86,116,15,20,24,30,30,202,30,2017,0,5,549,1
Houston,22,21,24,18,0,0,0,0,Golden State,31,23,34,38,0,0,0,0,20180520,85,126,9,11,21,41,41,211,41,2017,0,6,1642,1
Boston,18,35,23,26,0,0,0,0,Cleveland,34,34,21,22,0,0,0,0,20180521,102,111,16,15,13,9,9,213,9,2017,0,0,549,1
Houston,19,34,17,25,0,0,0,0,Golden State,28,18,34,12,0,0,0,0,20180522,95,92,-9,7,-10,3,3,187,-3,2017,0,1,1642,1
Cleveland,19,23,18,23,0,0,0,0,Boston,32,21,23,20,0,0,0,0,20180523,83,96,13,11,16,13,13,179,13,2017,0,2,549,1
Golden State,17,28,27,22,0,0,0,0,Houston,23,22,26,27,0,0,0,0,20180524,94,98,6,0,-1,4,4,192,4,2017,0,3,1642,1
Boston,25,18,30,26,0,0,0,0,Cleveland,20,34,29,26,0,0,0,0,20180525,99,109,-5,11,10,10,10,208,10,2017,0,4,549,1
Houston,39,22,16,9,0,0,0,0,Golden State,22,29,33,31,0,0,0,0,20180526,86,115,-17,-10,7,29,29,201,29,2017,0,5,1642,1
Cleveland,18,21,20,28,0,0,0,0,Boston,26,17,13,23,0,0,0,0,20180527,87,79,-8,-4,3,8,8,166,-8,2017,0,6,549,1
Golden State,19,24,33,25,0,0,0,0,Houston,24,30,15,23,0,0,0,0,20180528,101,92,-5,-11,7,9,9,193,-9,2017,0,0,1642,1
Cleveland,30,26,22,29,7,0,0,0,Golden State,29,27,28,23,17,0,0,0,20180531,114,124,-1,0,6,0,10,238,10,2017,1,3,2161,1
Cleveland,28,18,34,23,0,0,0,0,Golden State,32,27,31,32,0,0,0,0,20180603,103,122,4,13,10,19,19,225,19,2017,0,6,2161,1
Golden State,28,24,31,27,0,0,0,0,Cleveland,29,29,23,21,0,0,0,0,20180606,110,102,-1,-6,2,8,8,212,-8,2017,0,2,2161,1
Golden State,34,27,25,22,0,0,0,0,Cleveland,25,27,13,20,0,0,0,0,20180608,108,85,9,9,21,23,23,193,-23,2017,0,4,2161,1
Philadelphia,21,21,24,21,0,0,0,0,Boston,21,26,30,28,0,0,0,0,20181016,87,105,0,5,11,18,18,192,18,2018,0,1,270,0
Oklahoma City,23,24,32,21,0,0,0,0,Golden State,31,26,26,25,0,0,0,0,20181016,100,108,8,10,4,8,8,208,8,2018,0,1,1386,0
Minnesota,23,29,31,25,0,0,0,0,San Antonio,31,25,25,31,0,0,0,0,20181017,108,112,8,4,-2,4,4,220,4,2018,0,2,1112,0
Utah,30,38,25,30,0,0,0,0,Sacramento,34,21,32,30,0,0,0,0,20181017,123,117,-4,13,6,6,6,240,-6,2018,0,2,532,0
Dallas,24,22,27,27,0,0,0,0,Phoenix,37,19,27,38,0,0,0,0,20181017,100,121,13,10,10,21,21,221,21,2018,0,2,884,0
Miami,31,20,27,23,0,0,0,0,Orlando,25,29,25,25,0,0,0,0,20181017,101,104,-6,3,1,3,3,205,3,2018,0,2,204,0
Atlanta,24,25,35,23,0,0,0,0,New York,23,49,34,20,0,0,0,0,20181017,107,126,-1,23,22,19,19,233,19,2018,0,2,745,0
Milwaukee,36,31,26,20,0,0,0,0,Charlotte,23,31,29,29,0,0,0,0,20181017,113,112,13,13,10,1,1,225,-1,2018,0,2,658,0
Memphis,16,23,19,25,0,0,0,0,Indiana,27,29,20,35,0,0,0,0,20181017,83,111,11,17,18,28,28,194,28,2018,0,2,383,0
New Orleans,35,36,30,30,0,0,0,0,Houston,29,25,30,28,0,0,0,0,20181017,131,112,6,17,17,19,19,243,-19,2018,0,2,317,0
Brooklyn,29,22,25,24,0,0,0,0,Detroit,24,27,32,20,0,0,0,0,20181017,100,103,-5,0,7,3,3,203,3,2018,0,2,480,0
Cleveland,25,22,28,29,0,0,0,0,Toronto,28,32,30,26,0,0,0,0,20181017,104,116,3,13,15,12,12,220,12,2018,0,2,187,0
Denver,29,30,15,33,0,0,0,0,LA Clippers,24,30,18,26,0,0,0,0,20181017,107,98,5,5,2,9,9,205,-9,2018,0,2,830,0
LA Lakers,31,32,28,28,0,0,0,0,Portland,34,31,28,35,0,0,0,0,20181018,119,128,3,2,2,9,9,247,9,2018,0,3,826,0
Miami,24,34,27,28,0,0,0,0,Washington,25,34,30,23,0,0,0,0,20181018,113,112,-1,-1,-4,1,1,225,-1,2018,0,3,924,0
Chicago,41,17,18,32,0,0,0,0,Philadelphia,38,27,37,25,0,0,0,0,20181018,108,127,-3,7,26,19,19,235,19,2018,0,3,664,0
New York,24,26,26,29,0,0,0,0,Brooklyn,33,24,17,33,0,0,0,0,20181019,105,107,9,7,-2,2,2,212,2,2018,0,4,0,0
Oklahoma City,20,26,31,15,0,0,0,0,LA Clippers,27,21,23,37,0,0,0,0,20181019,92,108,7,2,-6,16,16,200,16,2018,0,4,1178,0
Atlanta,33,28,21,35,0,0,0,0,Memphis,37,40,29,25,0,0,0,0,20181019,117,131,4,16,24,14,14,248,14,2018,0,4,336,0
Indiana,25,28,23,25,0,0,0,0,Milwaukee,30,32,31,25,0,0,0,0,20181019,101,118,5,9,17,17,17,219,17,2018,0,4,243,0
Cleveland,30,24,41,28,0,0,0,0,Minnesota,32,39,33,27,0,0,0,0,20181019,123,131,2,17,9,8,8,254,8,2018,0,4,629,0
Sacramento,32,31,27,39,0,0,0,0,New Orleans,40,32,38,39,0,0,0,0,20181019,129,149,8,9,20,20,20,278,20,2018,0,4,1879,0
Charlotte,22,29,31,38,0,0,0,0,Orlando,10,21,23,34,0,0,0,0,20181019,120,88,12,20,28,32,32,208,-32,2018,0,4,463,0
Boston,25,28,26,22,0,0,0,0,Toronto,18,31,33,31,0,0,0,0,20181019,101,113,-7,-4,3,12,12,214,12,2018,0,4,430,0
Golden State,32,37,28,27,0,0,0,0,Utah,34,47,22,20,0,0,0,0,20181019,124,123,-2,-12,-6,1,1,247,-1,2018,0,4,599,0
Phoenix,16,33,30,12,0,0,0,0,Denver,30,35,27,27,0,0,0,0,20181020,91,119,14,16,13,28,28,210,28,2018,0,5,585,0
San Antonio,22,28,32,26,0,0,0,0,Portland,22,37,38,24,0,0,0,0,20181020,108,121,0,9,15,13,13,229,13,2018,0,5,1718,0
Orlando,32,20,34,29,0,0,0,0,Philadelphia,30,33,26,27,0,0,0,0,20181020,115,116,-2,11,3,1,1,231,1,2018,0,5,864,0
Boston,31,19,27,26,0,0,0,0,New York,18,30,22,31,0,0,0,0,20181020,103,101,13,2,7,2,2,204,-2,2018,0,5,190,0
Charlotte,34,38,20,21,0,0,0,0,Miami,29,23,30,30,0,0,0,0,20181020,113,112,5,20,10,1,1,225,-1,2018,0,5,654,0
Detroit,25,35,25,33,0,0,0,0,Chicago,27,31,26,32,0,0,0,0,20181020,118,116,-2,2,1,2,2,234,-2,2018,0,5,238,0
Brooklyn,29,29,27,27,0,0,0,0,Indiana,33,34,28,37,0,0,0,0,20181020,112,132,4,9,10,20,20,244,20,2018,0,5,643,0
Minnesota,46,23,30,37,0,0,0,0,Dallas,37,32,28,43,0,0,0,0,20181020,136,140,-9,0,-2,4,4,276,4,2018,0,5,863,0
Toronto,24,33,33,27,0,0,0,0,Washington,22,32,28,31,0,0,0,0,20181020,117,113,2,3,8,4,4,230,-4,2018,0,5,349,0
Houston,31,35,32,26,0,0,0,0,LA Lakers,28,34,35,18,0,0,0,0,20181020,124,115,3,4,1,9,9,239,-9,2018,0,5,1371,0
Houston,24,29,31,28,0,0,0,0,LA Clippers,29,25,39,22,0,0,0,0,20181021,112,115,5,1,9,3,3,227,3,2018,0,6,1371,0
Sacramento,34,34,29,34,0,0,0,0,Oklahoma City,32,24,34,30,0,0,0,0,20181021,131,120,2,12,7,11,11,251,-11,2018,0,6,1336,0
Atlanta,24,40,28,41,0,0,0,0,Cleveland,34,26,26,25,0,0,0,0,20181021,133,111,-10,4,6,22,22,244,-22,2018,0,6,555,0
Golden State,25,24,21,28,0,0,0,0,Denver,17,30,33,20,0,0,0,0,20181021,98,100,-8,-2,10,2,2,198,2,2018,0,6,947,0
Charlotte,22,25,32,27,0,0,0,0,Toronto,31,31,35,30,0,0,0,0,20181022,106,127,9,15,18,21,21,233,21,2018,0,0,585,0
Washington,28,34,16,33,14,0,0,0,Portland,32,30,15,34,13,0,0,0,20181022,125,124,-4,0,1,0,1,249,-1,2018,1,0,2347,0
Memphis,19,28,23,22,0,0,0,0,Utah,22,24,17,21,0,0,0,0,20181022,92,84,-3,1,7,8,8,176,-8,2018,0,0,1247,0
Indiana,28,21,24,18,0,0,0,0,Minnesota,25,25,22,29,0,0,0,0,20181022,91,101,-3,1,-1,10,10,192,10,2018,0,0,510,0
New York,29,23,35,26,0,0,0,0,Milwaukee,33,38,17,36,0,0,0,0,20181022,113,124,4,19,1,11,11,237,11,2018,0,0,732,0
San Antonio,40,25,34,29,15,0,0,0,LA Lakers,26,34,36,32,14,0,0,0,20181022,143,142,14,5,3,0,1,285,-1,2018,1,0,1201,0
Phoenix,23,24,34,22,0,0,0,0,Golden State,32,38,36,17,0,0,0,0,20181022,103,123,9,23,25,20,20,226,20,2018,0,0,652,0
Chicago,28,33,23,25,0,0,0,0,Dallas,31,28,29,27,0,0,0,0,20181022,109,115,3,-2,4,6,6,224,6,2018,0,0,802,0
Orlando,28,20,27,18,0,0,0,0,Boston,19,26,25,20,0,0,0,0,20181022,93,90,9,3,5,3,3,183,-3,2018,0,0,1115,0
Sacramento,26,29,26,31,0,0,0,0,Denver,33,35,37,21,0,0,0,0,20181023,112,126,7,13,24,14,14,238,14,2018,0,1,886,0
Philadelphia,28,36,30,26,12,0,0,0,Detroit,27,34,26,33,13,0,0,0,20181023,132,133,-1,-3,-7,0,1,265,1,2018,1,1,441,0
LA Clippers,26,36,22,25,0,0,0,0,New Orleans,27,32,32,25,0,0,0,0,20181023,109,116,1,-3,7,7,7,225,7,2018,0,1,1669,0
Minnesota,19,29,26,31,0,0,0,0,Toronto,26,31,26,29,0,0,0,0,20181024,105,112,7,9,9,7,7,217,7,2018,0,2,691,0
Indiana,28,34,26,28,0,0,0,0,San Antonio,22,28,21,25,0,0,0,0,20181024,116,96,6,12,17,20,20,212,-20,2018,0,2,999,0
Memphis,28,24,19,21,0,0,0,0,Sacramento,19,25,27,26,0,0,0,0,20181024,92,97,-9,-8,0,5,5,189,5,2018,0,2,1745,0
LA Lakers,32,44,30,25,0,0,0,0,Phoenix,30,24,32,27,0,0,0,0,20181024,131,113,2,22,20,18,18,244,-18,2018,0,2,356,0
Philadelphia,34,30,17,27,0,0,0,0,Milwaukee,22,49,21,31,0,0,0,0,20181024,108,123,-12,7,11,15,15,231,15,2018,0,2,692,0
New York,27,18,20,22,0,0,0,0,Miami,16,31,45,18,0,0,0,0,20181024,87,110,-11,2,27,23,23,197,23,2018,0,2,1091,0
Utah,24,28,23,25,0,0,0,0,Houston,29,15,22,23,0,0,0,0,20181024,100,89,-5,8,9,11,11,189,-11,2018,0,2,1199,0
Washington,37,34,26,25,0,0,0,0,Golden State,46,34,35,29,0,0,0,0,20181024,122,144,9,9,18,22,22,266,22,2018,0,2,2435,0
Brooklyn,24,21,38,19,0,0,0,0,Cleveland,17,28,17,24,0,0,0,0,20181024,102,86,7,0,21,16,16,188,-16,2018,0,2,403,0
Charlotte,27,26,29,28,0,0,0,0,Chicago,24,30,34,24,0,0,0,0,20181024,110,112,-3,1,6,2,2,222,2,2018,0,2,586,0
Dallas,42,16,29,17,0,0,0,0,Atlanta,22,26,32,31,0,0,0,0,20181024,104,111,-20,-10,-7,7,7,215,7,2018,0,2,719,0
Cleveland,27,23,18,35,0,0,0,0,Detroit,30,28,22,30,0,0,0,0,20181025,103,110,3,8,12,7,7,213,7,2018,0,3,90,0
Denver,26,31,32,25,0,0,0,0,LA Lakers,22,36,29,34,0,0,0,0,20181025,114,121,-4,1,-2,7,7,235,7,2018,0,3,830,0
Boston,16,18,40,27,0,0,0,0,Oklahoma City,22,28,23,22,0,0,0,0,20181025,101,95,-6,-16,1,6,6,196,-6,2018,0,3,1492,0
Portland,33,25,33,37,0,0,0,0,Orlando,22,26,36,30,0,0,0,0,20181025,128,114,11,10,7,14,14,242,-14,2018,0,3,2525,0
Dallas,26,34,29,18,0,0,0,0,Toronto,39,30,23,24,0,0,0,0,20181026,107,116,13,9,3,9,9,223,9,2018,0,4,1201,0
Golden State,25,28,28,47,0,0,0,0,New York,25,28,31,16,0,0,0,0,20181026,128,100,0,0,-3,28,28,228,-28,2018,0,4,2565,0
Brooklyn,30,36,25,24,0,0,0,0,New Orleans,32,25,31,29,0,0,0,0,20181026,115,117,2,-9,-3,2,2,232,2,2018,0,4,1168,0
Washington,27,34,24,27,0,0,0,0,Sacramento,28,27,24,37,0,0,0,0,20181026,112,116,1,-6,-6,4,4,228,4,2018,0,4,2371,0
LA Clippers,31,39,26,37,0,0,0,0,Houston,30,31,22,30,0,0,0,0,20181026,133,113,1,9,13,20,20,246,-20,2018,0,4,1371,0
Chicago,25,29,21,31,0,0,0,0,Charlotte,23,45,34,33,0,0,0,0,20181026,106,135,-2,14,27,29,29,241,29,2018,0,4,586,0
Milwaukee,27,36,34,28,0,0,0,0,Minnesota,16,22,29,28,0,0,0,0,20181026,125,95,11,25,30,30,30,220,-30,2018,0,4,298,0
Chicago,22,19,26,30,0,0,0,0,Atlanta,25,19,19,22,0,0,0,0,20181027,97,85,-3,-3,4,12,12,182,-12,2018,0,5,587,0
Indiana,30,30,28,31,0,0,0,0,Cleveland,30,25,28,24,0,0,0,0,20181027,119,107,0,5,5,12,12,226,-12,2018,0,5,262,0
Boston,30,33,21,25,0,0,0,0,Detroit,21,20,26,22,0,0,0,0,20181027,109,89,9,22,17,20,20,198,-20,2018,0,5,611,0
Phoenix,18,25,28,25,0,0,0,0,Memphis,26,42,19,30,0,0,0,0,20181027,96,117,8,25,16,21,21,213,21,2018,0,5,1260,0
Portland,22,20,37,32,0,0,0,0,Miami,33,24,32,31,0,0,0,0,20181027,111,120,11,15,10,9,9,231,9,2018,0,5,2704,0
Orlando,25,26,17,23,0,0,0,0,Milwaukee,30,35,28,20,0,0,0,0,20181027,91,113,5,14,25,22,22,204,22,2018,0,5,1065,0
Utah,28,36,38,30,0,0,0,0,New Orleans,31,18,33,29,0,0,0,0,20181027,132,111,-3,15,20,21,21,243,-21,2018,0,5,1432,0
Charlotte,28,34,23,18,0,0,0,0,Philadelphia,32,31,20,22,0,0,0,0,20181027,103,105,4,1,-2,2,2,208,2,2018,0,5,450,0
LA Lakers,36,24,28,18,0,0,0,0,San Antonio,29,25,33,23,0,0,0,0,20181027,106,110,-7,-6,-1,4,4,216,4,2018,0,5,1201,0
Phoenix,20,28,28,34,0,0,0,0,Oklahoma City,30,32,34,21,0,0,0,0,20181028,110,117,10,14,20,7,7,227,7,2018,0,6,840,0
Washington,20,34,23,27,0,0,0,0,LA Clippers,28,41,28,39,0,0,0,0,20181028,104,136,8,15,20,32,32,240,32,2018,0,6,2294,0
Golden State,32,31,30,27,0,0,0,0,Brooklyn,29,20,28,37,0,0,0,0,20181028,120,114,3,14,16,6,6,234,-6,2018,0,6,2565,0
Utah,26,24,32,31,0,0,0,0,Dallas,19,27,31,27,0,0,0,0,20181028,113,104,7,4,5,9,9,217,-9,2018,0,6,998,0
Golden State,44,48,33,24,0,0,0,0,Chicago,28,22,39,35,0,0,0,0,20181029,149,124,16,42,36,25,25,273,-25,2018,0,0,1853,0
New Orleans,24,21,31,35,0,0,0,0,Denver,20,38,26,32,0,0,0,0,20181029,111,116,-4,13,8,5,5,227,5,2018,0,0,1079,0
Portland,23,22,26,32,0,0,0,0,Indiana,16,33,20,24,0,0,0,0,20181029,103,93,7,-4,2,10,10,196,-10,2018,0,0,1880,0
Sacramento,17,34,43,29,0,0,0,0,Miami,28,23,32,30,0,0,0,0,20181029,123,113,-11,0,11,10,10,236,-10,2018,0,0,2547,0
Toronto,29,24,27,29,0,0,0,0,Milwaukee,30,32,33,29,0,0,0,0,20181029,109,124,1,9,15,15,15,233,15,2018,0,0,429,0
LA Lakers,32,34,28,26,0,0,0,0,Minnesota,36,28,29,31,0,0,0,0,20181029,120,124,4,-2,-1,4,4,244,4,2018,0,0,1521,0
Brooklyn,26,18,23,29,0,0,0,0,New York,26,26,33,30,0,0,0,0,20181029,96,115,0,8,18,19,19,211,19,2018,0,0,0,0
Atlanta,25,22,13,32,0,0,0,0,Philadelphia,20,27,31,35,0,0,0,0,20181029,92,113,-5,0,18,21,21,205,21,2018,0,0,665,0
Dallas,18,27,29,28,6,0,0,0,San Antonio,20,33,23,26,11,0,0,0,20181029,108,113,2,8,2,0,5,221,5,2018,1,0,252,0
LA Clippers,33,34,10,33,0,0,0,0,Oklahoma City,25,29,39,35,0,0,0,0,20181030,110,128,-8,-13,16,18,18,238,18,2018,0,1,1178,0
Philadelphia,26,27,33,26,0,0,0,0,Toronto,35,32,38,24,0,0,0,0,20181030,112,129,9,14,19,17,17,241,17,2018,0,1,334,0
Sacramento,26,33,26,22,0,0,0,0,Orlando,31,25,16,27,0,0,0,0,20181030,107,99,-5,3,13,8,8,206,-8,2018,0,1,2390,0
Washington,24,21,27,23,0,0,0,0,Memphis,22,24,32,29,0,0,0,0,20181030,95,107,-2,1,6,12,12,202,12,2018,0,1,762,0
Miami,29,26,18,40,0,0,0,0,Charlotte,31,34,27,33,0,0,0,0,20181030,113,125,2,10,19,12,12,238,12,2018,0,1,654,0
Atlanta,31,26,30,27,0,0,0,0,Cleveland,35,23,41,37,0,0,0,0,20181030,114,136,4,1,12,22,22,250,22,2018,0,1,555,0
Portland,19,32,34,19,0,0,0,0,Houston,15,21,26,23,0,0,0,0,20181030,104,85,4,15,23,19,19,189,-19,2018,0,1,1833,0
Detroit,28,30,13,34,0,0,0,0,Boston,31,25,25,27,0,0,0,0,20181030,105,108,3,-2,10,3,3,213,3,2018,0,1,611,0
Detroit,22,38,23,27,9,0,0,0,Brooklyn,28,26,23,33,10,0,0,0,20181031,119,120,6,-6,-6,0,1,239,1,2018,1,2,480,0
Denver,28,23,29,18,10,0,0,0,Chicago,24,24,30,20,9,0,0,0,20181031,108,107,4,3,2,0,1,215,-1,2018,1,2,916,0
New Orleans,37,26,29,29,0,0,0,0,Golden State,43,27,37,24,0,0,0,0,20181031,121,131,6,7,15,10,10,252,10,2018,0,2,1921,0
Dallas,21,38,22,32,0,0,0,0,LA Lakers,38,28,28,20,0,0,0,0,20181031,113,114,17,7,13,1,1,227,1,2018,0,2,1237,0
Utah,25,31,40,29,0,0,0,0,Minnesota,32,33,36,27,0,0,0,0,20181031,125,128,7,9,5,3,3,253,3,2018,0,2,984,0
Indiana,28,22,27,30,0,0,0,0,New York,25,27,29,20,0,0,0,0,20181031,107,101,3,-2,-4,6,6,208,-6,2018,0,2,643,0
San Antonio,28,32,34,26,0,0,0,0,Phoenix,15,24,27,24,0,0,0,0,20181031,120,90,13,21,28,30,30,210,-30,2018,0,2,846,0
New Orleans,31,34,34,20,0,0,0,0,Portland,35,35,32,30,0,0,0,0,20181101,119,132,4,5,3,13,13,251,13,2018,0,3,2059,0
LA Clippers,30,27,29,27,0,0,0,0,Philadelphia,34,38,18,32,0,0,0,0,20181101,113,122,4,15,4,9,9,235,9,2018,0,3,2388,0
Denver,15,35,33,27,0,0,0,0,Cleveland,27,15,24,25,0,0,0,0,20181101,110,91,-12,8,17,19,19,201,-19,2018,0,3,1223,0
Milwaukee,16,37,25,35,0,0,0,0,Boston,23,32,38,24,0,0,0,0,20181101,113,117,7,2,15,4,4,230,4,2018,0,3,855,0
Sacramento,35,34,46,31,0,0,0,0,Atlanta,29,35,23,28,0,0,0,0,20181101,146,115,6,5,28,31,31,261,-31,2018,0,3,2082,0
Oklahoma City,24,20,29,38,0,0,0,0,Charlotte,22,26,29,30,0,0,0,0,20181101,111,107,2,-4,-4,4,4,218,-4,2018,0,3,938,0
Houston,25,31,35,28,0,0,0,0,Brooklyn,32,29,25,25,0,0,0,0,20181102,119,111,-7,-5,5,8,8,230,-8,2018,0,4,1417,0
Indiana,22,38,27,20,0,0,0,0,Chicago,37,21,22,25,0,0,0,0,20181102,107,105,-15,2,7,2,2,212,-2,2018,0,4,163,0
New York,33,23,33,29,0,0,0,0,Dallas,27,32,18,29,0,0,0,0,20181102,118,106,6,-3,12,12,12,224,-12,2018,0,4,1370,0
Minnesota,32,26,29,12,0,0,0,0,Golden State,36,25,22,33,0,0,0,0,20181102,99,116,4,3,-4,17,17,215,17,2018,0,4,1581,0
LA Clippers,22,35,30,33,0,0,0,0,Orlando,22,22,28,23,0,0,0,0,20181102,120,95,0,13,15,25,25,215,-25,2018,0,4,2197,0
Toronto,23,25,29,30,0,0,0,0,Phoenix,26,26,19,27,0,0,0,0,20181102,107,98,-3,-4,6,9,9,205,-9,2018,0,4,1885,0
Memphis,29,24,30,27,0,0,0,0,Utah,31,29,18,22,0,0,0,0,20181102,110,100,-2,-7,5,10,10,210,-10,2018,0,4,1247,0
Oklahoma City,35,44,31,24,0,0,0,0,Washington,30,20,35,26,0,0,0,0,20181102,134,111,5,29,25,23,23,245,-23,2018,0,4,1149,0
Detroit,24,23,25,27,0,0,0,0,Philadelphia,30,39,16,24,0,0,0,0,20181103,99,109,6,22,13,10,10,208,10,2018,0,5,441,0
New Orleans,17,22,29,27,0,0,0,0,San Antonio,24,34,29,22,0,0,0,0,20181103,95,109,7,19,19,14,14,204,14,2018,0,5,506,0
LA Lakers,28,28,32,26,0,0,0,0,Portland,29,28,16,37,0,0,0,0,20181103,114,110,-1,-1,15,4,4,224,-4,2018,0,5,826,0
Boston,28,17,27,29,0,0,0,0,Indiana,18,27,27,30,0,0,0,0,20181103,101,102,-10,0,0,1,1,203,1,2018,0,5,805,0
Miami,31,37,25,25,0,0,0,0,Atlanta,41,33,28,21,0,0,0,0,20181103,118,123,10,6,9,5,5,241,5,2018,0,5,605,0
Cleveland,22,30,21,21,0,0,0,0,Charlotte,30,29,34,33,0,0,0,0,20181103,94,126,8,7,20,32,32,220,32,2018,0,5,435,0
Houston,27,27,21,21,0,0,0,0,Chicago,28,28,7,25,0,0,0,0,20181103,96,88,-1,-2,12,8,8,184,-8,2018,0,5,939,0
Utah,25,21,27,15,0,0,0,0,Denver,25,22,21,35,0,0,0,0,20181103,88,103,0,1,-5,15,15,191,15,2018,0,5,370,0
Orlando,36,27,28,26,0,0,0,0,San Antonio,26,28,20,36,0,0,0,0,20181104,117,110,10,9,17,7,7,227,-7,2018,0,6,1035,0
Minnesota,27,18,19,17,0,0,0,0,Portland,30,31,31,19,0,0,0,0,20181104,81,111,3,16,28,30,30,192,30,2018,0,6,1423,0
Memphis,28,28,25,19,0,0,0,0,Phoenix,21,31,25,25,0,0,0,0,20181104,100,102,-7,-4,-4,2,2,202,2,2018,0,6,1260,0
New York,17,33,28,17,0,0,0,0,Washington,24,34,23,27,0,0,0,0,20181104,95,108,7,8,3,13,13,203,13,2018,0,6,204,0
Toronto,42,29,30,20,0,0,0,0,LA Lakers,17,32,31,27,0,0,0,0,20181104,121,107,25,22,21,14,14,228,-14,2018,0,6,2170,0
Philadelphia,21,26,28,22,0,0,0,0,Brooklyn,18,33,41,30,0,0,0,0,20181104,97,122,-3,4,17,25,25,219,25,2018,0,6,80,0
Sacramento,30,20,32,27,0,0,0,0,Milwaukee,39,33,36,36,0,0,0,0,20181104,109,144,9,22,26,35,35,253,35,2018,0,6,1771,0
Toronto,30,35,29,30,0,0,0,0,Utah,31,23,18,39,0,0,0,0,20181105,124,111,-1,11,22,13,13,235,-13,2018,0,0,1664,0
Boston,34,22,25,26,0,0,0,0,Denver,19,35,34,27,0,0,0,0,20181105,107,115,-15,-2,7,8,8,222,8,2018,0,0,1765,0
Miami,28,25,34,18,15,0,0,0,Detroit,27,26,27,25,10,0,0,0,20181105,120,115,1,0,7,0,5,235,-5,2018,1,0,1155,0
Memphis,31,27,15,28,0,0,0,0,Golden State,29,29,34,25,0,0,0,0,20181105,101,117,-2,0,19,16,16,218,16,2018,0,0,1798,0
Houston,29,24,16,29,0,0,0,0,Indiana,22,33,20,19,0,0,0,0,20181105,98,94,7,-2,-6,4,4,192,-4,2018,0,0,865,0
Minnesota,33,26,25,25,0,0,0,0,LA Clippers,31,32,29,28,0,0,0,0,20181105,109,120,-2,4,8,11,11,229,11,2018,0,0,1521,0
Chicago,24,23,31,24,6,8,0,0,New York,21,26,25,30,6,7,0,0,20181105,116,115,3,0,6,0,1,231,-1,2018,2,0,711,0
New Orleans,28,35,23,30,0,0,0,0,Oklahoma City,36,26,38,22,0,0,0,0,20181105,116,122,8,-1,14,6,6,238,6,2018,0,0,576,0
Cleveland,21,26,32,21,0,0,0,0,Orlando,30,28,12,32,0,0,0,0,20181105,100,102,9,11,-9,2,2,202,2,2018,0,0,895,0
Brooklyn,24,28,24,28,0,0,0,0,Phoenix,22,20,24,16,0,0,0,0,20181106,104,82,2,10,10,22,22,186,-22,2018,0,1,2139,0
Milwaukee,31,20,26,26,0,0,0,0,Portland,33,24,34,27,0,0,0,0,20181106,103,118,2,6,14,15,15,221,15,2018,0,1,1714,0
Atlanta,25,29,23,25,0,0,0,0,Charlotte,23,28,30,32,0,0,0,0,20181106,102,113,-2,-3,4,11,11,215,11,2018,0,1,226,0
Washington,24,25,29,22,0,0,0,0,Dallas,35,35,17,32,0,0,0,0,20181106,100,119,11,21,9,19,19,219,19,2018,0,1,1181,0
Dallas,18,27,38,19,0,0,0,0,Utah,30,38,31,18,0,0,0,0,20181107,102,117,12,23,16,15,15,219,15,2018,0,2,998,0
Chicago,26,24,22,26,0,0,0,0,New Orleans,29,29,27,22,0,0,0,0,20181107,98,107,3,8,13,9,9,205,9,2018,0,2,832,0
Toronto,29,35,30,20,0,0,0,0,Sacramento,26,25,27,27,0,0,0,0,20181107,114,105,3,13,16,9,9,219,-9,2018,0,2,2195,0
Detroit,26,32,20,25,0,0,0,0,Orlando,31,20,29,16,0,0,0,0,20181107,103,96,-5,7,-2,7,7,199,-7,2018,0,2,957,0
San Antonio,20,22,22,24,0,0,0,0,Miami,27,23,25,20,0,0,0,0,20181107,88,95,7,8,11,7,7,183,7,2018,0,2,1147,0
Philadelphia,29,21,28,22,0,0,0,0,Indiana,23,27,21,23,0,0,0,0,20181107,100,94,6,0,7,6,6,194,-6,2018,0,2,582,0
Minnesota,32,35,21,22,0,0,0,0,LA Lakers,30,35,21,28,0,0,0,0,20181107,110,114,-2,-2,-2,4,4,224,4,2018,0,2,1521,0
New York,26,26,35,25,0,0,0,0,Atlanta,26,29,18,34,0,0,0,0,20181107,112,107,0,-3,14,5,5,219,-5,2018,0,2,745,0
Denver,29,18,23,17,0,0,0,0,Memphis,22,28,20,19,0,0,0,0,20181107,87,89,-7,3,0,2,2,176,2,2018,0,2,877,0
Oklahoma City,23,25,23,24,0,0,0,0,Cleveland,20,20,24,22,0,0,0,0,20181107,95,86,3,8,7,9,9,181,-9,2018,0,2,949,0
Milwaukee,32,32,41,29,0,0,0,0,Golden State,29,22,28,32,0,0,0,0,20181108,134,111,3,13,26,23,23,245,-23,2018,0,3,1838,0
Houston,19,26,15,20,0,0,0,0,Oklahoma City,29,30,21,18,0,0,0,0,20181108,80,98,10,14,20,18,18,178,18,2018,0,3,413,0
Boston,13,22,30,35,16,0,0,0,Phoenix,32,23,25,20,9,0,0,0,20181108,116,109,-19,-20,-15,0,7,225,-7,2018,1,3,2295,0
LA Clippers,28,29,24,24,0,0,0,0,Portland,37,24,23,32,0,0,0,0,20181108,105,116,9,4,3,11,11,221,11,2018,0,3,826,0
Boston,25,26,29,35,0,0,0,0,Utah,27,31,35,30,0,0,0,0,20181109,115,123,2,7,13,8,8,238,8,2018,0,4,2093,0
Minnesota,31,30,20,29,0,0,0,0,Sacramento,29,34,29,29,0,0,0,0,20181109,110,121,-2,2,11,11,11,231,11,2018,0,4,1511,0
Charlotte,33,17,35,34,13,0,0,0,Philadelphia,33,32,31,23,14,0,0,0,20181109,132,133,0,15,11,0,1,265,1,2018,1,4,450,0
Washington,25,23,26,34,0,0,0,0,Orlando,32,31,26,28,0,0,0,0,20181109,108,117,7,15,15,9,9,225,9,2018,0,4,757,0
Indiana,24,27,33,26,0,0,0,0,Miami,26,33,21,22,0,0,0,0,20181109,110,102,-2,-8,4,8,8,212,-8,2018,0,4,1026,0
Brooklyn,34,21,27,30,0,0,0,0,Denver,24,23,29,34,0,0,0,0,20181109,112,110,10,8,6,2,2,222,-2,2018,0,4,1627,0
Detroit,40,34,29,21,0,0,0,0,Atlanta,20,31,26,32,0,0,0,0,20181109,124,109,20,23,26,15,15,233,-15,2018,0,4,597,0
New York,25,28,29,30,0,0,0,0,Toronto,25,39,36,28,0,0,0,0,20181110,112,128,0,11,18,16,16,240,16,2018,0,5,341,0
Houston,21,29,21,18,0,0,0,0,San Antonio,20,32,20,24,0,0,0,0,20181110,89,96,-1,2,1,7,7,185,7,2018,0,5,189,0
LA Lakers,26,24,26,25,0,0,0,0,Sacramento,20,24,21,21,0,0,0,0,20181110,101,86,6,6,11,15,15,187,-15,2018,0,5,361,0
Phoenix,26,27,29,17,0,0,0,0,New Orleans,33,28,30,28,0,0,0,0,20181110,99,119,7,8,9,20,20,218,20,2018,0,5,1312,0
Washington,25,33,25,33,0,0,0,0,Miami,35,26,24,25,0,0,0,0,20181110,116,110,-10,-3,-2,6,6,226,-6,2018,0,5,924,0
Milwaukee,24,40,20,35,7,0,0,0,LA Clippers,33,29,27,30,9,0,0,0,20181110,126,128,9,-2,5,0,2,254,2,2018,1,5,1741,0
Brooklyn,30,23,21,26,0,0,0,0,Golden State,36,29,29,22,0,0,0,0,20181110,100,116,6,12,20,16,16,216,16,2018,0,5,2565,0
Oklahoma City,22,23,25,26,0,0,0,0,Dallas,23,34,25,29,0,0,0,0,20181110,96,111,1,12,12,15,15,207,15,2018,0,5,189,0
Cleveland,23,30,24,21,0,0,0,0,Chicago,37,16,26,20,0,0,0,0,20181110,98,99,14,0,2,1,1,197,1,2018,0,5,308,0
Philadelphia,26,37,17,22,4,0,0,0,Memphis,21,29,24,28,10,0,0,0,20181110,106,112,-5,-13,-6,0,6,218,6,2018,1,5,878,0
Milwaukee,33,30,36,22,0,0,0,0,Denver,35,24,29,26,0,0,0,0,20181111,121,114,-2,4,11,7,7,235,-7,2018,0,6,912,0
Charlotte,24,27,32,30,0,0,0,0,Detroit,27,22,26,28,0,0,0,0,20181111,113,103,-3,2,8,10,10,216,-10,2018,0,6,504,0
Indiana,31,23,27,22,0,0,0,0,Houston,32,44,26,13,0,0,0,0,20181111,103,115,1,22,21,12,12,218,12,2018,0,6,865,0
Atlanta,22,31,22,31,0,0,0,0,LA Lakers,28,24,32,23,0,0,0,0,20181111,106,107,6,-1,9,1,1,213,1,2018,0,6,1932,0
Orlando,30,35,22,28,0,0,0,0,New York,10,30,20,29,0,0,0,0,20181111,115,89,20,25,27,26,26,204,-26,2018,0,6,939,0
Boston,21,16,33,24,0,0,0,0,Portland,26,28,29,17,0,0,0,0,20181111,94,100,5,17,13,6,6,194,6,2018,0,6,2532,0
San Antonio,24,31,21,23,0,0,0,0,Sacramento,25,31,21,27,0,0,0,0,20181112,99,104,1,1,1,5,5,203,5,2018,0,0,1456,0
Orlando,30,25,28,26,0,0,0,0,Washington,30,25,28,34,0,0,0,0,20181112,109,117,0,0,0,8,8,226,8,2018,0,0,757,0
New Orleans,31,35,28,32,0,0,0,0,Toronto,29,32,22,27,0,0,0,0,20181112,126,110,2,5,11,16,16,236,-16,2018,0,0,1112,0
Phoenix,13,27,35,26,0,0,0,0,Oklahoma City,32,32,22,32,0,0,0,0,20181112,101,118,19,24,11,17,17,219,17,2018,0,0,840,0
Dallas,25,31,22,25,0,0,0,0,Chicago,20,29,26,23,0,0,0,0,20181112,103,98,5,7,3,5,5,201,-5,2018,0,0,802,0
Philadelphia,32,32,32,28,0,0,0,0,Miami,26,36,28,24,0,0,0,0,20181112,124,114,6,2,6,10,10,238,-10,2018,0,0,1021,0
Utah,20,20,34,22,0,0,0,0,Memphis,16,27,26,19,0,0,0,0,20181112,96,88,4,-3,5,8,8,184,-8,2018,0,0,1247,0
Golden State,30,31,20,25,10,0,0,0,LA Clippers,34,30,26,16,15,0,0,0,20181112,116,121,4,3,9,0,5,237,5,2018,1,0,347,0
Brooklyn,31,22,32,28,0,0,0,0,Minnesota,30,27,36,27,0,0,0,0,20181112,113,120,-1,4,8,7,7,233,7,2018,0,0,1016,0
Charlotte,23,28,18,20,0,0,0,0,Cleveland,38,29,21,25,0,0,0,0,20181113,89,113,15,16,19,24,24,202,24,2018,0,1,435,0
Houston,27,27,32,23,0,0,0,0,Denver,30,25,21,23,0,0,0,0,20181113,109,99,-3,-1,10,10,10,208,-10,2018,0,1,878,0
Atlanta,23,29,24,27,0,0,0,0,Golden State,20,29,33,28,0,0,0,0,20181113,103,110,-3,-3,6,7,7,213,7,2018,0,1,2135,0
Cleveland,29,23,22,21,0,0,0,0,Washington,41,32,23,23,0,0,0,0,20181114,95,119,12,21,22,24,24,214,24,2018,0,2,304,0
Detroit,26,27,24,29,0,0,0,0,Toronto,31,34,23,16,0,0,0,0,20181114,106,104,-5,-12,-11,2,2,210,-2,2018,0,2,205,0
San Antonio,19,29,22,26,0,0,0,0,Phoenix,34,18,35,29,0,0,0,0,20181114,96,116,15,4,17,20,20,212,20,2018,0,2,846,0
Philadelphia,30,22,35,19,0,0,0,0,Orlando,27,26,23,35,0,0,0,0,20181114,106,111,-3,1,-11,5,5,217,5,2018,0,2,864,0
New York,22,27,31,23,0,0,0,0,Oklahoma City,37,28,35,28,0,0,0,0,20181114,103,128,15,16,20,25,25,231,25,2018,0,2,1324,0
New Orleans,28,26,27,19,0,0,0,0,Minnesota,38,29,18,22,0,0,0,0,20181114,100,107,10,13,4,7,7,207,7,2018,0,2,1052,0
Portland,33,22,34,28,0,0,0,0,LA Lakers,26,33,38,29,0,0,0,0,20181114,117,126,-7,4,8,9,9,243,9,2018,0,2,826,0
Utah,24,22,13,9,0,0,0,0,Dallas,30,28,26,34,0,0,0,0,20181114,68,118,6,12,25,50,50,186,50,2018,0,2,998,0
Miami,37,24,29,30,0,0,0,0,Brooklyn,21,28,23,35,0,0,0,0,20181114,120,107,16,12,18,13,13,227,-13,2018,0,2,1091,0
Chicago,24,11,24,23,0,0,0,0,Boston,19,32,26,34,0,0,0,0,20181114,82,111,-5,16,18,29,29,193,29,2018,0,2,849,0
Memphis,29,19,36,32,0,0,0,0,Milwaukee,19,26,35,33,0,0,0,0,20181114,116,113,10,3,4,3,3,229,-3,2018,0,2,557,0
Atlanta,23,34,16,20,0,0,0,0,Denver,35,38,36,29,0,0,0,0,20181115,93,138,12,16,36,45,45,231,45,2018,0,3,1209,0
Golden State,19,22,22,23,0,0,0,0,Houston,25,22,29,31,0,0,0,0,20181115,86,107,6,6,13,21,21,193,21,2018,0,3,1642,0
San Antonio,28,32,24,27,0,0,0,0,LA Clippers,29,32,30,25,0,0,0,0,20181115,111,116,1,1,7,5,5,227,5,2018,0,3,1201,0
New York,32,32,32,28,0,0,0,0,New Orleans,16,38,34,41,0,0,0,0,20181116,124,129,-16,-10,-8,5,5,253,5,2018,0,4,1168,0
Brooklyn,26,30,35,24,0,0,0,0,Washington,30,24,25,25,0,0,0,0,20181116,115,104,-4,2,12,11,11,219,-11,2018,0,4,204,0
Utah,24,28,32,23,0,0,0,0,Philadelphia,38,16,32,27,0,0,0,0,20181116,107,113,14,2,2,6,6,220,6,2018,0,4,1920,0
Portland,21,22,24,29,0,0,0,0,Minnesota,29,26,28,29,0,0,0,0,20181116,96,112,8,12,16,16,16,208,16,2018,0,4,1423,0
Toronto,27,25,30,25,9,0,0,0,Boston,30,24,24,29,16,0,0,0,20181116,116,123,3,2,-4,0,7,239,7,2018,1,4,430,0
Sacramento,28,23,27,26,0,0,0,0,Memphis,29,33,25,25,0,0,0,0,20181116,104,112,1,11,9,8,8,216,8,2018,0,4,1745,0
Miami,27,16,24,24,0,0,0,0,Indiana,18,32,22,27,0,0,0,0,20181116,91,99,-9,7,5,8,8,190,8,2018,0,4,1026,0
Chicago,40,23,17,24,0,0,0,0,Milwaukee,27,18,46,32,0,0,0,0,20181116,104,123,-13,-18,11,19,19,227,19,2018,0,4,83,0
Oklahoma City,30,17,32,31,0,0,0,0,Phoenix,25,17,23,35,0,0,0,0,20181117,110,100,5,5,14,10,10,210,-10,2018,0,5,840,0
LA Lakers,31,22,28,36,0,0,0,0,Orlando,25,37,38,30,0,0,0,0,20181117,117,130,-6,9,19,13,13,247,13,2018,0,5,2197,0
Atlanta,24,32,16,17,0,0,0,0,Indiana,25,22,26,24,0,0,0,0,20181117,89,97,1,-9,1,8,8,186,8,2018,0,5,427,0
Sacramento,29,30,27,26,0,0,0,0,Houston,36,35,38,23,0,0,0,0,20181117,112,132,7,12,23,20,20,244,20,2018,0,5,1606,0
Denver,35,32,21,27,0,0,0,0,New Orleans,37,33,28,27,0,0,0,0,20181117,115,125,2,3,10,10,10,240,10,2018,0,5,1079,0
Philadelphia,42,21,19,28,12,0,0,0,Charlotte,30,26,30,24,9,0,0,0,20181117,122,119,12,7,-4,0,3,241,-3,2018,1,5,450,0
Toronto,27,30,32,33,0,0,0,0,Chicago,18,26,12,27,0,0,0,0,20181117,122,83,9,13,33,39,39,205,-39,2018,0,5,436,0
LA Clippers,32,28,30,37,0,0,0,0,Brooklyn,37,30,30,22,0,0,0,0,20181117,127,119,-5,-7,-7,8,8,246,-8,2018,0,5,2445,0
Utah,29,21,27,21,0,0,0,0,Boston,20,25,17,24,0,0,0,0,20181117,98,86,9,5,15,12,12,184,-12,2018,0,5,2093,0
Golden State,22,37,27,23,0,0,0,0,Dallas,26,31,25,30,0,0,0,0,20181117,109,112,4,-2,-4,3,3,221,3,2018,0,5,1480,0
LA Lakers,34,33,25,21,0,0,0,0,Miami,21,31,24,21,0,0,0,0,20181118,113,97,13,15,16,16,16,210,-16,2018,0,6,2335,0
Memphis,17,30,28,25,0,0,0,0,Minnesota,20,23,19,25,0,0,0,0,20181118,100,87,-3,4,13,13,13,187,-13,2018,0,6,700,0
New York,31,35,26,25,0,0,0,0,Orlando,44,23,31,33,0,0,0,0,20181118,117,131,13,1,6,14,14,248,14,2018,0,6,939,0
Golden State,27,21,22,22,0,0,0,0,San Antonio,33,23,23,25,0,0,0,0,20181118,92,104,6,8,9,12,12,196,12,2018,0,6,1487,0
Portland,32,30,29,28,0,0,0,0,Washington,25,16,29,39,0,0,0,0,20181118,119,109,7,21,21,10,10,228,-10,2018,0,6,2347,0
Denver,29,27,21,21,0,0,0,0,Milwaukee,25,21,32,26,0,0,0,0,20181119,98,104,-4,-10,1,6,6,202,6,2018,0,0,912,0
Oklahoma City,24,32,29,28,0,0,0,0,Sacramento,37,32,15,33,0,0,0,0,20181119,113,117,13,13,-1,4,4,230,4,2018,0,0,1336,0
San Antonio,39,28,30,29,0,0,0,0,New Orleans,30,38,40,32,0,0,0,0,20181119,126,140,-9,1,11,14,14,266,14,2018,0,0,506,0
Dallas,21,28,25,14,0,0,0,0,Memphis,25,28,21,24,0,0,0,0,20181119,88,98,4,4,0,10,10,186,10,2018,0,0,419,0
Phoenix,36,26,24,28,0,0,0,0,Philadelphia,26,31,35,27,0,0,0,0,20181119,114,119,-10,-5,6,5,5,233,5,2018,0,0,2078,0
Cleveland,27,19,23,33,0,0,0,0,Detroit,38,28,27,20,0,0,0,0,20181119,102,113,11,20,24,11,11,215,11,2018,0,0,90,0
Boston,24,32,31,25,0,0,0,0,Charlotte,29,25,30,33,0,0,0,0,20181119,112,117,5,-2,-3,5,5,229,5,2018,0,0,720,0
LA Clippers,29,32,28,38,0,0,0,0,Atlanta,34,30,32,23,0,0,0,0,20181119,127,119,-5,-3,-7,8,8,246,-8,2018,0,0,1932,0
Utah,19,28,23,24,0,0,0,0,Indiana,32,25,29,35,0,0,0,0,20181119,94,121,13,10,16,27,27,215,27,2018,0,0,1353,0
Brooklyn,20,19,35,30,0,0,0,0,Miami,13,29,35,15,0,0,0,0,20181120,104,92,7,-3,-3,12,12,196,-12,2018,0,1,1091,0
Portland,33,25,31,29,0,0,0,0,New York,35,25,25,29,0,0,0,0,20181120,118,114,-2,-2,4,4,4,232,-4,2018,0,1,2439,0
Toronto,29,18,26,20,0,0,0,0,Orlando,17,20,38,16,0,0,0,0,20181120,93,91,12,10,-2,2,2,184,-2,2018,0,1,1048,0
LA Clippers,40,33,22,23,0,0,0,0,Washington,21,33,32,39,0,0,0,0,20181120,118,125,-19,-19,-9,7,7,243,7,2018,0,1,2294,0
Sacramento,34,26,24,35,0,0,0,0,Utah,23,31,29,27,0,0,0,0,20181121,119,110,11,6,1,9,9,229,-9,2018,0,2,532,0
Memphis,30,31,20,23,0,0,0,0,San Antonio,32,27,18,26,0,0,0,0,20181121,104,103,-2,2,4,1,1,207,-1,2018,0,2,631,0
New Orleans,23,34,30,33,0,0,0,0,Philadelphia,38,29,29,25,0,0,0,0,20181121,120,121,15,10,9,1,1,241,1,2018,0,2,1088,0
Denver,23,27,35,18,0,0,0,0,Minnesota,25,31,18,27,0,0,0,0,20181121,103,101,-2,-6,11,2,2,204,-2,2018,0,2,698,0
Portland,20,30,29,21,0,0,0,0,Milwaukee,31,41,37,34,0,0,0,0,20181121,100,143,11,22,30,43,43,243,43,2018,0,2,1714,0
Detroit,29,28,26,41,0,0,0,0,Houston,31,25,37,33,0,0,0,0,20181121,124,126,2,-1,10,2,2,250,2,2018,0,2,1105,0
Brooklyn,32,18,31,32,0,0,0,0,Dallas,34,27,24,34,0,0,0,0,20181121,113,119,2,11,4,6,6,232,6,2018,0,2,1370,0
LA Lakers,24,25,32,28,0,0,0,0,Cleveland,28,24,29,24,0,0,0,0,20181121,109,105,-4,-3,0,4,4,214,-4,2018,0,2,2044,0
Indiana,30,30,24,25,0,0,0,0,Charlotte,35,33,37,22,0,0,0,0,20181121,109,127,5,8,21,18,18,236,18,2018,0,2,428,0
Phoenix,28,41,24,23,0,0,0,0,Chicago,25,39,30,30,0,0,0,0,20181121,116,124,-3,-5,1,8,8,240,8,2018,0,2,1450,0
New York,26,39,19,33,0,0,0,0,Boston,18,31,20,40,0,0,0,0,20181121,117,109,8,16,15,8,8,226,-8,2018,0,2,190,0
Toronto,29,26,31,38,0,0,0,0,Atlanta,24,20,29,35,0,0,0,0,20181121,124,108,5,11,13,16,16,232,-16,2018,0,2,733,0
Oklahoma City,23,37,27,36,0,0,0,0,Golden State,18,28,33,16,0,0,0,0,20181121,123,95,5,14,8,28,28,218,-28,2018,0,2,1386,0
Utah,16,22,25,20,0,0,0,0,LA Lakers,22,16,26,26,0,0,0,0,20181123,83,90,6,0,1,7,7,173,7,2018,0,4,579,0
Washington,26,36,25,20,0,0,0,0,Toronto,38,32,31,24,0,0,0,0,20181123,107,125,12,8,14,18,18,232,18,2018,0,4,349,0
Cleveland,31,23,30,37,0,0,0,0,Philadelphia,23,31,29,29,0,0,0,0,20181123,121,112,8,0,1,9,9,233,-9,2018,0,4,358,0
Charlotte,31,26,23,24,0,0,0,0,Oklahoma City,33,29,27,20,0,0,0,0,20181123,104,109,2,5,9,5,5,213,5,2018,0,4,938,0
New Orleans,34,26,30,19,0,0,0,0,New York,28,31,28,27,0,0,0,0,20181123,109,114,-6,-1,-3,5,5,223,5,2018,0,4,1168,0
Phoenix,34,30,27,25,0,0,0,0,Milwaukee,30,31,29,24,0,0,0,0,20181123,116,114,4,3,1,2,2,230,-2,2018,0,4,1462,0
Memphis,22,30,18,28,9,0,0,0,LA Clippers,16,28,31,23,14,0,0,0,20181123,107,112,-6,-8,5,0,5,219,5,2018,1,4,1599,0
San Antonio,29,25,28,29,0,0,0,0,Indiana,23,22,24,31,0,0,0,0,20181123,111,100,6,9,13,11,11,211,-11,2018,0,4,999,0
Portland,27,17,29,24,0,0,0,0,Golden State,24,35,33,33,0,0,0,0,20181123,97,125,-3,15,19,28,28,222,28,2018,0,4,535,0
Houston,30,26,23,19,13,0,0,0,Detroit,34,27,17,20,18,0,0,0,20181123,111,116,4,5,-1,0,5,227,5,2018,1,4,1105,0
Orlando,19,22,27,19,0,0,0,0,Denver,21,33,26,32,0,0,0,0,20181123,87,112,2,13,12,25,25,199,25,2018,0,4,1548,0
Miami,28,32,18,25,0,0,0,0,Chicago,26,13,30,27,0,0,0,0,20181123,103,96,2,21,9,7,7,199,-7,2018,0,4,1189,0
Minnesota,22,32,35,23,0,0,0,0,Brooklyn,26,23,23,30,0,0,0,0,20181123,112,102,-4,5,17,10,10,214,-10,2018,0,4,1016,0
Boston,45,16,21,32,0,0,0,0,Atlanta,23,22,19,32,0,0,0,0,20181123,114,96,22,16,18,18,18,210,-18,2018,0,4,935,0
New Orleans,34,34,23,23,0,0,0,0,Washington,37,31,22,34,0,0,0,0,20181124,114,124,3,0,-1,10,10,238,10,2018,0,5,964,0
Chicago,22,28,29,17,0,0,0,0,Minnesota,20,29,35,27,0,0,0,0,20181124,96,111,-2,-1,5,15,15,207,15,2018,0,5,355,0
San Antonio,36,32,34,27,0,0,0,0,Milwaukee,37,30,28,40,0,0,0,0,20181124,129,135,1,-1,-7,6,6,264,6,2018,0,5,1108,0
Denver,33,30,16,26,0,0,0,0,Oklahoma City,23,19,24,32,0,0,0,0,20181124,105,98,10,21,13,7,7,203,-7,2018,0,5,503,0
Boston,26,30,26,22,0,0,0,0,Dallas,32,27,28,26,0,0,0,0,20181124,104,113,6,3,5,9,9,217,9,2018,0,5,1548,0
Houston,30,28,25,25,0,0,0,0,Cleveland,29,34,30,24,0,0,0,0,20181124,108,117,-1,5,10,9,9,225,9,2018,0,5,1113,0
Sacramento,29,35,29,23,0,0,0,0,Golden State,28,32,35,22,0,0,0,0,20181124,116,117,-1,-4,2,1,1,233,1,2018,0,5,75,0
Charlotte,43,23,31,26,0,0,0,0,Atlanta,32,33,35,24,0,0,0,0,20181125,123,124,-11,-1,3,1,1,247,1,2018,0,6,226,0
Philadelphia,25,29,35,38,0,0,0,0,Brooklyn,32,36,34,23,0,0,0,0,20181125,127,125,-7,-14,-13,2,2,252,-2,2018,0,6,80,0
Phoenix,32,28,24,23,0,0,0,0,Detroit,27,35,21,35,0,0,0,0,20181125,107,118,-5,2,-1,11,11,225,11,2018,0,6,1687,0
Orlando,19,32,35,22,0,0,0,0,LA Lakers,29,23,19,33,0,0,0,0,20181125,108,104,-10,-1,15,4,4,212,-4,2018,0,6,2197,0
New York,21,22,35,25,0,0,0,0,Memphis,26,26,19,27,0,0,0,0,20181125,103,98,-5,-9,7,5,5,201,-5,2018,0,6,953,0
LA Clippers,24,21,38,21,0,0,0,0,Portland,28,30,16,26,0,0,0,0,20181125,104,100,-4,-13,9,4,4,204,-4,2018,0,6,826,0
Utah,30,29,32,42,0,0,0,0,Sacramento,26,24,30,32,0,0,0,0,20181125,133,112,4,9,11,21,21,245,-21,2018,0,6,532,0
Miami,29,25,35,26,0,0,0,0,Toronto,36,27,38,24,0,0,0,0,20181125,115,125,7,9,12,10,10,240,10,2018,0,6,1234,0
Indiana,33,25,31,32,0,0,0,0,Utah,25,22,23,18,0,0,0,0,20181126,121,88,8,11,19,33,33,209,-33,2018,0,0,1353,0
Houston,42,23,33,27,6,0,0,0,Washington,30,37,27,31,10,0,0,0,20181126,131,135,-12,2,-4,0,4,266,4,2018,1,0,1217,0
Orlando,25,39,19,27,0,0,0,0,Golden State,26,21,32,37,0,0,0,0,20181126,110,116,1,-17,-4,6,6,226,6,2018,0,0,2437,0
Boston,34,23,32,35,0,0,0,0,New Orleans,21,27,31,28,0,0,0,0,20181126,124,107,13,9,10,17,17,231,-17,2018,0,0,1358,0
Milwaukee,35,17,28,27,0,0,0,0,Charlotte,32,33,28,17,0,0,0,0,20181126,107,110,-3,13,13,3,3,217,3,2018,0,0,658,0
San Antonio,27,25,28,28,0,0,0,0,Chicago,27,23,33,24,0,0,0,0,20181126,108,107,0,2,-3,1,1,215,-1,2018,0,0,1050,0
Minnesota,29,25,21,27,0,0,0,0,Cleveland,26,21,24,24,0,0,0,0,20181126,102,95,3,7,4,7,7,197,-7,2018,0,0,629,0
LA Lakers,26,24,21,14,0,0,0,0,Denver,30,28,31,28,0,0,0,0,20181127,85,117,4,8,18,32,32,202,32,2018,0,1,830,0
New York,19,24,27,38,0,0,0,0,Detroit,24,27,30,34,0,0,0,0,20181127,108,115,5,8,11,7,7,223,7,2018,0,1,480,0
Toronto,31,28,34,29,0,0,0,0,Memphis,32,39,26,17,0,0,0,0,20181127,122,114,-1,-12,-4,8,8,236,-8,2018,0,1,815,0
Atlanta,35,33,32,15,0,0,0,0,Miami,38,14,34,27,0,0,0,0,20181127,115,113,-3,16,14,2,2,228,-2,2018,0,1,605,0
Indiana,26,35,20,28,0,0,0,0,Phoenix,26,28,23,27,0,0,0,0,20181127,109,104,0,7,4,5,5,213,-5,2018,0,1,1496,0
Chicago,40,22,27,24,0,0,0,0,Milwaukee,30,33,29,24,0,0,0,0,20181128,113,116,-10,1,3,3,3,229,3,2018,0,2,83,0
Orlando,30,33,21,28,0,0,0,0,Portland,33,22,40,20,0,0,0,0,20181128,112,115,3,-8,11,3,3,227,3,2018,0,2,2525,0
New York,27,21,20,23,0,0,0,0,Philadelphia,41,27,25,24,0,0,0,0,20181128,91,117,14,20,25,26,26,208,26,2018,0,2,80,0
Cleveland,28,19,15,21,0,0,0,0,Oklahoma City,21,26,26,27,0,0,0,0,20181128,83,100,-7,0,11,17,17,183,17,2018,0,2,949,0
Washington,24,23,34,23,0,0,0,0,New Orleans,31,36,31,27,0,0,0,0,20181128,104,125,7,20,17,21,21,229,21,2018,0,2,964,0
Dallas,36,38,22,32,0,0,0,0,Houston,28,28,33,19,0,0,0,0,20181128,128,108,8,18,7,20,20,236,-20,2018,0,2,225,0
Phoenix,22,27,25,25,0,0,0,0,LA Clippers,26,23,40,26,0,0,0,0,20181128,99,115,4,0,15,16,16,214,16,2018,0,2,356,0
Atlanta,28,21,26,19,0,0,0,0,Charlotte,24,31,31,22,0,0,0,0,20181128,94,108,-4,6,11,14,14,202,14,2018,0,2,226,0
Utah,17,26,27,31,0,0,0,0,Brooklyn,16,26,36,13,0,0,0,0,20181128,101,91,1,1,-8,10,10,192,-10,2018,0,2,1967,0
San Antonio,25,9,24,31,0,0,0,0,Minnesota,28,29,35,36,0,0,0,0,20181128,89,128,3,23,34,39,39,217,39,2018,0,2,1112,0
Golden State,25,33,30,31,9,0,0,0,Toronto,38,29,29,23,12,0,0,0,20181129,128,131,13,9,8,0,3,259,3,2018,1,3,2263,0
Indiana,15,35,25,21,0,0,0,0,LA Lakers,38,18,27,21,0,0,0,0,20181129,96,104,23,6,8,8,8,200,8,2018,0,3,1805,0
LA Clippers,42,29,30,32,0,0,0,0,Sacramento,26,42,25,28,0,0,0,0,20181129,133,121,16,3,8,12,12,254,-12,2018,0,3,361,0
Washington,19,27,24,28,0,0,0,0,Philadelphia,31,37,30,25,0,0,0,0,20181130,98,123,12,22,28,25,25,221,25,2018,0,4,123,0
Atlanta,26,20,30,33,0,0,0,0,Oklahoma City,28,38,25,33,0,0,0,0,20181130,109,124,2,20,15,15,15,233,15,2018,0,4,755,0
Houston,39,31,40,26,0,0,0,0,San Antonio,23,24,27,31,0,0,0,0,20181130,136,105,16,23,36,31,31,241,-31,2018,0,4,189,0
Denver,38,30,23,22,0,0,0,0,Portland,26,27,32,27,0,0,0,0,20181130,113,112,12,15,6,1,1,225,-1,2018,0,4,981,0
New Orleans,17,24,34,26,0,0,0,0,Miami,37,24,20,25,0,0,0,0,20181130,101,106,20,20,6,5,5,207,5,2018,0,4,668,0
Orlando,21,30,24,24,0,0,0,0,Phoenix,25,23,23,14,0,0,0,0,20181130,99,85,-4,3,4,14,14,184,-14,2018,0,4,1842,0
Chicago,21,19,25,23,0,0,0,0,Detroit,34,21,24,28,0,0,0,0,20181130,88,107,13,15,14,19,19,195,19,2018,0,4,238,0
Utah,33,24,34,28,0,0,0,0,Charlotte,19,34,30,28,0,0,0,0,20181130,119,111,14,4,8,8,8,230,-8,2018,0,4,1723,0
Memphis,26,32,27,26,6,14,0,0,Brooklyn,26,32,22,31,6,8,0,0,20181130,131,125,0,0,5,0,6,256,-6,2018,2,4,953,0
Cleveland,26,26,20,23,0,0,0,0,Boston,30,32,39,27,0,0,0,0,20181130,95,128,4,10,29,33,33,223,33,2018,0,4,549,0
Dallas,32,26,17,28,0,0,0,0,LA Lakers,22,31,25,36,0,0,0,0,20181130,103,114,-10,-5,3,11,11,217,11,2018,0,4,1237,0
Toronto,21,26,30,29,0,0,0,0,Cleveland,21,19,27,28,0,0,0,0,20181201,106,95,0,7,10,11,11,201,-11,2018,0,5,187,0
Golden State,24,22,32,24,0,0,0,0,Detroit,24,30,31,26,0,0,0,0,20181201,102,111,0,8,7,9,9,213,9,2018,0,5,2087,0
Chicago,22,24,29,30,0,0,0,0,Houston,38,18,31,34,0,0,0,0,20181201,105,121,16,10,12,16,16,226,16,2018,0,5,939,0
Boston,29,28,27,34,0,0,0,0,Minnesota,26,22,29,32,0,0,0,0,20181201,118,109,3,9,7,9,9,227,-9,2018,0,5,1120,0
Milwaukee,35,31,31,27,10,0,0,0,New York,28,33,32,31,12,0,0,0,20181201,134,136,-7,-5,-4,0,2,270,2,2018,1,5,732,0
Indiana,30,30,31,19,0,0,0,0,Sacramento,26,32,31,22,0,0,0,0,20181201,110,111,-4,-2,-2,1,1,221,1,2018,0,5,1882,0
Brooklyn,19,20,19,30,0,0,0,0,Washington,24,18,26,34,0,0,0,0,20181201,88,102,5,3,10,14,14,190,14,2018,0,5,204,0
Portland,33,22,35,28,0,0,0,0,San Antonio,32,30,35,34,0,0,0,0,20181202,118,131,-1,7,7,13,13,249,13,2018,0,6,1718,0
Memphis,25,19,24,27,0,0,0,0,Philadelphia,26,28,24,25,0,0,0,0,20181202,95,103,1,10,10,8,8,198,8,2018,0,6,878,0
Utah,35,20,22,23,0,0,0,0,Miami,27,26,27,22,0,0,0,0,20181202,100,102,-8,-2,3,2,2,202,2,2018,0,6,2086,0
LA Clippers,35,23,22,30,0,0,0,0,Dallas,34,28,26,26,0,0,0,0,20181202,110,114,-1,4,8,4,4,224,4,2018,0,6,1237,0
New Orleans,29,36,22,32,0,0,0,0,Charlotte,30,26,21,32,0,0,0,0,20181202,119,109,-1,9,10,10,10,228,-10,2018,0,6,648,0
Phoenix,31,15,28,22,0,0,0,0,LA Lakers,21,40,34,25,0,0,0,0,20181202,96,120,-10,15,21,24,24,216,24,2018,0,6,356,0
Golden State,34,27,36,31,0,0,0,0,Atlanta,17,30,30,34,0,0,0,0,20181203,128,111,17,14,20,17,17,239,-17,2018,0,0,2135,0
Cleveland,30,26,24,19,0,0,0,0,Brooklyn,29,21,26,21,0,0,0,0,20181203,99,97,1,6,4,2,2,196,-2,2018,0,0,403,0
Oklahoma City,26,24,37,23,0,0,0,0,Detroit,17,23,19,24,0,0,0,0,20181203,110,83,9,10,28,27,27,193,-27,2018,0,0,909,0
Houston,24,38,20,9,0,0,0,0,Minnesota,24,24,38,17,0,0,0,0,20181203,91,103,0,-14,4,12,12,194,12,2018,0,0,1057,0
LA Clippers,36,41,24,28,0,0,0,0,New Orleans,29,36,32,29,0,0,0,0,20181203,129,126,7,12,4,3,3,255,-3,2018,0,0,1669,0
Washington,26,26,34,24,0,0,0,0,New York,32,29,19,27,0,0,0,0,20181203,110,107,-6,-9,6,3,3,217,-3,2018,0,0,204,0
Denver,27,32,27,20,0,0,0,0,Toronto,24,23,31,25,0,0,0,0,20181203,106,103,3,12,8,3,3,209,-3,2018,0,0,1341,0
San Antonio,20,27,31,27,0,0,0,0,Utah,34,29,41,35,0,0,0,0,20181204,105,139,14,16,26,34,34,244,34,2018,0,1,1087,0
Orlando,27,19,30,29,0,0,0,0,Miami,25,25,12,28,0,0,0,0,20181204,105,90,2,-4,14,15,15,195,-15,2018,0,1,204,0
Sacramento,36,32,31,23,0,0,0,0,Phoenix,9,31,27,38,0,0,0,0,20181204,122,105,27,28,32,17,17,227,-17,2018,0,1,634,0
Portland,20,25,28,29,0,0,0,0,Dallas,34,26,27,24,0,0,0,0,20181204,102,111,14,15,14,9,9,213,9,2018,0,1,1630,0
Chicago,21,24,22,23,0,0,0,0,Indiana,23,20,27,26,0,0,0,0,20181204,90,96,2,-2,3,6,6,186,6,2018,0,1,163,0
Washington,33,39,31,28,0,0,0,0,Atlanta,25,24,45,23,0,0,0,0,20181205,131,117,8,23,9,14,14,248,-14,2018,0,2,541,0
Oklahoma City,24,22,29,39,0,0,0,0,Brooklyn,26,36,31,19,0,0,0,0,20181205,114,112,-2,-16,-18,2,2,226,-2,2018,0,2,1324,0
Golden State,31,27,37,34,0,0,0,0,Cleveland,25,39,22,19,0,0,0,0,20181205,129,105,6,-6,9,24,24,234,-24,2018,0,2,2161,0
San Antonio,23,22,37,31,0,0,0,0,LA Lakers,31,19,28,43,0,0,0,0,20181205,113,121,8,5,-4,8,8,234,8,2018,0,2,1201,0
LA Clippers,15,27,27,17,0,0,0,0,Memphis,27,24,18,27,0,0,0,0,20181205,86,96,12,9,0,10,10,182,10,2018,0,2,1599,0
Detroit,21,24,19,28,0,0,0,0,Milwaukee,30,26,28,31,0,0,0,0,20181205,92,115,9,11,20,23,23,207,23,2018,0,2,251,0
Charlotte,31,33,22,18,0,0,0,0,Minnesota,31,31,24,35,0,0,0,0,20181205,104,121,0,-2,0,17,17,225,17,2018,0,2,938,0
Dallas,31,22,27,26,0,0,0,0,New Orleans,32,37,28,35,0,0,0,0,20181205,106,132,1,16,17,26,26,238,26,2018,0,2,442,0
Denver,31,25,32,24,12,0,0,0,Orlando,28,26,32,26,6,0,0,0,20181205,124,118,3,2,2,0,6,242,-6,2018,1,2,1548,0
Philadelphia,29,20,28,25,0,0,0,0,Toronto,23,30,25,35,0,0,0,0,20181205,102,113,-6,4,1,11,11,215,11,2018,0,2,334,0
Phoenix,9,32,18,27,0,0,0,0,Portland,34,28,25,21,0,0,0,0,20181206,86,108,25,21,28,22,22,194,22,2018,0,3,1005,0
Houston,18,27,11,35,0,0,0,0,Utah,27,26,38,27,0,0,0,0,20181206,91,118,9,8,35,27,27,209,27,2018,0,3,1199,0
New York,30,28,26,16,0,0,0,0,Boston,38,31,30,29,0,0,0,0,20181206,100,128,8,11,15,28,28,228,28,2018,0,3,190,0
Toronto,20,33,26,19,7,0,0,0,Brooklyn,24,29,27,18,8,0,0,0,20181207,105,106,4,0,1,0,1,211,1,2018,1,4,341,0
Oklahoma City,28,34,29,21,0,0,0,0,Chicago,34,36,17,27,0,0,0,0,20181207,112,114,6,8,-4,2,2,226,2,2018,0,4,690,0
Denver,25,28,26,28,0,0,0,0,Charlotte,24,40,23,26,0,0,0,0,20181207,107,113,-1,11,8,6,6,220,6,2018,0,4,1355,0
Sacramento,38,28,30,33,0,0,0,0,Cleveland,27,39,23,21,0,0,0,0,20181207,129,110,11,0,7,19,19,239,-19,2018,0,4,2096,0
Philadelphia,28,28,33,28,0,0,0,0,Detroit,27,41,22,21,0,0,0,0,20181207,117,111,1,-12,-1,6,6,228,-6,2018,0,4,441,0
Golden State,27,30,26,22,0,0,0,0,Milwaukee,22,29,25,19,0,0,0,0,20181207,105,95,5,6,7,10,10,200,-10,2018,0,4,1838,0
Memphis,31,27,27,22,0,0,0,0,New Orleans,30,30,24,19,0,0,0,0,20181207,107,103,1,-2,1,4,4,210,-4,2018,0,4,358,0
Indiana,28,29,29,26,0,0,0,0,Orlando,25,20,25,20,0,0,0,0,20181207,112,90,3,12,16,22,22,202,-22,2018,0,4,822,0
Miami,34,26,29,26,0,0,0,0,Phoenix,36,14,23,25,0,0,0,0,20181207,115,98,-2,10,16,17,17,213,-17,2018,0,4,1978,0
LA Lakers,36,36,27,21,0,0,0,0,San Antonio,32,36,21,44,0,0,0,0,20181207,120,133,-4,-4,-10,13,13,253,13,2018,0,4,1201,0
LA Lakers,27,36,28,20,0,0,0,0,Memphis,16,24,26,22,0,0,0,0,20181208,111,88,11,23,25,23,23,199,-23,2018,0,5,1599,0
Minnesota,27,24,29,25,0,0,0,0,Portland,30,23,28,32,0,0,0,0,20181208,105,113,3,2,1,8,8,218,8,2018,0,5,1423,0
Brooklyn,30,26,38,18,0,0,0,0,New York,23,22,32,27,0,0,0,0,20181208,112,104,7,11,17,8,8,216,-8,2018,0,5,0,0
Miami,34,31,26,30,0,0,0,0,LA Clippers,30,32,28,8,0,0,0,0,20181208,121,98,4,3,1,23,23,219,-23,2018,0,5,2335,0
Denver,35,21,21,21,0,0,0,0,Atlanta,25,26,35,20,0,0,0,0,20181208,98,106,-10,-5,9,8,8,204,8,2018,0,5,1209,0
Houston,30,27,27,20,0,0,0,0,Dallas,32,24,28,23,0,0,0,0,20181208,104,107,2,-1,0,3,3,211,3,2018,0,5,225,0
Washington,25,21,20,35,0,0,0,0,Cleveland,38,24,25,29,0,0,0,0,20181208,101,116,13,16,21,15,15,217,15,2018,0,5,304,0
Boston,35,29,29,40,0,0,0,0,Chicago,17,26,17,17,0,0,0,0,20181208,133,77,18,21,33,56,56,210,-56,2018,0,5,849,0
Sacramento,31,21,18,27,0,0,0,0,Indiana,24,30,19,34,0,0,0,0,20181208,97,107,-7,2,3,10,10,204,10,2018,0,5,1882,0
New Orleans,28,28,35,25,0,0,0,0,Detroit,20,30,34,24,0,0,0,0,20181209,116,108,8,6,7,8,8,224,-8,2018,0,6,939,0
Charlotte,27,34,38,20,0,0,0,0,New York,24,23,31,29,0,0,0,0,20181209,119,107,3,14,21,12,12,226,-12,2018,0,6,531,0
Utah,18,18,36,25,0,0,0,0,San Antonio,23,31,28,28,0,0,0,0,20181209,97,110,5,18,10,13,13,207,13,2018,0,6,1087,0
Milwaukee,25,26,28,25,0,0,0,0,Toronto,30,19,25,25,0,0,0,0,20181209,104,99,-5,2,5,5,5,203,-5,2018,0,6,429,0
LA Clippers,21,37,30,23,12,0,0,0,Phoenix,29,27,30,25,8,0,0,0,20181210,123,119,-8,2,2,0,4,242,-4,2018,1,0,356,0
Detroit,29,18,29,26,0,0,0,0,Philadelphia,38,18,31,29,0,0,0,0,20181210,102,116,9,9,11,14,14,218,14,2018,0,0,441,0
Utah,22,24,29,38,0,0,0,0,Oklahoma City,30,27,42,23,0,0,0,0,20181210,113,122,8,11,24,9,9,235,9,2018,0,0,861,0
Cleveland,18,23,25,26,0,0,0,0,Milwaukee,31,28,25,24,0,0,0,0,20181210,92,108,13,18,18,16,16,200,16,2018,0,0,334,0
Miami,23,35,25,22,0,0,0,0,LA Lakers,27,28,29,24,0,0,0,0,20181210,105,108,4,-3,1,3,3,213,3,2018,0,0,2335,0
Washington,33,17,25,26,0,0,0,0,Indiana,29,30,28,22,0,0,0,0,20181210,101,109,-4,9,12,8,8,210,8,2018,0,0,490,0
Minnesota,24,33,20,31,0,0,0,0,Golden State,30,33,28,25,0,0,0,0,20181210,108,116,6,6,14,8,8,224,8,2018,0,0,1581,0
Memphis,22,28,33,16,0,0,0,0,Denver,26,29,29,21,0,0,0,0,20181210,99,105,4,5,1,6,6,204,6,2018,0,0,877,0
Orlando,19,21,13,23,0,0,0,0,Dallas,24,28,23,26,0,0,0,0,20181210,76,101,5,12,22,25,25,177,25,2018,0,0,961,0
Sacramento,26,19,36,27,0,0,0,0,Chicago,33,23,18,15,0,0,0,0,20181210,108,89,-7,-11,7,19,19,197,-19,2018,0,0,1788,0
New Orleans,21,32,19,28,0,0,0,0,Boston,28,31,24,30,0,0,0,0,20181210,100,113,7,6,11,13,13,213,13,2018,0,0,1358,0
Portland,29,25,24,26,0,0,0,0,Houston,27,24,30,30,0,0,0,0,20181211,104,111,-2,-3,3,7,7,215,7,2018,0,1,1833,0
Toronto,36,34,33,20,0,0,0,0,LA Clippers,23,34,17,25,0,0,0,0,20181211,123,99,13,13,29,24,24,222,-24,2018,0,1,2170,0
Phoenix,20,26,18,22,0,0,0,0,San Antonio,29,30,29,23,0,0,0,0,20181211,86,111,9,13,24,25,25,197,25,2018,0,1,846,0
Boston,24,22,38,29,17,0,0,0,Washington,28,27,22,36,12,0,0,0,20181212,130,125,-4,-9,7,0,5,255,-5,2018,1,2,394,0
Miami,15,18,20,31,0,0,0,0,Utah,40,20,32,19,0,0,0,0,20181212,84,111,25,27,39,27,27,195,27,2018,0,2,2086,0
Minnesota,31,19,42,38,0,0,0,0,Sacramento,35,28,33,45,0,0,0,0,20181212,130,141,4,13,4,11,11,271,11,2018,0,2,1511,0
Brooklyn,31,26,37,33,0,0,0,0,Philadelphia,29,27,28,40,0,0,0,0,20181212,127,124,2,1,10,3,3,251,-3,2018,0,2,80,0
Oklahoma City,28,28,28,30,0,0,0,0,New Orleans,25,32,32,29,0,0,0,0,20181212,114,118,-3,1,5,4,4,232,4,2018,0,2,576,0
Portland,26,14,23,20,0,0,0,0,Memphis,15,27,26,24,0,0,0,0,20181212,83,92,-11,2,5,9,9,175,9,2018,0,2,1845,0
Milwaukee,23,20,27,27,0,0,0,0,Indiana,29,29,27,28,0,0,0,0,20181212,97,113,6,15,15,16,16,210,16,2018,0,2,243,0
Toronto,31,26,25,31,0,0,0,0,Golden State,22,19,26,26,0,0,0,0,20181212,113,93,9,16,15,20,20,206,-20,2018,0,2,2263,0
Atlanta,26,26,26,29,0,0,0,0,Dallas,28,23,30,33,0,0,0,0,20181212,107,114,2,-1,3,7,7,221,7,2018,0,2,719,0
New York,23,31,32,20,0,0,0,0,Cleveland,39,26,21,27,0,0,0,0,20181212,106,113,16,11,0,7,7,219,7,2018,0,2,403,0
Detroit,25,30,38,14,0,0,0,0,Charlotte,37,23,22,26,0,0,0,0,20181212,107,108,12,5,-11,1,1,215,1,2018,0,2,504,0
LA Lakers,24,32,32,23,0,0,0,0,Houston,29,33,28,36,0,0,0,0,20181213,111,126,5,6,2,15,15,237,15,2018,0,3,1371,0
Chicago,26,20,25,20,0,0,0,0,Orlando,24,27,26,20,0,0,0,0,20181213,91,97,-2,5,6,6,6,188,6,2018,0,3,984,0
Dallas,21,19,27,22,0,0,0,0,Phoenix,25,25,28,21,0,0,0,0,20181213,89,99,4,10,11,10,10,188,10,2018,0,3,884,0
LA Clippers,27,30,20,10,0,0,0,0,San Antonio,38,28,32,27,0,0,0,0,20181213,87,125,11,9,21,38,38,212,38,2018,0,3,1201,0
Golden State,42,34,27,27,0,0,0,0,Sacramento,38,26,33,28,0,0,0,0,20181214,130,125,4,12,6,5,5,255,-5,2018,0,4,75,0
Toronto,23,27,39,33,0,0,0,0,Portland,28,30,33,37,0,0,0,0,20181214,122,128,5,8,2,6,6,250,6,2018,0,4,2108,0
Indiana,24,25,31,33,0,0,0,0,Philadelphia,34,25,18,24,0,0,0,0,20181214,113,101,-10,-10,3,12,12,214,-12,2018,0,4,582,0
Miami,29,22,20,29,0,0,0,0,Memphis,28,21,24,24,0,0,0,0,20181214,100,97,1,2,-2,3,3,197,-3,2018,0,4,873,0
Oklahoma City,32,20,24,22,0,0,0,0,Denver,39,21,22,27,0,0,0,0,20181214,98,109,7,8,6,11,11,207,11,2018,0,4,503,0
Milwaukee,27,34,30,23,0,0,0,0,Cleveland,16,31,30,25,0,0,0,0,20181214,114,102,11,14,14,12,12,216,-12,2018,0,4,334,0
New York,16,37,25,35,13,0,0,0,Charlotte,33,39,21,20,11,0,0,0,20181214,126,124,-17,-19,-15,0,2,250,-2,2018,1,4,531,0
Washington,31,28,26,33,0,0,0,0,Brooklyn,27,43,31,24,0,0,0,0,20181214,118,125,-4,11,16,7,7,243,7,2018,0,4,204,0
Atlanta,19,37,26,26,0,0,0,0,Boston,42,25,41,21,0,0,0,0,20181214,108,129,23,11,26,21,21,237,21,2018,0,4,935,0
LA Lakers,32,25,40,31,0,0,0,0,Charlotte,22,28,17,33,0,0,0,0,20181215,128,100,10,7,30,28,28,228,-28,2018,0,5,2115,0
Boston,33,23,22,26,0,0,0,0,Detroit,33,24,28,28,0,0,0,0,20181215,104,113,0,1,7,9,9,217,9,2018,0,5,611,0
Houston,36,25,18,26,0,0,0,0,Memphis,29,11,25,32,0,0,0,0,20181215,105,97,7,21,14,8,8,202,-8,2018,0,5,484,0
LA Clippers,25,25,19,35,0,0,0,0,Oklahoma City,30,31,25,24,0,0,0,0,20181215,104,110,5,11,17,6,6,214,6,2018,0,5,1178,0
Utah,14,21,24,30,0,0,0,0,Orlando,14,19,22,41,0,0,0,0,20181215,89,96,0,-2,-4,7,7,185,7,2018,0,5,1915,0
Minnesota,30,28,24,17,0,0,0,0,Phoenix,28,28,29,22,0,0,0,0,20181215,99,107,-2,-2,3,8,8,206,8,2018,0,5,1278,0
Chicago,21,22,31,24,0,0,0,0,San Antonio,28,34,16,15,0,0,0,0,20181215,98,93,-7,-19,-4,5,5,191,-5,2018,0,5,1050,0
LA Lakers,23,28,25,34,0,0,0,0,Washington,33,38,28,29,0,0,0,0,20181216,110,128,10,20,23,18,18,238,18,2018,0,6,2294,0
Miami,33,24,28,17,0,0,0,0,New Orleans,28,23,22,23,0,0,0,0,20181216,102,96,5,6,12,6,6,198,-6,2018,0,6,668,0
New York,26,27,20,26,0,0,0,0,Indiana,28,28,23,31,0,0,0,0,20181216,99,110,2,3,6,11,11,209,11,2018,0,6,643,0
Atlanta,23,43,30,31,0,0,0,0,Brooklyn,42,30,39,33,0,0,0,0,20181216,127,144,19,6,15,17,17,271,17,2018,0,6,745,0
Sacramento,34,27,32,27,0,0,0,0,Dallas,31,27,25,30,0,0,0,0,20181216,120,113,3,3,10,7,7,233,-7,2018,0,6,1437,0
Philadelphia,29,36,24,39,0,0,0,0,Cleveland,36,22,27,20,0,0,0,0,20181216,128,105,-7,7,4,23,23,233,-23,2018,0,6,358,0
Toronto,23,24,25,14,0,0,0,0,Denver,23,16,29,27,0,0,0,0,20181216,86,95,0,-8,-4,9,9,181,9,2018,0,6,1341,0
Philadelphia,32,17,22,25,0,0,0,0,San Antonio,29,31,33,30,0,0,0,0,20181217,96,123,-3,11,22,27,27,219,27,2018,0,0,1505,0
Phoenix,28,31,41,28,0,0,0,0,New York,32,34,17,27,0,0,0,0,20181217,128,110,-4,-7,17,18,18,238,-18,2018,0,0,2139,0
Sacramento,23,21,33,28,0,0,0,0,Minnesota,38,36,29,29,0,0,0,0,20181217,105,132,15,30,26,27,27,237,27,2018,0,0,1511,0
Chicago,22,22,25,27,0,0,0,0,Oklahoma City,31,33,24,33,0,0,0,0,20181217,96,121,9,20,19,25,25,217,25,2018,0,0,690,0
Utah,23,14,36,24,0,0,0,0,Houston,25,25,33,19,0,0,0,0,20181217,97,102,2,13,10,5,5,199,5,2018,0,0,1199,0
Memphis,22,16,29,26,0,0,0,0,Golden State,30,31,23,26,0,0,0,0,20181217,93,110,8,23,17,17,17,203,17,2018,0,0,1798,0
Milwaukee,25,30,26,26,0,0,0,0,Detroit,27,16,34,27,0,0,0,0,20181217,107,104,-2,12,4,3,3,211,-3,2018,0,0,251,0
Portland,37,21,42,31,0,0,0,0,LA Clippers,29,31,28,39,0,0,0,0,20181217,131,127,8,-2,12,4,4,258,-4,2018,0,0,826,0
Washington,24,30,28,28,0,0,0,0,Atlanta,35,23,24,36,0,0,0,0,20181218,110,118,11,4,0,8,8,228,8,2018,0,1,541,0
LA Lakers,32,25,26,27,0,0,0,0,Brooklyn,33,29,28,25,0,0,0,0,20181218,110,115,1,5,7,5,5,225,5,2018,0,1,2445,0
Dallas,33,36,26,23,0,0,0,0,Denver,34,40,31,21,0,0,0,0,20181218,118,126,1,5,10,8,8,244,8,2018,0,1,661,0
Cleveland,21,24,22,25,0,0,0,0,Indiana,19,25,24,23,0,0,0,0,20181218,92,91,2,1,-1,1,1,183,-1,2018,0,1,262,0
New York,33,28,24,24,0,0,0,0,Philadelphia,38,31,30,32,0,0,0,0,20181219,109,131,5,8,14,22,22,240,22,2018,0,2,80,0
Golden State,21,34,25,23,0,0,0,0,Utah,24,32,28,24,0,0,0,0,20181219,103,108,3,1,4,5,5,211,5,2018,0,2,599,0
Oklahoma City,36,35,27,34,0,0,0,0,Sacramento,33,19,37,24,0,0,0,0,20181219,132,113,3,19,9,19,19,245,-19,2018,0,2,1336,0
Memphis,18,34,19,21,0,0,0,0,Portland,17,30,27,25,0,0,0,0,20181219,92,99,-1,-5,3,7,7,191,7,2018,0,2,1845,0
San Antonio,31,35,38,25,0,0,0,0,Orlando,24,20,33,13,0,0,0,0,20181219,129,90,7,22,27,39,39,219,-39,2018,0,2,1035,0
Indiana,34,24,27,11,0,0,0,0,Toronto,24,26,25,24,0,0,0,0,20181219,96,99,-10,-8,-10,3,3,195,3,2018,0,2,438,0
New Orleans,31,35,24,25,0,0,0,0,Milwaukee,33,29,28,33,0,0,0,0,20181219,115,123,2,-4,0,8,8,238,8,2018,0,2,911,0
Washington,28,30,32,28,0,0,0,0,Houston,34,36,31,35,0,0,0,0,20181219,118,136,6,12,11,18,18,254,18,2018,0,2,1217,0
Cleveland,25,21,29,24,0,0,0,0,Charlotte,16,25,41,28,0,0,0,0,20181219,99,110,-9,-5,7,11,11,209,11,2018,0,2,435,0
Brooklyn,22,18,31,25,0,0,0,0,Chicago,27,12,32,22,0,0,0,0,20181219,96,93,-5,1,0,3,3,189,-3,2018,0,2,711,0
Phoenix,26,33,27,25,0,0,0,0,Boston,37,25,18,23,0,0,0,0,20181219,111,103,-11,-3,6,8,8,214,-8,2018,0,2,2295,0
Detroit,27,26,25,40,11,0,0,0,Minnesota,26,36,30,26,5,0,0,0,20181219,129,123,1,-9,-14,0,6,252,-6,2018,1,2,542,0
Dallas,27,27,28,39,0,0,0,0,LA Clippers,30,35,24,36,0,0,0,0,20181220,121,125,3,11,7,4,4,246,4,2018,0,3,1237,0
Houston,33,25,18,23,0,0,0,0,Miami,21,32,29,19,0,0,0,0,20181220,99,101,-12,-5,6,2,2,200,2,2018,0,3,966,0
Cleveland,28,24,41,17,0,0,0,0,Toronto,34,25,40,27,0,0,0,0,20181221,110,126,6,7,6,16,16,236,16,2018,0,4,187,0
Minnesota,21,23,27,27,0,0,0,0,San Antonio,29,33,25,37,0,0,0,0,20181221,98,124,8,18,16,26,26,222,26,2018,0,4,1112,0
Memphis,32,21,21,25,0,0,0,0,Sacramento,24,16,25,37,0,0,0,0,20181221,99,102,-8,-13,-9,3,3,201,3,2018,0,4,1745,0
Atlanta,28,32,27,27,0,0,0,0,New York,39,30,20,18,0,0,0,0,20181221,114,107,-11,-9,-2,7,7,221,-7,2018,0,4,745,0
Utah,33,22,28,37,0,0,0,0,Portland,26,23,19,22,0,0,0,0,20181221,120,90,7,6,15,30,30,210,-30,2018,0,4,634,0
Detroit,21,19,25,21,0,0,0,0,Charlotte,25,20,30,23,0,0,0,0,20181221,86,98,4,5,10,12,12,184,12,2018,0,4,504,0
Orlando,20,19,24,17,0,0,0,0,Chicago,19,27,27,17,0,0,0,0,20181221,80,90,-1,7,10,10,10,170,10,2018,0,4,984,0
Indiana,37,22,25,30,0,0,0,0,Brooklyn,27,22,31,26,0,0,0,0,20181221,114,106,10,10,4,8,8,220,-8,2018,0,4,643,0
Milwaukee,35,30,28,27,0,0,0,0,Boston,22,26,30,29,0,0,0,0,20181221,120,107,13,17,15,13,13,227,-13,2018,0,4,855,0
New Orleans,34,31,23,16,0,0,0,0,LA Lakers,34,35,25,18,0,0,0,0,20181221,104,112,0,4,6,8,8,216,8,2018,0,4,1669,0
Phoenix,29,26,24,30,13,10,14,0,Washington,33,22,28,26,13,10,17,0,20181222,146,149,4,0,4,0,3,295,3,2018,3,5,1977,0
Oklahoma City,26,32,35,14,0,0,0,0,Utah,32,29,20,25,0,0,0,0,20181222,107,106,-6,-3,12,1,1,213,-1,2018,0,5,861,0
Toronto,30,29,20,22,0,0,0,0,Philadelphia,29,36,26,35,0,0,0,0,20181222,101,126,-1,6,12,25,25,227,25,2018,0,5,334,0
Milwaukee,8,30,20,29,0,0,0,0,Miami,21,16,35,22,0,0,0,0,20181222,87,94,13,-1,14,7,7,181,7,2018,0,5,1269,0
San Antonio,26,17,26,32,0,0,0,0,Houston,28,13,43,24,0,0,0,0,20181222,101,108,2,-2,15,7,7,209,7,2018,0,5,189,0
Dallas,31,30,26,29,0,0,0,0,Golden State,28,30,36,26,0,0,0,0,20181222,116,120,-3,-3,7,4,4,236,4,2018,0,5,1480,0
Denver,26,33,27,25,0,0,0,0,LA Clippers,34,34,35,29,0,0,0,0,20181222,111,132,8,9,17,21,21,243,21,2018,0,5,830,0
Minnesota,35,18,33,28,0,0,0,0,Oklahoma City,25,38,17,32,0,0,0,0,20181223,114,112,10,-10,6,2,2,226,-2,2018,0,6,694,0
Dallas,27,25,28,27,11,0,0,0,Portland,25,37,26,19,14,0,0,0,20181223,118,121,-2,10,8,0,3,239,3,2018,1,6,1630,0
Miami,28,25,37,25,0,0,0,0,Orlando,17,27,27,20,0,0,0,0,20181223,115,91,11,9,19,24,24,206,-24,2018,0,6,204,0
New Orleans,36,33,27,21,0,0,0,0,Sacramento,25,33,28,36,0,0,0,0,20181223,117,122,-11,-11,-10,5,5,239,5,2018,0,6,1879,0
Memphis,26,24,22,35,0,0,0,0,LA Lakers,20,26,29,24,0,0,0,0,20181223,107,99,6,4,-3,8,8,206,-8,2018,0,6,1599,0
Chicago,28,26,30,28,0,0,0,0,Cleveland,29,30,15,18,0,0,0,0,20181223,112,92,-1,-5,10,20,20,204,-20,2018,0,6,308,0
LA Clippers,36,35,23,33,0,0,0,0,Golden State,36,31,36,26,0,0,0,0,20181223,127,129,0,-4,9,2,2,256,2,2018,0,6,347,0
Atlanta,28,29,22,19,0,0,0,0,Detroit,21,22,23,29,0,0,0,0,20181223,98,95,7,14,13,3,3,193,-3,2018,0,6,597,0
Phoenix,31,25,18,29,0,0,0,0,Brooklyn,38,25,28,20,0,0,0,0,20181223,103,111,7,7,17,8,8,214,8,2018,0,6,2139,0
Charlotte,26,21,20,36,0,0,0,0,Boston,29,39,26,25,0,0,0,0,20181223,103,119,3,21,27,16,16,222,16,2018,0,6,720,0
Washington,25,21,18,25,0,0,0,0,Indiana,27,26,31,21,0,0,0,0,20181223,89,105,2,7,20,16,16,194,16,2018,0,6,490,0
Philadelphia,25,26,38,19,6,0,0,0,Boston,32,25,29,22,13,0,0,0,20181225,114,121,7,6,-3,0,7,235,7,2018,1,1,270,0
LA Lakers,32,33,26,36,0,0,0,0,Golden State,25,25,32,19,0,0,0,0,20181225,127,101,7,15,9,26,26,228,-26,2018,0,1,347,0
Oklahoma City,22,38,28,21,0,0,0,0,Houston,22,30,34,27,0,0,0,0,20181225,109,113,0,-8,-2,4,4,222,4,2018,0,1,413,0
Milwaukee,22,26,36,25,0,0,0,0,New York,24,22,22,27,0,0,0,0,20181225,109,95,-2,2,16,14,14,204,-14,2018,0,1,732,0
Portland,24,23,23,26,0,0,0,0,Utah,24,35,24,34,0,0,0,0,20181225,96,117,0,12,13,21,21,213,21,2018,0,1,634,0
Denver,26,27,22,28,0,0,0,0,San Antonio,34,21,22,34,0,0,0,0,20181226,103,111,8,2,2,8,8,214,8,2018,0,2,802,0
Phoenix,26,36,28,28,4,0,0,0,Orlando,32,21,34,31,2,0,0,0,20181226,122,120,-6,9,3,0,2,242,-2,2018,1,2,1842,0
Toronto,23,21,37,25,0,0,0,0,Miami,31,27,21,25,0,0,0,0,20181226,106,104,-8,-14,2,2,2,210,-2,2018,0,2,1234,0
Cleveland,9,23,21,34,0,0,0,0,Memphis,21,24,20,30,0,0,0,0,20181226,87,95,12,13,12,8,8,182,8,2018,0,2,629,0
Sacramento,27,29,29,33,0,0,0,0,LA Clippers,39,32,31,25,0,0,0,0,20181226,118,127,12,15,17,9,9,245,9,2018,0,2,361,0
Washington,28,27,17,23,0,0,0,0,Detroit,27,27,31,21,0,0,0,0,20181226,95,106,-1,-1,13,11,11,201,11,2018,0,2,394,0
New Orleans,30,34,30,25,0,0,0,0,Dallas,33,34,23,32,0,0,0,0,20181226,119,122,3,3,-4,3,3,241,3,2018,0,2,442,0
Minnesota,29,31,23,36,0,0,0,0,Chicago,18,19,28,29,0,0,0,0,20181226,119,94,11,23,18,25,25,213,-25,2018,0,2,355,0
Charlotte,29,22,26,37,7,11,0,0,Brooklyn,22,34,23,35,7,13,0,0,20181226,132,134,-7,5,2,0,2,266,2,2018,2,2,531,0
Indiana,32,32,31,34,0,0,0,0,Atlanta,31,36,21,33,0,0,0,0,20181226,129,121,1,-3,7,8,8,250,-8,2018,0,2,427,0
Portland,27,25,23,27,8,0,0,0,Golden State,28,18,25,31,7,0,0,0,20181227,110,109,-1,6,4,0,1,219,-1,2018,1,3,535,0
Boston,24,31,31,27,0,0,0,0,Houston,35,22,35,35,0,0,0,0,20181227,113,127,11,2,6,14,14,240,14,2018,0,3,1603,0
New York,28,20,29,19,0,0,0,0,Milwaukee,24,29,34,25,0,0,0,0,20181227,96,112,-4,5,10,16,16,208,16,2018,0,3,732,0
LA Lakers,34,33,28,21,0,0,0,0,Sacramento,32,29,23,33,0,0,0,0,20181227,116,117,-2,-6,-11,1,1,233,1,2018,0,3,361,0
Philadelphia,22,35,38,19,0,0,0,0,Utah,29,23,27,18,0,0,0,0,20181227,114,97,-7,5,16,17,17,211,-17,2018,0,3,1920,0
Oklahoma City,36,22,23,37,0,0,0,0,Phoenix,29,28,27,18,0,0,0,0,20181228,118,102,7,1,-3,16,16,220,-16,2018,0,4,840,0
Chicago,20,20,34,27,0,0,0,0,Washington,22,20,30,20,0,0,0,0,20181228,101,92,-2,-2,2,9,9,193,-9,2018,0,4,594,0
Toronto,29,19,15,24,0,0,0,0,Orlando,25,32,35,24,0,0,0,0,20181228,87,116,-4,9,29,29,29,203,29,2018,0,4,1048,0
Dallas,29,37,22,24,0,0,0,0,New Orleans,26,29,31,28,0,0,0,0,20181228,112,114,-3,-11,-2,2,2,226,2,2018,0,4,442,0
Atlanta,42,29,18,23,11,0,0,0,Minnesota,27,32,30,23,8,0,0,0,20181228,123,120,15,12,0,0,3,243,-3,2018,1,4,908,0
San Antonio,23,24,28,24,0,0,0,0,Denver,31,30,17,24,0,0,0,0,20181228,99,102,8,14,3,3,3,201,3,2018,0,4,802,0
LA Clippers,28,23,31,36,0,0,0,0,LA Lakers,23,31,26,27,0,0,0,0,20181228,118,107,5,-3,2,11,11,225,-11,2018,0,4,0,0
Detroit,21,24,24,19,0,0,0,0,Indiana,32,26,33,34,0,0,0,0,20181228,88,125,11,13,22,37,37,213,37,2018,0,4,240,0
Brooklyn,17,25,23,22,0,0,0,0,Charlotte,33,21,19,27,0,0,0,0,20181228,87,100,16,12,8,13,13,187,13,2018,0,4,531,0
Cleveland,30,22,17,25,0,0,0,0,Miami,29,27,26,36,0,0,0,0,20181228,94,118,-1,4,13,24,24,212,24,2018,0,4,1089,0
Charlotte,29,32,31,34,0,0,0,0,Washington,27,40,27,36,0,0,0,0,20181229,126,130,-2,6,2,4,4,256,4,2018,0,5,329,0
New York,17,17,32,31,0,0,0,0,Utah,39,32,26,32,0,0,0,0,20181229,97,129,22,37,31,32,32,226,32,2018,0,5,1967,0
Denver,36,26,28,32,0,0,0,0,Phoenix,16,33,29,40,0,0,0,0,20181229,122,118,20,13,12,4,4,240,-4,2018,0,5,585,0
Houston,30,23,24,31,0,0,0,0,New Orleans,20,30,26,28,0,0,0,0,20181229,108,104,10,3,1,4,4,212,-4,2018,0,5,317,0
Golden State,30,28,35,22,0,0,0,0,Portland,27,23,33,22,0,0,0,0,20181229,115,105,3,8,10,10,10,220,-10,2018,0,5,535,0
Boston,29,18,32,33,0,0,0,0,Memphis,26,38,23,16,0,0,0,0,20181229,112,103,3,-17,-8,9,9,215,-9,2018,0,5,1134,0
San Antonio,32,24,39,27,0,0,0,0,LA Clippers,30,26,19,36,0,0,0,0,20181229,122,111,2,0,20,11,11,233,-11,2018,0,5,1201,0
Cleveland,26,25,23,34,0,0,0,0,Atlanta,23,34,27,27,0,0,0,0,20181229,108,111,-3,6,10,3,3,219,3,2018,0,5,555,0
Brooklyn,23,29,34,29,0,0,0,0,Milwaukee,29,42,35,23,0,0,0,0,20181229,115,129,6,19,20,14,14,244,14,2018,0,5,732,0
Oklahoma City,28,31,14,30,0,0,0,0,Dallas,27,30,27,21,0,0,0,0,20181230,103,105,-1,-2,11,2,2,208,2,2018,0,6,189,0
Sacramento,31,37,28,18,0,0,0,0,LA Lakers,37,27,28,29,0,0,0,0,20181230,114,121,6,-4,-4,7,7,235,7,2018,0,6,361,0
Minnesota,30,25,31,27,0,0,0,0,Miami,19,35,23,27,0,0,0,0,20181230,113,104,11,1,9,9,9,217,-9,2018,0,6,1513,0
Detroit,21,38,24,24,0,0,0,0,Orlando,31,31,23,24,0,0,0,0,20181230,107,109,10,3,2,2,2,216,2,2018,0,6,957,0
Philadelphia,20,21,26,28,0,0,0,0,Portland,31,39,36,23,0,0,0,0,20181230,95,129,11,29,39,34,34,224,34,2018,0,6,2405,0
Chicago,20,19,26,24,0,0,0,0,Toronto,14,26,28,27,0,0,0,0,20181230,89,95,-6,1,3,6,6,184,6,2018,0,6,436,0
Boston,23,29,30,29,0,0,0,0,San Antonio,17,29,46,28,0,0,0,0,20181231,111,120,-6,-6,10,9,9,231,9,2018,0,0,1765,0
Golden State,31,38,39,24,0,0,0,0,Phoenix,27,25,35,22,0,0,0,0,20181231,132,109,4,17,21,23,23,241,-23,2018,0,0,652,0
Dallas,21,22,32,27,0,0,0,0,Oklahoma City,32,28,32,30,0,0,0,0,20181231,102,122,11,17,17,20,20,224,20,2018,0,0,189,0
Memphis,18,20,35,28,0,0,0,0,Houston,27,34,25,27,0,0,0,0,20181231,101,113,9,23,13,12,12,214,12,2018,0,0,484,0
Atlanta,25,35,21,27,0,0,0,0,Indiana,33,30,34,19,0,0,0,0,20181231,108,116,8,3,16,8,8,224,8,2018,0,0,427,0
Minnesota,22,29,38,25,0,0,0,0,New Orleans,27,36,25,35,0,0,0,0,20181231,114,123,5,12,-1,9,9,237,9,2018,0,0,1052,0
Orlando,23,30,24,23,0,0,0,0,Charlotte,36,27,32,30,0,0,0,0,20181231,100,125,13,10,18,25,25,225,25,2018,0,0,463,0
New York,32,24,28,24,0,0,0,0,Denver,28,27,27,33,0,0,0,0,20190101,108,115,-4,-1,-2,7,7,223,7,2018,0,1,1627,0
Philadelphia,41,35,25,18,0,0,0,0,LA Clippers,28,30,30,25,0,0,0,0,20190101,119,113,13,18,13,6,6,232,-6,2018,0,1,2388,0
Detroit,27,25,21,25,0,0,0,0,Milwaukee,35,33,24,29,0,0,0,0,20190101,98,121,8,16,19,23,23,219,23,2018,0,1,251,0
Portland,26,38,19,20,10,0,0,0,Sacramento,25,25,27,26,5,0,0,0,20190101,113,108,1,14,6,0,5,221,-5,2018,1,1,483,0
Utah,24,29,32,31,0,0,0,0,Toronto,26,25,44,27,0,0,0,0,20190101,116,122,2,-2,10,6,6,238,6,2018,0,1,1664,0
Oklahoma City,25,34,19,29,0,0,0,0,LA Lakers,25,32,25,18,0,0,0,0,20190102,107,100,0,2,-4,7,7,207,-7,2018,0,2,1178,0
Atlanta,29,24,31,14,0,0,0,0,Washington,35,29,24,26,0,0,0,0,20190102,98,114,6,11,4,16,16,212,16,2018,0,2,541,0
Philadelphia,44,28,32,28,0,0,0,0,Phoenix,32,17,38,40,0,0,0,0,20190102,132,127,12,23,17,5,5,259,-5,2018,0,2,2078,0
Detroit,26,25,21,29,0,0,0,0,Memphis,24,31,12,27,0,0,0,0,20190102,101,94,2,-4,5,7,7,195,-7,2018,0,2,622,0
Miami,22,36,35,24,0,0,0,0,Cleveland,23,20,30,19,0,0,0,0,20190102,117,92,-1,15,20,25,25,209,-25,2018,0,2,1089,0
Dallas,42,23,29,28,0,0,0,0,Charlotte,26,15,24,19,0,0,0,0,20190102,122,84,16,24,29,38,38,206,-38,2018,0,2,928,0
Orlando,32,30,28,22,0,0,0,0,Chicago,16,29,17,22,0,0,0,0,20190102,112,84,16,17,28,28,28,196,-28,2018,0,2,984,0
New Orleans,29,29,29,34,0,0,0,0,Brooklyn,39,34,32,21,0,0,0,0,20190102,121,126,10,15,18,5,5,247,5,2018,0,2,1168,0
Minnesota,21,21,39,21,0,0,0,0,Boston,25,35,27,28,0,0,0,0,20190102,102,115,4,18,6,13,13,217,13,2018,0,2,1120,0
Houston,22,31,39,27,16,0,0,0,Golden State,34,36,28,21,15,0,0,0,20190103,135,134,-12,-17,-6,0,1,269,-1,2018,1,3,1642,0
Denver,30,23,31,33,0,0,0,0,Sacramento,30,36,18,29,0,0,0,0,20190103,117,113,0,-13,0,4,4,230,-4,2018,0,3,886,0
Toronto,19,32,24,32,0,0,0,0,San Antonio,38,29,29,29,0,0,0,0,20190103,107,125,19,16,21,18,18,232,18,2018,0,3,1438,0
LA Clippers,38,30,23,30,0,0,0,0,Phoenix,19,25,34,33,0,0,0,0,20190104,121,111,19,24,13,10,10,232,-10,2018,0,4,356,0
Orlando,40,28,17,18,0,0,0,0,Minnesota,31,33,31,25,0,0,0,0,20190104,103,120,-9,-4,10,17,17,223,17,2018,0,4,1309,0
Atlanta,14,29,36,33,0,0,0,0,Milwaukee,43,33,42,26,0,0,0,0,20190104,112,144,29,33,39,32,32,256,32,2018,0,4,669,0
Washington,24,34,28,23,0,0,0,0,Miami,31,30,34,20,0,0,0,0,20190104,109,115,7,3,9,6,6,224,6,2018,0,4,924,0
Oklahoma City,28,29,36,18,0,0,0,0,Portland,28,34,25,22,0,0,0,0,20190104,111,109,0,-5,6,2,2,220,-2,2018,0,4,1484,0
Brooklyn,26,22,33,28,0,0,0,0,Memphis,26,21,30,23,0,0,0,0,20190104,109,100,0,1,4,9,9,209,-9,2018,0,4,953,0
Utah,23,25,33,36,0,0,0,0,Cleveland,20,29,22,20,0,0,0,0,20190104,117,91,3,-1,10,26,26,208,-26,2018,0,4,1564,0
Indiana,18,36,21,30,14,0,0,0,Chicago,30,28,20,27,11,0,0,0,20190104,119,116,-12,-4,-3,0,3,235,-3,2018,1,4,163,0
Dallas,23,28,17,25,0,0,0,0,Boston,34,24,26,30,0,0,0,0,20190104,93,114,11,7,16,21,21,207,21,2018,0,4,1548,0
New York,39,24,23,33,0,0,0,0,LA Lakers,25,34,33,20,0,0,0,0,20190104,119,112,14,4,-6,7,7,231,-7,2018,0,4,2445,0
Golden State,43,27,26,31,0,0,0,0,Sacramento,29,40,34,20,0,0,0,0,20190105,127,123,14,1,-7,4,4,250,-4,2018,0,5,75,0
Houston,30,16,31,24,0,0,0,0,Portland,30,29,27,24,0,0,0,0,20190105,101,110,0,13,9,9,9,211,9,2018,0,5,1833,0
Dallas,26,25,19,30,0,0,0,0,Philadelphia,31,28,28,19,0,0,0,0,20190105,100,106,5,8,17,6,6,206,6,2018,0,5,1297,0
Memphis,25,19,22,22,0,0,0,0,San Antonio,27,37,24,20,0,0,0,0,20190105,88,108,2,20,22,20,20,196,20,2018,0,5,631,0
Utah,13,35,28,34,0,0,0,0,Detroit,31,22,25,27,0,0,0,0,20190105,110,105,-18,-5,-2,5,5,215,-5,2018,0,5,1488,0
Charlotte,26,30,28,26,0,0,0,0,Denver,31,27,31,34,0,0,0,0,20190105,110,123,5,2,5,13,13,233,13,2018,0,5,1355,0
New Orleans,28,33,37,35,0,0,0,0,Cleveland,26,26,20,26,0,0,0,0,20190105,133,98,2,9,26,35,35,231,-35,2018,0,5,924,0
Toronto,27,29,35,32,0,0,0,0,Milwaukee,34,23,25,34,0,0,0,0,20190105,123,116,-7,-1,9,7,7,239,-7,2018,0,5,429,0
Miami,16,21,21,24,0,0,0,0,Atlanta,23,15,41,27,0,0,0,0,20190106,82,106,7,1,21,24,24,188,24,2018,0,6,605,0
Brooklyn,28,27,33,29,0,0,0,0,Chicago,21,34,27,18,0,0,0,0,20190106,117,100,7,0,6,17,17,217,-17,2018,0,6,711,0
Orlando,28,19,20,29,0,0,0,0,LA Clippers,18,27,25,36,0,0,0,0,20190106,96,106,-10,-2,3,10,10,202,10,2018,0,6,2197,0
LA Lakers,19,26,23,18,0,0,0,0,Minnesota,35,29,19,25,0,0,0,0,20190106,86,108,16,19,15,22,22,194,22,2018,0,6,1521,0
Washington,28,26,36,26,0,0,0,0,Oklahoma City,25,25,29,19,0,0,0,0,20190106,116,98,3,4,11,18,18,214,-18,2018,0,6,1149,0
Charlotte,29,28,28,34,0,0,0,0,Phoenix,30,30,21,32,0,0,0,0,20190106,119,113,-1,-3,4,6,6,232,-6,2018,0,6,1778,0
Indiana,35,28,21,21,0,0,0,0,Toronto,37,33,26,25,0,0,0,0,20190106,105,121,2,7,12,16,16,226,16,2018,0,6,438,0
Memphis,27,24,22,22,0,0,0,0,New Orleans,31,22,33,28,0,0,0,0,20190107,95,114,4,2,13,19,19,209,19,2018,0,0,358,0
Orlando,25,17,20,33,0,0,0,0,Sacramento,29,29,32,21,0,0,0,0,20190107,95,111,4,16,28,16,16,206,16,2018,0,0,2390,0
New York,30,23,23,25,0,0,0,0,Portland,30,24,32,25,0,0,0,0,20190107,101,111,0,1,10,10,10,212,10,2018,0,0,2439,0
Utah,34,28,24,16,0,0,0,0,Milwaukee,32,26,25,31,0,0,0,0,20190107,102,114,-2,-4,-3,12,12,216,12,2018,0,0,1239,0
Brooklyn,22,23,29,21,0,0,0,0,Boston,34,22,30,30,0,0,0,0,20190107,95,116,12,11,12,21,21,211,21,2018,0,0,190,0
San Antonio,25,34,25,35,0,0,0,0,Detroit,31,20,22,34,0,0,0,0,20190107,119,107,-6,8,11,12,12,226,-12,2018,0,0,1238,0
LA Lakers,25,29,32,21,0,0,0,0,Dallas,33,34,13,17,0,0,0,0,20190107,107,97,-8,-13,6,10,10,204,-10,2018,0,0,1237,0
Denver,35,25,29,24,0,0,0,0,Houston,33,37,26,29,0,0,0,0,20190107,113,125,-2,10,7,12,12,238,12,2018,0,0,878,0
Indiana,38,25,29,31,0,0,0,0,Cleveland,16,27,36,36,0,0,0,0,20190108,123,115,22,20,13,8,8,238,-8,2018,0,1,262,0
New York,25,24,19,27,0,0,0,0,Golden State,31,30,33,28,0,0,0,0,20190108,95,122,6,12,26,27,27,217,27,2018,0,1,2565,0
Charlotte,24,33,20,32,0,0,0,0,LA Clippers,33,29,24,42,0,0,0,0,20190108,109,128,9,5,9,19,19,237,19,2018,0,1,2115,0
Denver,24,25,27,27,0,0,0,0,Miami,18,34,24,23,0,0,0,0,20190108,103,99,6,-3,0,4,4,202,-4,2018,0,1,1724,0
Minnesota,29,35,32,23,0,0,0,0,Oklahoma City,23,41,29,24,0,0,0,0,20190108,119,117,6,0,3,2,2,236,-2,2018,0,1,694,0
Washington,29,16,33,37,0,0,0,0,Philadelphia,32,36,36,28,0,0,0,0,20190108,115,132,3,23,26,17,17,247,17,2018,0,1,123,0
Sacramento,32,40,14,25,0,0,0,0,Phoenix,35,18,33,29,0,0,0,0,20190108,111,115,3,-19,0,4,4,226,4,2018,0,1,634,0
Atlanta,31,26,20,24,0,0,0,0,Toronto,28,28,24,24,0,0,0,0,20190108,101,104,-3,-1,3,3,3,205,3,2018,0,1,733,0
Philadelphia,20,28,27,31,0,0,0,0,Washington,25,38,29,31,0,0,0,0,20190109,106,123,5,15,17,17,17,229,17,2018,0,2,123,0
Orlando,32,31,12,18,0,0,0,0,Utah,19,27,32,28,0,0,0,0,20190109,93,106,-13,-17,3,13,13,199,13,2018,0,2,1915,0
Chicago,29,22,34,27,0,0,0,0,Portland,30,26,39,29,0,0,0,0,20190109,112,124,1,5,10,12,12,236,12,2018,0,2,1754,0
Cleveland,38,25,28,33,0,0,0,0,New Orleans,25,34,41,40,0,0,0,0,20190109,124,140,-13,-4,9,16,16,264,16,2018,0,2,924,0
San Antonio,18,13,33,22,0,0,0,0,Memphis,22,20,30,24,0,0,0,0,20190109,86,96,4,11,8,10,10,182,10,2018,0,2,631,0
Milwaukee,26,28,38,24,0,0,0,0,Houston,29,31,23,26,0,0,0,0,20190109,116,109,-3,-6,9,7,7,225,-7,2018,0,2,1005,0
Phoenix,26,24,19,25,0,0,0,0,Dallas,26,20,32,26,0,0,0,0,20190109,94,104,0,-4,9,10,10,198,10,2018,0,2,884,0
Atlanta,38,19,23,20,0,0,0,0,Brooklyn,23,28,35,30,0,0,0,0,20190109,100,116,-15,-6,6,16,16,216,16,2018,0,2,745,0
Indiana,23,30,27,28,0,0,0,0,Boston,29,39,37,30,0,0,0,0,20190109,108,135,6,15,25,27,27,243,27,2018,0,2,805,0
Detroit,24,23,30,23,0,0,0,0,LA Lakers,20,35,34,24,0,0,0,0,20190109,100,113,-4,8,12,13,13,213,13,2018,0,2,1979,0
LA Clippers,25,29,22,24,0,0,0,0,Denver,37,28,28,28,0,0,0,0,20190110,100,121,12,11,17,21,21,221,21,2018,0,3,830,0
Boston,24,19,29,27,0,0,0,0,Miami,28,33,22,32,0,0,0,0,20190110,99,115,4,18,11,16,16,214,16,2018,0,3,1257,0
Detroit,21,27,26,28,0,0,0,0,Sacramento,34,31,26,21,0,0,0,0,20190110,102,112,13,17,17,10,10,214,10,2018,0,3,2020,0
Oklahoma City,23,40,30,37,11,6,0,0,San Antonio,33,37,35,25,11,13,0,0,20190110,147,154,10,7,12,0,7,301,7,2018,2,3,421,0
Brooklyn,35,18,22,30,0,0,0,0,Toronto,28,36,35,23,0,0,0,0,20190111,105,122,-7,11,24,17,17,227,17,2018,0,4,341,0
Milwaukee,26,21,35,24,0,0,0,0,Washington,40,17,28,28,0,0,0,0,20190111,106,113,14,10,3,7,7,219,7,2018,0,4,634,0
LA Lakers,26,15,27,27,0,0,0,0,Utah,32,30,21,30,0,0,0,0,20190111,95,113,6,21,15,18,18,208,18,2018,0,4,579,0
Charlotte,27,22,19,28,0,0,0,0,Portland,37,33,31,26,0,0,0,0,20190111,96,127,10,21,33,31,31,223,31,2018,0,4,2284,0
Chicago,17,38,21,33,0,0,0,0,Golden State,43,33,40,30,0,0,0,0,20190111,109,146,26,21,40,37,37,255,37,2018,0,4,1853,0
Indiana,31,33,32,25,0,0,0,0,New York,22,30,30,24,0,0,0,0,20190111,121,106,9,12,14,15,15,227,-15,2018,0,4,643,0
Dallas,28,33,24,34,0,0,0,0,Minnesota,26,24,28,37,0,0,0,0,20190111,119,115,2,11,7,4,4,234,-4,2018,0,4,863,0
Cleveland,22,27,32,32,0,0,0,0,Houston,42,35,36,28,0,0,0,0,20190111,113,141,20,28,32,28,28,254,28,2018,0,4,1113,0
Atlanta,32,22,35,34,0,0,0,0,Philadelphia,30,26,32,33,0,0,0,0,20190111,123,121,2,-2,1,2,2,244,-2,2018,0,4,665,0
Chicago,19,34,29,20,0,0,0,0,Utah,29,22,30,29,0,0,0,0,20190112,102,110,10,-2,-1,8,8,212,8,2018,0,5,1256,0
Denver,23,24,22,24,0,0,0,0,Phoenix,31,29,21,21,0,0,0,0,20190112,93,102,8,13,12,9,9,195,9,2018,0,5,585,0
Boston,19,32,26,26,0,0,0,0,Orlando,19,22,31,33,0,0,0,0,20190112,103,105,0,-10,-5,2,2,208,2,2018,0,5,1115,0
Charlotte,29,30,17,21,0,0,0,0,Sacramento,35,22,25,22,0,0,0,0,20190112,97,104,6,-2,6,7,7,201,7,2018,0,5,2239,0
New Orleans,29,23,37,17,0,0,0,0,Minnesota,27,27,33,23,0,0,0,0,20190112,106,110,-2,2,-2,4,4,216,4,2018,0,5,1052,0
Memphis,34,27,22,25,0,0,0,0,Miami,30,33,28,21,0,0,0,0,20190112,108,112,-4,2,8,4,4,220,4,2018,0,5,873,0
Detroit,37,28,25,19,0,0,0,0,LA Clippers,24,30,26,24,0,0,0,0,20190112,109,104,13,11,10,5,5,213,-5,2018,0,5,1979,0
San Antonio,31,29,20,32,0,0,0,0,Oklahoma City,23,28,35,36,0,0,0,0,20190112,112,122,-8,-9,6,10,10,234,10,2018,0,5,421,0
Milwaukee,35,29,31,38,0,0,0,0,Atlanta,32,23,29,30,0,0,0,0,20190113,133,114,3,9,11,19,19,247,-19,2018,0,6,669,0
Golden State,25,37,30,27,0,0,0,0,Dallas,29,25,34,26,0,0,0,0,20190113,119,114,-4,8,4,5,5,233,-5,2018,0,6,1480,0
Portland,32,28,28,25,0,0,0,0,Denver,34,24,35,23,0,0,0,0,20190113,113,116,2,-2,5,3,3,229,3,2018,0,6,981,0
Cleveland,32,19,24,26,0,0,0,0,LA Lakers,24,22,19,30,0,0,0,0,20190113,101,95,8,5,10,6,6,196,-6,2018,0,6,2044,0
Philadelphia,36,30,17,25,0,0,0,0,New York,24,26,32,23,0,0,0,0,20190113,108,105,12,16,1,3,3,213,-3,2018,0,6,80,0
Houston,26,33,29,21,0,0,0,0,Orlando,18,34,34,30,0,0,0,0,20190113,109,116,-8,-7,-2,7,7,225,7,2018,0,6,847,0
Toronto,36,25,37,26,7,9,0,0,Washington,21,29,34,40,7,7,0,0,20190113,140,138,15,11,14,0,2,278,-2,2018,2,6,349,0
Charlotte,28,21,27,32,0,0,0,0,San Antonio,24,19,29,21,0,0,0,0,20190114,108,93,4,6,4,15,15,201,-15,2018,0,0,1103,0
Detroit,31,28,15,20,0,0,0,0,Utah,27,26,22,25,0,0,0,0,20190114,94,100,-4,-6,1,6,6,194,6,2018,0,0,1488,0
Portland,27,17,31,32,0,0,0,0,Sacramento,24,30,29,32,0,0,0,0,20190114,107,115,-3,10,8,8,8,222,8,2018,0,0,483,0
Boston,25,20,21,36,0,0,0,0,Brooklyn,27,19,44,19,0,0,0,0,20190114,102,109,2,1,24,7,7,211,7,2018,0,0,190,0
Memphis,29,19,22,24,0,0,0,0,Houston,24,30,33,25,0,0,0,0,20190114,94,112,-5,6,17,18,18,206,18,2018,0,0,484,0
New Orleans,32,34,28,27,0,0,0,0,LA Clippers,36,27,25,29,0,0,0,0,20190114,121,117,-4,3,6,4,4,238,-4,2018,0,0,1669,0
Oklahoma City,29,30,41,26,0,0,0,0,Atlanta,25,45,27,45,0,0,0,0,20190115,126,142,-4,11,-3,16,16,268,16,2018,0,1,755,0
Golden State,51,28,33,30,0,0,0,0,Denver,38,22,23,28,0,0,0,0,20190115,142,111,13,19,29,31,31,253,-31,2018,0,1,947,0
Phoenix,19,32,22,24,0,0,0,0,Indiana,38,24,34,35,0,0,0,0,20190115,97,131,19,11,23,34,34,228,34,2018,0,1,1496,0
Chicago,18,25,25,32,0,0,0,0,LA Lakers,19,25,32,31,0,0,0,0,20190115,100,107,1,1,8,7,7,207,7,2018,0,1,1741,0
Miami,23,22,18,23,0,0,0,0,Milwaukee,30,39,24,31,0,0,0,0,20190115,86,124,7,24,30,38,38,210,38,2018,0,1,1269,0
Minnesota,27,31,32,17,0,0,0,0,Philadelphia,40,43,32,34,0,0,0,0,20190115,107,149,13,25,25,42,42,256,42,2018,0,1,983,0
Cleveland,26,29,30,27,0,0,0,0,Portland,30,32,38,29,0,0,0,0,20190116,112,129,4,7,15,17,17,241,17,2018,0,2,2049,0
Milwaukee,28,22,41,20,0,0,0,0,Memphis,20,25,28,28,0,0,0,0,20190116,111,101,8,5,18,10,10,212,-10,2018,0,2,557,0
Utah,31,25,32,41,0,0,0,0,LA Clippers,22,27,23,37,0,0,0,0,20190116,129,109,9,7,16,20,20,238,-20,2018,0,2,579,0
Brooklyn,34,28,23,46,14,0,0,0,Houston,30,24,40,37,11,0,0,0,20190116,145,142,4,8,-9,0,3,287,-3,2018,1,2,1417,0
Orlando,34,29,21,25,6,0,0,0,Detroit,26,32,32,19,11,0,0,0,20190116,115,120,-8,-5,6,0,5,235,5,2018,1,2,957,0
San Antonio,20,25,30,30,0,0,0,0,Dallas,35,21,24,21,0,0,0,0,20190116,105,101,-15,-11,-5,4,4,206,-4,2018,0,2,252,0
Toronto,36,17,30,25,0,0,0,0,Boston,30,34,23,30,0,0,0,0,20190116,108,117,-6,11,4,9,9,225,9,2018,0,2,430,0
New Orleans,39,32,38,31,0,0,0,0,Golden State,31,35,44,37,0,0,0,0,20190116,140,147,-8,-5,1,7,7,287,7,2018,0,2,1921,0
Sacramento,25,25,23,22,0,0,0,0,Charlotte,20,43,20,31,0,0,0,0,20190117,95,114,-5,13,10,19,19,209,19,2018,0,3,2239,0
Chicago,30,17,26,32,0,0,0,0,Denver,28,33,42,32,0,0,0,0,20190117,105,135,-2,14,30,30,30,240,30,2018,0,3,916,0
Philadelphia,28,26,32,34,0,0,0,0,Indiana,25,23,23,25,0,0,0,0,20190117,120,96,3,6,15,24,24,216,-24,2018,0,3,582,0
LA Lakers,27,40,28,27,16,0,0,0,Oklahoma City,39,24,33,26,6,0,0,0,20190117,138,128,-12,4,-1,0,10,266,-10,2018,1,3,1178,0
Phoenix,20,29,29,31,0,0,0,0,Toronto,32,25,20,34,0,0,0,0,20190117,109,111,12,8,-1,2,2,220,2,2018,0,3,1885,0
New York,30,33,26,11,0,0,0,0,Washington,20,33,24,24,0,0,0,0,20190117,100,101,-10,-10,-12,1,1,201,1,2018,0,3,204,0
Cleveland,20,17,23,39,0,0,0,0,Utah,29,32,32,22,0,0,0,0,20190118,99,115,9,24,33,16,16,214,16,2018,0,4,1564,0
New Orleans,29,29,28,26,0,0,0,0,Portland,32,42,30,24,0,0,0,0,20190118,112,128,3,16,18,16,16,240,16,2018,0,4,2059,0
Brooklyn,25,29,32,31,0,0,0,0,Orlando,32,35,28,20,0,0,0,0,20190118,117,115,-7,-13,-9,2,2,232,-2,2018,0,4,939,0
Miami,17,22,30,24,0,0,0,0,Detroit,30,23,12,33,0,0,0,0,20190118,93,98,13,14,-4,5,5,191,5,2018,0,4,1155,0
Golden State,28,24,29,31,0,0,0,0,LA Clippers,25,26,21,22,0,0,0,0,20190118,112,94,3,1,9,18,18,206,-18,2018,0,4,347,0
Memphis,24,38,29,25,0,0,0,0,Boston,35,23,38,26,0,0,0,0,20190118,116,122,11,-4,5,6,6,238,6,2018,0,4,1134,0
San Antonio,28,30,30,28,0,0,0,0,Minnesota,31,27,32,23,0,0,0,0,20190118,116,113,-3,0,-2,3,3,229,-3,2018,0,4,1112,0
Memphis,19,29,14,28,0,0,0,0,Toronto,23,32,45,19,0,0,0,0,20190119,90,119,4,7,38,29,29,209,29,2018,0,5,815,0
Oklahoma City,33,26,29,29,0,0,0,0,Philadelphia,25,31,23,36,0,0,0,0,20190119,117,115,8,3,9,2,2,232,-2,2018,0,5,1256,0
Dallas,23,19,27,30,0,0,0,0,Indiana,24,34,26,27,0,0,0,0,20190119,99,111,1,16,15,12,12,210,12,2018,0,5,763,0
LA Lakers,39,25,22,34,14,0,0,0,Houston,26,20,36,38,18,0,0,0,20190119,134,138,-13,-18,-4,0,4,272,4,2018,1,5,1371,0
Milwaukee,33,26,28,31,0,0,0,0,Orlando,24,22,36,26,0,0,0,0,20190119,118,108,9,13,5,10,10,226,-10,2018,0,5,1065,0
Cleveland,25,21,30,26,0,0,0,0,Denver,37,33,31,23,0,0,0,0,20190119,102,124,12,24,25,22,22,226,22,2018,0,5,1223,0
Phoenix,26,34,26,29,0,0,0,0,Charlotte,39,32,38,26,0,0,0,0,20190119,115,135,13,11,23,20,20,250,20,2018,0,5,1778,0
Miami,31,24,28,34,0,0,0,0,Chicago,30,27,19,27,0,0,0,0,20190119,117,103,1,-2,7,14,14,220,-14,2018,0,5,1189,0
Boston,28,32,23,30,0,0,0,0,Atlanta,36,31,22,16,0,0,0,0,20190119,113,105,-8,-7,-6,8,8,218,-8,2018,0,5,935,0
Sacramento,26,25,23,29,0,0,0,0,Detroit,30,27,25,19,0,0,0,0,20190119,103,101,-4,-6,-8,2,2,204,-2,2018,0,5,2020,0
Charlotte,26,15,30,24,0,0,0,0,Indiana,34,22,27,37,0,0,0,0,20190120,95,120,8,15,12,25,25,215,25,2018,0,6,428,0
Phoenix,31,36,29,18,0,0,0,0,Minnesota,29,35,27,25,0,0,0,0,20190120,114,116,-2,-3,-5,2,2,230,2,2018,0,6,1278,0
LA Clippers,38,22,20,23,0,0,0,0,San Antonio,26,27,20,22,0,0,0,0,20190120,103,95,12,7,7,8,8,198,-8,2018,0,6,1201,0
Dallas,26,33,25,22,0,0,0,0,Milwaukee,35,22,35,24,0,0,0,0,20190121,106,116,9,-2,8,10,10,222,10,2018,0,0,857,0
Portland,29,15,39,26,0,0,0,0,Utah,28,23,28,25,0,0,0,0,20190121,109,104,1,-7,4,5,5,213,-5,2018,0,0,634,0
Houston,26,24,13,30,0,0,0,0,Philadelphia,30,35,29,27,0,0,0,0,20190121,93,121,4,15,31,28,28,214,28,2018,0,0,1339,0
Oklahoma City,34,33,36,24,0,0,0,0,New York,16,31,35,27,0,0,0,0,20190121,127,109,18,20,21,18,18,236,-18,2018,0,0,1324,0
New Orleans,21,33,28,23,0,0,0,0,Memphis,28,22,18,17,0,0,0,0,20190121,105,85,-7,4,14,20,20,190,-20,2018,0,0,358,0
Detroit,17,17,30,23,0,0,0,0,Washington,29,21,31,20,0,0,0,0,20190121,87,101,12,16,17,14,14,188,14,2018,0,0,394,0
Chicago,31,17,28,28,0,0,0,0,Cleveland,18,24,25,21,0,0,0,0,20190121,104,88,13,6,9,16,16,192,-16,2018,0,0,308,0
Orlando,28,32,31,31,0,0,0,0,Atlanta,31,26,21,25,0,0,0,0,20190121,122,103,-3,3,13,19,19,225,-19,2018,0,0,401,0
Golden State,29,36,45,20,0,0,0,0,LA Lakers,24,31,25,31,0,0,0,0,20190121,130,111,5,10,30,19,19,241,-19,2018,0,0,347,0
Sacramento,23,37,25,9,0,0,0,0,Brooklyn,29,26,38,30,0,0,0,0,20190121,94,123,6,-5,8,29,29,217,29,2018,0,0,2499,0
Miami,23,27,18,31,0,0,0,0,Boston,33,17,37,20,0,0,0,0,20190121,99,107,10,0,19,8,8,206,8,2018,0,0,1257,0
LA Clippers,29,27,17,25,0,0,0,0,Dallas,26,32,20,28,0,0,0,0,20190122,98,106,-3,2,5,8,8,204,8,2018,0,1,1237,0
Portland,25,30,32,27,0,0,0,0,Oklahoma City,25,37,31,30,0,0,0,0,20190122,114,123,0,7,6,9,9,237,9,2018,0,1,1484,0
Minnesota,32,32,29,25,0,0,0,0,Phoenix,27,22,22,20,0,0,0,0,20190122,118,91,5,15,22,27,27,209,-27,2018,0,1,1278,0
Sacramento,34,22,22,27,0,0,0,0,Toronto,29,31,28,32,0,0,0,0,20190122,105,120,-5,4,10,15,15,225,15,2018,0,1,2195,0
Denver,24,34,22,28,0,0,0,0,Utah,30,35,23,26,0,0,0,0,20190123,108,114,6,7,8,6,6,222,6,2018,0,2,370,0
San Antonio,35,29,32,24,0,0,0,0,Philadelphia,34,33,29,26,0,0,0,0,20190123,120,122,-1,3,0,2,2,242,2,2018,0,2,1505,0
Houston,28,30,30,26,0,0,0,0,New York,31,32,15,32,0,0,0,0,20190123,114,110,-3,-5,10,4,4,224,-4,2018,0,2,1417,0
Charlotte,23,35,28,32,0,0,0,0,Memphis,22,32,22,31,0,0,0,0,20190123,118,107,1,4,10,11,11,225,-11,2018,0,2,519,0
Detroit,31,26,22,19,0,0,0,0,New Orleans,28,19,23,24,0,0,0,0,20190123,98,94,3,10,9,4,4,192,-4,2018,0,2,939,0
Atlanta,42,24,32,23,0,0,0,0,Chicago,25,35,23,18,0,0,0,0,20190123,121,101,17,6,15,20,20,222,-20,2018,0,2,587,0
Orlando,25,31,30,24,0,0,0,0,Brooklyn,26,30,33,25,0,0,0,0,20190123,110,114,1,0,3,4,4,224,4,2018,0,2,939,0
Cleveland,30,20,30,23,0,0,0,0,Boston,27,38,27,31,0,0,0,0,20190123,103,123,-3,15,12,20,20,226,20,2018,0,2,549,0
Toronto,16,31,28,31,0,0,0,0,Indiana,24,35,25,26,0,0,0,0,20190123,106,110,8,12,9,4,4,216,4,2018,0,2,438,0
LA Clippers,27,27,23,34,0,0,0,0,Miami,31,23,18,27,0,0,0,0,20190123,111,99,-4,0,5,12,12,210,-12,2018,0,2,2335,0
Minnesota,28,30,26,36,0,0,0,0,LA Lakers,29,32,21,23,0,0,0,0,20190124,120,105,-1,-3,2,15,15,225,-15,2018,0,3,1521,0
New Orleans,28,25,29,34,0,0,0,0,Oklahoma City,28,37,33,24,0,0,0,0,20190124,116,122,0,12,16,6,6,238,6,2018,0,3,576,0
Portland,30,26,32,32,0,0,0,0,Phoenix,31,21,24,30,0,0,0,0,20190124,120,106,-1,4,12,14,14,226,-14,2018,0,3,1005,0
Golden State,37,30,37,22,0,0,0,0,Washington,28,31,33,26,0,0,0,0,20190124,126,118,9,8,12,8,8,244,-8,2018,0,3,2435,0
Sacramento,24,24,29,22,0,0,0,0,Memphis,23,19,29,25,0,0,0,0,20190125,99,96,1,6,6,3,3,195,-3,2018,0,4,1745,0
Minnesota,24,21,24,33,0,0,0,0,Utah,31,21,38,16,0,0,0,0,20190125,102,106,7,7,21,4,4,208,4,2018,0,4,984,0
Washington,24,26,25,20,0,0,0,0,Orlando,21,17,31,22,0,0,0,0,20190125,95,91,3,12,6,4,4,186,-4,2018,0,4,757,0
Charlotte,27,27,33,12,0,0,0,0,Milwaukee,22,30,24,32,0,0,0,0,20190125,99,108,-5,-2,-11,9,9,207,9,2018,0,4,658,0
Toronto,20,41,28,30,0,0,0,0,Houston,33,37,26,25,0,0,0,0,20190125,119,121,13,9,7,2,2,240,2,2018,0,4,1299,0
Detroit,28,26,31,16,0,0,0,0,Dallas,23,39,26,18,0,0,0,0,20190125,101,106,-5,8,3,5,5,207,5,2018,0,4,999,0
New York,37,23,22,17,0,0,0,0,Brooklyn,30,30,27,22,0,0,0,0,20190125,99,109,-7,0,5,10,10,208,10,2018,0,4,0,0
Phoenix,32,23,26,14,0,0,0,0,Denver,37,33,28,34,0,0,0,0,20190125,95,132,5,15,17,37,37,227,37,2018,0,4,585,0
Miami,27,21,32,20,0,0,0,0,Cleveland,23,30,17,24,0,0,0,0,20190125,100,94,4,-5,10,6,6,194,-6,2018,0,4,1089,0
LA Clippers,27,25,28,26,0,0,0,0,Chicago,20,36,26,19,0,0,0,0,20190125,106,101,7,-4,-2,5,5,207,-5,2018,0,4,1741,0
Golden State,29,32,29,25,0,0,0,0,Boston,26,33,25,27,0,0,0,0,20190126,115,111,3,2,6,4,4,226,-4,2018,0,5,2692,0
Philadelphia,37,31,28,14,0,0,0,0,Denver,41,36,30,19,0,0,0,0,20190126,110,126,4,9,11,16,16,236,16,2018,0,5,1574,0
Indiana,19,23,27,34,0,0,0,0,Memphis,24,29,25,28,0,0,0,0,20190126,103,106,5,11,9,3,3,209,3,2018,0,5,383,0
San Antonio,28,32,36,30,0,0,0,0,New Orleans,27,30,28,29,0,0,0,0,20190126,126,114,1,3,11,12,12,240,-12,2018,0,5,506,0
Atlanta,30,34,26,21,0,0,0,0,Portland,40,23,30,27,0,0,0,0,20190126,111,120,10,-1,3,9,9,231,9,2018,0,5,2168,0
Washington,26,43,17,33,0,0,0,0,San Antonio,36,34,29,33,0,0,0,0,20190127,119,132,10,1,13,13,13,251,13,2018,0,6,1385,0
Milwaukee,25,17,37,33,0,0,0,0,Oklahoma City,31,25,33,29,0,0,0,0,20190127,112,118,6,14,10,6,6,230,6,2018,0,6,732,0
Miami,25,27,29,25,0,0,0,0,New York,26,32,12,27,0,0,0,0,20190127,106,97,-1,-6,11,9,9,203,-9,2018,0,6,1091,0
Utah,25,28,37,35,0,0,0,0,Minnesota,22,28,35,26,0,0,0,0,20190127,125,111,3,3,5,14,14,236,-14,2018,0,6,984,0
Phoenix,27,26,28,21,0,0,0,0,LA Lakers,31,34,25,26,0,0,0,0,20190127,102,116,4,12,9,14,14,218,14,2018,0,6,356,0
Orlando,34,27,21,16,0,0,0,0,Houston,18,35,21,29,0,0,0,0,20190127,98,103,-16,-8,-8,5,5,201,5,2018,0,6,847,0
Toronto,38,32,15,38,0,0,0,0,Dallas,32,26,30,32,0,0,0,0,20190127,123,120,6,12,-3,3,3,243,-3,2018,0,6,1201,0
Cleveland,27,24,28,25,0,0,0,0,Chicago,29,24,26,22,0,0,0,0,20190127,104,101,-2,-2,0,3,3,205,-3,2018,0,6,308,0
Sacramento,21,30,25,32,0,0,0,0,LA Clippers,34,33,20,35,0,0,0,0,20190127,108,122,13,16,11,14,14,230,14,2018,0,6,361,0
Brooklyn,26,24,38,16,0,0,0,0,Boston,32,28,29,23,0,0,0,0,20190128,104,112,6,10,1,8,8,216,8,2018,0,0,190,0
New York,24,29,18,21,0,0,0,0,Charlotte,30,24,17,30,0,0,0,0,20190128,92,101,6,1,0,9,9,193,9,2018,0,0,531,0
Golden State,40,29,32,31,0,0,0,0,Indiana,22,26,31,21,0,0,0,0,20190128,132,100,18,21,22,32,32,232,-32,2018,0,0,1944,0
Atlanta,32,31,31,29,0,0,0,0,LA Clippers,25,36,22,35,0,0,0,0,20190128,123,118,7,2,11,5,5,241,-5,2018,0,0,1932,0
Denver,16,25,19,35,0,0,0,0,Memphis,30,30,17,15,0,0,0,0,20190128,95,92,-14,-19,-17,3,3,187,-3,2018,0,0,877,0
Phoenix,33,34,24,33,0,0,0,0,San Antonio,33,37,26,30,0,0,0,0,20190129,124,126,0,3,5,2,2,250,2,2018,0,1,846,0
Oklahoma City,32,37,22,35,0,0,0,0,Orlando,35,28,31,23,0,0,0,0,20190129,126,117,-3,6,-3,9,9,243,-9,2018,0,1,1057,0
Philadelphia,39,25,32,25,0,0,0,0,LA Lakers,20,33,28,24,0,0,0,0,20190129,121,105,19,11,15,16,16,226,-16,2018,0,1,2388,0
Milwaukee,30,32,27,26,0,0,0,0,Detroit,22,27,28,28,0,0,0,0,20190129,115,105,8,13,12,10,10,220,-10,2018,0,1,251,0
Washington,24,23,22,44,0,0,0,0,Cleveland,26,27,35,28,0,0,0,0,20190129,113,116,2,6,19,3,3,229,3,2018,0,1,304,0
Chicago,19,35,25,38,0,0,0,0,Brooklyn,20,30,33,39,0,0,0,0,20190129,117,122,1,-4,4,5,5,239,5,2018,0,1,711,0
New Orleans,28,31,35,27,0,0,0,0,Houston,35,31,25,25,0,0,0,0,20190129,121,116,-7,-7,3,5,5,237,-5,2018,0,1,317,0
Charlotte,28,31,16,19,0,0,0,0,Boston,35,28,35,28,0,0,0,0,20190130,94,126,7,4,23,32,32,220,32,2018,0,2,720,0
Chicago,31,19,28,27,0,0,0,0,Miami,21,27,20,21,0,0,0,0,20190130,105,89,10,2,10,16,16,194,-16,2018,0,2,1189,0
Memphis,16,28,25,24,4,0,0,0,Minnesota,24,20,27,22,6,0,0,0,20190130,97,99,8,0,2,0,2,196,2,2018,1,2,700,0
Denver,29,24,33,19,0,0,0,0,New Orleans,26,30,19,24,0,0,0,0,20190130,105,99,3,-3,11,6,6,204,-6,2018,0,2,1079,0
Dallas,24,31,35,24,0,0,0,0,New York,20,27,23,20,0,0,0,0,20190130,114,90,4,8,20,24,24,204,-24,2018,0,2,1370,0
Utah,27,31,22,25,0,0,0,0,Portland,45,29,35,23,0,0,0,0,20190130,105,132,18,16,29,27,27,237,27,2018,0,2,634,0
Atlanta,31,22,27,33,0,0,0,0,Sacramento,32,35,38,30,0,0,0,0,20190130,113,135,1,14,25,22,22,248,22,2018,0,2,2082,0
Indiana,25,20,24,20,0,0,0,0,Washington,35,24,23,25,0,0,0,0,20190130,89,107,10,14,13,18,18,196,18,2018,0,2,490,0
Milwaukee,22,34,31,18,0,0,0,0,Toronto,25,22,29,16,0,0,0,0,20190131,105,92,-3,9,11,13,13,197,-13,2018,0,3,429,0
Brooklyn,25,26,38,25,0,0,0,0,San Antonio,29,23,33,32,0,0,0,0,20190131,114,117,4,1,-4,3,3,231,3,2018,0,3,1581,0
Indiana,19,29,25,27,0,0,0,0,Orlando,24,27,18,38,0,0,0,0,20190131,100,107,5,3,-4,7,7,207,7,2018,0,3,822,0
LA Lakers,32,22,33,25,11,0,0,0,LA Clippers,26,27,22,37,8,0,0,0,20190131,123,120,6,1,12,0,3,243,-3,2018,1,3,0,0
Dallas,21,28,21,19,0,0,0,0,Detroit,19,26,18,30,0,0,0,0,20190131,89,93,-2,-4,-7,4,4,182,4,2018,0,3,999,0
Philadelphia,30,23,42,18,0,0,0,0,Golden State,35,25,26,18,0,0,0,0,20190131,113,104,-5,-7,9,9,9,217,-9,2018,0,3,2516,0
Memphis,29,16,28,19,0,0,0,0,Charlotte,17,28,25,30,0,0,0,0,20190201,92,100,-12,0,-3,8,8,192,8,2018,0,4,519,0
Houston,43,28,24,27,0,0,0,0,Denver,35,48,30,23,0,0,0,0,20190201,122,136,-8,12,18,14,14,258,14,2018,0,4,878,0
Oklahoma City,31,41,22,24,0,0,0,0,Miami,24,29,21,28,0,0,0,0,20190201,118,102,7,19,20,16,16,220,-16,2018,0,4,1225,0
Boston,25,31,24,33,0,0,0,0,New York,20,27,26,26,0,0,0,0,20190201,113,99,5,9,7,14,14,212,-14,2018,0,4,190,0
Atlanta,34,26,27,25,0,0,0,0,Utah,36,22,38,32,0,0,0,0,20190201,112,128,2,-2,9,16,16,240,16,2018,0,4,1580,0
Milwaukee,38,35,27,31,0,0,0,0,Washington,26,24,34,31,0,0,0,0,20190202,131,115,12,23,16,16,16,246,-16,2018,0,5,634,0
Houston,31,32,28,34,0,0,0,0,Utah,27,23,19,29,0,0,0,0,20190202,125,98,4,13,22,27,27,223,-27,2018,0,5,1199,0
New Orleans,24,26,28,30,0,0,0,0,San Antonio,35,28,31,19,0,0,0,0,20190202,108,113,11,13,16,5,5,221,5,2018,0,5,506,0
Philadelphia,26,26,27,29,0,0,0,0,Sacramento,32,30,24,29,0,0,0,0,20190202,108,115,6,10,7,7,7,223,7,2018,0,5,2451,0
Atlanta,33,25,28,32,0,0,0,0,Phoenix,30,27,31,24,0,0,0,0,20190202,118,112,3,1,-2,6,6,230,-6,2018,0,5,1588,0
Brooklyn,21,27,22,19,0,0,0,0,Orlando,26,18,34,24,0,0,0,0,20190202,89,102,5,-4,8,13,13,191,13,2018,0,5,939,0
Indiana,21,32,31,11,0,0,0,0,Miami,27,27,23,11,0,0,0,0,20190202,95,88,-6,-1,7,7,7,183,-7,2018,0,5,1026,0
LA Lakers,24,34,28,15,0,0,0,0,Golden State,33,30,25,27,0,0,0,0,20190202,101,115,9,5,2,14,14,216,14,2018,0,5,347,0
LA Clippers,22,25,29,35,0,0,0,0,Detroit,40,25,22,14,0,0,0,0,20190202,111,101,-18,-18,-11,10,10,212,-10,2018,0,5,1979,0
Dallas,40,18,28,25,0,0,0,0,Cleveland,31,24,25,18,0,0,0,0,20190202,111,98,9,3,6,13,13,209,-13,2018,0,5,1024,0
Chicago,26,34,26,32,0,0,0,0,Charlotte,27,24,37,37,0,0,0,0,20190202,118,125,1,-9,2,7,7,243,7,2018,0,5,586,0
Denver,29,32,28,18,0,0,0,0,Minnesota,38,26,24,18,0,0,0,0,20190202,107,106,-9,-3,1,1,1,213,-1,2018,0,5,698,0
Oklahoma City,29,29,35,36,0,0,0,0,Boston,31,35,33,35,0,0,0,0,20190203,129,134,2,8,6,5,5,263,5,2018,0,6,1492,0
Memphis,19,23,32,22,0,0,0,0,New York,22,19,21,22,0,0,0,0,20190203,96,84,-3,1,12,12,12,180,-12,2018,0,6,953,0
LA Clippers,23,28,29,23,0,0,0,0,Toronto,23,42,32,24,0,0,0,0,20190203,103,121,0,14,17,18,18,224,18,2018,0,6,2170,0
Atlanta,35,26,38,38,0,0,0,0,Washington,20,37,32,40,0,0,0,0,20190204,137,129,15,4,10,8,8,266,-8,2018,0,0,541,0
Houston,32,31,31,24,0,0,0,0,Phoenix,28,29,23,30,0,0,0,0,20190204,118,110,4,6,14,8,8,228,-8,2018,0,0,1014,0
San Antonio,25,34,27,26,0,0,0,0,Sacramento,37,26,35,29,0,0,0,0,20190204,112,127,12,4,12,15,15,239,15,2018,0,0,1456,0
Denver,36,19,28,20,0,0,0,0,Detroit,34,34,29,32,0,0,0,0,20190204,103,129,-2,13,14,26,26,232,26,2018,0,0,1154,0
Milwaukee,23,28,36,26,0,0,0,0,Brooklyn,17,25,22,30,0,0,0,0,20190204,113,94,6,9,23,19,19,207,-19,2018,0,0,732,0
Indiana,25,28,30,26,0,0,0,0,New Orleans,20,30,24,33,0,0,0,0,20190204,109,107,5,3,9,2,2,216,-2,2018,0,0,713,0
LA Clippers,26,27,31,33,0,0,0,0,Charlotte,25,33,34,23,0,0,0,0,20190205,117,115,1,-5,-8,2,2,232,-2,2018,0,1,2115,0
Boston,28,31,26,18,0,0,0,0,Cleveland,30,21,28,17,0,0,0,0,20190205,103,96,-2,8,6,7,7,199,-7,2018,0,1,549,0
LA Lakers,26,20,27,21,0,0,0,0,Indiana,33,36,32,35,0,0,0,0,20190205,94,136,7,23,28,42,42,230,42,2018,0,1,1805,0
Minnesota,19,35,29,23,0,0,0,0,Memphis,32,34,19,23,0,0,0,0,20190205,106,108,13,12,2,2,2,214,2,2018,0,1,700,0
Detroit,36,27,15,27,0,0,0,0,New York,28,26,17,21,0,0,0,0,20190205,105,92,8,9,7,13,13,197,-13,2018,0,1,480,0
Orlando,32,37,23,30,0,0,0,0,Oklahoma City,31,31,36,34,0,0,0,0,20190205,122,132,-1,-7,6,10,10,254,10,2018,0,1,1057,0
Toronto,40,32,28,19,0,0,0,0,Philadelphia,28,27,27,25,0,0,0,0,20190205,119,107,12,17,18,12,12,226,-12,2018,0,1,334,0
Miami,34,28,32,24,0,0,0,0,Portland,30,25,24,29,0,0,0,0,20190205,118,108,4,7,15,10,10,226,-10,2018,0,1,2704,0
Phoenix,24,22,25,17,0,0,0,0,Utah,30,26,23,37,0,0,0,0,20190206,88,116,6,10,8,28,28,204,28,2018,0,2,505,0
Houston,32,44,28,23,0,0,0,0,Sacramento,28,17,29,27,0,0,0,0,20190206,127,101,4,31,30,26,26,228,-26,2018,0,2,1606,0
San Antonio,31,21,31,19,0,0,0,0,Golden State,33,33,49,26,0,0,0,0,20190206,102,141,2,14,32,39,39,243,39,2018,0,2,1487,0
Washington,35,30,42,22,0,0,0,0,Milwaukee,50,35,35,28,0,0,0,0,20190206,129,148,15,20,13,19,19,277,19,2018,0,2,634,0
New Orleans,37,27,27,34,0,0,0,0,Chicago,39,26,17,38,0,0,0,0,20190206,125,120,-2,-1,9,5,5,245,-5,2018,0,2,832,0
Denver,35,25,27,43,0,0,0,0,Brooklyn,30,42,36,27,0,0,0,0,20190206,130,135,-5,12,21,5,5,265,5,2018,0,2,1627,0
Charlotte,20,26,25,22,0,0,0,0,Dallas,27,25,22,25,0,0,0,0,20190206,93,99,7,6,3,6,6,192,6,2018,0,2,928,0
Toronto,22,38,28,31,0,0,0,0,Atlanta,33,35,17,16,0,0,0,0,20190207,119,101,-11,-8,3,18,18,220,-18,2018,0,3,733,0
LA Lakers,24,33,42,30,0,0,0,0,Boston,30,36,27,35,0,0,0,0,20190207,129,128,-6,-9,6,1,1,257,-1,2018,0,3,2590,0
LA Clippers,31,22,20,19,0,0,0,0,Indiana,36,35,27,18,0,0,0,0,20190207,92,116,5,18,25,24,24,208,24,2018,0,3,1805,0
Memphis,32,21,19,23,0,0,0,0,Oklahoma City,27,24,32,34,0,0,0,0,20190207,95,117,-5,-2,11,22,22,212,22,2018,0,3,421,0
Minnesota,31,27,27,27,0,0,0,0,Orlando,32,39,31,20,0,0,0,0,20190207,112,122,1,13,17,10,10,234,10,2018,0,3,1309,0
San Antonio,34,23,33,28,0,0,0,0,Portland,31,39,26,31,0,0,0,0,20190207,118,127,-3,13,6,9,9,245,9,2018,0,3,1718,0
Cleveland,27,25,34,20,0,0,0,0,Washington,41,25,26,27,0,0,0,0,20190208,106,119,14,14,6,13,13,225,13,2018,0,4,304,0
Miami,28,31,24,13,0,0,0,0,Sacramento,17,33,25,27,0,0,0,0,20190208,96,102,-11,-9,-8,6,6,198,6,2018,0,4,2547,0
Golden State,26,34,22,35,0,0,0,0,Phoenix,31,22,32,22,0,0,0,0,20190208,117,107,-5,7,-3,10,10,224,-10,2018,0,4,652,0
Denver,23,33,26,28,0,0,0,0,Philadelphia,33,23,27,34,0,0,0,0,20190208,110,117,10,0,1,7,7,227,7,2018,0,4,1574,0
Milwaukee,29,35,30,28,0,0,0,0,Dallas,29,22,35,21,0,0,0,0,20190208,122,107,0,13,8,15,15,229,-15,2018,0,4,857,0
New York,22,32,30,19,0,0,0,0,Detroit,41,22,26,31,0,0,0,0,20190208,103,120,19,9,5,17,17,223,17,2018,0,4,480,0
Chicago,32,23,38,32,0,0,0,0,Brooklyn,27,21,32,26,0,0,0,0,20190208,125,106,5,7,13,19,19,231,-19,2018,0,4,711,0
Minnesota,35,27,26,29,0,0,0,0,New Orleans,22,40,28,32,0,0,0,0,20190208,117,122,-13,0,2,5,5,239,5,2018,0,4,1052,0
New Orleans,28,16,18,28,0,0,0,0,Memphis,20,21,31,27,0,0,0,0,20190209,90,99,-8,-3,10,9,9,189,9,2018,0,5,358,0
San Antonio,24,24,27,30,0,0,0,0,Utah,23,39,24,39,0,0,0,0,20190209,105,125,-1,14,11,20,20,230,20,2018,0,5,1087,0
Orlando,20,39,20,24,0,0,0,0,Milwaukee,19,30,15,19,0,0,0,0,20190209,103,83,1,10,15,20,20,186,-20,2018,0,5,1065,0
Cleveland,17,25,18,30,0,0,0,0,Indiana,30,24,20,31,0,0,0,0,20190209,90,105,13,12,14,15,15,195,15,2018,0,5,262,0
Toronto,25,21,28,30,0,0,0,0,New York,23,19,27,30,0,0,0,0,20190209,104,99,2,4,5,5,5,203,-5,2018,0,5,341,0
Washington,34,42,30,28,0,0,0,0,Chicago,32,29,35,29,0,0,0,0,20190209,134,125,2,15,10,9,9,259,-9,2018,0,5,594,0
LA Clippers,20,33,28,42,0,0,0,0,Boston,43,31,12,26,0,0,0,0,20190209,123,112,-23,-21,-5,11,11,235,-11,2018,0,5,2590,0
Charlotte,46,27,33,23,0,0,0,0,Atlanta,31,37,18,34,0,0,0,0,20190209,129,120,15,5,20,9,9,249,-9,2018,0,5,226,0
Oklahoma City,25,23,42,27,0,0,0,0,Houston,28,42,20,22,0,0,0,0,20190209,117,112,-3,-22,0,5,5,229,-5,2018,0,5,413,0
Orlando,26,37,35,26,0,0,0,0,Atlanta,25,23,26,34,0,0,0,0,20190210,124,108,1,15,24,16,16,232,-16,2018,0,6,401,0
Portland,24,33,35,9,0,0,0,0,Dallas,25,22,31,24,0,0,0,0,20190210,101,102,1,-10,-14,1,1,203,1,2018,0,6,1630,0
Miami,34,25,23,36,0,0,0,0,Golden State,24,30,36,30,0,0,0,0,20190210,118,120,-10,-5,8,2,2,238,2,2018,0,6,2590,0
LA Lakers,40,27,27,26,0,0,0,0,Philadelphia,39,37,33,34,0,0,0,0,20190210,120,143,-1,9,15,23,23,263,23,2018,0,6,2388,0
Phoenix,23,21,28,32,0,0,0,0,Sacramento,33,30,24,30,0,0,0,0,20190210,104,117,10,19,15,13,13,221,13,2018,0,6,634,0
Brooklyn,29,31,32,33,0,0,0,0,Toronto,21,35,36,35,0,0,0,0,20190211,125,127,-8,-4,0,2,2,252,2,2018,0,0,341,0
Portland,26,23,33,29,0,0,0,0,Oklahoma City,36,32,19,33,0,0,0,0,20190211,111,120,10,19,5,9,9,231,9,2018,0,0,1484,0
LA Clippers,26,29,36,29,0,0,0,0,Minnesota,29,34,36,31,0,0,0,0,20190211,120,130,3,8,8,10,10,250,10,2018,0,0,1521,0
Charlotte,19,19,33,19,0,0,0,0,Indiana,32,22,23,22,0,0,0,0,20190211,90,99,13,16,6,9,9,189,9,2018,0,0,428,0
Dallas,22,28,28,26,0,0,0,0,Houston,25,39,28,28,0,0,0,0,20190211,104,120,3,14,14,16,16,224,16,2018,0,0,225,0
Miami,27,22,21,17,0,0,0,0,Denver,35,19,29,20,0,0,0,0,20190211,87,103,8,5,13,16,16,190,16,2018,0,0,1724,0
New York,22,26,31,25,0,0,0,0,Cleveland,30,33,26,18,0,0,0,0,20190211,104,107,8,15,10,3,3,211,3,2018,0,0,403,0
Milwaukee,22,28,29,33,0,0,0,0,Chicago,21,28,22,28,0,0,0,0,20190211,112,99,1,1,8,13,13,211,-13,2018,0,0,83,0
Washington,27,32,20,33,0,0,0,0,Detroit,36,25,29,31,0,0,0,0,20190211,112,121,9,2,11,9,9,233,9,2018,0,0,394,0
LA Lakers,32,37,26,18,0,0,0,0,Atlanta,38,27,35,17,0,0,0,0,20190212,113,117,6,-4,5,4,4,230,4,2018,0,1,1932,0
Utah,14,30,40,24,0,0,0,0,Golden State,25,22,34,34,0,0,0,0,20190212,108,115,11,3,-3,7,7,223,7,2018,0,1,599,0
San Antonio,20,37,37,14,0,0,0,0,Memphis,33,25,28,21,0,0,0,0,20190212,108,107,-13,-1,8,1,1,215,-1,2018,0,1,631,0
Orlando,39,24,29,26,0,0,0,0,New Orleans,17,29,15,27,0,0,0,0,20190212,118,88,22,17,31,30,30,206,-30,2018,0,1,533,0
Boston,28,24,25,35,0,0,0,0,Philadelphia,23,23,28,35,0,0,0,0,20190212,112,109,5,6,3,3,3,221,-3,2018,0,1,270,0
Phoenix,22,29,28,28,0,0,0,0,LA Clippers,32,35,33,34,0,0,0,0,20190213,107,134,10,16,21,27,27,241,27,2018,0,2,356,0
Golden State,33,28,34,12,0,0,0,0,Portland,31,33,30,35,0,0,0,0,20190213,107,129,-2,3,-1,22,22,236,22,2018,0,2,535,0
Washington,26,39,28,27,0,0,0,0,Toronto,30,29,44,26,0,0,0,0,20190213,120,129,4,-6,10,9,9,249,9,2018,0,2,349,0
Houston,29,29,26,27,0,0,0,0,Minnesota,28,24,35,34,0,0,0,0,20190213,111,121,-1,-6,3,10,10,232,10,2018,0,2,1057,0
Milwaukee,26,29,21,30,0,0,0,0,Indiana,18,29,32,18,0,0,0,0,20190213,106,97,8,8,-3,9,9,203,-9,2018,0,2,243,0
Philadelphia,37,34,29,26,0,0,0,0,New York,33,22,36,20,0,0,0,0,20190213,126,111,4,16,9,15,15,237,-15,2018,0,2,80,0
Miami,29,28,32,23,0,0,0,0,Dallas,25,33,16,27,0,0,0,0,20190213,112,101,4,-1,15,11,11,213,-11,2018,0,2,1110,0
Detroit,29,23,20,38,0,0,0,0,Boston,28,29,34,27,0,0,0,0,20190213,110,118,-1,5,19,8,8,228,8,2018,0,2,611,0
Sacramento,41,28,22,27,0,0,0,0,Denver,30,28,35,27,0,0,0,0,20190213,118,120,-11,-11,2,2,2,238,2,2018,0,2,886,0
Brooklyn,30,25,29,25,9,10,20,0,Cleveland,29,29,26,25,9,10,11,0,20190213,148,139,1,-3,0,0,9,287,-9,2018,3,2,403,0
Memphis,32,30,21,27,0,0,0,0,Chicago,36,31,25,30,0,0,0,0,20190213,110,122,4,5,9,12,12,232,12,2018,0,2,480,0
New York,28,26,28,24,0,0,0,0,Atlanta,13,38,22,18,0,0,0,0,20190214,106,91,15,3,9,15,15,197,-15,2018,0,3,745,0
Oklahoma City,31,32,26,33,0,0,0,0,New Orleans,31,35,35,30,0,0,0,0,20190214,122,131,0,3,12,9,9,253,9,2018,0,3,576,0
Charlotte,18,18,31,22,0,0,0,0,Orlando,33,38,27,29,0,0,0,0,20190214,89,127,15,35,31,38,38,216,38,2018,0,3,463,0
Portland,23,27,34,29,0,0,0,0,Brooklyn,21,29,22,27,0,0,0,0,20190221,113,99,2,0,12,14,14,212,-14,2018,0,3,2439,0
Phoenix,28,23,21,26,0,0,0,0,Cleveland,23,32,22,34,0,0,0,0,20190221,98,111,-5,4,5,13,13,209,13,2018,0,3,1745,0
Sacramento,30,32,29,32,0,0,0,0,Golden State,35,25,29,36,0,0,0,0,20190221,123,125,5,-2,-2,2,2,248,2,2018,0,3,75,0
Houston,32,26,32,16,0,0,0,0,LA Lakers,22,30,31,28,0,0,0,0,20190221,106,111,-10,-6,-7,5,5,217,5,2018,0,3,1371,0
Boston,22,25,21,29,0,0,0,0,Milwaukee,20,33,19,26,0,0,0,0,20190221,97,98,-2,6,4,1,1,195,1,2018,0,3,855,0
Miami,21,29,25,27,0,0,0,0,Philadelphia,29,28,16,33,0,0,0,0,20190221,102,106,8,7,-2,4,4,208,4,2018,0,3,1021,0
San Antonio,23,33,35,26,0,0,0,0,Toronto,26,29,33,32,0,0,0,0,20190222,117,120,3,-1,-3,3,3,237,3,2018,0,4,1438,0
Chicago,24,27,38,21,0,0,0,0,Orlando,26,27,29,27,0,0,0,0,20190222,110,109,-2,-2,7,1,1,219,-1,2018,0,4,984,0
Utah,34,23,38,34,10,8,0,0,Oklahoma City,35,31,27,36,10,9,0,0,20190222,147,148,1,9,-2,0,1,295,1,2018,2,4,861,0
Minnesota,29,37,28,21,0,0,0,0,New York,33,25,25,21,0,0,0,0,20190222,115,104,-4,8,11,11,11,219,-11,2018,0,4,1016,0
Washington,38,22,27,23,0,0,0,0,Charlotte,27,38,31,27,0,0,0,0,20190222,110,123,-11,5,9,13,13,233,13,2018,0,4,329,0
New Orleans,35,36,23,17,0,0,0,0,Indiana,24,34,39,29,0,0,0,0,20190222,111,126,-11,-13,3,15,15,237,15,2018,0,4,713,0
Denver,25,27,39,23,0,0,0,0,Dallas,30,21,23,30,0,0,0,0,20190222,114,104,-5,1,17,10,10,218,-10,2018,0,4,661,0
LA Clippers,36,29,18,29,0,0,0,0,Memphis,23,30,33,20,0,0,0,0,20190222,112,106,13,12,-3,6,6,218,-6,2018,0,4,1599,0
Detroit,33,35,32,25,0,0,0,0,Atlanta,34,36,25,27,0,0,0,0,20190222,125,122,-1,-2,5,3,3,247,-3,2018,0,4,597,0
Minnesota,32,38,39,19,0,0,0,0,Milwaukee,35,34,38,33,0,0,0,0,20190223,128,140,3,-1,-2,12,12,268,12,2018,0,5,298,0
Indiana,29,36,24,30,0,0,0,0,Washington,21,29,30,32,0,0,0,0,20190223,119,112,8,15,9,7,7,231,-7,2018,0,5,490,0
Dallas,25,33,20,31,0,0,0,0,Utah,31,30,25,39,0,0,0,0,20190223,109,125,6,3,8,16,16,234,16,2018,0,5,998,0
Portland,27,32,41,30,0,0,0,0,Philadelphia,25,31,26,33,0,0,0,0,20190223,130,115,2,3,18,15,15,245,-15,2018,0,5,2405,0
Sacramento,31,32,31,25,0,0,0,0,Oklahoma City,24,25,34,33,0,0,0,0,20190223,119,116,7,14,11,3,3,235,-3,2018,0,5,1336,0
LA Lakers,35,22,27,31,0,0,0,0,New Orleans,42,27,31,28,0,0,0,0,20190223,115,128,7,12,16,13,13,243,13,2018,0,5,1669,0
Detroit,20,34,30,35,0,0,0,0,Miami,29,17,30,20,0,0,0,0,20190223,119,96,-9,8,8,23,23,215,-23,2018,0,5,1155,0
Memphis,24,32,28,23,0,0,0,0,Cleveland,37,26,19,30,0,0,0,0,20190223,107,112,13,7,-2,5,5,219,5,2018,0,5,629,0
Brooklyn,34,29,27,27,0,0,0,0,Charlotte,20,30,34,31,0,0,0,0,20190223,117,115,14,13,6,2,2,232,-2,2018,0,5,531,0
Boston,33,18,30,35,0,0,0,0,Chicago,28,36,30,32,0,0,0,0,20190223,116,126,-5,13,13,10,10,242,10,2018,0,5,849,0
Phoenix,33,26,28,25,0,0,0,0,Atlanta,33,30,23,34,0,0,0,0,20190223,112,120,0,4,-1,8,8,232,8,2018,0,5,1588,0
Houston,35,26,31,26,0,0,0,0,Golden State,20,34,32,26,0,0,0,0,20190223,118,112,15,7,6,6,6,230,-6,2018,0,5,1642,0
LA Clippers,27,29,21,19,0,0,0,0,Denver,34,30,33,26,0,0,0,0,20190224,96,123,7,8,20,27,27,219,27,2018,0,6,830,0
San Antonio,26,27,30,35,0,0,0,0,New York,30,32,32,36,0,0,0,0,20190224,118,130,4,9,11,12,12,248,12,2018,0,6,1581,0
Orlando,25,28,27,33,0,0,0,0,Toronto,15,35,21,27,0,0,0,0,20190224,113,98,10,3,9,15,15,211,-15,2018,0,6,1048,0
Philadelphia,31,34,28,18,0,0,0,0,New Orleans,24,28,31,27,0,0,0,0,20190225,111,110,7,13,10,1,1,221,-1,2018,0,0,1088,0
Sacramento,30,23,27,25,0,0,0,0,Minnesota,19,44,30,19,0,0,0,0,20190225,105,112,-11,10,13,7,7,217,7,2018,0,0,1511,0
Phoenix,23,29,32,40,0,0,0,0,Miami,29,34,24,34,0,0,0,0,20190225,124,121,-6,-11,-3,3,3,245,-3,2018,0,0,1978,0
LA Lakers,31,25,25,24,0,0,0,0,Memphis,34,27,26,23,0,0,0,0,20190225,105,110,3,5,6,5,5,215,5,2018,0,0,1599,0
Dallas,22,35,31,24,0,0,0,0,LA Clippers,29,34,28,30,0,0,0,0,20190225,112,121,7,6,3,9,9,233,9,2018,0,0,1237,0
Atlanta,28,32,25,26,0,0,0,0,Houston,39,21,35,24,0,0,0,0,20190225,111,119,11,0,10,8,8,230,8,2018,0,0,700,0
Portland,29,42,17,35,0,0,0,0,Cleveland,18,30,36,26,0,0,0,0,20190225,123,110,11,23,4,13,13,233,-13,2018,0,0,2049,0
Golden State,34,34,30,23,0,0,0,0,Charlotte,30,30,28,22,0,0,0,0,20190225,121,110,4,8,10,11,11,231,-11,2018,0,0,2296,0
Milwaukee,25,38,27,27,0,0,0,0,Chicago,38,16,26,26,0,0,0,0,20190225,117,106,-13,9,10,11,11,223,-11,2018,0,0,83,0
San Antonio,20,18,21,26,0,0,0,0,Brooklyn,28,24,29,20,0,0,0,0,20190225,85,101,8,14,22,16,16,186,16,2018,0,0,1581,0
Indiana,20,31,26,32,0,0,0,0,Detroit,36,19,29,29,0,0,0,0,20190225,109,113,16,4,7,4,4,222,4,2018,0,0,240,0
Oklahoma City,26,25,27,34,0,0,0,0,Denver,29,35,27,30,0,0,0,0,20190226,112,121,3,13,13,9,9,233,9,2018,0,1,503,0
Orlando,34,27,29,13,0,0,0,0,New York,20,36,22,30,0,0,0,0,20190226,103,108,-14,-5,-12,5,5,211,5,2018,0,1,939,0
Boston,32,13,23,27,0,0,0,0,Toronto,30,36,29,23,0,0,0,0,20190226,95,118,-2,21,27,23,23,213,23,2018,0,1,430,0
LA Clippers,33,23,27,22,0,0,0,0,Utah,26,23,34,28,0,0,0,0,20190227,105,111,-7,-7,0,6,6,216,6,2018,0,2,579,0
Detroit,27,21,19,26,0,0,0,0,San Antonio,32,19,27,27,0,0,0,0,20190227,93,105,5,3,11,12,12,198,12,2018,0,2,1238,0
Milwaukee,34,39,31,22,15,0,0,0,Sacramento,33,29,29,35,14,0,0,0,20190227,141,140,1,11,13,0,1,281,-1,2018,1,2,1771,0
Golden State,22,37,33,33,0,0,0,0,Miami,32,42,26,26,0,0,0,0,20190227,125,126,10,15,8,1,1,251,1,2018,0,2,2590,0
Chicago,20,26,29,34,0,0,0,0,Memphis,20,26,28,33,0,0,0,0,20190227,109,107,0,0,1,2,2,216,-2,2018,0,2,480,0
Houston,41,21,28,28,0,0,0,0,Charlotte,33,36,25,19,0,0,0,0,20190227,118,113,8,-7,-4,5,5,231,-5,2018,0,2,925,0
Indiana,27,26,25,23,0,0,0,0,Dallas,28,25,26,31,0,0,0,0,20190227,101,110,1,0,1,9,9,211,9,2018,0,2,763,0
Minnesota,40,28,27,23,5,0,0,0,Atlanta,33,27,26,32,13,0,0,0,20190227,123,131,-7,-8,-9,0,8,254,8,2018,1,2,908,0
New Orleans,28,29,35,27,0,0,0,0,LA Lakers,35,28,32,30,0,0,0,0,20190227,119,125,7,6,3,6,6,244,6,2018,0,2,1669,0
Washington,34,34,33,24,0,0,0,0,Brooklyn,28,32,19,37,0,0,0,0,20190227,125,116,6,8,22,9,9,241,-9,2018,0,2,204,0
Portland,25,18,31,23,0,0,0,0,Boston,24,18,22,28,0,0,0,0,20190227,97,92,1,1,10,5,5,189,-5,2018,0,2,2532,0
Utah,19,33,29,30,0,0,0,0,Denver,22,15,33,34,0,0,0,0,20190228,111,104,-3,15,11,7,7,215,-7,2018,0,3,370,0
Miami,32,37,29,20,0,0,0,0,Houston,33,22,31,35,0,0,0,0,20190228,118,121,1,-14,-12,3,3,239,3,2018,0,3,966,0
Minnesota,35,25,30,25,0,0,0,0,Indiana,26,38,28,30,0,0,0,0,20190228,115,122,-9,4,2,7,7,237,7,2018,0,3,510,0
Cleveland,27,30,28,40,0,0,0,0,New York,31,28,38,21,0,0,0,0,20190228,125,118,-4,-2,-12,7,7,243,-7,2018,0,3,403,0
Philadelphia,37,23,26,22,0,0,0,0,Oklahoma City,26,23,30,25,0,0,0,0,20190228,108,104,11,11,7,4,4,212,-4,2018,0,3,1256,0
Golden State,22,29,30,15,0,0,0,0,Orlando,28,31,11,33,0,0,0,0,20190228,96,103,6,8,-11,7,7,199,7,2018,0,3,2437,0
Portland,24,30,30,33,0,0,0,0,Toronto,31,30,32,26,0,0,0,0,20190301,117,119,7,7,9,2,2,236,2,2018,0,4,2108,0
LA Clippers,26,26,35,29,0,0,0,0,Sacramento,23,33,26,27,0,0,0,0,20190301,116,109,3,-4,5,7,7,225,-7,2018,0,4,361,0
New Orleans,27,29,38,36,0,0,0,0,Phoenix,32,25,27,32,0,0,0,0,20190301,130,116,-5,-1,10,14,14,246,-14,2018,0,4,1312,0
Washington,20,25,36,15,0,0,0,0,Boston,30,19,33,25,0,0,0,0,20190301,96,107,10,4,1,11,11,203,11,2018,0,4,394,0
Charlotte,31,37,30,25,0,0,0,0,Brooklyn,32,18,36,26,0,0,0,0,20190301,123,112,-1,18,12,11,11,235,-11,2018,0,4,531,0
Chicago,26,31,38,29,16,7,8,13,Atlanta,33,27,24,40,16,7,8,6,20190301,168,161,-7,-3,11,0,7,329,-7,2018,4,4,587,0
Milwaukee,27,32,34,38,0,0,0,0,LA Lakers,26,39,29,26,0,0,0,0,20190301,131,120,1,-6,-1,11,11,251,-11,2018,0,4,1741,0
Golden State,31,24,38,27,0,0,0,0,Philadelphia,32,35,23,27,0,0,0,0,20190302,120,117,-1,-12,3,3,3,237,-3,2018,0,5,2516,0
Oklahoma City,25,38,15,24,0,0,0,0,San Antonio,38,34,20,24,0,0,0,0,20190302,102,116,13,9,14,14,14,218,14,2018,0,5,421,0
LA Lakers,26,33,19,31,0,0,0,0,Phoenix,33,33,29,23,0,0,0,0,20190302,109,118,7,7,17,9,9,227,9,2018,0,5,356,0
Brooklyn,23,21,20,24,0,0,0,0,Miami,28,26,30,33,0,0,0,0,20190302,88,117,5,10,20,29,29,205,29,2018,0,5,1091,0
Milwaukee,26,20,32,33,0,0,0,0,Utah,23,30,20,42,0,0,0,0,20190302,111,115,-3,7,-5,4,4,226,4,2018,0,5,1239,0
New Orleans,27,40,29,24,0,0,0,0,Denver,39,32,22,19,0,0,0,0,20190302,120,112,-12,-4,3,8,8,232,-8,2018,0,5,1079,0
Memphis,33,29,28,21,0,0,0,0,Dallas,21,28,18,14,0,0,0,0,20190302,111,81,12,13,23,30,30,192,-30,2018,0,5,419,0
Detroit,42,29,29,29,0,0,0,0,Cleveland,23,15,34,21,0,0,0,0,20190302,129,93,19,33,28,36,36,222,-36,2018,0,5,90,0
Orlando,27,28,28,34,0,0,0,0,Indiana,27,33,27,25,0,0,0,0,20190302,117,112,0,-5,-4,5,5,229,-5,2018,0,5,822,0
Minnesota,36,28,23,34,0,0,0,0,Washington,40,22,35,38,0,0,0,0,20190303,121,135,4,-2,10,14,14,256,14,2018,0,6,931,0
Memphis,28,24,23,20,0,0,0,0,Oklahoma City,25,21,21,32,0,0,0,0,20190303,95,99,-3,-6,-8,4,4,194,4,2018,0,6,421,0
New York,20,26,32,29,0,0,0,0,LA Clippers,38,44,19,27,0,0,0,0,20190303,107,128,18,36,23,21,21,235,21,2018,0,6,2445,0
Toronto,19,26,33,22,7,0,0,0,Detroit,24,24,25,27,12,0,0,0,20190303,107,112,5,3,-5,0,5,219,5,2018,1,6,205,0
Houston,33,32,35,15,0,0,0,0,Boston,23,20,35,26,0,0,0,0,20190303,115,104,10,22,22,11,11,219,-11,2018,0,6,1603,0
Portland,32,24,25,37,0,0,0,0,Charlotte,25,25,30,28,0,0,0,0,20190303,118,108,7,6,1,10,10,226,-10,2018,0,6,2284,0
Atlanta,35,32,29,27,0,0,0,0,Chicago,32,28,31,27,0,0,0,0,20190303,123,118,3,7,5,5,5,241,-5,2018,0,6,587,0
Orlando,24,24,24,21,0,0,0,0,Cleveland,29,23,15,40,0,0,0,0,20190303,93,107,5,4,-5,14,14,200,14,2018,0,6,895,0
New Orleans,24,28,30,33,0,0,0,0,Utah,33,28,27,24,0,0,0,0,20190304,115,112,-9,-9,-6,3,3,227,-3,2018,0,0,1432,0
Denver,17,31,21,34,0,0,0,0,San Antonio,36,22,27,19,0,0,0,0,20190304,103,104,19,10,16,1,1,207,1,2018,0,0,802,0
New York,25,26,29,28,0,0,0,0,Sacramento,34,21,31,29,0,0,0,0,20190304,108,115,9,4,6,7,7,223,7,2018,0,0,2499,0
Atlanta,31,30,24,28,0,0,0,0,Miami,32,29,24,29,0,0,0,0,20190304,113,114,1,0,0,1,1,227,1,2018,0,0,605,0
LA Clippers,26,35,30,22,0,0,0,0,LA Lakers,34,23,28,20,0,0,0,0,20190304,113,105,-8,4,6,8,8,218,-8,2018,0,0,0,0
Dallas,21,26,26,15,0,0,0,0,Brooklyn,31,34,34,28,0,0,0,0,20190304,88,127,10,18,26,39,39,215,39,2018,0,0,1370,0
Milwaukee,31,23,28,23,0,0,0,0,Phoenix,20,32,24,38,0,0,0,0,20190304,105,114,-11,-2,-6,9,9,219,9,2018,0,0,1462,0
Chicago,17,25,33,21,0,0,0,0,Indiana,27,22,28,28,0,0,0,0,20190305,96,105,10,7,2,9,9,201,9,2018,0,1,163,0
Portland,33,30,23,25,0,0,0,0,Memphis,20,41,21,38,0,0,0,0,20190305,111,120,-13,-2,-4,9,9,231,9,2018,0,1,1845,0
Oklahoma City,24,33,30,33,0,0,0,0,Minnesota,30,41,31,29,0,0,0,0,20190305,120,131,6,14,15,11,11,251,11,2018,0,1,694,0
Orlando,34,30,18,24,0,0,0,0,Philadelphia,39,31,24,20,0,0,0,0,20190305,106,114,5,6,12,8,8,220,8,2018,0,1,864,0
Houston,23,32,14,38,0,0,0,0,Toronto,19,18,34,24,0,0,0,0,20190305,107,95,4,18,-2,12,12,202,-12,2018,0,1,1299,0
Boston,32,41,32,23,0,0,0,0,Golden State,24,24,28,19,0,0,0,0,20190305,128,95,8,25,29,33,33,223,-33,2018,0,1,2692,0
Denver,43,23,19,30,0,0,0,0,LA Lakers,25,24,28,22,0,0,0,0,20190306,115,99,18,17,8,16,16,214,-16,2018,0,2,830,0
Dallas,43,22,31,27,0,0,0,0,Washington,33,36,30,33,0,0,0,0,20190306,123,132,-10,4,3,9,9,255,9,2018,0,2,1181,0
Boston,26,23,33,29,0,0,0,0,Sacramento,32,17,28,32,0,0,0,0,20190306,111,109,-6,0,5,2,2,220,-2,2018,0,2,2624,0
New York,22,25,17,32,0,0,0,0,Phoenix,16,33,32,26,0,0,0,0,20190306,96,107,-6,2,17,11,11,203,11,2018,0,2,2139,0
Utah,25,33,27,29,0,0,0,0,New Orleans,23,24,29,28,0,0,0,0,20190306,114,104,2,11,9,10,10,218,-10,2018,0,2,1432,0
Minnesota,35,29,24,26,0,0,0,0,Detroit,22,38,30,41,0,0,0,0,20190306,114,131,-13,-4,2,17,17,245,17,2018,0,2,542,0
Philadelphia,30,27,29,21,0,0,0,0,Chicago,30,27,25,26,0,0,0,0,20190306,107,108,0,0,-4,1,1,215,1,2018,0,2,664,0
San Antonio,27,26,27,31,0,0,0,0,Atlanta,23,33,21,27,0,0,0,0,20190306,111,104,4,-3,3,7,7,215,-7,2018,0,2,881,0
Miami,29,14,18,30,0,0,0,0,Charlotte,18,25,15,26,0,0,0,0,20190306,91,84,11,0,3,7,7,175,-7,2018,0,2,654,0
Cleveland,20,30,35,22,0,0,0,0,Brooklyn,31,24,25,33,0,0,0,0,20190306,107,113,11,5,-5,6,6,220,6,2018,0,2,403,0
Indiana,24,26,22,26,0,0,0,0,Milwaukee,32,22,30,33,0,0,0,0,20190307,98,117,8,4,12,19,19,215,19,2018,0,3,243,0
Oklahoma City,31,27,27,28,16,0,0,0,Portland,30,31,22,30,8,0,0,0,20190307,129,121,1,-3,2,0,8,250,-8,2018,1,3,1484,0
Toronto,29,35,29,34,0,0,0,0,New Orleans,31,30,19,24,0,0,0,0,20190308,127,104,-2,3,13,23,23,231,-23,2018,0,4,1112,0
Dallas,19,28,26,33,0,0,0,0,Orlando,29,33,30,19,0,0,0,0,20190308,106,111,10,15,19,5,5,217,5,2018,0,4,961,0
Utah,23,30,26,25,0,0,0,0,Memphis,29,31,24,30,0,0,0,0,20190308,104,114,6,7,5,10,10,218,10,2018,0,4,1247,0
Oklahoma City,32,24,28,26,0,0,0,0,LA Clippers,36,32,20,30,0,0,0,0,20190308,110,118,4,12,4,8,8,228,8,2018,0,4,1178,0
Cleveland,29,28,26,27,0,0,0,0,Miami,28,29,37,32,0,0,0,0,20190308,110,126,-1,0,11,16,16,236,16,2018,0,4,1089,0
Denver,20,30,25,30,0,0,0,0,Golden State,30,37,23,32,0,0,0,0,20190308,105,122,10,17,15,17,17,227,17,2018,0,4,947,0
Washington,22,30,31,28,0,0,0,0,Charlotte,32,19,31,30,0,0,0,0,20190308,111,112,10,-1,-1,1,1,223,1,2018,0,4,329,0
Detroit,24,25,20,43,0,0,0,0,Chicago,30,36,14,24,0,0,0,0,20190308,112,104,-6,-17,-11,8,8,216,-8,2018,0,4,238,0
Philadelphia,21,23,21,26,0,0,0,0,Houston,37,22,28,20,0,0,0,0,20190308,91,107,16,15,22,16,16,198,16,2018,0,4,1339,0
Brooklyn,26,30,27,31,0,0,0,0,Atlanta,23,24,30,35,0,0,0,0,20190309,114,112,3,9,6,2,2,226,-2,2018,0,5,745,0
Boston,25,32,36,27,0,0,0,0,LA Lakers,24,23,29,31,0,0,0,0,20190309,120,107,1,10,17,13,13,227,-13,2018,0,5,2590,0
Charlotte,32,27,28,27,0,0,0,0,Milwaukee,24,31,39,37,0,0,0,0,20190309,114,131,-8,-4,7,17,17,245,17,2018,0,5,658,0
Washington,39,32,28,22,9,0,0,0,Minnesota,28,32,35,26,14,0,0,0,20190309,130,135,-11,-11,-4,0,5,265,5,2018,1,5,931,0
Sacramento,23,25,32,22,0,0,0,0,New York,30,16,22,26,0,0,0,0,20190309,102,94,-7,2,12,8,8,196,-8,2018,0,5,2499,0
Phoenix,23,24,30,43,0,0,0,0,Portland,24,42,36,25,0,0,0,0,20190309,120,127,1,19,25,7,7,247,7,2018,0,5,1005,0
Toronto,32,36,23,34,0,0,0,0,Miami,27,27,25,25,0,0,0,0,20190310,125,104,5,14,12,21,21,229,-21,2018,0,6,1234,0
Indiana,25,34,11,19,0,0,0,0,Philadelphia,26,25,21,34,0,0,0,0,20190310,89,106,1,-8,2,17,17,195,17,2018,0,6,582,0
New York,22,23,20,27,0,0,0,0,Minnesota,23,32,25,23,0,0,0,0,20190310,92,103,1,10,15,11,11,195,11,2018,0,6,1016,0
Milwaukee,32,28,23,31,0,0,0,0,San Antonio,25,29,33,34,0,0,0,0,20190310,114,121,-7,-6,4,7,7,235,7,2018,0,6,1108,0
Orlando,17,31,24,25,0,0,0,0,Memphis,26,23,26,30,0,0,0,0,20190310,97,105,9,1,3,8,8,202,8,2018,0,6,683,0
Chicago,32,23,25,28,0,0,0,0,Detroit,31,30,42,28,0,0,0,0,20190310,108,131,-1,6,23,23,23,239,23,2018,0,6,238,0
Houston,25,33,23,13,0,0,0,0,Dallas,26,28,18,21,0,0,0,0,20190310,94,93,-1,4,9,1,1,187,-1,2018,0,6,225,0
New Orleans,33,33,20,30,0,0,0,0,Atlanta,26,39,29,34,0,0,0,0,20190310,116,128,-7,-1,8,12,12,244,12,2018,0,6,424,0
Phoenix,16,40,23,36,0,0,0,0,Golden State,29,28,23,31,0,0,0,0,20190310,115,111,-13,-1,-1,4,4,226,-4,2018,0,6,652,0
Detroit,19,16,27,13,0,0,0,0,Brooklyn,27,34,27,15,0,0,0,0,20190311,75,103,8,26,26,28,28,178,28,2018,0,0,480,0
Toronto,24,31,22,24,0,0,0,0,Cleveland,25,34,32,35,0,0,0,0,20190311,101,126,1,4,14,25,25,227,25,2018,0,0,187,0
Charlotte,19,25,36,26,0,0,0,0,Houston,38,33,22,25,0,0,0,0,20190311,106,118,19,27,13,12,12,224,12,2018,0,0,925,0
Boston,19,30,36,30,0,0,0,0,LA Clippers,25,37,39,39,0,0,0,0,20190311,115,140,6,13,16,25,25,255,25,2018,0,0,2590,0
Oklahoma City,22,28,27,21,0,0,0,0,Utah,21,16,26,26,0,0,0,0,20190311,98,89,1,13,14,9,9,187,-9,2018,0,0,861,0
Sacramento,20,40,21,34,0,0,0,0,Washington,28,31,31,31,0,0,0,0,20190311,115,121,8,-1,9,6,6,236,6,2018,0,0,2371,0
Cleveland,12,35,30,22,0,0,0,0,Philadelphia,24,29,28,25,0,0,0,0,20190312,99,106,12,6,4,7,7,205,7,2018,0,1,358,0
Milwaukee,23,33,45,29,0,0,0,0,New Orleans,23,25,41,24,0,0,0,0,20190312,130,113,0,8,12,17,17,243,-17,2018,0,1,911,0
Portland,23,27,35,40,0,0,0,0,LA Clippers,30,22,32,20,0,0,0,0,20190312,125,104,-7,-2,1,21,21,229,-21,2018,0,1,826,0
Minnesota,20,28,30,29,0,0,0,0,Denver,31,27,36,39,0,0,0,0,20190312,107,133,11,10,16,26,26,240,26,2018,0,1,698,0
San Antonio,34,26,24,28,0,0,0,0,Dallas,24,29,21,31,0,0,0,0,20190312,112,105,10,7,10,7,7,217,-7,2018,0,1,252,0
LA Lakers,16,39,43,25,0,0,0,0,Chicago,34,26,24,23,0,0,0,0,20190312,123,107,-18,-5,14,16,16,230,-16,2018,0,1,1741,0
New York,29,23,21,25,0,0,0,0,Indiana,27,28,30,18,0,0,0,0,20190312,98,103,-2,3,12,5,5,201,5,2018,0,1,643,0
Memphis,28,32,30,21,0,0,0,0,Atlanta,33,39,38,22,0,0,0,0,20190313,111,132,5,12,20,21,21,243,21,2018,0,2,336,0
Golden State,33,21,31,21,0,0,0,0,Houston,23,29,26,26,0,0,0,0,20190313,106,104,10,2,7,2,2,210,-2,2018,0,2,1642,0
Detroit,18,31,8,17,0,0,0,0,Miami,30,24,33,21,0,0,0,0,20190313,74,108,12,5,30,34,34,182,34,2018,0,2,1155,0
Brooklyn,27,25,26,18,0,0,0,0,Oklahoma City,19,23,38,28,0,0,0,0,20190313,96,108,-8,-10,2,12,12,204,12,2018,0,2,1324,0
Utah,25,28,25,36,0,0,0,0,Phoenix,27,16,32,22,0,0,0,0,20190313,114,97,-2,10,3,17,17,211,-17,2018,0,2,505,0
Orlando,28,25,21,16,0,0,0,0,Washington,29,32,15,24,0,0,0,0,20190313,90,100,1,8,2,10,10,190,10,2018,0,2,757,0
LA Lakers,25,29,30,14,0,0,0,0,Toronto,33,32,25,21,0,0,0,0,20190314,98,111,8,11,6,13,13,209,13,2018,0,3,2170,0
Cleveland,20,21,22,28,0,0,0,0,Orlando,36,25,27,32,0,0,0,0,20190314,91,120,16,20,25,29,29,211,29,2018,0,3,895,0
Minnesota,25,30,26,19,0,0,0,0,Utah,34,30,27,29,0,0,0,0,20190314,100,120,9,9,10,20,20,220,20,2018,0,3,984,0
Dallas,29,28,32,10,0,0,0,0,Denver,26,25,28,21,0,0,0,0,20190314,99,100,-3,-6,-10,1,1,199,1,2018,0,3,661,0
Sacramento,38,24,29,29,0,0,0,0,Boston,25,31,37,33,0,0,0,0,20190314,120,126,-13,-6,2,6,6,246,6,2018,0,3,2624,0
Oklahoma City,29,34,25,18,0,0,0,0,Indiana,22,28,31,27,0,0,0,0,20190314,106,108,-7,-13,-7,2,2,214,2,2018,0,3,688,0
Charlotte,40,26,29,21,0,0,0,0,Washington,26,27,25,32,0,0,0,0,20190315,116,110,14,13,17,6,6,226,-6,2018,0,4,329,0
Sacramento,29,29,31,25,0,0,0,0,Philadelphia,33,29,37,24,0,0,0,0,20190315,114,123,4,4,10,9,9,237,9,2018,0,4,2451,0
New York,20,21,28,14,0,0,0,0,San Antonio,31,25,26,27,0,0,0,0,20190315,83,109,11,15,13,26,26,192,26,2018,0,4,1581,0
Portland,30,26,31,35,0,0,0,0,New Orleans,37,20,25,28,0,0,0,0,20190315,122,110,-7,-1,5,12,12,232,-12,2018,0,4,2059,0
LA Lakers,22,18,22,35,0,0,0,0,Detroit,27,19,31,34,0,0,0,0,20190315,97,111,5,6,15,14,14,208,14,2018,0,4,1979,0
Chicago,34,29,21,37,0,0,0,0,LA Clippers,29,28,45,26,0,0,0,0,20190315,121,128,-5,-6,18,7,7,249,7,2018,0,4,1741,0
Milwaukee,19,23,37,34,0,0,0,0,Miami,37,25,18,18,0,0,0,0,20190315,113,98,-18,-20,-1,15,15,211,-15,2018,0,4,1269,0
Phoenix,31,26,28,17,0,0,0,0,Houston,26,29,28,25,0,0,0,0,20190315,102,108,-5,-2,-2,6,6,210,6,2018,0,4,1014,0
Atlanta,36,26,30,28,0,0,0,0,Boston,43,31,31,24,0,0,0,0,20190316,120,129,7,12,13,9,9,249,9,2018,0,5,935,0
Cleveland,26,31,31,28,0,0,0,0,Dallas,34,32,34,21,0,0,0,0,20190316,116,121,8,9,12,5,5,237,5,2018,0,5,1024,0
Indiana,36,24,15,25,0,0,0,0,Denver,25,32,22,23,0,0,0,0,20190316,100,102,-11,-3,4,2,2,202,2,2018,0,5,998,0
Phoenix,34,32,23,33,16,0,0,0,New Orleans,31,29,25,37,14,0,0,0,20190316,138,136,3,6,4,0,2,274,-2,2018,1,5,1312,0
Golden State,40,24,23,23,0,0,0,0,Oklahoma City,27,19,25,17,0,0,0,0,20190316,110,88,13,18,16,22,22,198,-22,2018,0,5,1386,0
Portland,21,29,26,27,0,0,0,0,San Antonio,23,25,24,36,0,0,0,0,20190316,103,108,2,-2,-4,5,5,211,5,2018,0,5,1718,0
Brooklyn,21,21,22,34,0,0,0,0,Utah,28,31,24,31,0,0,0,0,20190316,98,114,7,17,19,16,16,212,16,2018,0,5,1967,0
Memphis,37,34,32,25,0,0,0,0,Washington,35,34,36,30,0,0,0,0,20190316,128,135,-2,-2,2,7,7,263,7,2018,0,5,762,0
Chicago,23,17,31,31,0,0,0,0,Sacramento,24,32,43,30,0,0,0,0,20190317,102,129,1,16,28,27,27,231,27,2018,0,6,1788,0
Atlanta,25,21,22,23,0,0,0,0,Orlando,28,28,19,26,0,0,0,0,20190317,91,101,3,10,7,10,10,192,10,2018,0,6,401,0
LA Lakers,30,36,30,27,0,0,0,0,New York,41,22,31,30,0,0,0,0,20190317,123,124,11,-3,-2,1,1,247,1,2018,0,6,2445,0
Philadelphia,31,31,27,41,0,0,0,0,Milwaukee,28,25,29,43,0,0,0,0,20190317,130,125,3,9,7,5,5,255,-5,2018,0,6,692,0
Minnesota,30,19,29,24,0,0,0,0,Houston,26,24,43,24,0,0,0,0,20190317,102,117,-4,1,15,15,15,219,15,2018,0,6,1057,0
Brooklyn,30,25,32,29,0,0,0,0,LA Clippers,23,37,27,32,0,0,0,0,20190317,116,119,-7,5,0,3,3,235,3,2018,0,6,2445,0
Toronto,21,26,37,23,0,0,0,0,Detroit,25,25,28,32,0,0,0,0,20190317,107,110,4,3,-6,3,3,217,3,2018,0,6,205,0
Charlotte,20,19,21,15,0,0,0,0,Miami,19,20,22,32,0,0,0,0,20190317,75,93,-1,0,1,18,18,168,18,2018,0,6,654,0
Indiana,31,17,24,26,0,0,0,0,Portland,28,27,33,18,0,0,0,0,20190318,98,106,-3,7,16,8,8,204,8,2018,0,0,1880,0
Utah,31,26,34,25,0,0,0,0,Washington,24,21,26,24,0,0,0,0,20190318,116,95,7,12,20,21,21,211,-21,2018,0,0,1841,0
Golden State,25,22,31,27,0,0,0,0,San Antonio,25,33,24,29,0,0,0,0,20190318,105,111,0,11,4,6,6,216,6,2018,0,0,1487,0
Chicago,34,22,30,30,0,0,0,0,Phoenix,20,23,30,28,0,0,0,0,20190318,116,101,14,13,13,15,15,217,-15,2018,0,0,1450,0
New York,29,25,15,23,0,0,0,0,Toronto,38,35,28,27,0,0,0,0,20190318,92,128,9,19,32,36,36,220,36,2018,0,0,341,0
New Orleans,28,21,35,26,19,0,0,0,Dallas,34,25,20,31,15,0,0,0,20190318,129,125,-6,-10,5,0,4,254,-4,2018,1,0,442,0
Detroit,32,29,27,31,0,0,0,0,Cleveland,25,35,27,39,0,0,0,0,20190318,119,126,-7,-1,-1,7,7,245,7,2018,0,0,90,0
Denver,24,31,25,34,0,0,0,0,Boston,22,30,28,25,0,0,0,0,20190318,114,105,2,3,0,9,9,219,-9,2018,0,0,1765,0
Miami,27,31,28,30,0,0,0,0,Oklahoma City,25,30,20,32,0,0,0,0,20190318,116,107,2,3,11,9,9,223,-9,2018,0,0,1225,0
Houston,25,28,31,37,0,0,0,0,Atlanta,25,22,25,33,0,0,0,0,20190319,121,105,0,6,12,16,16,226,-16,2018,0,1,700,0
Philadelphia,31,31,23,33,0,0,0,0,Charlotte,30,29,30,25,0,0,0,0,20190319,118,114,1,3,-4,4,4,232,-4,2018,0,1,450,0
Indiana,16,33,26,34,0,0,0,0,LA Clippers,25,30,34,26,0,0,0,0,20190319,109,115,9,6,14,6,6,224,6,2018,0,1,1805,0
LA Lakers,24,34,26,17,0,0,0,0,Milwaukee,35,26,38,16,0,0,0,0,20190319,101,115,11,3,15,14,14,216,14,2018,0,1,1741,0
Golden State,30,29,32,26,0,0,0,0,Minnesota,27,20,28,32,0,0,0,0,20190319,117,107,3,12,16,10,10,224,-10,2018,0,1,1581,0
Brooklyn,25,33,20,45,0,0,0,0,Sacramento,38,28,37,18,0,0,0,0,20190319,123,121,-13,-8,-25,2,2,244,-2,2018,0,1,2499,0
Miami,24,38,28,20,0,0,0,0,San Antonio,22,25,31,27,0,0,0,0,20190320,110,105,2,15,12,5,5,215,-5,2018,0,2,1147,0
Dallas,17,35,31,35,0,0,0,0,Portland,26,39,36,25,0,0,0,0,20190320,118,126,9,13,18,8,8,244,8,2018,0,2,1630,0
Boston,39,30,21,25,0,0,0,0,Philadelphia,30,28,27,33,0,0,0,0,20190320,115,118,-9,-11,-5,3,3,233,3,2018,0,2,270,0
New Orleans,25,21,21,29,0,0,0,0,Orlando,39,29,30,21,0,0,0,0,20190320,96,119,14,22,31,23,23,215,23,2018,0,2,533,0
Utah,39,35,37,26,0,0,0,0,New York,25,22,32,37,0,0,0,0,20190320,137,116,14,27,32,21,21,253,-21,2018,0,2,1967,0
Houston,25,28,25,37,10,0,0,0,Memphis,38,25,34,18,11,0,0,0,20190320,125,126,13,10,19,0,1,251,1,2018,1,2,484,0
Milwaukee,24,23,34,21,0,0,0,0,Cleveland,30,28,23,26,0,0,0,0,20190320,102,107,6,11,0,5,5,209,5,2018,0,2,334,0
Washington,28,32,21,32,7,0,0,0,Chicago,35,25,25,28,13,0,0,0,20190320,120,126,7,0,4,0,6,246,6,2018,1,2,594,0
Toronto,39,24,29,18,13,0,0,0,Oklahoma City,31,24,23,32,4,0,0,0,20190320,123,114,8,8,14,0,9,237,-9,2018,1,2,1114,0
Utah,28,26,37,23,0,0,0,0,Atlanta,29,36,21,31,0,0,0,0,20190321,114,117,1,11,-5,3,3,231,3,2018,0,3,1580,0
Minnesota,25,26,27,28,0,0,0,0,Charlotte,25,29,27,32,0,0,0,0,20190321,106,113,0,3,3,7,7,219,7,2018,0,3,938,0
Indiana,19,24,19,27,0,0,0,0,Golden State,19,34,35,24,0,0,0,0,20190321,89,112,0,10,26,23,23,201,23,2018,0,3,1944,0
Detroit,29,29,29,31,0,0,0,0,Phoenix,32,28,20,18,0,0,0,0,20190321,118,98,-3,-2,7,20,20,216,-20,2018,0,3,1687,0
Dallas,29,22,25,24,0,0,0,0,Sacramento,27,26,31,32,0,0,0,0,20190321,100,116,-2,2,8,16,16,216,16,2018,0,3,1437,0
Denver,33,28,24,28,0,0,0,0,Washington,30,23,32,23,0,0,0,0,20190321,113,108,3,8,0,5,5,221,-5,2018,0,3,1489,0
Denver,37,19,26,29,0,0,0,0,New York,18,24,20,31,0,0,0,0,20190322,111,93,19,14,20,18,18,204,-18,2018,0,4,1627,0
Memphis,33,31,31,15,9,0,0,0,Orlando,23,35,23,29,13,0,0,0,20190322,119,123,-10,-6,-14,0,4,242,4,2018,1,4,683,0
Miami,32,19,18,18,0,0,0,0,Milwaukee,33,30,31,22,0,0,0,0,20190322,87,116,1,12,25,29,29,203,29,2018,0,4,1269,0
Oklahoma City,22,26,35,33,0,0,0,0,Toronto,29,29,22,29,0,0,0,0,20190322,116,109,-7,-10,3,7,7,225,-7,2018,0,4,1114,0
San Antonio,24,23,34,24,0,0,0,0,Houston,36,26,19,30,0,0,0,0,20190322,105,111,12,15,0,6,6,216,6,2018,0,4,189,0
Brooklyn,20,24,34,33,0,0,0,0,LA Lakers,23,20,30,33,0,0,0,0,20190322,111,106,-3,1,5,5,5,217,-5,2018,0,4,2445,0
LA Clippers,25,33,34,18,0,0,0,0,Cleveland,40,20,23,25,0,0,0,0,20190322,110,108,-15,-2,9,2,2,218,-2,2018,0,4,2044,0
Philadelphia,41,27,32,27,0,0,0,0,Atlanta,34,40,26,29,0,0,0,0,20190323,127,129,-7,6,0,2,2,256,2,2018,0,5,665,0
Utah,33,37,21,23,0,0,0,0,Chicago,18,18,25,22,0,0,0,0,20190323,114,83,15,34,30,31,31,197,-31,2018,0,5,1256,0
Boston,35,29,34,19,0,0,0,0,Charlotte,29,34,26,35,0,0,0,0,20190323,117,124,-6,-1,-9,7,7,241,7,2018,0,5,720,0
Dallas,37,37,34,18,0,0,0,0,Golden State,22,24,24,21,0,0,0,0,20190323,126,91,15,28,38,35,35,217,-35,2018,0,5,1480,0
Minnesota,25,24,35,28,0,0,0,0,Memphis,25,25,18,31,0,0,0,0,20190323,112,99,0,-1,16,13,13,211,-13,2018,0,5,700,0
Detroit,28,28,36,20,0,0,0,0,Portland,32,27,30,28,0,0,0,0,20190323,112,117,4,3,-3,5,5,229,5,2018,0,5,1964,0
Phoenix,32,21,22,28,0,0,0,0,Sacramento,19,28,32,33,0,0,0,0,20190323,103,112,-13,-6,4,9,9,215,9,2018,0,5,634,0
Miami,25,27,26,35,0,0,0,0,Washington,27,26,26,29,0,0,0,0,20190323,113,108,-2,-1,-1,5,5,221,-5,2018,0,5,924,0
Sacramento,20,29,28,29,0,0,0,0,LA Lakers,22,26,39,24,0,0,0,0,20190324,106,111,2,-1,10,5,5,217,5,2018,0,6,361,0
Charlotte,27,31,37,20,0,0,0,0,Toronto,32,25,26,31,0,0,0,0,20190324,115,114,-5,1,12,1,1,229,-1,2018,0,6,585,0
LA Clippers,29,31,29,35,0,0,0,0,New York,24,35,25,29,0,0,0,0,20190324,124,113,5,1,5,11,11,237,-11,2018,0,6,2445,0
Houston,33,30,24,26,0,0,0,0,New Orleans,19,25,25,21,0,0,0,0,20190324,113,90,14,19,18,23,23,203,-23,2018,0,6,317,0
Denver,23,23,21,21,0,0,0,0,Indiana,27,35,30,32,0,0,0,0,20190324,88,124,4,16,25,36,36,212,36,2018,0,6,998,0
Detroit,28,21,28,37,0,0,0,0,Golden State,29,34,34,24,0,0,0,0,20190324,114,121,1,14,20,7,7,235,7,2018,0,6,2087,0
San Antonio,31,23,30,31,0,0,0,0,Boston,24,23,25,24,0,0,0,0,20190324,115,96,7,7,12,19,19,211,-19,2018,0,6,1765,0
Cleveland,27,28,22,28,0,0,0,0,Milwaukee,32,36,22,37,0,0,0,0,20190324,105,127,5,13,13,22,22,232,22,2018,0,6,334,0
Oklahoma City,23,25,30,25,0,0,0,0,Memphis,31,23,32,29,0,0,0,0,20190325,103,115,8,6,8,12,12,218,12,2018,0,0,421,0
Philadelphia,31,29,17,21,0,0,0,0,Orlando,31,26,32,30,0,0,0,0,20190325,98,119,0,-3,12,21,21,217,21,2018,0,0,864,0
Brooklyn,27,35,28,30,12,12,0,0,Portland,31,31,33,25,12,16,0,0,20190325,144,148,4,0,5,0,4,292,4,2018,2,0,2439,0
Phoenix,21,22,31,18,0,0,0,0,Utah,26,36,26,37,0,0,0,0,20190325,92,125,5,19,14,33,33,217,33,2018,0,0,505,0
Orlando,18,24,34,28,0,0,0,0,Miami,32,19,19,29,0,0,0,0,20190326,104,99,-14,-9,6,5,5,203,-5,2018,0,1,204,0
Atlanta,42,28,32,28,0,0,0,0,New Orleans,34,23,30,33,0,0,0,0,20190326,130,120,8,13,15,10,10,250,-10,2018,0,1,424,0
LA Clippers,42,33,25,22,0,0,0,0,Minnesota,23,32,30,26,0,0,0,0,20190326,122,111,19,20,15,11,11,233,-11,2018,0,1,1521,0
Houston,25,28,18,23,0,0,0,0,Milwaukee,20,38,32,18,0,0,0,0,20190326,94,108,-5,5,19,14,14,202,14,2018,0,1,1005,0
Chicago,18,23,31,31,0,0,0,0,Toronto,26,30,29,27,0,0,0,0,20190326,103,112,8,15,13,9,9,215,9,2018,0,1,436,0
Washington,29,27,27,23,0,0,0,0,LA Lakers,34,33,30,27,0,0,0,0,20190326,106,124,5,11,14,18,18,230,18,2018,0,1,2294,0
Sacramento,25,29,33,38,0,0,0,0,Dallas,23,33,33,32,0,0,0,0,20190326,125,121,2,-2,-2,4,4,246,-4,2018,0,1,1437,0
Boston,32,25,31,28,0,0,0,0,Cleveland,27,24,30,25,0,0,0,0,20190326,116,106,5,6,7,10,10,222,-10,2018,0,1,549,0
San Antonio,23,36,21,26,10,0,0,0,Charlotte,29,26,27,24,19,0,0,0,20190326,116,125,6,-4,2,0,9,241,9,2018,1,1,1103,0
Detroit,9,30,23,30,0,0,0,0,Denver,27,39,15,14,0,0,0,0,20190326,92,95,18,27,19,3,3,187,3,2018,0,1,1154,0
Portland,27,32,28,31,0,0,0,0,Chicago,14,27,24,33,0,0,0,0,20190327,118,98,13,18,22,20,20,216,-20,2018,0,2,1754,0
Golden State,31,35,23,29,0,0,0,0,Memphis,37,23,24,19,0,0,0,0,20190327,118,103,-6,6,5,15,15,221,-15,2018,0,2,1798,0
Indiana,27,27,15,30,0,0,0,0,Oklahoma City,29,16,31,31,0,0,0,0,20190327,99,107,2,-9,7,8,8,206,8,2018,0,2,688,0
Washington,27,32,30,35,0,0,0,0,Phoenix,30,29,31,31,0,0,0,0,20190327,124,121,-3,0,-1,3,3,245,-3,2018,0,2,1977,0
LA Lakers,25,28,18,29,0,0,0,0,Utah,32,28,27,28,0,0,0,0,20190327,100,115,7,7,16,15,15,215,15,2018,0,2,579,0
Cleveland,28,25,28,29,0,0,0,0,San Antonio,27,17,40,32,0,0,0,0,20190328,110,116,-1,-9,3,6,6,226,6,2018,0,3,1256,0
Brooklyn,23,35,24,28,0,0,0,0,Philadelphia,38,30,30,25,0,0,0,0,20190328,110,123,15,10,16,13,13,233,13,2018,0,3,80,0
Toronto,30,25,32,30,0,0,0,0,New York,18,18,28,28,0,0,0,0,20190328,117,92,12,19,23,25,25,209,-25,2018,0,3,341,0
Sacramento,26,36,26,30,0,0,0,0,New Orleans,30,34,29,28,0,0,0,0,20190328,118,121,4,2,5,3,3,239,3,2018,0,3,1879,0
Dallas,29,30,23,17,0,0,0,0,Miami,26,23,26,30,0,0,0,0,20190328,99,105,-3,-10,-7,6,6,204,6,2018,0,3,1110,0
Denver,25,19,21,20,0,0,0,0,Houston,22,40,25,25,0,0,0,0,20190328,85,112,-3,18,22,27,27,197,27,2018,0,3,878,0
Orlando,27,19,25,27,0,0,0,0,Detroit,30,30,34,21,0,0,0,0,20190328,98,115,3,14,23,17,17,213,17,2018,0,3,957,0
LA Clippers,25,21,31,41,0,0,0,0,Milwaukee,28,39,33,28,0,0,0,0,20190328,118,128,3,21,23,10,10,246,10,2018,0,3,1741,0
Portland,38,22,30,28,0,0,0,0,Atlanta,30,21,25,22,0,0,0,0,20190329,118,98,8,9,14,20,20,216,-20,2018,0,4,2168,0
Indiana,25,35,31,21,0,0,0,0,Boston,35,28,26,25,0,0,0,0,20190329,112,114,10,3,-2,2,2,226,2,2018,0,4,805,0
Charlotte,35,24,32,24,0,0,0,0,LA Lakers,33,36,32,28,0,0,0,0,20190329,115,129,-2,10,10,14,14,244,14,2018,0,4,2115,0
Golden State,32,36,18,29,15,0,0,0,Minnesota,27,27,32,29,16,0,0,0,20190329,130,131,-5,-14,0,0,1,261,1,2018,1,4,1581,0
Denver,33,23,30,29,0,0,0,0,Oklahoma City,29,23,23,30,0,0,0,0,20190329,115,105,4,4,11,10,10,220,-10,2018,0,4,503,0
Washington,30,32,28,34,0,0,0,0,Utah,39,31,22,36,0,0,0,0,20190329,124,128,9,8,2,4,4,252,4,2018,0,4,1841,0
Philadelphia,38,30,24,26,0,0,0,0,Minnesota,20,35,26,28,0,0,0,0,20190330,118,109,18,13,11,9,9,227,-9,2018,0,5,983,0
Memphis,23,31,34,32,0,0,0,0,Phoenix,38,24,30,23,0,0,0,0,20190330,120,115,-15,-8,-4,5,5,235,-5,2018,0,5,1260,0
Miami,29,26,24,21,0,0,0,0,New York,33,28,18,13,0,0,0,0,20190330,100,92,-4,-6,0,8,8,192,-8,2018,0,5,1091,0
Cleveland,29,23,31,25,0,0,0,0,LA Clippers,29,36,28,39,0,0,0,0,20190330,108,132,0,13,10,24,24,240,24,2018,0,5,2044,0
Orlando,32,24,34,31,0,0,0,0,Indiana,28,29,35,24,0,0,0,0,20190330,121,116,4,-1,-2,5,5,237,-5,2018,0,5,822,0
Sacramento,32,28,33,15,0,0,0,0,Houston,35,28,28,28,0,0,0,0,20190330,108,119,3,3,-2,11,11,227,11,2018,0,5,1606,0
Portland,14,20,25,31,0,0,0,0,Detroit,11,20,35,33,0,0,0,0,20190330,90,99,-3,-3,7,9,9,189,9,2018,0,5,1964,0
Toronto,26,41,26,31,0,0,0,0,Chicago,28,28,19,26,0,0,0,0,20190330,124,101,-2,11,18,23,23,225,-23,2018,0,5,436,0
Boston,21,27,22,26,0,0,0,0,Brooklyn,17,32,33,28,0,0,0,0,20190330,96,110,-4,1,12,14,14,206,14,2018,0,5,190,0
Milwaukee,43,28,26,25,13,0,0,0,Atlanta,26,42,30,24,14,0,0,0,20190331,135,136,-17,-3,1,0,1,271,1,2018,1,6,669,0
Washington,23,30,22,20,0,0,0,0,Denver,34,28,10,18,0,0,0,0,20190331,95,90,-11,-9,3,5,5,185,-5,2018,0,6,1489,0
Charlotte,27,22,23,18,0,0,0,0,Golden State,35,36,34,32,0,0,0,0,20190331,90,137,8,22,33,47,47,227,47,2018,0,6,2296,0
Memphis,19,27,22,28,0,0,0,0,LA Clippers,25,36,26,26,0,0,0,0,20190331,96,113,6,15,19,17,17,209,17,2018,0,6,1599,0
LA Lakers,26,35,44,25,0,0,0,0,New Orleans,26,36,22,18,0,0,0,0,20190331,130,102,0,-1,21,28,28,232,-28,2018,0,6,1669,0
Dallas,31,27,22,26,0,0,0,0,Oklahoma City,24,32,19,28,0,0,0,0,20190331,106,103,7,2,5,3,3,209,-3,2018,0,6,189,0
Sacramento,28,30,31,24,0,0,0,0,San Antonio,30,27,30,19,0,0,0,0,20190331,113,106,-2,1,2,7,7,219,-7,2018,0,6,1456,0
Charlotte,23,16,25,38,0,0,0,0,Utah,26,26,27,32,0,0,0,0,20190401,102,111,3,13,15,9,9,213,9,2018,0,0,1723,0
Orlando,36,16,23,34,0,0,0,0,Toronto,29,33,33,26,0,0,0,0,20190401,109,121,-7,10,20,12,12,230,12,2018,0,0,1048,0
Cleveland,23,29,32,29,0,0,0,0,Phoenix,31,40,20,31,0,0,0,0,20190401,113,122,8,19,7,9,9,235,9,2018,0,0,1745,0
Chicago,19,28,30,28,0,0,0,0,New York,37,27,27,22,0,0,0,0,20190401,105,113,18,17,14,8,8,218,8,2018,0,0,711,0
Detroit,33,22,25,22,0,0,0,0,Indiana,23,36,28,24,0,0,0,0,20190401,102,111,-10,4,7,9,9,213,9,2018,0,0,240,0
Philadelphia,32,18,27,25,0,0,0,0,Dallas,27,41,29,25,0,0,0,0,20190401,102,122,-5,18,20,20,20,224,20,2018,0,0,1297,0
Milwaukee,35,24,32,40,0,0,0,0,Brooklyn,20,34,35,32,0,0,0,0,20190401,131,121,15,5,2,10,10,252,-10,2018,0,0,732,0
Miami,17,30,30,28,0,0,0,0,Boston,36,25,27,22,0,0,0,0,20190401,105,110,19,14,11,5,5,215,5,2018,0,0,1257,0
Portland,38,37,22,35,0,0,0,0,Minnesota,23,41,36,22,0,0,0,0,20190401,132,122,15,11,-3,10,10,254,-10,2018,0,0,1423,0
Denver,24,19,21,38,0,0,0,0,Golden State,30,29,27,30,0,0,0,0,20190402,102,116,6,16,22,14,14,218,14,2018,0,1,947,0
LA Lakers,28,27,23,25,0,0,0,0,Oklahoma City,34,25,35,25,0,0,0,0,20190402,103,119,6,4,16,16,16,222,16,2018,0,1,1178,0
Houston,33,29,29,39,0,0,0,0,Sacramento,23,23,31,28,0,0,0,0,20190402,130,105,10,16,14,25,25,235,-25,2018,0,1,1606,0
Atlanta,31,25,34,21,0,0,0,0,San Antonio,33,25,28,31,0,0,0,0,20190402,111,117,2,2,-4,6,6,228,6,2018,0,1,881,0
Charlotte,24,35,24,32,0,0,0,0,New Orleans,21,34,23,31,0,0,0,0,20190403,115,109,3,4,5,6,6,224,-6,2018,0,2,648,0
Chicago,26,30,27,32,0,0,0,0,Washington,28,29,30,27,0,0,0,0,20190403,115,114,-2,-1,-4,1,1,229,-1,2018,0,2,594,0
Memphis,30,29,10,20,0,0,0,0,Portland,28,34,24,30,0,0,0,0,20190403,89,116,-2,3,17,27,27,205,27,2018,0,2,1845,0
Utah,25,31,28,34,0,0,0,0,Phoenix,31,22,23,21,0,0,0,0,20190403,118,97,-6,3,8,21,21,215,-21,2018,0,2,505,0
New York,26,19,29,26,0,0,0,0,Orlando,26,32,27,29,0,0,0,0,20190403,100,114,0,13,11,14,14,214,14,2018,0,2,939,0
Boston,29,24,30,29,0,0,0,0,Miami,31,18,32,21,0,0,0,0,20190403,112,102,-2,4,2,10,10,214,-10,2018,0,2,1257,0
Toronto,34,23,33,25,0,0,0,0,Brooklyn,22,28,28,27,0,0,0,0,20190403,115,105,12,7,12,10,10,220,-10,2018,0,2,341,0
Indiana,18,26,34,30,0,0,0,0,Detroit,15,21,26,27,0,0,0,0,20190403,108,89,3,8,16,19,19,197,-19,2018,0,2,240,0
San Antonio,24,19,21,21,0,0,0,0,Denver,28,33,25,27,0,0,0,0,20190403,85,113,4,18,22,28,28,198,28,2018,0,2,802,0
Minnesota,32,26,31,21,0,0,0,0,Dallas,27,31,21,29,0,0,0,0,20190403,110,108,5,0,10,2,2,218,-2,2018,0,2,863,0
Philadelphia,38,30,26,28,0,0,0,0,Atlanta,42,30,26,32,0,0,0,0,20190403,122,130,4,4,4,8,8,252,8,2018,0,2,665,0
Houston,39,29,34,33,0,0,0,0,LA Clippers,26,27,20,30,0,0,0,0,20190403,135,103,13,15,29,32,32,238,-32,2018,0,2,1371,0
Golden State,39,21,34,14,0,0,0,0,LA Lakers,12,30,24,24,0,0,0,0,20190404,108,90,27,18,28,18,18,198,-18,2018,0,3,347,0
Milwaukee,30,26,26,46,0,0,0,0,Philadelphia,26,32,28,36,0,0,0,0,20190404,128,122,4,-2,-4,6,6,250,-6,2018,0,3,692,0
Cleveland,22,29,33,20,0,0,0,0,Sacramento,29,28,36,24,0,0,0,0,20190404,104,117,7,6,9,13,13,221,13,2018,0,3,2096,0
New Orleans,38,38,23,18,9,0,0,0,Phoenix,31,34,31,21,16,0,0,0,20190405,126,133,-7,-11,-3,0,7,259,7,2018,1,4,1312,0
Atlanta,18,30,32,33,0,0,0,0,Orlando,42,39,32,36,0,0,0,0,20190405,113,149,24,33,33,36,36,262,36,2018,0,4,401,0
Detroit,34,32,30,14,0,0,0,0,Oklahoma City,30,35,32,26,0,0,0,0,20190405,110,123,-4,-1,1,13,13,233,13,2018,0,4,909,0
Miami,35,34,22,18,0,0,0,0,Minnesota,36,25,29,21,0,0,0,0,20190405,109,111,1,-8,-1,2,2,220,2,2018,0,4,1513,0
LA Lakers,35,26,23,38,0,0,0,0,LA Clippers,30,37,19,31,0,0,0,0,20190405,122,117,5,-6,-2,5,5,239,-5,2018,0,4,0,0
Portland,29,21,37,23,0,0,0,0,Denver,22,34,28,35,0,0,0,0,20190405,110,119,-7,6,-3,9,9,229,9,2018,0,4,981,0
New York,16,27,21,32,0,0,0,0,Houston,32,40,31,17,0,0,0,0,20190405,96,120,16,29,39,24,24,216,24,2018,0,4,1417,0
Cleveland,26,23,35,30,0,0,0,0,Golden State,36,32,31,21,0,0,0,0,20190405,114,120,10,19,15,6,6,234,6,2018,0,4,2161,0
Memphis,31,34,34,23,0,0,0,0,Dallas,30,23,31,28,0,0,0,0,20190405,122,112,1,12,15,10,10,234,-10,2018,0,4,419,0
Toronto,34,31,21,25,0,0,0,0,Charlotte,33,24,33,23,0,0,0,0,20190405,111,113,-1,-8,4,2,2,224,2,2018,0,4,585,0
Sacramento,20,24,26,28,0,0,0,0,Utah,35,35,26,23,0,0,0,0,20190405,98,119,15,26,26,21,21,217,21,2018,0,4,532,0
Boston,24,34,33,26,0,0,0,0,Indiana,27,20,27,23,0,0,0,0,20190405,117,97,-3,11,17,20,20,214,-20,2018,0,4,805,0
San Antonio,37,40,28,24,0,0,0,0,Washington,32,26,30,24,0,0,0,0,20190405,129,112,5,19,17,17,17,241,-17,2018,0,4,1385,0
Brooklyn,34,32,42,25,0,0,0,0,Milwaukee,26,39,31,32,0,0,0,0,20190406,133,128,8,1,12,5,5,261,-5,2018,0,5,732,0
Philadelphia,24,33,29,30,0,0,0,0,Chicago,20,29,19,28,0,0,0,0,20190406,116,96,4,8,18,20,20,212,-20,2018,0,5,664,0
Atlanta,21,24,27,35,0,0,0,0,Milwaukee,28,26,31,30,0,0,0,0,20190407,107,115,7,9,13,8,8,222,8,2018,0,6,669,0
Orlando,27,21,35,33,0,0,0,0,Boston,27,25,26,30,0,0,0,0,20190407,116,108,0,-4,5,8,8,224,-8,2018,0,6,1115,0
San Antonio,24,38,17,33,0,0,0,0,Cleveland,24,22,17,27,0,0,0,0,20190407,112,90,0,16,16,22,22,202,-22,2018,0,6,1256,0
Charlotte,32,28,23,21,0,0,0,0,Detroit,27,15,33,16,0,0,0,0,20190407,104,91,5,18,8,13,13,195,-13,2018,0,6,504,0
LA Clippers,28,27,18,31,0,0,0,0,Golden State,32,30,42,27,0,0,0,0,20190407,104,131,4,7,31,27,27,235,27,2018,0,6,347,0
Phoenix,24,23,30,36,0,0,0,0,Houston,34,43,40,32,0,0,0,0,20190407,113,149,10,30,40,36,36,262,36,2018,0,6,1014,0
Brooklyn,31,21,30,26,0,0,0,0,Indiana,25,19,25,27,0,0,0,0,20190407,108,96,6,8,13,12,12,204,-12,2018,0,6,643,0
Utah,27,32,24,26,0,0,0,0,LA Lakers,34,20,27,32,0,0,0,0,20190407,109,113,7,-5,-2,4,4,222,4,2018,0,6,579,0
Dallas,24,28,31,29,17,0,0,0,Memphis,26,30,32,24,15,0,0,0,20190407,129,127,-2,-4,-5,0,2,256,-2,2018,1,6,419,0
Oklahoma City,38,24,33,37,0,0,0,0,Minnesota,31,29,37,29,0,0,0,0,20190407,132,126,7,2,-2,6,6,258,-6,2018,0,6,694,0
Washington,23,33,33,21,0,0,0,0,New York,29,23,27,34,0,0,0,0,20190407,110,113,6,-4,-10,3,3,223,3,2018,0,6,204,0
Denver,25,24,32,27,0,0,0,0,Portland,29,31,26,29,0,0,0,0,20190407,108,115,4,11,5,7,7,223,7,2018,0,6,981,0
New Orleans,32,34,36,31,0,0,0,0,Sacramento,39,29,34,27,0,0,0,0,20190407,133,129,-7,-2,0,4,4,262,-4,2018,0,6,1879,0
Miami,26,31,22,24,6,0,0,0,Toronto,25,25,28,25,14,0,0,0,20190407,109,117,-1,-7,-1,0,8,226,8,2018,1,6,1234,0
Houston,32,28,33,18,0,0,0,0,Oklahoma City,26,25,29,32,0,0,0,0,20190409,111,112,-6,-9,-13,1,1,223,1,2018,0,1,413,0
Boston,25,38,26,27,0,0,0,0,Washington,39,25,31,15,0,0,0,0,20190409,116,110,-14,-1,-6,6,6,226,-6,2018,0,1,394,0
Golden State,18,38,32,24,0,0,0,0,New Orleans,19,37,23,24,0,0,0,0,20190409,112,103,-1,0,9,9,9,215,-9,2018,0,1,1921,0
Denver,21,38,27,22,0,0,0,0,Utah,27,33,31,27,0,0,0,0,20190409,108,118,6,1,5,10,10,226,10,2018,0,1,370,0
Toronto,26,43,29,22,0,0,0,0,Minnesota,28,19,31,22,0,0,0,0,20190409,120,100,-2,22,20,20,20,220,-20,2018,0,1,691,0
New York,39,18,17,22,0,0,0,0,Chicago,24,26,18,18,0,0,0,0,20190409,96,86,15,7,6,10,10,182,-10,2018,0,1,711,0
Portland,26,27,20,31,0,0,0,0,LA Lakers,25,23,26,27,0,0,0,0,20190409,104,101,1,5,-1,3,3,205,-3,2018,0,1,826,0
Memphis,32,25,22,14,0,0,0,0,Detroit,20,18,26,36,0,0,0,0,20190409,93,100,-12,-19,-15,7,7,193,7,2018,0,1,622,0
Phoenix,18,20,41,30,0,0,0,0,Dallas,33,35,30,22,0,0,0,0,20190409,109,120,15,30,19,11,11,229,11,2018,0,1,884,0
Charlotte,33,31,26,34,0,0,0,0,Cleveland,31,25,19,22,0,0,0,0,20190409,124,97,2,8,15,27,27,221,-27,2018,0,1,435,0
Philadelphia,20,22,18,39,0,0,0,0,Miami,34,27,30,31,0,0,0,0,20190409,99,122,14,19,31,23,23,221,23,2018,0,1,1021,0
Dallas,16,21,28,29,0,0,0,0,San Antonio,30,27,23,25,0,0,0,0,20190410,94,105,14,20,15,11,11,199,11,2018,0,2,252,0
Detroit,36,29,27,23,0,0,0,0,New York,22,19,18,30,0,0,0,0,20190410,115,89,14,24,33,26,26,204,-26,2018,0,2,480,0
Sacramento,39,48,26,18,0,0,0,0,Portland,30,32,36,38,0,0,0,0,20190410,131,136,-9,-25,-15,5,5,267,5,2018,0,2,483,0
Chicago,20,22,22,45,0,0,0,0,Philadelphia,32,30,35,28,0,0,0,0,20190410,109,125,12,20,33,16,16,234,16,2018,0,2,664,0
Oklahoma City,29,39,30,29,0,0,0,0,Milwaukee,31,27,31,27,0,0,0,0,20190410,127,116,-2,10,9,11,11,243,-11,2018,0,2,732,0
Indiana,35,38,36,26,0,0,0,0,Atlanta,28,41,34,31,0,0,0,0,20190410,135,134,7,4,6,1,1,269,-1,2018,0,2,427,0
Utah,26,40,31,29,11,0,0,0,LA Clippers,39,31,32,24,17,0,0,0,20190410,137,143,13,4,5,0,6,280,6,2018,1,2,579,0
Minnesota,21,29,29,16,0,0,0,0,Denver,22,29,22,26,0,0,0,0,20190410,95,99,1,1,-6,4,4,194,4,2018,0,2,698,0
Orlando,30,32,35,25,0,0,0,0,Charlotte,25,33,30,26,0,0,0,0,20190410,122,114,5,4,9,8,8,236,-8,2018,0,2,463,0
Miami,23,24,24,23,0,0,0,0,Brooklyn,32,31,29,21,0,0,0,0,20190410,94,113,9,16,21,19,19,207,19,2018,0,2,1091,0
Golden State,41,27,22,27,0,0,0,0,Memphis,45,41,28,18,0,0,0,0,20190410,117,132,4,18,24,15,15,249,15,2018,0,2,1798,0
San Antonio,25,34,13,29,0,0,0,0,Denver,20,31,17,28,0,0,0,0,20190413,101,96,5,8,4,5,5,197,-5,2018,0,5,802,1
LA Clippers,27,29,23,25,0,0,0,0,Golden State,36,33,29,23,0,0,0,0,20190413,104,121,9,13,19,17,17,225,17,2018,0,5,347,1
Brooklyn,31,31,31,18,0,0,0,0,Philadelphia,22,32,28,20,0,0,0,0,20190413,111,102,9,8,11,9,9,213,-9,2018,0,5,80,1
Orlando,25,32,18,29,0,0,0,0,Toronto,30,19,27,25,0,0,0,0,20190413,104,101,-5,8,-1,3,3,205,-3,2018,0,5,1048,1
Oklahoma City,25,23,21,30,0,0,0,0,Portland,39,15,22,28,0,0,0,0,20190414,99,104,14,6,7,5,5,203,5,2018,0,6,1484,1
Detroit,18,25,18,25,0,0,0,0,Milwaukee,38,32,27,24,0,0,0,0,20190414,86,121,20,27,36,35,35,207,35,2018,0,6,251,1
Indiana,20,25,8,21,0,0,0,0,Boston,20,18,26,20,0,0,0,0,20190414,74,84,0,-7,11,10,10,158,10,2018,0,6,805,1
Utah,24,20,27,19,0,0,0,0,Houston,31,28,24,39,0,0,0,0,20190414,90,122,7,15,12,32,32,212,32,2018,0,6,1199,1
LA Clippers,25,25,44,41,0,0,0,0,Golden State,33,40,35,23,0,0,0,0,20190415,135,131,-8,-23,-14,4,4,266,-4,2018,0,0,347,1
Brooklyn,28,36,23,36,0,0,0,0,Philadelphia,34,31,51,29,0,0,0,0,20190415,123,145,6,1,29,22,22,268,22,2018,0,0,80,1
Orlando,18,21,27,16,0,0,0,0,Toronto,26,25,39,21,0,0,0,0,20190416,82,111,8,12,24,29,29,193,29,2018,0,1,1048,1
San Antonio,26,33,23,23,0,0,0,0,Denver,21,28,26,39,0,0,0,0,20190416,105,114,-5,-10,-7,9,9,219,9,2018,0,1,802,1
Oklahoma City,31,23,21,19,0,0,0,0,Portland,26,28,37,23,0,0,0,0,20190416,94,114,-5,0,16,20,20,208,20,2018,0,1,1484,1
Utah,19,25,23,31,0,0,0,0,Houston,39,31,25,23,0,0,0,0,20190417,98,118,20,26,28,20,20,216,20,2018,0,2,1199,1
Detroit,27,32,17,23,0,0,0,0,Milwaukee,38,20,35,27,0,0,0,0,20190417,99,120,11,-1,17,21,21,219,21,2018,0,2,251,1
Indiana,33,17,29,12,0,0,0,0,Boston,29,23,16,31,0,0,0,0,20190417,91,99,-4,2,-11,8,8,190,8,2018,0,2,805,1
Denver,22,36,26,24,0,0,0,0,San Antonio,31,30,27,30,0,0,0,0,20190418,108,118,9,3,4,10,10,226,10,2018,0,3,802,1
Philadelphia,32,33,32,34,0,0,0,0,Brooklyn,24,35,31,25,0,0,0,0,20190418,131,115,8,6,7,16,16,246,-16,2018,0,3,80,1
Golden State,41,32,36,23,0,0,0,0,LA Clippers,24,28,24,29,0,0,0,0,20190418,132,105,17,21,33,27,27,237,-27,2018,0,3,347,1
Boston,41,18,21,24,0,0,0,0,Indiana,28,33,12,23,0,0,0,0,20190419,104,96,13,-2,7,8,8,200,-8,2018,0,4,805,1
Portland,22,17,43,26,0,0,0,0,Oklahoma City,21,28,37,34,0,0,0,0,20190419,108,120,-1,10,4,12,12,228,12,2018,0,4,1484,1
Toronto,26,22,28,22,0,0,0,0,Orlando,21,24,20,28,0,0,0,0,20190419,98,93,5,3,11,5,5,191,-5,2018,0,4,1048,1
Philadelphia,24,33,28,27,0,0,0,0,Brooklyn,33,30,28,17,0,0,0,0,20190420,112,108,-9,-6,-6,4,4,220,-4,2018,0,5,80,1
Milwaukee,32,35,33,19,0,0,0,0,Detroit,24,30,24,25,0,0,0,0,20190420,119,103,8,13,22,16,16,222,-16,2018,0,5,251,1
Denver,22,32,37,26,0,0,0,0,San Antonio,34,20,25,24,0,0,0,0,20190420,117,103,-12,0,12,14,14,220,-14,2018,0,5,802,1
Houston,28,22,24,30,0,0,0,0,Utah,30,25,21,25,0,0,0,0,20190420,104,101,-2,-5,-2,3,3,205,-3,2018,0,5,1199,1
Portland,26,24,29,32,0,0,0,0,Oklahoma City,24,22,22,30,0,0,0,0,20190421,111,98,2,4,11,13,13,209,-13,2018,0,6,1484,1
Toronto,28,30,24,25,0,0,0,0,Orlando,26,16,28,15,0,0,0,0,20190421,107,85,2,16,12,22,22,192,-22,2018,0,6,1048,1
Boston,21,26,26,37,0,0,0,0,Indiana,23,26,23,34,0,0,0,0,20190421,110,106,-2,-2,1,4,4,216,-4,2018,0,6,805,1
Golden State,32,30,25,26,0,0,0,0,LA Clippers,22,32,30,21,0,0,0,0,20190421,113,105,10,8,3,8,8,218,-8,2018,0,6,347,1
Milwaukee,26,30,39,32,0,0,0,0,Detroit,28,34,23,19,0,0,0,0,20190422,127,104,-2,-6,10,23,23,231,-23,2018,0,0,251,1
Houston,24,23,32,12,0,0,0,0,Utah,32,21,23,31,0,0,0,0,20190422,91,107,8,6,-3,16,16,198,16,2018,0,0,1199,1
San Antonio,19,23,21,27,0,0,0,0,Denver,26,27,32,23,0,0,0,0,20190423,90,108,7,11,22,18,18,198,18,2018,0,1,802,1
Brooklyn,15,16,33,36,0,0,0,0,Philadelphia,32,28,35,27,0,0,0,0,20190423,100,122,17,29,31,22,22,222,22,2018,0,1,80,1
Oklahoma City,37,23,30,25,0,0,0,0,Portland,29,32,27,30,0,0,0,0,20190423,115,118,-8,1,-2,3,3,233,3,2018,0,1,1484,1
Orlando,19,28,23,26,0,0,0,0,Toronto,35,32,32,16,0,0,0,0,20190423,96,115,16,20,29,19,19,211,19,2018,0,1,1048,1
LA Clippers,37,34,33,25,0,0,0,0,Golden State,41,22,31,27,0,0,0,0,20190424,129,121,-4,8,10,8,8,250,-8,2018,0,2,347,1
Utah,20,22,27,24,0,0,0,0,Houston,20,26,29,25,0,0,0,0,20190424,93,100,0,4,6,7,7,193,7,2018,0,2,1199,1
Denver,24,36,25,18,0,0,0,0,San Antonio,34,30,26,30,0,0,0,0,20190425,103,120,10,4,5,17,17,223,17,2018,0,3,802,1
Golden State,35,37,30,27,0,0,0,0,LA Clippers,31,22,25,32,0,0,0,0,20190426,129,110,4,19,24,19,19,239,-19,2018,0,4,347,1
San Antonio,13,21,27,25,0,0,0,0,Denver,23,24,25,18,0,0,0,0,20190427,86,90,10,13,11,4,4,176,4,2018,0,5,802,1
Philadelphia,31,21,29,14,0,0,0,0,Toronto,39,22,31,16,0,0,0,0,20190427,95,108,8,9,11,13,13,203,13,2018,0,5,334,1
Boston,26,26,36,24,0,0,0,0,Milwaukee,17,33,21,19,0,0,0,0,20190428,112,90,9,2,17,22,22,202,-22,2018,0,6,855,1
Houston,19,34,23,24,0,0,0,0,Golden State,28,25,30,21,0,0,0,0,20190428,100,104,9,0,7,4,4,204,4,2018,0,6,1642,1
Portland,32,23,29,29,0,0,0,0,Denver,32,26,35,28,0,0,0,0,20190429,113,121,0,3,9,8,8,234,8,2018,0,0,981,1
Philadelphia,26,25,18,25,0,0,0,0,Toronto,17,21,25,26,0,0,0,0,20190429,94,89,9,13,6,5,5,183,-5,2018,0,0,334,1
Houston,20,29,26,34,0,0,0,0,Golden State,29,29,24,33,0,0,0,0,20190430,109,115,9,9,7,6,6,224,6,2018,0,1,1642,1
Boston,30,25,18,29,0,0,0,0,Milwaukee,25,34,39,25,0,0,0,0,20190430,102,123,-5,4,25,21,21,225,21,2018,0,1,855,1
Portland,28,22,28,19,0,0,0,0,Denver,23,12,29,26,0,0,0,0,20190501,97,90,5,15,14,7,7,187,-7,2018,0,2,981,1
Toronto,29,24,28,14,0,0,0,0,Philadelphia,32,32,25,27,0,0,0,0,20190502,95,116,3,11,8,21,21,211,21,2018,0,3,334,1
Milwaukee,25,30,40,28,0,0,0,0,Boston,30,26,31,29,0,0,0,0,20190503,123,116,-5,-1,8,7,7,239,-7,2018,0,4,855,1
Denver,17,30,29,26,7,9,11,8,Portland,23,25,33,21,7,9,11,11,20190503,137,140,6,1,5,0,3,277,3,2018,4,4,981,1
Golden State,26,23,35,28,9,0,0,0,Houston,25,33,33,21,14,0,0,0,20190504,121,126,-1,9,7,0,5,247,5,2018,1,5,1642,1
Toronto,24,23,28,26,0,0,0,0,Philadelphia,21,24,30,21,0,0,0,0,20190505,101,96,3,2,0,5,5,197,-5,2018,0,6,334,1
Denver,29,28,27,32,0,0,0,0,Portland,33,30,14,35,0,0,0,0,20190505,116,112,-4,-6,7,4,4,228,-4,2018,0,6,981,1
Golden State,28,26,30,24,0,0,0,0,Houston,25,36,32,19,0,0,0,0,20190506,108,112,-3,7,9,4,4,220,4,2018,0,0,1642,1
Milwaukee,22,25,33,33,0,0,0,0,Boston,30,19,23,29,0,0,0,0,20190506,113,101,-8,-2,8,12,12,214,-12,2018,0,0,855,1
Portland,25,22,18,33,0,0,0,0,Denver,31,34,28,31,0,0,0,0,20190507,98,124,6,18,28,26,26,222,26,2018,0,1,981,1
Philadelphia,26,17,27,19,0,0,0,0,Toronto,27,37,28,33,0,0,0,0,20190507,89,125,1,21,22,36,36,214,36,2018,0,1,334,1
Houston,17,26,29,27,0,0,0,0,Golden State,31,26,15,32,0,0,0,0,20190508,99,104,14,14,0,5,5,203,5,2018,0,2,1642,1
Boston,19,20,23,29,0,0,0,0,Milwaukee,22,30,28,36,0,0,0,0,20190508,91,116,3,13,18,25,25,207,25,2018,0,2,855,1
Toronto,21,22,24,34,0,0,0,0,Philadelphia,29,29,29,25,0,0,0,0,20190509,101,112,8,15,20,11,11,213,11,2018,0,3,334,1
Denver,34,20,26,28,0,0,0,0,Portland,26,32,29,32,0,0,0,0,20190509,108,119,-8,4,7,11,11,227,11,2018,0,3,981,1
Golden State,27,30,25,36,0,0,0,0,Houston,28,29,30,26,0,0,0,0,20190510,118,113,-1,0,-5,5,5,231,-5,2018,0,4,1642,1
Portland,17,22,32,29,0,0,0,0,Denver,29,19,24,24,0,0,0,0,20190512,100,96,-12,-9,-1,4,4,196,-4,2018,0,6,981,1
Philadelphia,13,27,24,26,0,0,0,0,Toronto,18,26,23,25,0,0,0,0,20190512,90,92,5,4,3,2,2,182,2,2018,0,6,334,1
Portland,23,22,26,23,0,0,0,0,Golden State,27,27,23,39,0,0,0,0,20190514,94,116,4,9,6,22,22,210,22,2018,0,1,535,1
Toronto,34,25,24,17,0,0,0,0,Milwaukee,23,28,25,32,0,0,0,0,20190515,100,108,-11,-8,-7,8,8,208,8,2018,0,2,429,1
Portland,31,34,24,22,0,0,0,0,Golden State,29,21,39,25,0,0,0,0,20190516,111,114,-2,-15,0,3,3,225,3,2018,0,3,535,1
Toronto,21,18,39,25,0,0,0,0,Milwaukee,35,29,31,30,0,0,0,0,20190517,103,125,14,25,17,22,22,228,22,2018,0,4,429,1
Golden State,27,26,29,28,0,0,0,0,Portland,29,37,13,20,0,0,0,0,20190518,110,99,-2,-13,3,11,11,209,-11,2018,0,5,535,1
Milwaukee,21,30,24,21,7,9,0,0,Toronto,30,28,19,19,7,15,0,0,20190519,112,118,9,7,2,0,6,230,6,2018,2,6,429,1
Golden State,36,29,22,24,8,0,0,0,Portland,35,34,26,16,6,0,0,0,20190520,119,117,1,-4,-8,0,2,236,-2,2018,1,0,535,1
Milwaukee,31,24,26,21,0,0,0,0,Toronto,32,33,29,26,0,0,0,0,20190521,102,120,1,10,13,18,18,222,18,2018,0,1,429,1
Toronto,22,24,26,33,0,0,0,0,Milwaukee,32,17,26,24,0,0,0,0,20190523,105,99,-10,-3,-3,6,6,204,-6,2018,0,3,429,1
Milwaukee,31,19,26,18,0,0,0,0,Toronto,18,25,28,29,0,0,0,0,20190525,94,100,-13,-7,-5,6,6,194,6,2018,0,5,429,1
Golden State,21,28,32,28,0,0,0,0,Toronto,25,34,29,30,0,0,0,0,20190530,109,118,4,10,7,9,9,227,9,2018,0,3,2263,1
Golden State,26,28,34,21,0,0,0,0,Toronto,27,32,21,24,0,0,0,0,20190602,109,104,-1,-5,8,5,5,213,-5,2018,0,6,2263,1
Toronto,36,24,36,27,0,0,0,0,Golden State,29,23,31,26,0,0,0,0,20190605,123,109,7,8,13,14,14,232,-14,2018,0,2,2263,1
Toronto,17,25,37,26,0,0,0,0,Golden State,23,23,21,25,0,0,0,0,20190607,105,92,-6,-4,12,13,13,197,-13,2018,0,4,2263,1
Golden State,34,28,22,22,0,0,0,0,Toronto,28,28,22,27,0,0,0,0,20190610,106,105,6,6,6,1,1,211,-1,2018,0,0,2263,1
Toronto,33,27,26,28,0,0,0,0,Golden State,32,25,31,22,0,0,0,0,20190613,114,110,1,3,-2,4,4,224,-4,2018,0,3,2263,1
New Orleans,30,31,25,31,5,0,0,0,Toronto,27,29,32,29,13,0,0,0,20191022,122,130,-3,-5,2,0,8,252,8,2019,1,1,1112,0
LA Lakers,25,29,31,17,0,0,0,0,LA Clippers,22,40,23,27,0,0,0,0,20191022,102,112,-3,8,0,10,10,214,10,2019,0,1,0,0
New York,15,36,33,27,0,0,0,0,San Antonio,22,37,24,37,0,0,0,0,20191023,111,120,7,8,-1,9,9,231,9,2019,0,2,1581,0
Minnesota,33,35,20,27,12,0,0,0,Brooklyn,22,34,37,22,11,0,0,0,20191023,127,126,11,12,-5,0,1,253,-1,2019,1,2,1016,0
Chicago,28,27,40,30,0,0,0,0,Charlotte,37,26,33,30,0,0,0,0,20191023,125,126,9,8,1,1,1,251,1,2019,0,2,586,0
Washington,25,23,20,32,0,0,0,0,Dallas,24,38,29,17,0,0,0,0,20191023,100,108,-1,14,23,8,8,208,8,2019,0,2,1181,0
Detroit,27,27,29,36,0,0,0,0,Indiana,24,31,31,24,0,0,0,0,20191023,119,110,3,-1,-3,9,9,229,-9,2019,0,2,240,0
Memphis,32,28,24,17,0,0,0,0,Miami,24,30,29,37,0,0,0,0,20191023,101,120,-8,-6,-1,19,19,221,19,2019,0,2,873,0
Cleveland,24,17,24,20,0,0,0,0,Orlando,28,27,16,23,0,0,0,0,20191023,85,94,4,14,6,9,9,179,9,2019,0,2,895,0
Boston,25,23,20,25,0,0,0,0,Philadelphia,20,29,28,30,0,0,0,0,20191023,93,107,-5,1,9,14,14,200,14,2019,0,2,270,0
Sacramento,29,30,17,19,0,0,0,0,Phoenix,25,29,32,38,0,0,0,0,20191023,95,124,-4,-5,10,29,29,219,29,2019,0,2,634,0
Denver,24,30,19,35,0,0,0,0,Portland,27,23,24,26,0,0,0,0,20191023,108,100,-3,4,-1,8,8,208,-8,2019,0,2,981,0
Oklahoma City,12,34,28,21,0,0,0,0,Utah,23,26,19,32,0,0,0,0,20191023,95,100,11,3,-6,5,5,195,5,2019,0,2,861,0
Milwaukee,23,27,28,39,0,0,0,0,Houston,30,36,21,24,0,0,0,0,20191024,117,111,-7,-16,-9,6,6,228,-6,2019,0,3,1005,0
LA Clippers,35,30,46,30,0,0,0,0,Golden State,29,25,33,35,0,0,0,0,20191024,141,122,6,11,24,19,19,263,-19,2019,0,3,347,0
Atlanta,38,22,31,26,0,0,0,0,Detroit,32,31,18,19,0,0,0,0,20191024,117,100,6,-3,10,17,17,217,-17,2019,0,3,597,0
Toronto,21,28,33,24,0,0,0,0,Boston,22,28,26,36,0,0,0,0,20191025,106,112,1,1,-6,6,6,218,6,2019,0,4,430,0
New York,23,28,32,26,0,0,0,0,Brooklyn,32,32,30,19,0,0,0,0,20191025,109,113,9,13,11,4,4,222,4,2019,0,4,0,0
Minnesota,30,28,45,18,0,0,0,0,Charlotte,32,24,25,18,0,0,0,0,20191025,121,99,-2,2,22,22,22,220,-22,2019,0,4,938,0
Phoenix,21,24,17,33,12,0,0,0,Denver,15,24,25,31,13,0,0,0,20191025,107,108,-6,-6,2,0,1,215,1,2019,1,4,585,0
Utah,17,20,18,31,0,0,0,0,LA Lakers,24,19,31,21,0,0,0,0,20191025,86,95,7,6,19,9,9,181,9,2019,0,4,579,0
Chicago,25,22,32,31,0,0,0,0,Memphis,29,31,21,21,0,0,0,0,20191025,110,102,-4,-13,-2,8,8,212,-8,2019,0,4,480,0
Dallas,27,45,23,28,0,0,0,0,New Orleans,41,23,29,23,0,0,0,0,20191025,123,116,-14,8,2,7,7,239,-7,2019,0,4,442,0
Washington,28,24,26,19,0,0,0,0,Oklahoma City,24,22,24,15,0,0,0,0,20191025,97,85,4,6,8,12,12,182,-12,2019,0,4,1149,0
Portland,25,32,37,28,0,0,0,0,Sacramento,27,30,27,28,0,0,0,0,20191025,122,112,-2,0,10,10,10,234,-10,2019,0,4,483,0
Sacramento,25,16,17,23,0,0,0,0,Utah,35,31,27,20,0,0,0,0,20191026,81,113,10,25,35,32,32,194,32,2019,0,5,532,0
Washington,26,34,30,32,0,0,0,0,San Antonio,30,30,32,32,0,0,0,0,20191026,122,124,4,0,2,2,2,246,2,2019,0,5,1385,0
LA Clippers,22,33,30,37,0,0,0,0,Phoenix,26,29,36,39,0,0,0,0,20191026,122,130,4,0,6,8,8,252,8,2019,0,5,356,0
Boston,22,24,36,36,0,0,0,0,New York,24,27,25,19,0,0,0,0,20191026,118,95,-2,-5,6,23,23,213,-23,2019,0,5,190,0
Miami,29,24,29,39,10,0,0,0,Milwaukee,33,37,23,28,5,0,0,0,20191026,131,126,-4,-17,-11,0,5,257,-5,2019,1,5,1269,0
Indiana,28,20,26,25,0,0,0,0,Cleveland,26,39,25,20,0,0,0,0,20191026,99,110,-2,17,16,11,11,209,11,2019,0,5,262,0
Philadelphia,28,26,29,34,0,0,0,0,Detroit,29,28,26,28,0,0,0,0,20191026,117,111,-1,-3,0,6,6,228,-6,2019,0,5,441,0
Toronto,24,24,36,24,0,0,0,0,Chicago,23,17,22,22,0,0,0,0,20191026,108,84,1,8,22,24,24,192,-24,2019,0,5,436,0
Orlando,26,24,25,24,0,0,0,0,Atlanta,23,29,25,26,0,0,0,0,20191026,99,103,-3,2,2,4,4,202,4,2019,0,5,401,0
New Orleans,24,37,39,23,0,0,0,0,Houston,29,32,36,29,0,0,0,0,20191026,123,126,5,0,-3,3,3,249,3,2019,0,5,317,0
Portland,25,34,36,26,0,0,0,0,Dallas,40,31,24,24,0,0,0,0,20191027,121,119,-15,-12,0,2,2,240,-2,2019,0,6,1630,0
Charlotte,28,34,18,21,0,0,0,0,LA Lakers,30,33,24,33,0,0,0,0,20191027,101,120,2,1,7,19,19,221,19,2019,0,6,2115,0
Brooklyn,29,28,40,23,13,0,0,0,Memphis,35,24,33,28,14,0,0,0,20191027,133,134,6,2,-5,0,1,267,1,2019,1,6,953,0
Miami,23,34,27,25,0,0,0,0,Minnesota,36,19,22,39,0,0,0,0,20191027,109,116,13,-2,-7,7,7,225,7,2019,0,6,1513,0
Golden State,20,17,31,24,0,0,0,0,Oklahoma City,35,35,35,15,0,0,0,0,20191027,92,120,15,33,37,28,28,212,28,2019,0,6,1386,0
Denver,21,26,30,24,0,0,0,0,Sacramento,28,25,17,24,0,0,0,0,20191028,101,94,-7,-6,7,7,7,195,-7,2019,0,0,886,0
Oklahoma City,35,27,18,32,0,0,0,0,Houston,22,30,39,25,0,0,0,0,20191028,112,116,-13,-10,11,4,4,228,4,2019,0,0,413,0
Orlando,22,24,21,28,0,0,0,0,Toronto,31,20,27,26,0,0,0,0,20191028,95,104,9,5,11,9,9,199,9,2019,0,0,1048,0
Utah,28,18,24,26,0,0,0,0,Phoenix,21,18,31,25,0,0,0,0,20191028,96,95,7,7,0,1,1,191,-1,2019,0,0,505,0
Portland,33,18,20,39,0,0,0,0,San Antonio,19,26,37,31,0,0,0,0,20191028,110,113,-14,-6,11,3,3,223,3,2019,0,0,1718,0
Chicago,33,19,28,18,0,0,0,0,New York,15,27,30,33,0,0,0,0,20191028,98,105,-18,-10,-8,7,7,203,7,2019,0,0,711,0
Philadelphia,31,32,19,23,0,0,0,0,Atlanta,40,25,18,20,0,0,0,0,20191028,105,103,-9,-2,-1,2,2,208,-2,2019,0,0,665,0
Cleveland,31,21,28,32,0,0,0,0,Milwaukee,30,29,32,38,0,0,0,0,20191028,112,129,-1,7,11,17,17,241,17,2019,0,0,334,0
Charlotte,28,26,20,22,0,0,0,0,LA Clippers,29,28,29,25,0,0,0,0,20191028,96,111,1,3,12,15,15,207,15,2019,0,0,2115,0
Indiana,25,28,18,23,0,0,0,0,Detroit,33,26,19,18,0,0,0,0,20191028,94,96,8,6,7,2,2,190,2,2019,0,0,240,0
Golden State,27,45,31,31,0,0,0,0,New Orleans,23,32,24,44,0,0,0,0,20191028,134,123,4,17,24,11,11,257,-11,2019,0,0,1921,0
Dallas,27,33,23,26,0,0,0,0,Denver,31,30,27,18,0,0,0,0,20191029,109,106,-4,-1,-5,3,3,215,-3,2019,0,1,661,0
Memphis,32,15,20,24,0,0,0,0,LA Lakers,27,22,39,32,0,0,0,0,20191029,91,120,-5,2,21,29,29,211,29,2019,0,1,1599,0
Atlanta,26,23,21,27,0,0,0,0,Miami,29,30,29,24,0,0,0,0,20191029,97,112,3,10,18,15,15,209,15,2019,0,1,605,0
Houston,35,41,35,48,0,0,0,0,Washington,34,43,40,41,0,0,0,0,20191030,159,158,1,-1,-6,1,1,317,-1,2019,0,2,1217,0
LA Clippers,23,28,20,25,0,0,0,0,Utah,33,19,38,20,0,0,0,0,20191030,96,110,10,1,19,14,14,206,14,2019,0,2,579,0
Detroit,28,30,27,28,0,0,0,0,Toronto,37,27,37,24,0,0,0,0,20191030,113,125,9,6,16,12,12,238,12,2019,0,2,205,0
Charlotte,30,31,32,25,0,0,0,0,Sacramento,33,33,18,27,0,0,0,0,20191030,118,111,-3,-5,9,7,7,229,-7,2019,0,2,2239,0
Minnesota,24,19,35,17,0,0,0,0,Philadelphia,32,30,30,25,0,0,0,0,20191030,95,117,8,19,14,22,22,212,22,2019,0,2,983,0
Portland,24,25,19,34,0,0,0,0,Oklahoma City,17,27,25,30,0,0,0,0,20191030,102,99,7,5,-1,3,3,201,-3,2019,0,2,1484,0
Phoenix,43,29,23,26,0,0,0,0,Golden State,14,32,21,43,0,0,0,0,20191030,121,110,29,26,28,11,11,231,-11,2019,0,2,652,0
Chicago,26,27,29,29,0,0,0,0,Cleveland,25,25,30,37,0,0,0,0,20191030,111,117,-1,-3,-2,6,6,228,6,2019,0,2,308,0
Indiana,31,29,30,28,0,0,0,0,Brooklyn,31,32,20,25,0,0,0,0,20191030,118,108,0,-3,7,10,10,226,-10,2019,0,2,643,0
Milwaukee,34,24,18,29,0,0,0,0,Boston,19,23,38,36,0,0,0,0,20191030,105,116,-15,-16,4,11,11,221,11,2019,0,2,855,0
New York,25,19,23,16,0,0,0,0,Orlando,22,20,30,23,0,0,0,0,20191030,83,95,-3,-2,5,12,12,178,12,2019,0,2,939,0
Miami,30,22,33,21,0,0,0,0,Atlanta,26,20,29,22,0,0,0,0,20191031,106,97,4,6,10,9,9,203,-9,2019,0,3,605,0
San Antonio,24,24,27,22,0,0,0,0,LA Clippers,23,27,30,23,0,0,0,0,20191031,97,103,-1,2,5,6,6,200,6,2019,0,3,1201,0
Denver,30,22,23,32,0,0,0,0,New Orleans,32,24,30,36,0,0,0,0,20191031,107,122,2,4,11,15,15,229,15,2019,0,3,1079,0
Milwaukee,31,31,26,35,0,0,0,0,Orlando,27,14,30,20,0,0,0,0,20191101,123,91,4,21,17,32,32,214,-32,2019,0,4,1065,0
Utah,18,30,32,21,0,0,0,0,Sacramento,28,23,30,21,0,0,0,0,20191101,101,102,10,3,1,1,1,203,1,2019,0,4,532,0
Cleveland,26,11,24,34,0,0,0,0,Indiana,19,23,26,34,0,0,0,0,20191101,95,102,-7,5,7,7,7,197,7,2019,0,4,262,0
San Antonio,29,28,40,30,0,0,0,0,Golden State,28,27,31,24,0,0,0,0,20191101,127,110,1,2,11,17,17,237,-17,2019,0,4,1487,0
Detroit,23,29,28,26,0,0,0,0,Chicago,30,27,29,26,0,0,0,0,20191101,106,112,7,5,6,6,6,218,6,2019,0,4,238,0
Houston,33,26,24,33,0,0,0,0,Brooklyn,24,37,34,28,0,0,0,0,20191101,116,123,-9,2,12,7,7,239,7,2019,0,4,1417,0
New York,23,27,24,28,0,0,0,0,Boston,22,27,26,29,0,0,0,0,20191101,102,104,-1,-1,1,2,2,206,2,2019,0,4,190,0
LA Lakers,20,28,28,27,16,0,0,0,Dallas,25,33,27,18,7,0,0,0,20191101,119,110,-5,-10,-9,0,9,229,-9,2019,1,4,1237,0
Minnesota,42,28,36,25,0,0,0,0,Washington,34,22,16,37,0,0,0,0,20191102,131,109,8,14,34,22,22,240,-22,2019,0,5,931,0
Brooklyn,26,28,18,37,0,0,0,0,Detroit,33,13,32,35,0,0,0,0,20191102,109,113,7,-8,6,4,4,222,4,2019,0,5,480,0
Charlotte,25,25,18,25,0,0,0,0,Golden State,30,25,16,16,0,0,0,0,20191102,93,87,-5,-5,-3,6,6,180,-6,2019,0,5,2296,0
Phoenix,31,14,37,32,0,0,0,0,Memphis,24,23,22,36,0,0,0,0,20191102,114,105,7,-2,13,9,9,219,-9,2019,0,5,1260,0
Toronto,17,33,40,15,0,0,0,0,Milwaukee,36,30,29,20,0,0,0,0,20191102,105,115,19,16,5,10,10,220,10,2019,0,5,429,0
New Orleans,26,34,26,18,0,0,0,0,Oklahoma City,33,32,29,21,0,0,0,0,20191102,104,115,7,5,8,11,11,219,11,2019,0,5,576,0
Denver,17,23,29,22,0,0,0,0,Orlando,26,19,18,24,0,0,0,0,20191102,91,87,-9,-5,6,4,4,178,-4,2019,0,5,1548,0
Philadelphia,27,30,35,37,0,0,0,0,Portland,32,36,34,26,0,0,0,0,20191102,129,128,-5,-11,-10,1,1,257,-1,2019,0,5,2405,0
LA Lakers,26,30,21,26,0,0,0,0,San Antonio,25,18,29,24,0,0,0,0,20191103,103,96,1,13,5,7,7,199,-7,2019,0,6,1201,0
Sacramento,32,29,29,23,0,0,0,0,New York,23,18,23,28,0,0,0,0,20191103,113,92,9,20,26,21,21,205,-21,2019,0,6,2499,0
Houston,14,32,25,29,0,0,0,0,Miami,46,25,28,30,0,0,0,0,20191103,100,129,32,25,28,29,29,229,29,2019,0,6,966,0
Chicago,18,24,32,21,0,0,0,0,Indiana,24,31,31,22,0,0,0,0,20191103,95,108,6,13,12,13,13,203,13,2019,0,6,163,0
Dallas,31,27,32,41,0,0,0,0,Cleveland,28,25,33,25,0,0,0,0,20191103,131,111,3,5,4,20,20,242,-20,2019,0,6,1024,0
Utah,20,21,28,25,0,0,0,0,LA Clippers,16,23,26,40,0,0,0,0,20191103,94,105,-4,-2,-4,11,11,199,11,2019,0,6,579,0
Philadelphia,31,30,21,27,0,0,0,0,Phoenix,29,26,26,33,0,0,0,0,20191104,109,114,-2,-6,-1,5,5,223,5,2019,0,0,2078,0
New Orleans,27,23,48,27,0,0,0,0,Brooklyn,33,34,37,31,0,0,0,0,20191104,125,135,6,17,6,10,10,260,10,2019,0,0,1168,0
Portland,32,31,20,35,0,0,0,0,Golden State,34,26,27,40,0,0,0,0,20191104,118,127,2,-3,4,9,9,245,9,2019,0,0,535,0
Houston,33,29,22,23,0,0,0,0,Memphis,28,32,16,24,0,0,0,0,20191104,107,100,5,2,8,7,7,207,-7,2019,0,0,484,0
Milwaukee,31,33,38,32,0,0,0,0,Minnesota,27,30,25,24,0,0,0,0,20191104,134,106,4,7,20,28,28,240,-28,2019,0,0,298,0
Detroit,30,31,17,21,0,0,0,0,Washington,31,32,30,22,0,0,0,0,20191104,99,115,1,2,15,16,16,214,16,2019,0,0,394,0
Miami,28,20,21,20,0,0,0,0,Denver,29,29,31,20,0,0,0,0,20191105,89,109,1,10,20,20,20,198,20,2019,0,1,1724,0
Orlando,26,27,26,15,0,0,0,0,Oklahoma City,31,27,23,21,0,0,0,0,20191105,94,102,5,5,2,8,8,196,8,2019,0,1,1057,0
Boston,32,29,28,30,0,0,0,0,Cleveland,24,28,31,30,0,0,0,0,20191105,119,113,8,9,6,6,6,232,-6,2019,0,1,549,0
San Antonio,21,24,33,22,0,0,0,0,Atlanta,22,22,26,38,0,0,0,0,20191105,100,108,1,-1,-8,8,8,208,8,2019,0,1,881,0
LA Lakers,24,24,32,38,0,0,0,0,Chicago,29,36,28,19,0,0,0,0,20191105,118,112,-5,-17,-13,6,6,230,-6,2019,0,1,1741,0
Indiana,35,29,28,21,7,0,0,0,Charlotte,20,37,21,35,9,0,0,0,20191105,120,122,-15,-7,-14,0,2,242,2,2019,1,1,428,0
Philadelphia,29,27,17,31,0,0,0,0,Utah,26,32,26,22,0,0,0,0,20191106,104,106,-3,2,11,2,2,210,2,2019,0,2,1920,0
Minnesota,26,38,32,25,0,0,0,0,Memphis,37,35,29,36,0,0,0,0,20191106,121,137,11,8,5,16,16,258,16,2019,0,2,700,0
Milwaukee,28,42,28,31,0,0,0,0,LA Clippers,30,29,30,35,0,0,0,0,20191106,129,124,-2,11,9,5,5,253,-5,2019,0,2,1741,0
Washington,26,36,18,26,0,0,0,0,Indiana,26,44,24,27,0,0,0,0,20191106,106,121,0,8,14,15,15,227,15,2019,0,2,490,0
Sacramento,23,35,30,32,0,0,0,0,Toronto,36,30,29,29,0,0,0,0,20191106,120,124,13,8,7,4,4,244,4,2019,0,2,2195,0
New York,25,34,26,17,0,0,0,0,Detroit,33,31,32,26,0,0,0,0,20191106,102,122,8,5,11,20,20,224,20,2019,0,2,480,0
Orlando,28,28,23,27,0,0,0,0,Dallas,25,29,32,21,0,0,0,0,20191106,106,107,-3,-2,7,1,1,213,1,2019,0,2,961,0
Chicago,33,23,35,22,0,0,0,0,Atlanta,19,22,24,28,0,0,0,0,20191106,113,93,14,15,26,20,20,206,-20,2019,0,2,587,0
Golden State,29,23,31,29,0,0,0,0,Houston,30,33,35,31,0,0,0,0,20191106,112,129,1,11,15,17,17,241,17,2019,0,2,1642,0
Boston,30,22,33,23,0,0,0,0,Charlotte,20,23,24,20,0,0,0,0,20191107,108,87,10,9,18,21,21,195,-21,2019,0,3,720,0
Portland,22,18,36,25,0,0,0,0,LA Clippers,26,21,23,37,0,0,0,0,20191107,101,107,4,7,-6,6,6,208,6,2019,0,3,826,0
Miami,31,33,29,31,0,0,0,0,Phoenix,30,27,29,22,0,0,0,0,20191107,124,108,1,7,7,16,16,232,-16,2019,0,3,1978,0
Oklahoma City,30,27,27,28,0,0,0,0,San Antonio,33,23,36,29,0,0,0,0,20191107,112,121,3,-1,8,9,9,233,9,2019,0,3,421,0
Toronto,30,45,22,25,0,0,0,0,New Orleans,30,23,22,29,0,0,0,0,20191108,122,104,0,22,22,18,18,226,-18,2019,0,4,1112,0
Milwaukee,16,19,39,26,0,0,0,0,Utah,30,25,26,22,0,0,0,0,20191108,100,103,14,20,7,3,3,203,3,2019,0,4,1239,0
Brooklyn,26,28,35,30,0,0,0,0,Portland,20,29,37,29,0,0,0,0,20191108,119,115,6,5,3,4,4,234,-4,2019,0,4,2439,0
Cleveland,30,37,21,25,0,0,0,0,Washington,26,26,32,16,0,0,0,0,20191108,113,100,4,15,4,13,13,213,-13,2019,0,4,304,0
Golden State,31,30,25,24,9,0,0,0,Minnesota,29,31,20,30,15,0,0,0,20191108,119,125,-2,-1,-6,0,6,244,6,2019,1,4,1581,0
Memphis,15,33,30,8,0,0,0,0,Orlando,27,24,33,34,0,0,0,0,20191108,86,118,12,3,6,32,32,204,32,2019,0,4,683,0
Detroit,35,18,19,34,0,0,0,0,Indiana,27,30,28,27,0,0,0,0,20191108,106,112,-8,4,13,6,6,218,6,2019,0,4,240,0
Philadelphia,24,33,27,13,0,0,0,0,Denver,18,24,23,35,0,0,0,0,20191108,97,100,-6,-15,-19,3,3,197,3,2019,0,4,1574,0
New York,36,25,23,22,0,0,0,0,Dallas,28,29,23,22,0,0,0,0,20191108,106,102,8,4,4,4,4,208,-4,2019,0,4,1370,0
Sacramento,31,32,28,30,0,0,0,0,Atlanta,24,23,36,26,0,0,0,0,20191108,121,109,7,16,8,12,12,230,-12,2019,0,4,2082,0
Miami,21,25,20,14,0,0,0,0,LA Lakers,28,20,30,17,0,0,0,0,20191108,80,95,7,2,12,15,15,175,15,2019,0,4,2335,0
Houston,20,30,36,31,0,0,0,0,Chicago,27,22,18,27,0,0,0,0,20191109,117,94,-7,1,19,23,23,211,-23,2019,0,5,939,0
New Orleans,33,22,26,34,0,0,0,0,Charlotte,28,33,25,24,0,0,0,0,20191109,115,110,5,-6,-5,5,5,225,-5,2019,0,5,648,0
Dallas,31,37,36,34,0,0,0,0,Memphis,34,28,29,31,0,0,0,0,20191109,138,122,-3,6,13,16,16,260,-16,2019,0,5,419,0
Golden State,27,16,41,24,0,0,0,0,Oklahoma City,36,24,24,30,0,0,0,0,20191109,108,114,9,17,0,6,6,222,6,2019,0,5,1386,0
Boston,39,33,32,31,0,0,0,0,San Antonio,30,24,37,24,0,0,0,0,20191109,135,115,9,18,13,20,20,250,-20,2019,0,5,1765,0
Atlanta,21,23,31,32,6,0,0,0,Portland,20,26,29,32,17,0,0,0,20191110,113,124,-1,2,0,0,11,237,11,2019,1,6,2168,0
Brooklyn,30,20,30,32,0,0,0,0,Phoenix,37,31,38,32,0,0,0,0,20191110,112,138,7,18,26,26,26,250,26,2019,0,6,2139,0
Charlotte,24,34,23,25,0,0,0,0,Philadelphia,33,20,35,26,0,0,0,0,20191110,106,114,9,-5,7,8,8,220,8,2019,0,6,450,0
Indiana,29,22,30,28,0,0,0,0,Orlando,33,27,17,25,0,0,0,0,20191110,109,102,-4,-9,4,7,7,211,-7,2019,0,6,822,0
Cleveland,31,23,24,30,0,0,0,0,New York,19,17,27,24,0,0,0,0,20191110,108,87,12,18,15,21,21,195,-21,2019,0,6,403,0
Denver,27,22,27,14,10,0,0,0,Minnesota,27,24,13,26,8,0,0,0,20191110,100,98,0,-2,12,0,2,198,-2,2019,1,6,698,0
Toronto,29,23,26,35,0,0,0,0,LA Lakers,30,30,18,26,0,0,0,0,20191110,113,104,-1,-8,0,9,9,217,-9,2019,0,6,2170,0
Milwaukee,21,29,37,34,0,0,0,0,Oklahoma City,24,32,24,39,0,0,0,0,20191110,121,119,-3,-6,7,2,2,240,-2,2019,0,6,732,0
Memphis,35,22,34,22,0,0,0,0,San Antonio,22,32,26,29,0,0,0,0,20191111,113,109,13,3,11,4,4,222,-4,2019,0,0,631,0
Dallas,21,33,25,27,0,0,0,0,Boston,25,29,30,32,0,0,0,0,20191111,106,116,4,0,5,10,10,222,10,2019,0,0,1548,0
Minnesota,41,25,26,28,0,0,0,0,Detroit,26,25,30,33,0,0,0,0,20191111,120,114,15,15,11,6,6,234,-6,2019,0,0,542,0
Utah,34,35,28,25,0,0,0,0,Golden State,30,24,31,23,0,0,0,0,20191111,122,108,4,15,12,14,14,230,-14,2019,0,0,599,0
Toronto,23,23,32,10,0,0,0,0,LA Clippers,15,36,22,25,0,0,0,0,20191111,88,98,-8,5,-5,10,10,186,10,2019,0,0,2170,0
Houston,30,28,32,32,0,0,0,0,New Orleans,23,29,30,34,0,0,0,0,20191111,122,116,7,6,8,6,6,238,-6,2019,0,0,317,0
LA Lakers,26,34,35,28,0,0,0,0,Phoenix,29,29,34,23,0,0,0,0,20191112,123,115,-3,2,3,8,8,238,-8,2019,0,1,356,0
Cleveland,21,27,30,19,0,0,0,0,Philadelphia,24,30,28,16,0,0,0,0,20191112,97,98,3,6,4,1,1,195,1,2019,0,1,358,0
Portland,24,25,21,29,0,0,0,0,Sacramento,21,25,35,26,0,0,0,0,20191112,99,107,-3,-3,11,8,8,206,8,2019,0,1,483,0
Brooklyn,35,33,24,22,0,0,0,0,Utah,29,24,31,35,0,0,0,0,20191112,114,119,-6,-15,-8,5,5,233,5,2019,0,1,1967,0
Detroit,17,20,35,36,0,0,0,0,Miami,28,31,33,25,0,0,0,0,20191112,108,117,11,22,20,9,9,225,9,2019,0,1,1155,0
Atlanta,25,38,35,27,0,0,0,0,Denver,34,20,35,32,0,0,0,0,20191112,125,121,-9,9,9,4,4,246,-4,2019,0,1,1209,0
New York,22,32,31,17,0,0,0,0,Chicago,30,30,25,35,0,0,0,0,20191112,102,120,8,6,0,18,18,222,18,2019,0,1,711,0
Oklahoma City,25,17,20,23,0,0,0,0,Indiana,31,21,34,25,0,0,0,0,20191112,85,111,6,10,24,26,26,196,26,2019,0,1,688,0
Washington,34,32,30,37,0,0,0,0,Boston,34,34,34,38,0,0,0,0,20191113,133,140,0,2,6,7,7,273,7,2019,0,2,394,0
Memphis,26,37,31,25,0,0,0,0,Charlotte,29,35,32,21,0,0,0,0,20191113,119,117,-3,-1,-2,2,2,236,-2,2019,0,2,519,0
LA Clippers,15,22,31,25,0,0,0,0,Houston,31,18,25,28,0,0,0,0,20191113,93,102,16,12,6,9,9,195,9,2019,0,2,1371,0
Golden State,26,29,27,12,0,0,0,0,LA Lakers,38,29,31,22,0,0,0,0,20191113,94,120,12,12,16,26,26,214,26,2019,0,2,347,0
San Antonio,24,35,36,19,0,0,0,0,Minnesota,26,40,40,23,0,0,0,0,20191113,114,129,2,7,11,15,15,243,15,2019,0,2,1112,0
Philadelphia,30,23,29,15,0,0,0,0,Orlando,31,22,27,32,0,0,0,0,20191113,97,112,1,0,-2,15,15,209,15,2019,0,2,864,0
Toronto,23,31,33,27,0,0,0,0,Portland,30,23,25,28,0,0,0,0,20191113,114,106,-7,1,9,8,8,220,-8,2019,0,2,2108,0
Atlanta,33,28,29,22,0,0,0,0,Phoenix,31,36,37,24,0,0,0,0,20191114,112,128,-2,6,14,16,16,240,16,2019,0,3,1588,0
Dallas,23,30,34,16,0,0,0,0,New York,27,31,29,19,0,0,0,0,20191114,103,106,4,5,0,3,3,209,3,2019,0,3,1370,0
LA Clippers,35,24,38,30,0,0,0,0,New Orleans,34,38,24,36,0,0,0,0,20191114,127,132,-1,13,-1,5,5,259,5,2019,0,3,1669,0
Brooklyn,35,26,18,14,0,0,0,0,Denver,28,21,30,22,0,0,0,0,20191114,93,101,-7,-12,0,8,8,194,8,2019,0,3,1627,0
Miami,34,34,26,14,0,0,0,0,Cleveland,22,22,30,23,0,0,0,0,20191114,108,97,12,24,20,11,11,205,-11,2019,0,3,1089,0
Chicago,32,34,20,29,0,0,0,0,Milwaukee,30,35,32,27,0,0,0,0,20191114,115,124,-2,-1,11,9,9,239,9,2019,0,3,83,0
Detroit,35,30,18,23,0,0,0,0,Charlotte,25,26,32,26,0,0,0,0,20191115,106,109,-10,-14,0,3,3,215,3,2019,0,4,504,0
Boston,23,29,24,29,0,0,0,0,Golden State,32,19,20,29,0,0,0,0,20191115,105,100,-9,1,5,5,5,205,-5,2019,0,4,2692,0
Indiana,22,27,30,23,0,0,0,0,Houston,26,28,26,31,0,0,0,0,20191115,102,111,4,5,1,9,9,213,9,2019,0,4,865,0
Sacramento,30,20,21,26,0,0,0,0,LA Lakers,20,29,25,25,0,0,0,0,20191115,97,99,-10,-1,3,2,2,196,2,2019,0,4,361,0
Utah,26,22,31,27,0,0,0,0,Memphis,23,30,24,30,0,0,0,0,20191115,106,107,-3,5,-2,1,1,213,1,2019,0,4,1247,0
Washington,39,37,26,35,0,0,0,0,Minnesota,30,43,19,24,0,0,0,0,20191115,137,116,9,3,10,21,21,253,-21,2019,0,4,931,0
Philadelphia,29,20,34,24,12,0,0,0,Oklahoma City,24,30,26,27,20,0,0,0,20191115,119,127,-5,5,-3,0,8,246,8,2019,1,4,1256,0
San Antonio,31,25,26,27,0,0,0,0,Orlando,24,23,32,32,0,0,0,0,20191115,109,111,-7,-9,-3,2,2,220,2,2019,0,4,1035,0
Houston,31,33,29,32,0,0,0,0,Minnesota,30,32,23,20,0,0,0,0,20191116,125,105,1,2,8,20,20,230,-20,2019,0,5,1057,0
Portland,41,25,24,31,0,0,0,0,San Antonio,23,35,38,20,0,0,0,0,20191116,121,116,18,8,-6,5,5,237,-5,2019,0,5,1718,0
Charlotte,20,27,28,28,0,0,0,0,New York,23,32,21,26,0,0,0,0,20191116,103,102,-3,-8,-1,1,1,205,-1,2019,0,5,531,0
New Orleans,22,27,16,29,0,0,0,0,Miami,29,25,24,31,0,0,0,0,20191116,94,109,7,5,13,15,15,203,15,2019,0,5,668,0
Atlanta,30,32,20,19,0,0,0,0,LA Clippers,43,31,38,38,0,0,0,0,20191116,101,150,13,12,30,49,49,251,49,2019,0,5,1932,0
Milwaukee,26,23,22,31,0,0,0,0,Indiana,22,14,27,20,0,0,0,0,20191116,102,83,4,13,8,19,19,185,-19,2019,0,5,243,0
Toronto,22,38,17,25,0,0,0,0,Dallas,32,21,25,32,0,0,0,0,20191116,102,110,10,-7,1,8,8,212,8,2019,0,5,1201,0
Brooklyn,30,20,24,43,0,0,0,0,Chicago,19,37,22,33,0,0,0,0,20191116,117,111,11,-6,-4,6,6,228,-6,2019,0,5,711,0
Philadelphia,33,35,27,19,0,0,0,0,Cleveland,22,22,25,26,0,0,0,0,20191117,114,95,11,24,26,19,19,209,-19,2019,0,6,358,0
Atlanta,24,17,36,24,0,0,0,0,LA Lakers,36,33,27,26,0,0,0,0,20191117,101,122,12,28,19,21,21,223,21,2019,0,6,1932,0
Denver,28,44,36,23,0,0,0,0,Memphis,32,17,31,34,0,0,0,0,20191117,131,114,-4,23,28,17,17,245,-17,2019,0,6,877,0
Golden State,23,26,20,31,0,0,0,0,New Orleans,26,29,21,32,0,0,0,0,20191117,100,108,3,6,7,8,8,208,8,2019,0,6,1921,0
Washington,22,30,25,44,0,0,0,0,Orlando,29,32,27,37,0,0,0,0,20191117,121,125,7,9,11,4,4,246,4,2019,0,6,757,0
Boston,18,28,29,24,0,0,0,0,Sacramento,30,20,21,29,0,0,0,0,20191117,99,100,12,4,-4,1,1,199,1,2019,0,6,2624,0
Minnesota,36,23,17,36,0,0,0,0,Utah,32,24,22,24,0,0,0,0,20191118,112,102,4,3,-2,10,10,214,-10,2019,0,0,984,0
Charlotte,25,31,18,22,0,0,0,0,Toronto,26,34,32,40,0,0,0,0,20191118,96,132,1,4,18,36,36,228,36,2019,0,0,585,0
Boston,26,31,23,19,0,0,0,0,Phoenix,22,20,23,20,0,0,0,0,20191118,99,85,4,15,15,14,14,184,-14,2019,0,0,2295,0
Cleveland,20,31,20,34,0,0,0,0,New York,32,32,30,29,0,0,0,0,20191118,105,123,12,13,23,18,18,228,18,2019,0,0,403,0
Oklahoma City,17,30,17,24,0,0,0,0,LA Clippers,23,19,24,24,0,0,0,0,20191118,88,90,6,-5,2,2,2,178,2,2019,0,0,1178,0
Portland,30,20,26,32,0,0,0,0,Houston,29,35,35,33,0,0,0,0,20191118,108,132,-1,14,23,24,24,240,24,2019,0,0,1833,0
San Antonio,22,27,30,31,0,0,0,0,Dallas,36,23,34,24,0,0,0,0,20191118,110,117,14,10,14,7,7,227,7,2019,0,0,252,0
Milwaukee,29,31,24,31,0,0,0,0,Chicago,26,30,25,20,0,0,0,0,20191118,115,101,3,4,3,14,14,216,-14,2019,0,0,83,0
Indiana,18,41,25,31,0,0,0,0,Brooklyn,18,17,33,18,0,0,0,0,20191118,115,86,0,24,16,29,29,201,-29,2019,0,0,643,0
Oklahoma City,28,25,34,20,0,0,0,0,LA Lakers,33,30,30,19,0,0,0,0,20191119,107,112,5,10,6,5,5,219,5,2019,0,1,1178,0
Golden State,28,33,22,31,0,0,0,0,Memphis,30,16,26,23,0,0,0,0,20191119,114,95,-2,15,11,19,19,209,-19,2019,0,1,1798,0
Portland,28,26,25,25,0,0,0,0,New Orleans,27,26,35,27,0,0,0,0,20191119,104,115,-1,-1,9,11,11,219,11,2019,0,1,2059,0
Phoenix,19,26,30,41,0,0,0,0,Sacramento,33,29,25,33,0,0,0,0,20191119,116,120,14,17,12,4,4,236,4,2019,0,1,634,0
San Antonio,38,31,29,34,0,0,0,0,Washington,35,28,38,37,0,0,0,0,20191120,132,138,-3,-6,3,6,6,270,6,2019,0,2,1385,0
Orlando,32,19,17,29,0,0,0,0,Toronto,32,29,18,34,0,0,0,0,20191120,97,113,0,10,11,16,16,210,16,2019,0,2,1048,0
New York,25,26,28,25,0,0,0,0,Philadelphia,27,26,21,35,0,0,0,0,20191120,104,109,2,2,-5,5,5,213,5,2019,0,2,80,0
Utah,26,22,25,30,0,0,0,0,Minnesota,19,27,22,27,0,0,0,0,20191120,103,95,7,2,5,8,8,198,-8,2019,0,2,984,0
Cleveland,22,26,29,23,0,0,0,0,Miami,32,43,24,25,0,0,0,0,20191120,100,124,10,27,22,24,24,224,24,2019,0,2,1089,0
Golden State,16,22,26,30,0,0,0,0,Dallas,44,30,30,38,0,0,0,0,20191120,94,142,28,36,40,48,48,236,48,2019,0,2,1480,0
Houston,22,29,22,22,0,0,0,0,Denver,27,27,28,23,0,0,0,0,20191120,95,105,5,3,9,10,10,200,10,2019,0,2,878,0
Boston,21,21,33,22,7,0,0,0,LA Clippers,22,18,29,28,10,0,0,0,20191120,104,107,1,-2,-6,0,3,211,3,2019,1,2,2590,0
Detroit,30,25,16,18,0,0,0,0,Chicago,30,29,25,25,0,0,0,0,20191120,89,109,0,4,13,20,20,198,20,2019,0,2,238,0
Charlotte,26,25,22,18,0,0,0,0,Brooklyn,26,30,26,19,0,0,0,0,20191120,91,101,0,5,9,10,10,192,10,2019,0,2,531,0
Milwaukee,34,24,38,39,0,0,0,0,Atlanta,26,35,22,44,0,0,0,0,20191120,135,127,8,-3,13,8,8,262,-8,2019,0,2,669,0
Portland,27,31,40,31,0,0,0,0,Milwaukee,37,35,35,30,0,0,0,0,20191121,129,137,10,14,9,8,8,266,8,2019,0,3,1714,0
New Orleans,38,21,36,29,0,0,0,0,Phoenix,33,33,28,27,0,0,0,0,20191121,124,121,5,-7,1,3,3,245,-3,2019,0,3,1312,0
Charlotte,34,34,28,22,0,0,0,0,Washington,33,29,28,35,0,0,0,0,20191122,118,125,-1,-6,-6,7,7,243,7,2019,0,4,329,0
Golden State,28,23,21,37,0,0,0,0,Utah,30,35,25,23,0,0,0,0,20191122,109,113,2,14,18,4,4,222,4,2019,0,4,599,0
San Antonio,22,30,28,24,0,0,0,0,Philadelphia,29,30,28,28,0,0,0,0,20191122,104,115,7,7,7,11,11,219,11,2019,0,4,1505,0
LA Lakers,34,32,40,24,0,0,0,0,Oklahoma City,33,34,36,24,0,0,0,0,20191122,130,127,1,-1,3,3,3,257,-3,2019,0,4,1178,0
Houston,23,28,33,35,0,0,0,0,LA Clippers,31,24,25,42,0,0,0,0,20191122,119,122,8,4,-4,3,3,241,3,2019,0,4,1371,0
Boston,13,21,23,35,0,0,0,0,Denver,27,18,25,26,0,0,0,0,20191122,92,96,14,11,13,4,4,188,4,2019,0,4,1765,0
Cleveland,26,16,29,30,0,0,0,0,Dallas,29,37,45,32,0,0,0,0,20191122,101,143,3,24,40,42,42,244,42,2019,0,4,1024,0
Miami,34,33,18,31,0,0,0,0,Chicago,16,27,24,41,0,0,0,0,20191122,116,108,18,24,18,8,8,224,-8,2019,0,4,1189,0
Sacramento,23,26,21,27,0,0,0,0,Brooklyn,26,30,30,30,0,0,0,0,20191122,97,116,3,7,16,19,19,213,19,2019,0,4,2499,0
Atlanta,23,34,27,19,0,0,0,0,Detroit,33,43,31,21,0,0,0,0,20191122,103,128,10,19,23,25,25,231,25,2019,0,4,597,0
Phoenix,30,22,30,18,0,0,0,0,Minnesota,23,22,28,25,0,0,0,0,20191123,100,98,7,7,9,2,2,198,-2,2019,0,5,1278,0
New Orleans,31,23,34,32,0,0,0,0,Utah,44,30,24,30,0,0,0,0,20191123,120,128,13,20,10,8,8,248,8,2019,0,5,1432,0
San Antonio,32,36,21,22,0,0,0,0,New York,16,27,28,33,0,0,0,0,20191123,111,104,16,25,18,7,7,215,-7,2019,0,5,1581,0
Detroit,24,23,22,21,0,0,0,0,Milwaukee,27,27,23,27,0,0,0,0,20191123,90,104,3,7,8,14,14,194,14,2019,0,5,251,0
Miami,13,22,24,27,0,0,0,0,Philadelphia,28,27,37,21,0,0,0,0,20191123,86,113,15,20,33,27,27,199,27,2019,0,5,1021,0
Orlando,25,20,40,21,0,0,0,0,Indiana,24,31,28,28,0,0,0,0,20191123,106,111,-1,10,-2,5,5,217,5,2019,0,5,822,0
Portland,19,23,27,35,0,0,0,0,Cleveland,19,30,27,34,0,0,0,0,20191123,104,110,0,7,7,6,6,214,6,2019,0,5,2049,0
Chicago,34,22,13,47,0,0,0,0,Charlotte,23,26,25,41,0,0,0,0,20191123,116,115,11,7,-5,1,1,231,-1,2019,0,5,586,0
Toronto,26,26,35,32,0,0,0,0,Atlanta,27,34,29,26,0,0,0,0,20191123,119,116,-1,-9,-3,3,3,235,-3,2019,0,5,733,0
LA Lakers,25,30,30,24,0,0,0,0,Memphis,35,28,21,24,0,0,0,0,20191123,109,108,-10,-8,1,1,1,217,-1,2019,0,5,1599,0
Phoenix,28,29,20,27,0,0,0,0,Denver,28,24,27,37,0,0,0,0,20191124,104,116,0,-5,2,12,12,220,12,2019,0,6,585,0
Dallas,45,33,27,32,0,0,0,0,Houston,29,31,35,28,0,0,0,0,20191124,137,123,16,18,10,14,14,260,-14,2019,0,6,225,0
New Orleans,27,29,31,22,0,0,0,0,LA Clippers,40,32,28,34,0,0,0,0,20191124,109,134,13,16,13,25,25,243,25,2019,0,6,1669,0
Brooklyn,29,23,30,21,0,0,0,0,New York,22,24,26,29,0,0,0,0,20191124,103,101,7,6,10,2,2,204,-2,2019,0,6,0,0
Sacramento,24,33,33,23,0,0,0,0,Washington,27,30,28,21,0,0,0,0,20191124,113,106,-3,0,5,7,7,219,-7,2019,0,6,2371,0
Philadelphia,34,15,31,16,0,0,0,0,Toronto,28,23,30,20,0,0,0,0,20191125,96,101,-6,2,1,5,5,197,5,2019,0,0,334,0
LA Lakers,25,29,32,28,0,0,0,0,San Antonio,22,34,26,22,0,0,0,0,20191125,114,104,3,-2,4,10,10,218,-10,2019,0,0,1201,0
Utah,25,32,26,35,0,0,0,0,Milwaukee,23,25,42,32,0,0,0,0,20191125,118,122,-2,-9,7,4,4,240,4,2019,0,0,1239,0
Charlotte,31,27,24,18,0,0,0,0,Miami,36,33,29,19,0,0,0,0,20191125,100,117,5,11,16,17,17,217,17,2019,0,0,654,0
Memphis,27,29,27,31,0,0,0,0,Indiana,36,31,37,22,0,0,0,0,20191125,114,126,9,11,21,12,12,240,12,2019,0,0,383,0
Orlando,31,24,15,18,0,0,0,0,Detroit,23,30,25,25,0,0,0,0,20191125,88,103,-8,-2,8,15,15,191,15,2019,0,0,957,0
Brooklyn,25,27,29,27,0,0,0,0,Cleveland,26,25,24,31,0,0,0,0,20191125,108,106,-1,1,6,2,2,214,-2,2019,0,0,403,0
Portland,27,35,30,25,0,0,0,0,Chicago,28,26,18,22,0,0,0,0,20191125,117,94,-1,8,20,23,23,211,-23,2019,0,0,1754,0
Sacramento,22,24,29,27,0,0,0,0,Boston,19,34,22,28,0,0,0,0,20191125,102,103,-3,7,0,1,1,205,1,2019,0,0,2624,0
Minnesota,38,16,39,32,0,0,0,0,Atlanta,30,34,26,23,0,0,0,0,20191125,125,113,8,-10,3,12,12,238,-12,2019,0,0,908,0
Oklahoma City,25,28,21,26,0,0,0,0,Golden State,28,31,24,14,0,0,0,0,20191125,100,97,-3,-6,-9,3,3,197,-3,2019,0,0,1386,0
LA Clippers,34,28,31,21,0,0,0,0,Dallas,27,19,31,22,0,0,0,0,20191126,114,99,7,16,16,15,15,213,-15,2019,0,1,1237,0
Washington,23,24,22,35,0,0,0,0,Denver,25,39,22,31,0,0,0,0,20191126,104,117,2,17,17,13,13,221,13,2019,0,1,1489,0
LA Lakers,25,29,25,35,0,0,0,0,New Orleans,38,26,25,21,0,0,0,0,20191127,114,110,-13,-10,-10,4,4,224,-4,2019,0,2,1669,0
New York,29,17,23,29,0,0,0,0,Toronto,21,37,31,37,0,0,0,0,20191127,98,126,-8,12,20,28,28,224,28,2019,0,2,341,0
Minnesota,22,35,24,32,0,0,0,0,San Antonio,24,23,31,23,0,0,0,0,20191127,113,101,-2,10,3,12,12,214,-12,2019,0,2,1112,0
Oklahoma City,26,24,27,42,0,0,0,0,Portland,42,21,41,32,0,0,0,0,20191127,119,136,16,13,27,17,17,255,17,2019,0,2,1484,0
Washington,36,38,34,32,0,0,0,0,Phoenix,34,35,26,37,0,0,0,0,20191127,140,132,2,5,13,8,8,272,-8,2019,0,2,1977,0
Sacramento,18,28,19,26,0,0,0,0,Philadelphia,25,22,29,21,0,0,0,0,20191127,91,97,7,1,11,6,6,188,6,2019,0,2,2451,0
Atlanta,17,42,23,20,0,0,0,0,Milwaukee,33,27,21,30,0,0,0,0,20191127,102,111,16,1,-1,9,9,213,9,2019,0,2,669,0
Orlando,27,32,28,29,0,0,0,0,Cleveland,27,25,21,31,0,0,0,0,20191127,116,104,0,7,14,12,12,220,-12,2019,0,2,895,0
Utah,20,23,37,22,0,0,0,0,Indiana,21,32,36,32,0,0,0,0,20191127,102,121,1,10,9,19,19,223,19,2019,0,2,1353,0
Brooklyn,23,40,23,24,0,0,0,0,Boston,30,27,34,30,0,0,0,0,20191127,110,121,7,-6,5,11,11,231,11,2019,0,2,190,0
Detroit,32,28,20,21,0,0,0,0,Charlotte,31,24,31,16,0,0,0,0,20191127,101,102,-1,-5,6,1,1,203,1,2019,0,2,504,0
LA Clippers,35,29,28,29,0,0,0,0,Memphis,31,29,28,31,0,0,0,0,20191127,121,119,4,4,4,2,2,240,-2,2019,0,2,1599,0
Chicago,17,31,25,17,0,0,0,0,Golden State,25,28,25,26,0,0,0,0,20191127,90,104,8,5,5,14,14,194,14,2019,0,2,1853,0
Miami,23,19,26,40,0,0,0,0,Houston,27,39,25,26,0,0,0,0,20191127,108,117,4,24,23,9,9,225,9,2019,0,2,966,0
LA Clippers,30,23,18,26,0,0,0,0,San Antonio,27,26,29,25,0,0,0,0,20191129,97,107,-3,0,11,10,10,204,10,2019,0,4,1201,0
Chicago,28,19,31,25,0,0,0,0,Portland,25,28,28,26,0,0,0,0,20191129,103,107,-3,6,3,4,4,210,4,2019,0,4,1754,0
Dallas,31,22,36,31,0,0,0,0,Phoenix,25,25,39,24,0,0,0,0,20191129,120,113,6,3,0,7,7,233,-7,2019,0,4,884,0
New Orleans,26,27,31,20,0,0,0,0,Oklahoma City,34,28,17,30,0,0,0,0,20191129,104,109,8,9,-5,5,5,213,5,2019,0,4,576,0
Philadelphia,18,21,31,31,0,0,0,0,New York,31,20,17,27,0,0,0,0,20191129,101,95,-13,-12,2,6,6,196,-6,2019,0,4,80,0
Golden State,21,37,21,26,0,0,0,0,Miami,41,30,24,27,0,0,0,0,20191129,105,122,20,13,16,17,17,227,17,2019,0,4,2590,0
Toronto,20,20,26,24,0,0,0,0,Orlando,23,24,12,24,0,0,0,0,20191129,90,83,-3,-7,7,7,7,173,-7,2019,0,4,1048,0
Washington,23,26,30,24,0,0,0,0,LA Lakers,37,33,35,20,0,0,0,0,20191129,103,125,14,21,26,22,22,228,22,2019,0,4,2294,0
Atlanta,23,31,11,29,10,0,0,0,Indiana,22,21,29,22,11,0,0,0,20191129,104,105,-1,-11,7,0,1,209,1,2019,1,4,427,0
Charlotte,38,24,23,25,0,0,0,0,Detroit,37,20,28,22,0,0,0,0,20191129,110,107,1,5,0,3,3,217,-3,2019,0,4,504,0
Milwaukee,38,29,32,20,0,0,0,0,Cleveland,29,18,42,21,0,0,0,0,20191129,119,110,9,20,10,9,9,229,-9,2019,0,4,334,0
Boston,24,31,26,26,0,0,0,0,Brooklyn,31,27,29,25,0,0,0,0,20191129,107,112,7,3,6,5,5,219,5,2019,0,4,190,0
Utah,22,18,35,28,0,0,0,0,Memphis,24,31,18,21,0,0,0,0,20191129,103,94,-2,-15,2,9,9,197,-9,2019,0,4,1247,0
Atlanta,21,31,21,38,0,0,0,0,Houston,38,43,46,31,0,0,0,0,20191130,111,158,17,29,54,47,47,269,47,2019,0,5,700,0
Charlotte,25,24,26,21,0,0,0,0,Milwaukee,32,34,35,36,0,0,0,0,20191130,96,137,7,17,26,41,41,233,41,2019,0,5,658,0
Indiana,29,36,28,23,0,0,0,0,Philadelphia,38,27,28,26,0,0,0,0,20191130,116,119,9,0,0,3,3,235,3,2019,0,5,582,0
Denver,27,30,18,15,7,0,0,0,Sacramento,17,23,27,23,10,0,0,0,20191130,97,100,-10,-17,-8,0,3,197,3,2019,1,5,886,0
Boston,31,27,23,32,0,0,0,0,New York,30,28,27,19,0,0,0,0,20191201,113,104,1,0,-4,9,9,217,-9,2019,0,6,190,0
Utah,20,17,49,24,0,0,0,0,Toronto,37,40,30,23,0,0,0,0,20191201,110,130,17,40,21,20,20,240,20,2019,0,6,1664,0
Golden State,22,29,20,25,0,0,0,0,Orlando,26,25,21,28,0,0,0,0,20191201,96,100,4,0,1,4,4,196,4,2019,0,6,2437,0
Oklahoma City,33,23,26,25,0,0,0,0,New Orleans,29,26,22,27,0,0,0,0,20191201,107,104,4,1,5,3,3,211,-3,2019,0,6,576,0
Dallas,25,34,35,20,0,0,0,0,LA Lakers,30,32,17,21,0,0,0,0,20191201,114,100,-5,-3,15,14,14,214,-14,2019,0,6,1237,0
San Antonio,27,24,20,27,0,0,0,0,Detroit,32,27,37,36,0,0,0,0,20191201,98,132,5,8,25,34,34,230,34,2019,0,6,1238,0
Washington,35,22,41,27,0,0,0,0,LA Clippers,39,43,34,34,0,0,0,0,20191201,125,150,4,25,18,25,25,275,25,2019,0,6,2294,0
Miami,32,26,25,26,0,0,0,0,Brooklyn,30,35,16,25,0,0,0,0,20191201,109,106,2,-7,2,3,3,215,-3,2019,0,6,1091,0
Memphis,25,23,38,29,0,0,0,0,Minnesota,21,26,32,28,0,0,0,0,20191201,115,107,4,1,7,8,8,222,-8,2019,0,6,700,0
Golden State,23,17,13,26,0,0,0,0,Atlanta,20,29,27,28,0,0,0,0,20191202,79,104,-3,9,23,25,25,183,25,2019,0,0,2135,0
Phoenix,28,31,21,29,0,0,0,0,Charlotte,21,18,34,31,0,0,0,0,20191202,109,104,7,20,7,5,5,213,-5,2019,0,0,1778,0
Indiana,24,33,28,32,0,0,0,0,Memphis,19,28,26,31,0,0,0,0,20191202,117,104,5,10,12,13,13,221,-13,2019,0,0,383,0
New York,15,30,17,26,0,0,0,0,Milwaukee,33,39,28,32,0,0,0,0,20191202,88,132,18,27,38,44,44,220,44,2019,0,0,732,0
Utah,23,19,24,28,0,0,0,0,Philadelphia,31,29,25,18,0,0,0,0,20191202,94,103,8,18,19,9,9,197,9,2019,0,0,1920,0
Chicago,22,33,29,29,0,0,0,0,Sacramento,23,21,30,32,0,0,0,0,20191202,113,106,-1,11,10,7,7,219,-7,2019,0,0,1788,0
Orlando,32,36,29,30,0,0,0,0,Washington,26,28,34,32,0,0,0,0,20191203,127,120,6,14,9,7,7,247,-7,2019,0,1,757,0
Miami,32,26,25,25,13,0,0,0,Toronto,23,30,28,27,2,0,0,0,20191203,121,110,9,5,2,0,11,231,-11,2019,1,1,1234,0
Houston,25,38,34,18,11,7,0,0,San Antonio,27,32,22,34,11,9,0,0,20191203,133,135,2,-4,-16,0,2,268,2,2019,2,1,189,0
Detroit,32,30,35,30,0,0,0,0,Cleveland,28,18,22,26,0,0,0,0,20191203,127,94,4,16,29,33,33,221,-33,2019,0,1,90,0
Portland,30,29,17,21,0,0,0,0,LA Clippers,29,33,27,28,0,0,0,0,20191203,97,117,-1,3,13,20,20,214,20,2019,0,1,826,0
LA Lakers,28,32,24,21,0,0,0,0,Denver,24,25,27,20,0,0,0,0,20191203,105,96,4,11,8,9,9,201,-9,2019,0,1,830,0
Dallas,24,35,25,34,0,0,0,0,New Orleans,24,29,22,22,0,0,0,0,20191203,118,97,0,6,9,21,21,215,-21,2019,0,1,442,0
Milwaukee,22,37,33,35,0,0,0,0,Detroit,24,24,24,31,0,0,0,0,20191204,127,103,-2,11,20,24,24,230,-24,2019,0,2,251,0
Sacramento,35,29,31,21,0,0,0,0,Portland,30,36,34,27,0,0,0,0,20191204,116,127,-5,2,5,11,11,243,11,2019,0,2,483,0
Phoenix,37,21,28,28,0,0,0,0,Orlando,31,34,38,25,0,0,0,0,20191204,114,128,-6,7,17,14,14,242,14,2019,0,2,1842,0
Indiana,26,23,30,28,0,0,0,0,Oklahoma City,29,21,28,22,0,0,0,0,20191204,107,100,-3,-1,1,7,7,207,-7,2019,0,2,688,0
LA Lakers,34,31,29,27,0,0,0,0,Utah,26,21,28,21,0,0,0,0,20191204,121,96,8,18,19,25,25,217,-25,2019,0,2,579,0
Minnesota,25,31,28,30,0,0,0,0,Dallas,30,23,27,41,0,0,0,0,20191204,114,121,5,-3,-4,7,7,235,7,2019,0,2,863,0
Memphis,20,15,29,35,0,0,0,0,Chicago,27,23,28,28,0,0,0,0,20191204,99,106,7,15,14,7,7,205,7,2019,0,2,480,0
Miami,28,16,25,24,0,0,0,0,Boston,20,32,30,30,0,0,0,0,20191204,93,112,-8,8,13,19,19,205,19,2019,0,2,1257,0
Brooklyn,22,34,35,39,0,0,0,0,Atlanta,26,21,35,36,0,0,0,0,20191204,130,118,-4,9,9,12,12,248,-12,2019,0,2,745,0
Golden State,20,34,22,15,0,0,0,0,Charlotte,28,30,28,20,0,0,0,0,20191204,91,106,8,4,10,15,15,197,15,2019,0,2,2296,0
Phoenix,38,36,33,18,14,0,0,0,New Orleans,40,30,21,34,7,0,0,0,20191205,139,132,-2,4,16,0,7,271,-7,2019,1,3,1312,0
Denver,33,34,31,31,0,0,0,0,New York,27,18,30,17,0,0,0,0,20191205,129,92,6,22,23,37,37,221,-37,2019,0,3,1627,0
Houston,34,29,31,25,0,0,0,0,Toronto,28,27,33,21,0,0,0,0,20191205,119,109,6,8,6,10,10,228,-10,2019,0,3,1299,0
Philadelphia,33,22,26,32,0,0,0,0,Washington,25,40,26,28,0,0,0,0,20191205,113,119,-8,10,10,6,6,232,6,2019,0,3,123,0
Sacramento,17,25,30,28,4,0,0,0,San Antonio,21,31,17,31,5,0,0,0,20191206,104,105,4,10,-3,0,1,209,1,2019,1,4,1456,0
LA Lakers,39,38,33,26,0,0,0,0,Portland,34,28,31,20,0,0,0,0,20191206,136,113,5,15,17,23,23,249,-23,2019,0,4,826,0
Minnesota,27,31,39,25,5,0,0,0,Oklahoma City,30,23,41,28,17,0,0,0,20191206,127,139,3,-5,-3,0,12,266,12,2019,1,4,694,0
LA Clippers,15,28,19,29,0,0,0,0,Milwaukee,30,22,35,32,0,0,0,0,20191206,91,119,15,9,25,28,28,210,28,2019,0,4,1741,0
Washington,28,37,20,18,0,0,0,0,Miami,27,34,25,26,0,0,0,0,20191206,103,112,-1,-4,1,9,9,215,9,2019,0,4,924,0
Orlando,24,28,16,25,0,0,0,0,Cleveland,25,22,23,17,0,0,0,0,20191206,93,87,-1,5,-2,6,6,180,-6,2019,0,4,895,0
Brooklyn,29,26,31,25,0,0,0,0,Charlotte,32,25,27,20,0,0,0,0,20191206,111,104,-3,-2,2,7,7,215,-7,2019,0,4,531,0
Golden State,23,27,27,23,0,0,0,0,Chicago,28,23,32,15,0,0,0,0,20191206,100,98,-5,-1,-6,2,2,198,-2,2019,0,4,1853,0
Denver,26,19,19,31,0,0,0,0,Boston,33,20,32,23,0,0,0,0,20191206,95,108,7,8,21,13,13,203,13,2019,0,4,1765,0
Indiana,19,25,31,26,0,0,0,0,Detroit,32,23,16,37,0,0,0,0,20191206,101,108,13,11,-4,7,7,209,7,2019,0,4,240,0
New Orleans,28,24,14,18,0,0,0,0,Dallas,31,33,40,26,0,0,0,0,20191207,84,130,3,12,38,46,46,214,46,2019,0,5,442,0
Phoenix,31,21,26,31,0,0,0,0,Houston,23,37,23,32,0,0,0,0,20191207,109,115,-8,8,5,6,6,224,6,2019,0,5,1014,0
Indiana,32,34,23,15,0,0,0,0,New York,27,33,21,22,0,0,0,0,20191207,104,103,5,6,8,1,1,207,-1,2019,0,5,643,0
Cleveland,18,18,26,32,0,0,0,0,Philadelphia,36,41,31,33,0,0,0,0,20191207,94,141,18,41,46,47,47,235,47,2019,0,5,358,0
Memphis,36,18,30,28,0,0,0,0,Utah,32,37,28,29,0,0,0,0,20191207,112,126,-4,15,13,14,14,238,14,2019,0,5,1247,0
Toronto,22,20,26,36,0,0,0,0,Philadelphia,27,30,29,24,0,0,0,0,20191208,104,110,5,15,18,6,6,214,6,2019,0,6,334,0
Oklahoma City,21,34,27,26,0,0,0,0,Portland,20,27,31,18,0,0,0,0,20191208,108,96,1,8,4,12,12,204,-12,2019,0,6,1484,0
LA Clippers,35,30,35,35,0,0,0,0,Washington,25,39,29,26,0,0,0,0,20191208,135,119,10,1,7,16,16,254,-16,2019,0,6,2294,0
Chicago,25,24,24,24,8,0,0,0,Miami,16,31,27,23,13,0,0,0,20191208,105,110,-9,-2,1,0,5,215,5,2019,1,6,1189,0
Atlanta,24,27,37,34,0,0,0,0,Charlotte,27,26,30,24,0,0,0,0,20191208,122,107,-3,-2,5,15,15,229,-15,2019,0,6,226,0
Sacramento,36,30,26,18,0,0,0,0,Dallas,27,19,32,28,0,0,0,0,20191208,110,106,9,20,14,4,4,216,-4,2019,0,6,1437,0
Denver,21,33,23,25,0,0,0,0,Brooklyn,25,28,29,23,0,0,0,0,20191208,102,105,4,-1,5,3,3,207,3,2019,0,6,1627,0
Minnesota,31,34,38,22,0,0,0,0,LA Lakers,39,34,37,32,0,0,0,0,20191208,125,142,8,8,7,17,17,267,17,2019,0,6,1521,0
Oklahoma City,25,26,34,19,0,0,0,0,Utah,24,23,21,22,0,0,0,0,20191209,104,90,1,4,17,14,14,194,-14,2019,0,0,861,0
Detroit,25,22,34,24,0,0,0,0,New Orleans,29,24,21,29,0,0,0,0,20191209,105,103,-4,-6,7,2,2,208,-2,2019,0,0,939,0
Orlando,20,20,33,28,0,0,0,0,Milwaukee,31,21,28,30,0,0,0,0,20191209,101,110,11,12,7,9,9,211,9,2019,0,0,1065,0
LA Clippers,24,36,31,19,0,0,0,0,Indiana,19,29,25,26,0,0,0,0,20191209,110,99,5,12,18,11,11,209,-11,2019,0,0,1805,0
Minnesota,31,33,21,24,0,0,0,0,Phoenix,33,28,33,31,0,0,0,0,20191209,109,125,2,-3,9,16,16,234,16,2019,0,0,1278,0
Memphis,29,25,34,22,0,0,0,0,Golden State,20,27,32,23,0,0,0,0,20191209,110,102,9,7,9,8,8,212,-8,2019,0,0,1798,0
Toronto,30,19,22,22,0,0,0,0,Chicago,30,21,20,21,0,0,0,0,20191209,93,92,0,-2,0,1,1,185,-1,2019,0,0,436,0
Cleveland,18,22,26,22,0,0,0,0,Boston,29,24,30,27,0,0,0,0,20191209,88,110,11,13,17,22,22,198,22,2019,0,0,549,0
Sacramento,32,27,35,25,0,0,0,0,Houston,28,36,29,25,0,0,0,0,20191209,119,118,4,-5,1,1,1,237,-1,2019,0,0,1606,0
Washington,20,28,27,32,0,0,0,0,Charlotte,28,25,29,32,0,0,0,0,20191210,107,114,8,5,7,7,7,221,7,2019,0,1,329,0
Atlanta,30,34,32,21,4,0,0,0,Miami,36,30,27,24,18,0,0,0,20191210,121,135,6,2,-3,0,14,256,14,2019,1,1,605,0
Denver,27,23,26,16,0,0,0,0,Philadelphia,26,29,28,14,0,0,0,0,20191210,92,97,-1,5,7,5,5,189,5,2019,0,1,1574,0
New York,22,19,18,28,0,0,0,0,Portland,32,28,26,29,0,0,0,0,20191210,87,115,10,19,27,28,28,202,28,2019,0,1,2439,0
Utah,25,34,38,30,0,0,0,0,Minnesota,23,36,24,33,0,0,0,0,20191211,127,116,2,0,14,11,11,243,-11,2019,0,2,984,0
LA Clippers,27,37,24,24,0,0,0,0,Toronto,32,14,25,21,0,0,0,0,20191211,112,92,-5,18,17,20,20,204,-20,2019,0,2,2170,0
Memphis,27,24,33,31,0,0,0,0,Phoenix,19,32,28,29,0,0,0,0,20191211,115,108,8,0,5,7,7,223,-7,2019,0,2,1260,0
LA Lakers,26,25,18,27,0,0,0,0,Orlando,9,29,27,22,0,0,0,0,20191211,96,87,17,13,4,9,9,183,-9,2019,0,2,2197,0
New Orleans,20,26,40,26,0,0,0,0,Milwaukee,35,34,36,22,0,0,0,0,20191211,112,127,15,23,19,15,15,239,15,2019,0,2,911,0
Oklahoma City,18,29,24,22,0,0,0,0,Sacramento,23,15,31,25,0,0,0,0,20191211,93,94,5,-9,-2,1,1,187,1,2019,0,2,1336,0
New York,30,38,19,25,12,0,0,0,Golden State,20,30,30,32,10,0,0,0,20191211,124,122,10,18,7,0,2,246,-2,2019,1,2,2565,0
Houston,35,29,24,28,0,0,0,0,Cleveland,29,28,25,28,0,0,0,0,20191211,116,110,6,7,6,6,6,226,-6,2019,0,2,1113,0
Atlanta,33,19,35,15,0,0,0,0,Chicago,37,29,40,30,0,0,0,0,20191211,102,136,4,14,19,34,34,238,34,2019,0,2,587,0
Charlotte,26,27,31,29,0,0,0,0,Brooklyn,34,30,22,22,0,0,0,0,20191211,113,108,-8,-11,-2,5,5,221,-5,2019,0,2,531,0
Boston,32,25,37,23,0,0,0,0,Indiana,30,31,23,38,0,0,0,0,20191211,117,122,-2,4,-10,5,5,239,5,2019,0,2,805,0
Philadelphia,28,28,25,34,0,0,0,0,Boston,34,25,21,29,0,0,0,0,20191212,115,109,-6,-3,1,6,6,224,-6,2019,0,3,270,0
Portland,26,27,25,21,0,0,0,0,Denver,33,29,27,25,0,0,0,0,20191212,99,114,7,9,11,15,15,213,15,2019,0,3,981,0
Dallas,34,31,30,27,0,0,0,0,Detroit,29,29,27,26,0,0,0,0,20191212,122,111,5,7,10,11,11,233,-11,2019,0,3,999,0
Cleveland,28,25,25,25,14,0,0,0,San Antonio,19,24,25,35,6,0,0,0,20191212,117,109,9,10,10,0,8,226,-8,2019,1,3,1256,0
Golden State,29,27,28,22,0,0,0,0,Utah,22,27,37,28,0,0,0,0,20191213,106,114,-7,-7,2,8,8,220,8,2019,0,4,599,0
New York,20,25,27,31,0,0,0,0,Sacramento,32,22,26,21,0,0,0,0,20191213,103,101,-12,-9,-8,2,2,204,-2,2019,0,4,2499,0
New Orleans,25,32,25,27,0,0,0,0,Philadelphia,39,23,30,24,0,0,0,0,20191213,109,116,14,5,10,7,7,225,7,2019,0,4,1088,0
Houston,28,34,34,34,0,0,0,0,Orlando,22,33,23,29,0,0,0,0,20191213,130,107,6,7,18,23,23,237,-23,2019,0,4,847,0
Charlotte,24,20,15,24,0,0,0,0,Chicago,15,25,10,23,0,0,0,0,20191213,83,73,9,4,9,10,10,156,-10,2019,0,4,586,0
LA Lakers,30,21,37,25,0,0,0,0,Miami,29,30,26,25,0,0,0,0,20191213,113,110,1,-8,3,3,3,223,-3,2019,0,4,2335,0
Milwaukee,35,29,26,37,0,0,0,0,Memphis,29,33,33,19,0,0,0,0,20191213,127,114,6,2,-5,13,13,241,-13,2019,0,4,557,0
Indiana,29,34,23,24,0,0,0,0,Atlanta,22,26,35,17,0,0,0,0,20191213,110,100,7,15,3,10,10,210,-10,2019,0,4,427,0
LA Clippers,33,32,37,22,0,0,0,0,Minnesota,29,29,23,36,0,0,0,0,20191213,124,117,4,7,21,7,7,241,-7,2019,0,4,1521,0
Cleveland,20,31,28,29,0,0,0,0,Milwaukee,26,43,33,23,0,0,0,0,20191214,108,125,6,18,23,17,17,233,17,2019,0,5,334,0
Brooklyn,31,29,23,19,0,0,0,0,Toronto,38,27,25,20,0,0,0,0,20191214,102,110,7,5,7,8,8,212,8,2019,0,5,341,0
Washington,30,24,30,27,0,0,0,0,Memphis,35,34,35,24,0,0,0,0,20191214,111,128,5,15,20,17,17,239,17,2019,0,5,762,0
San Antonio,28,16,34,31,12,0,0,0,Phoenix,18,30,32,29,10,0,0,0,20191214,121,119,10,-4,-2,0,2,240,-2,2019,1,5,846,0
Oklahoma City,20,29,19,34,0,0,0,0,Denver,27,25,30,28,0,0,0,0,20191214,102,110,7,3,14,8,8,212,8,2019,0,5,503,0
Miami,37,36,18,21,10,0,0,0,Dallas,23,27,31,31,6,0,0,0,20191214,122,118,14,23,10,0,4,240,-4,2019,1,5,1110,0
LA Clippers,29,28,22,27,0,0,0,0,Chicago,24,31,29,25,0,0,0,0,20191214,106,109,-5,-2,5,3,3,215,3,2019,0,5,1741,0
Detroit,30,32,26,27,0,0,0,0,Houston,32,20,23,32,0,0,0,0,20191214,115,107,-2,10,13,8,8,222,-8,2019,0,5,1105,0
LA Lakers,24,31,27,19,0,0,0,0,Atlanta,25,23,30,18,0,0,0,0,20191215,101,96,-1,7,4,5,5,197,-5,2019,0,6,1932,0
Philadelphia,23,20,23,23,0,0,0,0,Brooklyn,28,29,26,26,0,0,0,0,20191215,89,109,5,14,17,20,20,198,20,2019,0,6,80,0
New York,22,29,33,21,0,0,0,0,Denver,33,34,20,24,0,0,0,0,20191215,105,111,11,16,3,6,6,216,6,2019,0,6,1627,0
Sacramento,26,25,28,21,0,0,0,0,Golden State,18,24,17,20,0,0,0,0,20191215,100,79,8,9,20,21,21,179,-21,2019,0,6,75,0
Charlotte,20,24,22,19,0,0,0,0,Indiana,33,26,13,35,0,0,0,0,20191215,85,107,13,15,6,22,22,192,22,2019,0,6,428,0
Orlando,24,34,41,31,0,0,0,0,New Orleans,30,27,27,35,0,0,0,0,20191215,130,119,-6,1,15,11,11,249,-11,2019,0,6,533,0
Cleveland,29,25,30,29,0,0,0,0,Toronto,37,29,38,29,0,0,0,0,20191216,113,133,8,12,20,20,20,246,20,2019,0,0,187,0
Portland,25,34,31,21,0,0,0,0,Phoenix,33,34,21,22,0,0,0,0,20191216,111,110,-8,-8,2,1,1,221,-1,2019,0,0,1005,0
Chicago,37,31,22,16,0,0,0,0,Oklahoma City,16,33,33,27,0,0,0,0,20191216,106,109,-21,-19,-8,3,3,215,3,2019,0,0,690,0
Dallas,36,23,27,34,0,0,0,0,Milwaukee,22,34,20,40,0,0,0,0,20191216,120,116,14,3,10,4,4,236,-4,2019,0,0,857,0
San Antonio,35,37,17,18,0,0,0,0,Houston,21,32,30,26,0,0,0,0,20191216,107,109,-14,-19,-6,2,2,216,2,2019,0,0,189,0
Washington,43,24,29,37,0,0,0,0,Detroit,31,30,30,28,0,0,0,0,20191216,133,119,12,6,5,14,14,252,-14,2019,0,0,394,0
Miami,32,26,28,25,0,0,0,0,Memphis,36,37,22,23,0,0,0,0,20191216,111,118,4,15,9,7,7,229,7,2019,0,0,873,0
Sacramento,21,26,32,23,0,0,0,0,Charlotte,26,27,27,30,0,0,0,0,20191217,102,110,5,6,1,8,8,212,8,2019,0,1,2239,0
LA Lakers,28,24,24,26,0,0,0,0,Indiana,24,26,28,27,0,0,0,0,20191217,102,105,-4,-2,2,3,3,207,3,2019,0,1,1805,0
Phoenix,23,21,25,30,0,0,0,0,LA Clippers,31,23,36,30,0,0,0,0,20191217,99,120,8,10,21,21,21,219,21,2019,0,1,356,0
Brooklyn,21,21,19,32,15,0,0,0,New Orleans,21,14,29,29,8,0,0,0,20191217,108,101,0,7,-3,0,7,209,-7,2019,1,1,1168,0
Atlanta,27,26,31,36,0,0,0,0,New York,41,36,32,34,0,0,0,0,20191217,120,143,14,24,25,23,23,263,23,2019,0,1,745,0
Orlando,20,27,24,31,0,0,0,0,Utah,26,32,24,27,0,0,0,0,20191217,102,109,6,11,11,7,7,211,7,2019,0,1,1915,0
Memphis,32,36,32,22,0,0,0,0,Oklahoma City,27,32,34,33,0,0,0,0,20191218,122,126,-5,-9,-7,4,4,248,4,2019,0,2,421,0
Chicago,23,29,21,25,12,0,0,0,Washington,27,31,27,13,11,0,0,0,20191218,110,109,-4,-6,-12,0,1,219,-1,2019,1,2,594,0
Miami,19,37,26,26,0,0,0,0,Philadelphia,29,19,26,30,0,0,0,0,20191218,108,104,-10,8,8,4,4,212,-4,2019,0,2,1021,0
New Orleans,32,31,24,20,0,0,0,0,Minnesota,25,25,22,27,0,0,0,0,20191218,107,99,7,13,15,8,8,206,-8,2019,0,2,1052,0
Golden State,29,37,26,20,0,0,0,0,Portland,40,27,30,25,0,0,0,0,20191218,112,122,11,1,5,10,10,234,10,2019,0,2,535,0
Orlando,32,28,16,28,0,0,0,0,Denver,27,18,39,29,0,0,0,0,20191218,104,113,-5,-15,8,9,9,217,9,2019,0,2,1548,0
Boston,29,21,26,33,0,0,0,0,Dallas,29,26,18,30,0,0,0,0,20191218,109,103,0,-5,3,6,6,212,-6,2019,0,2,1548,0
Charlotte,21,20,23,34,0,0,0,0,Cleveland,29,24,23,24,0,0,0,0,20191218,98,100,8,12,12,2,2,198,2,2019,0,2,435,0
Toronto,30,40,26,16,0,0,0,0,Detroit,29,35,15,20,0,0,0,0,20191218,112,99,1,6,17,13,13,211,-13,2019,0,2,205,0
Utah,28,24,31,28,0,0,0,0,Atlanta,30,26,28,22,0,0,0,0,20191219,111,106,-2,-4,-1,5,5,217,-5,2019,0,3,1580,0
Houston,27,27,36,32,0,0,0,0,LA Clippers,28,41,18,30,0,0,0,0,20191219,122,117,-1,-15,3,5,5,239,-5,2019,0,3,1371,0
LA Lakers,17,29,35,23,0,0,0,0,Milwaukee,23,42,24,22,0,0,0,0,20191219,104,111,6,19,8,7,7,215,7,2019,0,3,1741,0
Brooklyn,33,23,25,24,0,0,0,0,San Antonio,27,23,33,35,0,0,0,0,20191219,105,118,-6,-6,2,13,13,223,13,2019,0,3,1581,0
Washington,23,29,33,33,0,0,0,0,Toronto,40,28,28,26,0,0,0,0,20191220,118,122,17,16,11,4,4,240,4,2019,0,4,349,0
Orlando,13,31,31,28,0,0,0,0,Portland,31,26,36,25,0,0,0,0,20191220,103,118,18,13,18,15,15,221,15,2019,0,4,2525,0
Dallas,35,28,25,29,0,0,0,0,Philadelphia,28,29,20,21,0,0,0,0,20191220,117,98,7,6,11,19,19,215,-19,2019,0,4,1297,0
New York,20,27,27,40,0,0,0,0,Miami,39,31,28,31,0,0,0,0,20191220,114,129,19,23,24,15,15,243,15,2019,0,4,1091,0
Phoenix,23,27,41,17,0,0,0,0,Oklahoma City,26,31,44,25,0,0,0,0,20191220,108,126,3,7,10,18,18,234,18,2019,0,4,840,0
New Orleans,16,28,37,21,0,0,0,0,Golden State,31,25,22,28,0,0,0,0,20191220,102,106,15,12,-3,4,4,208,4,2019,0,4,1921,0
Minnesota,20,31,24,25,0,0,0,0,Denver,33,28,21,27,0,0,0,0,20191220,100,109,13,10,7,9,9,209,9,2019,0,4,698,0
Memphis,27,24,36,20,0,0,0,0,Cleveland,25,30,26,33,0,0,0,0,20191220,107,114,-2,4,-6,7,7,221,7,2019,0,4,629,0
Detroit,26,22,21,24,0,0,0,0,Boston,28,32,31,23,0,0,0,0,20191220,93,114,2,12,22,21,21,207,21,2019,0,4,611,0
Sacramento,32,25,22,26,0,0,0,0,Indiana,30,38,24,27,0,0,0,0,20191220,105,119,-2,11,13,14,14,224,14,2019,0,4,1882,0
Atlanta,34,39,25,14,0,0,0,0,Brooklyn,34,26,25,37,0,0,0,0,20191221,112,122,0,-13,-13,10,10,234,10,2019,0,5,745,0
Utah,31,25,28,30,0,0,0,0,Charlotte,33,31,22,21,0,0,0,0,20191221,114,107,-2,-8,-2,7,7,221,-7,2019,0,5,1723,0
Chicago,25,28,40,26,0,0,0,0,Detroit,28,31,30,18,0,0,0,0,20191221,119,107,-3,-6,4,12,12,226,-12,2019,0,5,238,0
Sacramento,21,29,28,37,0,0,0,0,Memphis,23,37,31,28,0,0,0,0,20191221,115,119,2,10,13,4,4,234,4,2019,0,5,1745,0
Milwaukee,37,31,27,28,0,0,0,0,New York,23,31,16,32,0,0,0,0,20191221,123,102,14,14,25,21,21,225,-21,2019,0,5,732,0
Washington,25,28,27,28,0,0,0,0,Philadelphia,32,33,23,37,0,0,0,0,20191221,108,125,7,12,8,17,17,233,17,2019,0,5,123,0
Houston,36,34,36,33,0,0,0,0,Phoenix,35,30,30,30,0,0,0,0,20191221,139,125,1,5,11,14,14,264,-14,2019,0,5,1014,0
Minnesota,23,29,28,26,0,0,0,0,Portland,27,34,22,30,0,0,0,0,20191221,106,113,4,9,3,7,7,219,7,2019,0,5,1423,0
LA Clippers,33,39,38,24,0,0,0,0,San Antonio,31,30,22,26,0,0,0,0,20191221,134,109,2,11,27,25,25,243,-25,2019,0,5,1201,0
Dallas,17,34,35,21,0,0,0,0,Toronto,20,22,21,47,0,0,0,0,20191222,107,110,3,-9,-23,3,3,217,3,2019,0,6,1201,0
LA Clippers,33,30,26,23,0,0,0,0,Oklahoma City,27,30,29,32,0,0,0,0,20191222,112,118,-6,-6,-3,6,6,230,6,2019,0,6,1178,0
Charlotte,37,19,21,16,0,0,0,0,Boston,30,29,25,35,0,0,0,0,20191222,93,119,-7,3,7,26,26,212,26,2019,0,6,720,0
Denver,23,32,36,37,0,0,0,0,LA Lakers,28,25,25,26,0,0,0,0,20191222,128,104,-5,2,13,24,24,232,-24,2019,0,6,830,0
Indiana,22,33,18,16,0,0,0,0,Milwaukee,21,38,24,34,0,0,0,0,20191222,89,117,-1,4,10,28,28,206,28,2019,0,6,243,0
New Orleans,31,23,28,20,0,0,0,0,Portland,31,25,21,17,0,0,0,0,20191223,102,94,0,-2,5,8,8,196,-8,2019,0,0,2059,0
Denver,34,22,26,31,0,0,0,0,Phoenix,22,27,32,30,0,0,0,0,20191223,113,111,12,7,1,2,2,224,-2,2019,0,0,585,0
Chicago,28,26,27,14,0,0,0,0,Orlando,28,23,32,20,0,0,0,0,20191223,95,103,0,-3,2,8,8,198,8,2019,0,0,984,0
Washington,32,31,31,27,0,0,0,0,New York,37,27,27,24,0,0,0,0,20191223,121,115,-5,-1,3,6,6,236,-6,2019,0,0,204,0
Utah,28,24,29,23,0,0,0,0,Miami,32,21,23,31,0,0,0,0,20191223,104,107,4,1,-5,3,3,211,3,2019,0,0,2086,0
Houston,37,28,32,16,0,0,0,0,Sacramento,21,36,22,25,0,0,0,0,20191223,113,104,16,8,18,9,9,217,-9,2019,0,0,1606,0
Toronto,19,25,35,28,8,0,0,0,Indiana,30,24,24,29,13,0,0,0,20191223,115,120,11,10,-1,0,5,235,5,2019,1,0,438,0
Minnesota,22,21,24,37,0,0,0,0,Golden State,22,35,27,29,0,0,0,0,20191223,104,113,0,14,17,9,9,217,9,2019,0,0,1581,0
Philadelphia,30,30,34,31,0,0,0,0,Detroit,23,29,34,23,0,0,0,0,20191223,125,109,7,8,8,16,16,234,-16,2019,0,0,441,0
Atlanta,32,32,30,24,0,0,0,0,Cleveland,42,29,23,27,0,0,0,0,20191223,118,121,10,7,0,3,3,239,3,2019,0,0,555,0
San Antonio,46,26,36,37,0,0,0,0,Memphis,31,30,28,26,0,0,0,0,20191223,145,115,15,11,19,30,30,260,-30,2019,0,0,631,0
Boston,28,27,33,30,0,0,0,0,Toronto,19,28,22,33,0,0,0,0,20191225,118,102,9,8,19,16,16,220,-16,2019,0,2,430,0
LA Clippers,31,20,35,25,0,0,0,0,LA Lakers,33,30,23,20,0,0,0,0,20191225,111,106,-2,-12,0,5,5,217,-5,2019,0,2,0,0
Milwaukee,30,18,25,36,0,0,0,0,Philadelphia,38,31,31,21,0,0,0,0,20191225,109,121,8,21,27,12,12,230,12,2019,0,2,692,0
New Orleans,29,29,26,28,0,0,0,0,Denver,26,29,25,20,0,0,0,0,20191225,112,100,3,3,4,12,12,212,-12,2019,0,2,1079,0
Houston,29,39,19,17,0,0,0,0,Golden State,28,36,28,24,0,0,0,0,20191225,104,116,-1,-4,5,12,12,220,12,2019,0,2,1642,0
New York,24,22,33,15,0,0,0,0,Brooklyn,15,26,20,21,0,0,0,0,20191226,94,82,9,5,18,12,12,176,-12,2019,0,3,0,0
San Antonio,24,23,27,24,0,0,0,0,Dallas,20,32,27,23,0,0,0,0,20191226,98,102,-4,5,5,4,4,200,4,2019,0,3,252,0
Washington,23,25,28,26,0,0,0,0,Detroit,31,37,38,26,0,0,0,0,20191226,102,132,8,20,30,30,30,234,30,2019,0,3,394,0
Memphis,23,26,37,24,0,0,0,0,Oklahoma City,18,29,27,23,0,0,0,0,20191226,110,97,5,2,12,13,13,207,-13,2019,0,3,421,0
Minnesota,21,29,21,19,7,8,0,0,Sacramento,26,22,31,11,7,7,0,0,20191226,105,104,-5,2,-8,0,1,209,-1,2019,2,3,1511,0
Portland,22,30,24,39,0,0,0,0,Utah,37,25,34,25,0,0,0,0,20191226,115,121,15,10,20,6,6,236,6,2019,0,3,634,0
Philadelphia,21,26,21,29,0,0,0,0,Orlando,19,27,25,27,0,0,0,0,20191227,97,98,-2,-1,3,1,1,195,1,2019,0,4,864,0
Phoenix,29,22,27,18,0,0,0,0,Golden State,25,18,23,39,0,0,0,0,20191227,96,105,-4,-8,-12,9,9,201,9,2019,0,4,652,0
Indiana,27,28,27,30,0,0,0,0,Miami,25,33,26,29,0,0,0,0,20191227,112,113,-2,3,2,1,1,225,1,2019,0,4,1026,0
Cleveland,22,25,34,36,0,0,0,0,Boston,33,29,30,37,0,0,0,0,20191227,117,129,11,15,11,12,12,246,12,2019,0,4,549,0
Milwaukee,32,31,21,28,0,0,0,0,Atlanta,19,21,23,23,0,0,0,0,20191227,112,86,13,23,21,26,26,198,-26,2019,0,4,669,0
Oklahoma City,26,27,19,22,10,0,0,0,Charlotte,18,25,22,29,8,0,0,0,20191227,104,102,8,10,7,0,2,206,-2,2019,1,4,938,0
New York,33,26,27,21,0,0,0,0,Washington,23,35,20,22,0,0,0,0,20191228,107,100,10,1,8,7,7,207,-7,2019,0,5,204,0
Phoenix,31,28,22,31,0,0,0,0,Sacramento,30,19,28,33,0,0,0,0,20191228,112,110,1,10,4,2,2,222,-2,2019,0,5,634,0
LA Lakers,34,37,32,25,0,0,0,0,Portland,32,32,31,25,0,0,0,0,20191228,128,120,2,7,8,8,8,248,-8,2019,0,5,826,0
Indiana,32,13,23,30,0,0,0,0,New Orleans,19,29,38,34,0,0,0,0,20191228,98,120,-13,3,18,22,22,218,22,2019,0,5,713,0
Cleveland,27,22,18,27,0,0,0,0,Minnesota,21,22,17,28,0,0,0,0,20191228,94,88,6,6,7,6,6,182,-6,2019,0,5,629,0
Orlando,25,21,28,26,0,0,0,0,Milwaukee,37,19,22,33,0,0,0,0,20191228,100,111,12,10,4,11,11,211,11,2019,0,5,1065,0
Detroit,28,27,25,29,0,0,0,0,San Antonio,30,29,42,35,0,0,0,0,20191228,109,136,2,4,21,27,27,245,27,2019,0,5,1238,0
Utah,22,39,32,27,0,0,0,0,LA Clippers,32,31,29,15,0,0,0,0,20191228,120,107,-10,-2,1,13,13,227,-13,2019,0,5,579,0
Brooklyn,20,34,25,19,0,0,0,0,Houston,42,21,25,20,0,0,0,0,20191228,98,108,22,9,9,10,10,206,10,2019,0,5,1417,0
Dallas,41,31,45,24,0,0,0,0,Golden State,41,33,24,23,0,0,0,0,20191228,141,121,0,-2,19,20,20,262,-20,2019,0,5,1480,0
Memphis,11,28,29,42,0,0,0,0,Denver,26,24,32,37,0,0,0,0,20191228,110,119,15,11,14,9,9,229,9,2019,0,5,877,0
Atlanta,19,24,22,16,0,0,0,0,Chicago,35,29,19,33,0,0,0,0,20191228,81,116,16,21,18,35,35,197,35,2019,0,5,587,0
Toronto,36,23,30,24,0,0,0,0,Boston,25,29,25,18,0,0,0,0,20191228,113,97,11,5,10,16,16,210,-16,2019,0,5,430,0
Philadelphia,33,26,20,29,8,0,0,0,Miami,28,26,31,23,9,0,0,0,20191228,116,117,-5,-5,6,0,1,233,1,2019,1,5,1021,0
Oklahoma City,22,25,29,22,0,0,0,0,Toronto,20,27,33,17,0,0,0,0,20191229,98,97,2,0,-4,1,1,195,-1,2019,0,6,1114,0
Charlotte,20,26,29,29,0,0,0,0,Memphis,31,25,30,31,0,0,0,0,20191229,104,117,11,10,11,13,13,221,13,2019,0,6,519,0
Houston,37,27,29,19,0,0,0,0,New Orleans,36,28,22,41,0,0,0,0,20191229,112,127,-1,0,-7,15,15,239,15,2019,0,6,317,0
Sacramento,32,25,24,34,0,0,0,0,Denver,31,31,26,32,0,0,0,0,20191229,115,120,-1,5,7,5,5,235,5,2019,0,6,886,0
Dallas,19,24,26,26,0,0,0,0,LA Lakers,25,29,30,24,0,0,0,0,20191229,95,108,6,11,15,13,13,203,13,2019,0,6,1237,0
Milwaukee,31,24,40,28,0,0,0,0,Chicago,20,32,25,25,0,0,0,0,20191230,123,102,11,3,18,21,21,225,-21,2019,0,0,83,0
Brooklyn,29,21,30,23,12,0,0,0,Minnesota,27,22,25,29,19,0,0,0,20191230,115,122,-2,-1,-6,0,7,237,7,2019,1,0,1016,0
Atlanta,25,22,27,27,0,0,0,0,Orlando,21,36,15,21,0,0,0,0,20191230,101,93,4,-10,2,8,8,194,-8,2019,0,0,401,0
Phoenix,19,36,28,39,0,0,0,0,Portland,38,26,25,27,0,0,0,0,20191230,122,116,-19,-9,-6,6,6,238,-6,2019,0,0,1005,0
Detroit,21,19,18,23,0,0,0,0,Utah,19,20,29,36,0,0,0,0,20191230,81,104,-2,-1,10,23,23,185,23,2019,0,0,1488,0
Miami,39,24,18,24,0,0,0,0,Washington,29,42,19,33,0,0,0,0,20191230,105,123,-10,8,9,18,18,228,18,2019,0,0,924,0
Golden State,32,23,20,25,13,0,0,0,San Antonio,25,28,24,23,17,0,0,0,20191231,113,117,-7,-2,2,0,4,230,4,2019,1,1,1487,0
Cleveland,25,18,26,28,0,0,0,0,Toronto,27,32,27,31,0,0,0,0,20191231,97,117,2,16,17,20,20,214,20,2019,0,1,187,0
LA Clippers,28,29,31,17,0,0,0,0,Sacramento,23,17,33,14,0,0,0,0,20191231,105,87,5,17,15,18,18,192,-18,2019,0,1,361,0
Denver,26,26,37,15,0,0,0,0,Houston,38,31,23,38,0,0,0,0,20191231,104,130,12,17,3,26,26,234,26,2019,0,1,878,0
Philadelphia,27,16,23,31,0,0,0,0,Indiana,29,38,29,19,0,0,0,0,20191231,97,115,2,24,30,18,18,212,18,2019,0,1,582,0
Boston,24,26,30,29,0,0,0,0,Charlotte,18,25,30,19,0,0,0,0,20191231,109,92,6,7,7,17,17,201,-17,2019,0,1,720,0
Dallas,32,19,27,23,0,0,0,0,Oklahoma City,20,30,27,29,0,0,0,0,20191231,101,106,-12,-1,-1,5,5,207,5,2019,0,1,189,0
Phoenix,17,24,38,28,0,0,0,0,LA Lakers,43,31,27,16,0,0,0,0,20200101,107,117,26,33,22,10,10,224,10,2019,0,2,356,0
Minnesota,23,28,20,33,0,0,0,0,Milwaukee,19,33,25,29,0,0,0,0,20200101,104,106,-4,1,6,2,2,210,2,2019,0,2,298,0
Portland,27,21,29,16,0,0,0,0,New York,25,26,32,34,0,0,0,0,20200101,93,117,-2,3,6,24,24,210,24,2019,0,2,2439,0
Orlando,31,31,32,28,0,0,0,0,Washington,29,29,25,18,0,0,0,0,20200101,122,101,2,4,11,21,21,223,-21,2019,0,2,757,0
Oklahoma City,27,19,28,35,0,0,0,0,San Antonio,27,28,21,27,0,0,0,0,20200102,109,103,0,-9,-2,6,6,212,-6,2019,0,3,421,0
Memphis,42,18,37,26,0,0,0,0,Sacramento,26,37,27,38,0,0,0,0,20200102,123,128,-16,3,-7,5,5,251,5,2019,0,3,1745,0
Toronto,20,19,21,16,0,0,0,0,Miami,18,24,21,21,0,0,0,0,20200102,76,84,-2,3,3,8,8,160,8,2019,0,3,1234,0
Detroit,33,30,16,33,0,0,0,0,LA Clippers,30,39,37,20,0,0,0,0,20200102,112,126,-3,6,27,14,14,238,14,2019,0,3,1979,0
Golden State,19,22,26,17,0,0,0,0,Minnesota,34,24,23,18,0,0,0,0,20200102,84,99,15,17,14,15,15,183,15,2019,0,3,1581,0
Brooklyn,30,35,28,18,0,0,0,0,Dallas,31,29,33,30,0,0,0,0,20200102,111,123,1,-5,0,12,12,234,12,2019,0,3,1370,0
Charlotte,31,21,30,27,0,0,0,0,Cleveland,29,30,26,21,0,0,0,0,20200102,109,106,2,-7,-3,3,3,215,-3,2019,0,3,435,0
Utah,25,22,29,26,0,0,0,0,Chicago,22,29,19,28,0,0,0,0,20200102,102,98,3,-4,6,4,4,200,-4,2019,0,3,1256,0
Denver,27,35,30,32,0,0,0,0,Indiana,37,27,24,28,0,0,0,0,20200102,124,116,-10,-2,4,8,8,240,-8,2019,0,3,998,0
Atlanta,32,23,25,26,0,0,0,0,Boston,19,34,29,27,0,0,0,0,20200103,106,109,-13,-2,2,3,3,215,3,2019,0,4,935,0
Philadelphia,27,26,31,24,0,0,0,0,Houston,20,40,36,22,0,0,0,0,20200103,108,118,-7,7,12,10,10,226,10,2019,0,4,1339,0
New Orleans,30,32,21,30,0,0,0,0,LA Lakers,42,32,31,18,0,0,0,0,20200103,113,123,12,12,22,10,10,236,10,2019,0,4,1669,0
Miami,22,22,35,6,0,0,0,0,Orlando,27,29,28,21,0,0,0,0,20200103,85,105,5,12,5,20,20,190,20,2019,0,4,204,0
New York,37,24,26,25,0,0,0,0,Phoenix,29,22,32,37,0,0,0,0,20200103,112,120,-8,-10,-4,8,8,232,8,2019,0,4,2139,0
Portland,27,39,25,31,0,0,0,0,Washington,31,27,20,25,0,0,0,0,20200103,122,103,-4,8,13,19,19,225,-19,2019,0,4,2347,0
San Antonio,31,35,25,27,0,0,0,0,Milwaukee,29,42,32,24,0,0,0,0,20200104,118,127,-2,5,12,9,9,245,9,2019,0,5,1108,0
New Orleans,25,27,24,41,0,0,0,0,Sacramento,26,22,32,35,0,0,0,0,20200104,117,115,-1,4,-4,2,2,232,-2,2019,0,5,1879,0
Denver,19,36,35,24,0,0,0,0,Washington,31,30,34,33,0,0,0,0,20200104,114,128,12,6,5,14,14,242,14,2019,0,5,1489,0
Utah,33,19,24,33,0,0,0,0,Orlando,25,22,28,21,0,0,0,0,20200104,109,96,8,5,1,13,13,205,-13,2019,0,5,1915,0
Memphis,40,25,39,36,0,0,0,0,LA Clippers,27,30,23,34,0,0,0,0,20200104,140,114,13,8,24,26,26,254,-26,2019,0,5,1599,0
Toronto,24,24,35,38,0,0,0,0,Brooklyn,33,19,28,22,0,0,0,0,20200104,121,102,-9,-4,3,19,19,223,-19,2019,0,5,341,0
Charlotte,32,25,23,23,20,0,0,0,Dallas,20,24,40,19,17,0,0,0,20200104,123,120,12,13,-4,0,3,243,-3,2019,1,5,928,0
Oklahoma City,34,32,25,30,0,0,0,0,Cleveland,27,26,26,27,0,0,0,0,20200104,121,106,7,13,12,15,15,227,-15,2019,0,5,949,0
Boston,30,25,30,26,0,0,0,0,Chicago,28,24,21,31,0,0,0,0,20200104,111,104,2,3,12,7,7,215,-7,2019,0,5,849,0
Indiana,26,34,35,16,0,0,0,0,Atlanta,43,21,32,20,0,0,0,0,20200104,111,116,17,4,1,5,5,227,5,2019,0,5,427,0
Detroit,25,31,27,28,0,0,0,0,Golden State,23,36,21,24,0,0,0,0,20200104,111,104,2,-3,3,7,7,215,-7,2019,0,5,2087,0
Minnesota,24,42,28,24,0,0,0,0,Cleveland,20,28,31,24,0,0,0,0,20200105,118,103,4,18,15,15,15,221,-15,2019,0,6,629,0
New York,45,24,31,32,0,0,0,0,LA Clippers,29,47,38,21,0,0,0,0,20200105,132,135,-16,7,14,3,3,267,3,2019,0,6,2445,0
Detroit,22,25,32,20,0,0,0,0,LA Lakers,23,33,19,31,0,0,0,0,20200105,99,106,1,9,-4,7,7,205,7,2019,0,6,1979,0
Portland,19,27,35,30,0,0,0,0,Miami,31,34,29,28,0,0,0,0,20200105,111,122,12,19,13,11,11,233,11,2019,0,6,2704,0
Memphis,27,35,34,25,0,0,0,0,Phoenix,31,26,20,37,0,0,0,0,20200105,121,114,-4,5,19,7,7,235,-7,2019,0,6,1260,0
Boston,17,23,32,22,0,0,0,0,Washington,26,25,23,25,0,0,0,0,20200106,94,99,9,11,2,5,5,193,5,2019,0,0,394,0
Milwaukee,22,30,29,23,0,0,0,0,San Antonio,27,38,26,35,0,0,0,0,20200106,104,126,5,13,10,22,22,230,22,2019,0,0,1108,0
Golden State,19,21,24,34,0,0,0,0,Sacramento,26,26,38,21,0,0,0,0,20200106,98,111,7,12,26,13,13,209,13,2019,0,0,75,0
Oklahoma City,31,21,34,27,0,0,0,0,Philadelphia,31,31,28,30,0,0,0,0,20200106,113,120,0,10,4,7,7,233,7,2019,0,0,1256,0
Brooklyn,22,17,32,18,0,0,0,0,Orlando,20,32,23,26,0,0,0,0,20200106,89,101,-2,13,4,12,12,190,12,2019,0,0,939,0
Utah,35,33,27,33,0,0,0,0,New Orleans,36,28,33,29,0,0,0,0,20200106,128,126,-1,4,-2,2,2,254,-2,2019,0,0,1432,0
Chicago,27,28,27,28,0,0,0,0,Dallas,33,28,27,30,0,0,0,0,20200106,110,118,6,6,6,8,8,228,8,2019,0,0,802,0
Indiana,27,15,37,36,0,0,0,0,Charlotte,29,15,21,39,0,0,0,0,20200106,115,104,-2,-2,14,11,11,219,-11,2019,0,0,428,0
Denver,29,35,27,32,0,0,0,0,Atlanta,31,25,30,29,0,0,0,0,20200106,123,115,-2,8,5,8,8,238,-8,2019,0,0,1209,0
Oklahoma City,27,22,25,27,10,0,0,0,Brooklyn,23,25,29,24,2,0,0,0,20200107,111,103,4,1,-3,0,8,214,-8,2019,1,1,1324,0
Detroit,27,27,30,31,0,0,0,0,Cleveland,29,38,28,18,0,0,0,0,20200107,115,113,-2,-13,-11,2,2,228,-2,2019,0,1,90,0
New York,21,24,25,17,0,0,0,0,LA Lakers,26,36,23,32,0,0,0,0,20200107,87,117,5,17,15,30,30,204,30,2019,0,1,2445,0
Minnesota,32,24,28,28,0,0,0,0,Memphis,27,24,31,37,0,0,0,0,20200107,112,119,-5,-5,-2,7,7,231,7,2019,0,1,700,0
Sacramento,26,27,25,36,0,0,0,0,Phoenix,29,24,34,16,0,0,0,0,20200107,114,103,-3,0,-9,11,11,217,-11,2019,0,1,634,0
Portland,15,31,23,32,0,0,0,0,Toronto,24,32,22,21,0,0,0,0,20200107,101,99,-9,-10,-9,2,2,200,-2,2019,0,1,2108,0
New York,29,24,16,35,0,0,0,0,Utah,39,33,23,33,0,0,0,0,20200108,104,128,10,19,26,24,24,232,24,2019,0,2,1967,0
Washington,23,29,20,17,0,0,0,0,Orlando,32,37,28,26,0,0,0,0,20200108,89,123,9,17,25,34,34,212,34,2019,0,2,757,0
Chicago,21,27,27,33,0,0,0,0,New Orleans,23,25,44,31,0,0,0,0,20200108,108,123,2,0,17,15,15,231,15,2019,0,2,832,0
Miami,31,31,38,22,0,0,0,0,Indiana,23,26,23,36,0,0,0,0,20200108,122,108,8,13,28,14,14,230,-14,2019,0,2,1026,0
Houston,45,32,22,23,0,0,0,0,Atlanta,29,33,23,30,0,0,0,0,20200108,122,115,16,15,14,7,7,237,-7,2019,0,2,700,0
Denver,27,29,30,21,0,0,0,0,Dallas,32,27,30,17,0,0,0,0,20200108,107,106,-5,-3,-3,1,1,213,-1,2019,0,2,661,0
Toronto,29,31,22,18,12,0,0,0,Charlotte,31,24,26,19,10,0,0,0,20200108,112,110,-2,5,1,0,2,222,-2,2019,1,2,585,0
San Antonio,34,31,34,30,0,0,0,0,Boston,22,25,36,31,0,0,0,0,20200108,129,114,12,18,16,15,15,243,-15,2019,0,2,1765,0
Milwaukee,19,28,34,26,0,0,0,0,Golden State,19,20,33,26,0,0,0,0,20200108,107,98,0,8,9,9,9,205,-9,2019,0,2,1838,0
Cleveland,26,24,31,21,13,0,0,0,Detroit,32,29,22,19,10,0,0,0,20200109,115,112,-6,-11,-2,0,3,227,-3,2019,1,3,90,0
Portland,34,13,27,28,0,0,0,0,Minnesota,28,31,41,16,0,0,0,0,20200109,102,116,-6,12,26,14,14,218,14,2019,0,3,1423,0
Houston,21,27,19,25,0,0,0,0,Oklahoma City,37,23,29,24,0,0,0,0,20200109,92,113,16,12,22,21,21,205,21,2019,0,3,413,0
Boston,35,20,25,18,0,0,0,0,Philadelphia,26,22,29,32,0,0,0,0,20200109,98,109,-9,-7,-3,11,11,207,11,2019,0,3,270,0
Atlanta,21,30,28,22,0,0,0,0,Washington,30,26,25,30,0,0,0,0,20200110,101,111,9,5,2,10,10,212,10,2019,0,4,541,0
Charlotte,13,25,24,30,0,0,0,0,Utah,29,32,26,22,0,0,0,0,20200110,92,109,16,23,25,17,17,201,17,2019,0,4,1723,0
Milwaukee,34,19,37,37,0,0,0,0,Sacramento,18,26,31,31,0,0,0,0,20200110,127,106,16,9,15,21,21,233,-21,2019,0,4,1771,0
Orlando,25,23,27,19,0,0,0,0,Phoenix,27,31,19,21,0,0,0,0,20200110,94,98,2,10,2,4,4,192,4,2019,0,4,1842,0
New Orleans,33,34,28,28,0,0,0,0,New York,31,30,25,25,0,0,0,0,20200110,123,111,2,6,9,12,12,234,-12,2019,0,4,1168,0
LA Lakers,45,34,20,30,0,0,0,0,Dallas,27,31,28,28,0,0,0,0,20200110,129,114,18,21,13,15,15,243,-15,2019,0,4,1237,0
Golden State,20,33,30,17,0,0,0,0,LA Clippers,22,26,25,36,0,0,0,0,20200110,100,109,2,-5,-10,9,9,209,9,2019,0,4,347,0
Indiana,29,25,25,37,0,0,0,0,Chicago,27,19,26,33,0,0,0,0,20200110,116,105,2,8,7,11,11,221,-11,2019,0,4,163,0
Miami,42,27,20,24,0,0,0,0,Brooklyn,32,25,32,28,0,0,0,0,20200110,113,117,-10,-12,0,4,4,230,4,2019,0,4,1091,0
San Antonio,32,25,41,23,0,0,0,0,Memphis,37,26,37,34,0,0,0,0,20200110,121,134,5,6,2,13,13,255,13,2019,0,4,631,0
Minnesota,20,21,35,33,0,0,0,0,Houston,22,35,45,37,0,0,0,0,20200111,109,139,2,16,26,30,30,248,30,2019,0,5,1057,0
LA Lakers,41,32,29,23,0,0,0,0,Oklahoma City,19,30,33,28,0,0,0,0,20200111,125,110,22,24,20,15,15,235,-15,2019,0,5,1178,0
Milwaukee,32,32,33,25,0,0,0,0,Portland,24,31,25,21,0,0,0,0,20200111,122,101,8,9,17,21,21,223,-21,2019,0,5,1714,0
Chicago,35,26,20,27,0,0,0,0,Detroit,20,29,22,28,0,0,0,0,20200111,108,99,15,12,10,9,9,207,-9,2019,0,5,238,0
Philadelphia,22,28,16,25,0,0,0,0,Dallas,20,21,32,36,0,0,0,0,20200111,91,109,-2,-9,7,18,18,200,18,2019,0,5,1297,0
New Orleans,24,33,25,23,0,0,0,0,Boston,41,31,42,26,0,0,0,0,20200111,105,140,17,15,32,35,35,245,35,2019,0,5,1358,0
Cleveland,23,28,34,26,0,0,0,0,Denver,18,24,29,32,0,0,0,0,20200111,111,103,5,9,14,8,8,214,-8,2019,0,5,1223,0
Atlanta,16,30,20,20,0,0,0,0,Brooklyn,37,33,22,16,0,0,0,0,20200112,86,108,21,24,26,22,22,194,22,2019,0,6,745,0
LA Clippers,30,22,22,30,0,0,0,0,Denver,29,37,23,25,0,0,0,0,20200112,104,114,-1,14,15,10,10,218,10,2019,0,6,830,0
Golden State,26,33,17,26,0,0,0,0,Memphis,27,33,35,27,0,0,0,0,20200112,102,122,1,1,19,20,20,224,20,2019,0,6,1798,0
Miami,31,29,34,27,0,0,0,0,New York,27,28,29,40,0,0,0,0,20200112,121,124,-4,-5,-10,3,3,245,3,2019,0,6,1091,0
Charlotte,24,21,26,21,0,0,0,0,Phoenix,18,28,25,29,0,0,0,0,20200112,92,100,-6,1,0,8,8,192,8,2019,0,6,1778,0
San Antonio,21,22,26,36,0,0,0,0,Toronto,28,23,31,22,0,0,0,0,20200112,105,104,-7,-8,-13,1,1,209,-1,2019,0,6,1438,0
Utah,23,32,38,34,0,0,0,0,Washington,34,32,25,25,0,0,0,0,20200112,127,116,-11,-11,2,11,11,243,-11,2019,0,6,1841,0
Orlando,33,32,21,28,0,0,0,0,Sacramento,25,27,33,27,0,0,0,0,20200113,114,112,8,13,1,2,2,226,-2,2019,0,0,2390,0
Charlotte,26,20,43,23,0,0,0,0,Portland,25,37,29,24,0,0,0,0,20200113,112,115,-1,16,2,3,3,227,3,2019,0,0,2284,0
Oklahoma City,30,33,29,25,0,0,0,0,Minnesota,33,27,19,25,0,0,0,0,20200113,117,104,-3,3,13,13,13,221,-13,2019,0,0,694,0
Cleveland,27,21,22,29,0,0,0,0,LA Lakers,21,26,37,44,0,0,0,0,20200113,99,128,-6,-1,14,29,29,227,29,2019,0,0,2044,0
Philadelphia,23,26,20,26,0,0,0,0,Indiana,22,18,29,32,0,0,0,0,20200113,95,101,-1,-9,0,6,6,196,6,2019,0,0,582,0
New Orleans,32,31,26,13,15,0,0,0,Detroit,23,29,25,25,8,0,0,0,20200113,117,110,9,11,12,0,7,227,-7,2019,1,0,939,0
Chicago,14,23,34,30,0,0,0,0,Boston,28,27,28,30,0,0,0,0,20200113,101,113,14,18,12,12,12,214,12,2019,0,0,849,0
Phoenix,25,26,32,27,0,0,0,0,Atlanta,28,28,28,39,0,0,0,0,20200114,110,123,3,5,1,13,13,233,13,2019,0,1,1588,0
Utah,30,29,29,30,0,0,0,0,Brooklyn,26,19,29,33,0,0,0,0,20200114,118,107,4,14,14,11,11,225,-11,2019,0,1,1967,0
Dallas,36,29,29,30,0,0,0,0,Golden State,26,21,24,26,0,0,0,0,20200114,124,97,10,18,23,27,27,221,-27,2019,0,1,1480,0
Cleveland,26,24,21,32,0,0,0,0,LA Clippers,31,35,40,22,0,0,0,0,20200114,103,128,5,16,35,25,25,231,25,2019,0,1,2044,0
Houston,37,24,22,27,0,0,0,0,Memphis,32,35,18,36,0,0,0,0,20200114,110,121,-5,6,2,11,11,231,11,2019,0,1,484,0
New York,23,17,36,26,0,0,0,0,Milwaukee,29,36,43,20,0,0,0,0,20200114,102,128,6,25,32,26,26,230,26,2019,0,1,732,0
Dallas,35,36,37,19,0,0,0,0,Sacramento,31,36,26,30,0,0,0,0,20200115,127,123,4,4,15,4,4,250,-4,2019,0,2,1437,0
Brooklyn,28,29,33,16,0,0,0,0,Philadelphia,25,29,32,31,0,0,0,0,20200115,106,117,-3,-3,-4,11,11,223,11,2019,0,2,80,0
Toronto,38,35,24,33,0,0,0,0,Oklahoma City,25,30,28,38,0,0,0,0,20200115,130,121,13,18,14,9,9,251,-9,2019,0,2,1114,0
Indiana,24,30,22,28,0,0,0,0,Minnesota,30,29,18,22,0,0,0,0,20200115,104,99,-6,-5,-1,5,5,203,-5,2019,0,2,510,0
San Antonio,17,34,26,23,0,0,0,0,Miami,24,27,24,31,0,0,0,0,20200115,100,106,7,0,-2,6,6,206,6,2019,0,2,1147,0
Washington,26,34,20,26,0,0,0,0,Chicago,24,31,30,30,0,0,0,0,20200115,106,115,-2,-5,5,9,9,221,9,2019,0,2,594,0
Portland,28,32,30,27,0,0,0,0,Houston,26,21,30,30,0,0,0,0,20200115,117,107,2,13,13,10,10,224,-10,2019,0,2,1833,0
Charlotte,25,17,27,17,0,0,0,0,Denver,28,29,17,26,0,0,0,0,20200115,86,100,3,15,5,14,14,186,14,2019,0,2,1355,0
Detroit,27,30,34,25,0,0,0,0,Boston,24,35,23,21,0,0,0,0,20200115,116,103,3,-2,9,13,13,219,-13,2019,0,2,611,0
Orlando,35,30,24,30,0,0,0,0,LA Lakers,29,29,30,30,0,0,0,0,20200115,119,118,6,7,1,1,1,237,-1,2019,0,2,2197,0
Denver,19,26,28,40,21,0,0,0,Golden State,34,28,23,28,18,0,0,0,20200116,134,131,-15,-17,-12,0,3,265,-3,2019,1,3,947,0
Orlando,26,22,28,19,0,0,0,0,LA Clippers,34,33,24,31,0,0,0,0,20200116,95,122,8,19,15,27,27,217,27,2019,0,3,2197,0
Boston,20,38,29,36,0,0,0,0,Milwaukee,36,40,30,22,0,0,0,0,20200116,123,128,16,18,19,5,5,251,5,2019,0,3,855,0
Utah,28,21,42,31,10,0,0,0,New Orleans,25,31,31,35,16,0,0,0,20200116,132,138,-3,7,-4,0,6,270,6,2019,1,3,1432,0
Phoenix,25,33,32,31,0,0,0,0,New York,32,20,27,19,0,0,0,0,20200116,121,98,-7,6,11,23,23,219,-23,2019,0,3,2139,0
Washington,26,25,25,35,0,0,0,0,Toronto,38,27,35,40,0,0,0,0,20200117,111,140,12,14,24,29,29,251,29,2019,0,4,349,0
Atlanta,29,38,21,33,0,0,0,0,San Antonio,27,31,41,21,0,0,0,0,20200117,121,120,2,9,-11,1,1,241,-1,2019,0,4,881,0
Chicago,24,23,24,18,0,0,0,0,Philadelphia,21,25,35,19,0,0,0,0,20200117,89,100,-3,-1,10,11,11,189,11,2019,0,4,664,0
Minnesota,26,35,32,21,0,0,0,0,Indiana,32,35,32,17,0,0,0,0,20200117,114,116,6,6,6,2,2,230,2,2019,0,4,510,0
Cleveland,25,31,20,33,0,0,0,0,Memphis,27,27,38,21,0,0,0,0,20200117,109,113,2,-2,16,4,4,222,4,2019,0,4,629,0
Portland,37,26,26,23,0,0,0,0,Dallas,38,34,26,22,0,0,0,0,20200117,112,120,1,9,9,8,8,232,8,2019,0,4,1630,0
Miami,40,21,31,23,0,0,0,0,Oklahoma City,26,21,31,30,0,0,0,0,20200117,115,108,14,14,14,7,7,223,-7,2019,0,4,1225,0
Toronto,32,26,31,33,0,0,0,0,Minnesota,39,23,22,28,0,0,0,0,20200118,122,112,-7,-4,5,10,10,234,-10,2019,0,5,691,0
Sacramento,22,27,28,24,0,0,0,0,Utah,38,25,32,28,0,0,0,0,20200118,101,123,16,14,18,22,22,224,22,2019,0,5,532,0
Portland,24,33,20,29,0,0,0,0,Oklahoma City,32,32,23,32,0,0,0,0,20200118,106,119,8,7,10,13,13,225,13,2019,0,5,1484,0
LA Clippers,33,39,30,31,0,0,0,0,New Orleans,35,45,30,20,0,0,0,0,20200118,133,130,-2,-8,-8,3,3,263,-3,2019,0,5,1669,0
LA Lakers,27,32,32,33,0,0,0,0,Houston,34,31,17,33,0,0,0,0,20200118,124,115,-7,-6,9,9,9,239,-9,2019,0,5,1371,0
Philadelphia,28,24,18,20,0,0,0,0,New York,25,21,23,18,0,0,0,0,20200118,90,87,3,6,1,3,3,177,-3,2019,0,5,80,0
Cleveland,33,40,29,14,0,0,0,0,Chicago,31,25,31,31,0,0,0,0,20200118,116,118,-2,-17,-15,2,2,234,2,2019,0,5,308,0
Detroit,36,35,32,33,0,0,0,0,Atlanta,29,26,21,27,0,0,0,0,20200118,136,103,7,16,27,33,33,239,-33,2019,0,5,597,0
Phoenix,26,34,27,36,0,0,0,0,Boston,20,31,25,43,0,0,0,0,20200118,123,119,6,9,11,4,4,242,-4,2019,0,5,2295,0
Orlando,25,27,19,24,0,0,0,0,Golden State,28,25,29,27,0,0,0,0,20200118,95,109,3,1,11,14,14,204,14,2019,0,5,2437,0
Milwaukee,30,27,36,24,0,0,0,0,Brooklyn,22,20,29,26,0,0,0,0,20200118,117,97,8,15,22,20,20,214,-20,2019,0,5,732,0
Indiana,15,29,30,41,0,0,0,0,Denver,21,29,31,26,0,0,0,0,20200119,115,107,-6,-6,-7,8,8,222,-8,2019,0,6,998,0
Miami,31,23,30,18,0,0,0,0,San Antonio,28,32,26,21,0,0,0,0,20200119,102,107,-3,6,2,5,5,209,5,2019,0,6,1147,0
Detroit,35,23,23,19,0,0,0,0,Washington,30,30,23,23,0,0,0,0,20200120,100,106,-5,2,2,6,6,206,6,2019,0,0,394,0
Indiana,23,21,19,25,0,0,0,0,Utah,29,27,24,38,0,0,0,0,20200120,88,118,6,12,17,30,30,206,30,2019,0,0,1353,0
Golden State,23,34,35,21,11,0,0,0,Portland,27,26,34,26,16,0,0,0,20200120,124,129,4,-4,-5,0,5,253,5,2019,1,0,535,0
San Antonio,28,38,30,24,0,0,0,0,Phoenix,26,25,32,35,0,0,0,0,20200120,120,118,2,15,13,2,2,238,-2,2019,0,0,846,0
Denver,26,29,26,26,0,0,0,0,Minnesota,29,25,25,21,0,0,0,0,20200120,107,100,-3,1,2,7,7,207,-7,2019,0,0,698,0
Sacramento,24,34,20,27,8,0,0,0,Miami,21,35,20,29,13,0,0,0,20200120,113,118,-3,-2,-2,0,5,231,5,2019,1,0,2547,0
Chicago,23,29,25,21,0,0,0,0,Milwaukee,30,23,31,27,0,0,0,0,20200120,98,111,7,1,7,13,13,209,13,2019,0,0,83,0
Oklahoma City,22,35,14,41,0,0,0,0,Houston,25,39,23,20,0,0,0,0,20200120,112,107,-3,-7,-16,5,5,219,-5,2019,0,0,413,0
New York,26,23,30,27,0,0,0,0,Cleveland,26,24,14,22,0,0,0,0,20200120,106,86,0,-1,15,20,20,192,-20,2019,0,0,403,0
Orlando,19,32,21,34,0,0,0,0,Charlotte,27,18,20,18,0,0,0,0,20200120,106,83,-8,6,7,23,23,189,-23,2019,0,0,463,0
Philadelphia,29,35,26,27,0,0,0,0,Brooklyn,32,36,23,20,0,0,0,0,20200120,117,111,-3,-4,-1,6,6,228,-6,2019,0,0,80,0
LA Lakers,30,25,25,27,0,0,0,0,Boston,33,36,35,35,0,0,0,0,20200120,107,139,3,14,24,32,32,246,32,2019,0,0,2590,0
Toronto,36,21,26,39,0,0,0,0,Atlanta,25,35,22,35,0,0,0,0,20200120,122,117,11,-3,1,5,5,239,-5,2019,0,0,733,0
New Orleans,31,38,29,28,0,0,0,0,Memphis,30,20,27,39,0,0,0,0,20200120,126,116,1,19,21,10,10,242,-10,2019,0,0,358,0
LA Clippers,24,36,22,28,0,0,0,0,Dallas,24,25,29,29,0,0,0,0,20200121,110,107,0,11,4,3,3,217,-3,2019,0,1,1237,0
Philadelphia,35,15,22,23,0,0,0,0,Toronto,26,24,26,31,0,0,0,0,20200122,95,107,-9,0,4,12,12,202,12,2019,0,2,334,0
Indiana,30,24,29,29,0,0,0,0,Phoenix,24,24,17,22,0,0,0,0,20200122,112,87,6,6,18,25,25,199,-25,2019,0,2,1496,0
Oklahoma City,24,36,32,28,0,0,0,0,Orlando,21,30,38,25,0,0,0,0,20200122,120,114,3,9,3,6,6,234,-6,2019,0,2,1057,0
LA Lakers,28,20,28,24,0,0,0,0,New York,25,23,22,22,0,0,0,0,20200122,100,92,3,0,6,8,8,192,-8,2019,0,2,2445,0
San Antonio,31,29,34,27,0,0,0,0,New Orleans,24,27,31,35,0,0,0,0,20200122,121,117,7,9,12,4,4,238,-4,2019,0,2,506,0
Washington,27,23,33,35,11,0,0,0,Miami,30,39,21,28,16,0,0,0,20200122,129,134,3,19,7,0,5,263,5,2019,1,2,924,0
Utah,31,34,35,29,0,0,0,0,Golden State,17,26,26,27,0,0,0,0,20200122,129,96,14,22,31,33,33,225,-33,2019,0,2,599,0
Sacramento,27,23,25,31,0,0,0,0,Detroit,26,31,36,34,0,0,0,0,20200122,106,127,-1,7,18,21,21,233,21,2019,0,2,2020,0
Minnesota,26,26,27,31,0,0,0,0,Chicago,35,24,22,36,0,0,0,0,20200122,110,117,9,7,2,7,7,227,7,2019,0,2,355,0
Memphis,27,17,19,32,0,0,0,0,Boston,25,33,41,20,0,0,0,0,20200122,95,119,-2,14,36,24,24,214,24,2019,0,2,1134,0
LA Clippers,32,28,15,20,0,0,0,0,Atlanta,16,25,28,33,0,0,0,0,20200122,95,102,-16,-19,-6,7,7,197,7,2019,0,2,1932,0
Denver,28,15,28,34,0,0,0,0,Houston,35,25,32,29,0,0,0,0,20200122,105,121,7,17,21,16,16,226,16,2019,0,2,878,0
LA Lakers,38,37,29,24,0,0,0,0,Brooklyn,35,35,24,19,0,0,0,0,20200123,128,113,3,5,10,15,15,241,-15,2019,0,3,2445,0
Washington,29,39,32,24,0,0,0,0,Cleveland,24,37,25,26,0,0,0,0,20200123,124,112,5,7,14,12,12,236,-12,2019,0,3,304,0
Dallas,45,33,25,30,0,0,0,0,Portland,37,26,27,35,0,0,0,0,20200123,133,125,8,15,13,8,8,258,-8,2019,0,3,1630,0
Phoenix,22,34,22,25,0,0,0,0,San Antonio,28,16,28,27,0,0,0,0,20200124,103,99,-6,12,6,4,4,202,-4,2019,0,4,846,0
Boston,24,29,29,27,0,0,0,0,Orlando,30,27,20,21,0,0,0,0,20200124,109,98,-6,-4,5,11,11,207,-11,2019,0,4,1115,0
Atlanta,30,28,32,21,0,0,0,0,Oklahoma City,33,33,38,36,0,0,0,0,20200124,111,140,3,8,14,29,29,251,29,2019,0,4,755,0
Toronto,20,36,29,33,0,0,0,0,New York,28,25,26,33,0,0,0,0,20200124,118,112,-8,3,6,6,6,230,-6,2019,0,4,341,0
Denver,37,26,31,19,0,0,0,0,New Orleans,28,28,26,24,0,0,0,0,20200124,113,106,9,7,12,7,7,219,-7,2019,0,4,1079,0
Houston,36,27,31,37,0,0,0,0,Minnesota,26,34,24,40,0,0,0,0,20200124,131,124,10,3,10,7,7,255,-7,2019,0,4,1057,0
Indiana,35,32,31,31,0,0,0,0,Golden State,30,21,35,32,0,0,0,0,20200124,129,118,5,16,12,11,11,247,-11,2019,0,4,1944,0
Memphis,35,31,26,33,0,0,0,0,Detroit,23,38,24,27,0,0,0,0,20200124,125,112,12,5,7,13,13,237,-13,2019,0,4,622,0
Milwaukee,24,26,28,38,0,0,0,0,Charlotte,31,24,23,25,0,0,0,0,20200124,116,103,-7,-5,0,13,13,219,-13,2019,0,4,658,0
Sacramento,29,25,21,23,0,0,0,0,Chicago,21,23,25,12,0,0,0,0,20200124,98,81,8,10,6,17,17,179,-17,2019,0,4,1788,0
LA Clippers,22,41,38,21,0,0,0,0,Miami,30,35,20,32,0,0,0,0,20200124,122,117,-8,-2,16,5,5,239,-5,2019,0,4,2335,0
Chicago,25,34,40,19,0,0,0,0,Cleveland,31,26,19,30,0,0,0,0,20200125,118,106,-6,2,23,12,12,224,-12,2019,0,5,308,0
Brooklyn,26,24,30,26,15,0,0,0,Detroit,25,35,17,29,5,0,0,0,20200125,121,111,1,-10,3,0,10,232,-10,2019,1,5,480,0
Oklahoma City,28,24,39,22,0,0,0,0,Minnesota,22,26,24,32,0,0,0,0,20200125,113,104,6,4,19,9,9,217,-9,2019,0,5,694,0
LA Lakers,25,25,23,18,0,0,0,0,Philadelphia,35,24,26,23,0,0,0,0,20200125,91,108,10,9,12,17,17,199,17,2019,0,5,2388,0
Dallas,36,22,26,23,0,0,0,0,Utah,25,30,25,32,0,0,0,0,20200125,107,112,-11,-3,-4,5,5,219,5,2019,0,5,998,0
LA Clippers,26,28,31,27,0,0,0,0,Orlando,28,24,20,25,0,0,0,0,20200126,112,97,-2,2,13,15,15,209,-15,2019,0,6,2197,0
Toronto,37,26,23,24,0,0,0,0,San Antonio,21,30,34,21,0,0,0,0,20200126,110,106,16,12,1,4,4,216,-4,2019,0,6,1438,0
Indiana,27,29,37,36,0,0,0,0,Portland,36,30,40,33,0,0,0,0,20200126,129,139,9,10,13,10,10,268,10,2019,0,6,1880,0
Brooklyn,28,24,24,21,0,0,0,0,New York,30,25,30,25,0,0,0,0,20200126,97,110,2,3,9,13,13,207,13,2019,0,6,0,0
Boston,20,22,39,27,0,0,0,0,New Orleans,32,30,29,32,0,0,0,0,20200126,108,123,12,20,10,15,15,231,15,2019,0,6,1358,0
Phoenix,18,27,33,31,0,0,0,0,Memphis,30,26,25,33,0,0,0,0,20200126,109,114,12,11,3,5,5,223,5,2019,0,6,1260,0
Houston,36,23,30,21,0,0,0,0,Denver,27,30,33,27,0,0,0,0,20200126,110,117,-9,-2,1,7,7,227,7,2019,0,6,878,0
Washington,33,39,30,31,0,0,0,0,Atlanta,31,47,41,33,0,0,0,0,20200126,133,152,-2,6,17,19,19,285,19,2019,0,6,541,0
San Antonio,28,20,37,24,0,0,0,0,Chicago,21,29,25,35,0,0,0,0,20200127,109,110,-7,2,-10,1,1,219,1,2019,0,0,1050,0
Cleveland,24,29,36,26,0,0,0,0,Detroit,23,22,27,28,0,0,0,0,20200127,115,100,1,8,17,15,15,215,-15,2019,0,0,90,0
Orlando,21,27,23,21,0,0,0,0,Miami,31,23,31,28,0,0,0,0,20200127,92,113,10,6,14,21,21,205,21,2019,0,0,204,0
Sacramento,24,26,28,41,14,0,0,0,Minnesota,37,31,29,22,10,0,0,0,20200127,133,129,-13,-18,-19,0,4,262,-4,2019,1,0,1511,0
Dallas,25,34,29,19,0,0,0,0,Oklahoma City,22,25,30,20,0,0,0,0,20200127,107,97,3,12,11,10,10,204,-10,2019,0,0,189,0
Houston,28,31,28,39,0,0,0,0,Utah,20,26,29,42,0,0,0,0,20200127,126,117,8,13,12,9,9,243,-9,2019,0,0,1199,0
Atlanta,23,33,27,31,0,0,0,0,Toronto,33,35,29,33,0,0,0,0,20200128,114,130,10,12,14,16,16,244,16,2019,0,1,733,0
Golden State,27,27,28,22,0,0,0,0,Philadelphia,26,33,27,29,0,0,0,0,20200128,104,115,-1,5,4,11,11,219,11,2019,0,1,2516,0
Washington,28,35,41,27,0,0,0,0,Milwaukee,42,46,29,34,0,0,0,0,20200128,131,151,14,25,13,20,20,282,20,2019,0,1,634,0
Boston,36,17,27,29,0,0,0,0,Miami,28,20,28,25,0,0,0,0,20200128,109,101,8,5,4,8,8,210,-8,2019,0,1,1257,0
Denver,18,32,16,30,0,0,0,0,Memphis,31,32,19,22,0,0,0,0,20200128,96,104,13,13,16,8,8,200,8,2019,0,1,877,0
Phoenix,32,28,48,25,0,0,0,0,Dallas,19,36,22,27,0,0,0,0,20200128,133,104,13,5,31,29,29,237,-29,2019,0,1,884,0
New Orleans,40,34,30,21,0,0,0,0,Cleveland,34,31,25,21,0,0,0,0,20200128,125,111,6,9,14,14,14,236,-14,2019,0,1,924,0
New York,26,24,16,26,0,0,0,0,Charlotte,15,32,21,29,0,0,0,0,20200128,92,97,-11,-3,2,5,5,189,5,2019,0,1,531,0
Detroit,30,38,25,22,0,0,0,0,Brooklyn,32,38,29,26,0,0,0,0,20200129,115,125,2,2,6,10,10,240,10,2019,0,2,480,0
Chicago,24,27,29,20,6,0,0,0,Indiana,25,30,25,20,15,0,0,0,20200129,106,115,1,4,0,0,9,221,9,2019,1,2,163,0
Memphis,32,27,37,31,0,0,0,0,New York,32,20,32,22,0,0,0,0,20200129,127,106,0,7,12,21,21,233,-21,2019,0,2,953,0
Houston,36,24,22,30,0,0,0,0,Portland,30,41,26,28,0,0,0,0,20200129,112,125,-6,11,15,13,13,237,13,2019,0,2,1833,0
Oklahoma City,23,36,37,24,0,0,0,0,Sacramento,16,31,29,24,0,0,0,0,20200129,120,100,7,12,20,20,20,220,-20,2019,0,2,1336,0
Utah,29,33,32,26,0,0,0,0,San Antonio,37,33,28,29,0,0,0,0,20200129,120,127,8,8,4,7,7,247,7,2019,0,2,1087,0
Charlotte,33,27,19,28,0,0,0,0,Washington,26,29,31,35,0,0,0,0,20200130,107,121,-7,-5,7,14,14,228,14,2019,0,3,329,0
Utah,23,25,22,30,0,0,0,0,Denver,21,22,33,30,0,0,0,0,20200130,100,106,-2,-5,6,6,6,206,6,2019,0,3,370,0
Sacramento,28,36,21,39,0,0,0,0,LA Clippers,33,14,24,32,0,0,0,0,20200130,124,103,-5,17,14,21,21,227,-21,2019,0,3,361,0
Golden State,22,28,29,25,0,0,0,0,Boston,29,31,31,28,0,0,0,0,20200130,104,119,7,10,12,15,15,223,15,2019,0,3,2692,0
Philadelphia,31,36,25,25,0,0,0,0,Atlanta,39,35,25,28,0,0,0,0,20200130,117,127,8,7,7,10,10,244,10,2019,0,3,665,0
Toronto,31,25,32,27,0,0,0,0,Cleveland,26,26,24,33,0,0,0,0,20200130,115,109,5,4,12,6,6,224,-6,2019,0,3,187,0
Chicago,23,34,39,22,0,0,0,0,Brooklyn,35,38,30,30,0,0,0,0,20200131,118,133,12,16,7,15,15,251,15,2019,0,4,711,0
Toronto,30,30,18,27,0,0,0,0,Detroit,20,27,22,23,0,0,0,0,20200131,105,92,10,13,9,13,13,197,-13,2019,0,4,205,0
Dallas,28,32,25,36,0,0,0,0,Houston,35,30,36,27,0,0,0,0,20200131,121,128,7,5,16,7,7,249,7,2019,0,4,225,0
Portland,38,22,43,24,0,0,0,0,LA Lakers,36,26,34,23,0,0,0,0,20200131,127,119,2,-2,7,8,8,246,-8,2019,0,4,826,0
Denver,35,25,40,27,0,0,0,0,Milwaukee,43,24,24,24,0,0,0,0,20200131,127,115,-8,-7,9,12,12,242,-12,2019,0,4,912,0
Memphis,22,37,27,25,0,0,0,0,New Orleans,31,35,44,29,0,0,0,0,20200131,111,139,9,7,24,28,28,250,28,2019,0,4,358,0
Oklahoma City,25,28,26,32,0,0,0,0,Phoenix,27,25,29,26,0,0,0,0,20200131,111,107,-2,1,-2,4,4,218,-4,2019,0,4,840,0
Brooklyn,36,25,23,23,0,0,0,0,Washington,27,32,22,32,0,0,0,0,20200201,107,113,-9,-2,-3,6,6,220,6,2019,0,5,204,0
Charlotte,28,35,11,16,0,0,0,0,San Antonio,30,20,29,35,0,0,0,0,20200201,90,114,2,-13,5,24,24,204,24,2019,0,5,1103,0
LA Lakers,44,37,23,25,0,0,0,0,Sacramento,22,42,25,24,0,0,0,0,20200201,129,113,22,17,15,16,16,242,-16,2019,0,5,361,0
Utah,34,19,30,24,0,0,0,0,Portland,33,30,31,30,0,0,0,0,20200201,107,124,-1,10,11,17,17,231,17,2019,0,5,634,0
Miami,28,29,19,26,0,0,0,0,Orlando,25,24,18,22,0,0,0,0,20200201,102,89,3,8,9,13,13,191,-13,2019,0,5,204,0
Minnesota,32,23,31,20,0,0,0,0,LA Clippers,40,22,36,20,0,0,0,0,20200201,106,118,8,7,12,12,12,224,12,2019,0,5,1521,0
Atlanta,26,23,23,28,0,0,0,0,Dallas,36,26,35,26,0,0,0,0,20200201,100,123,10,13,25,23,23,223,23,2019,0,5,719,0
Golden State,31,30,44,26,0,0,0,0,Cleveland,32,27,19,34,0,0,0,0,20200201,131,112,-1,2,27,19,19,243,-19,2019,0,5,2161,0
Philadelphia,19,32,16,28,0,0,0,0,Boston,32,27,27,30,0,0,0,0,20200201,95,116,13,8,19,21,21,211,21,2019,0,5,270,0
New York,24,26,22,20,0,0,0,0,Indiana,11,28,32,14,0,0,0,0,20200201,92,85,13,11,1,7,7,177,-7,2019,0,5,643,0
Denver,44,21,24,22,12,0,0,0,Detroit,30,38,22,21,17,0,0,0,20200202,123,128,-14,3,1,0,5,251,5,2019,1,6,1154,0
New Orleans,28,32,33,16,0,0,0,0,Houston,30,35,27,25,0,0,0,0,20200202,109,117,2,5,-1,8,8,226,8,2019,0,6,317,0
Phoenix,26,26,28,28,0,0,0,0,Milwaukee,30,37,30,32,0,0,0,0,20200202,108,129,4,15,17,21,21,237,21,2019,0,6,1462,0
Chicago,29,34,22,17,0,0,0,0,Toronto,32,28,35,34,0,0,0,0,20200202,102,129,3,-3,10,27,27,231,27,2019,0,6,436,0
Detroit,32,21,10,19,0,0,0,0,Memphis,36,17,19,24,0,0,0,0,20200203,82,96,4,0,9,14,14,178,14,2019,0,0,622,0
Golden State,40,32,27,26,0,0,0,0,Washington,36,27,23,31,0,0,0,0,20200203,125,117,4,9,13,8,8,242,-8,2019,0,0,2435,0
Minnesota,20,30,34,25,0,0,0,0,Sacramento,29,36,28,20,0,0,0,0,20200203,109,113,9,15,9,4,4,222,4,2019,0,0,1511,0
Philadelphia,26,26,25,29,0,0,0,0,Miami,30,26,41,40,0,0,0,0,20200203,106,137,4,4,20,31,31,243,31,2019,0,0,1021,0
San Antonio,39,24,19,23,0,0,0,0,LA Clippers,29,25,31,23,0,0,0,0,20200203,105,108,-10,-9,3,3,3,213,3,2019,0,0,1201,0
Orlando,25,31,29,27,0,0,0,0,Charlotte,24,30,23,23,0,0,0,0,20200203,112,100,1,2,8,12,12,212,-12,2019,0,0,463,0
New York,33,30,32,32,12,0,0,0,Cleveland,37,25,38,27,7,0,0,0,20200203,139,134,-4,1,-5,0,5,273,-5,2019,1,0,403,0
Phoenix,31,21,21,24,0,0,0,0,Brooklyn,35,20,35,29,0,0,0,0,20200203,97,119,4,3,17,22,22,216,22,2019,0,0,2139,0
Boston,28,32,35,28,0,0,0,0,Atlanta,34,28,22,31,0,0,0,0,20200203,123,115,-6,-2,11,8,8,238,-8,2019,0,0,935,0
Dallas,25,28,29,30,0,0,0,0,Indiana,22,33,22,26,0,0,0,0,20200203,112,103,3,-2,5,9,9,215,-9,2019,0,0,763,0
Portland,28,10,36,25,0,0,0,0,Denver,37,27,36,27,0,0,0,0,20200204,99,127,9,26,26,28,28,226,28,2019,0,1,981,0
Charlotte,34,29,25,22,0,0,0,0,Houston,22,40,30,33,0,0,0,0,20200204,110,125,-12,-1,4,15,15,235,15,2019,0,1,925,0
San Antonio,19,22,33,28,0,0,0,0,LA Lakers,21,30,36,42,0,0,0,0,20200204,102,129,2,10,13,27,27,231,27,2019,0,1,1201,0
Milwaukee,26,32,42,20,0,0,0,0,New Orleans,33,28,24,23,0,0,0,0,20200204,120,108,-7,-3,15,12,12,228,-12,2019,0,1,911,0
Denver,25,24,23,26,0,0,0,0,Utah,32,25,18,20,0,0,0,0,20200205,98,95,-7,-8,-3,3,3,193,-3,2019,0,2,370,0
Indiana,20,43,23,32,0,0,0,0,Toronto,30,18,34,37,0,0,0,0,20200205,118,119,10,-15,-4,1,1,237,1,2019,0,2,438,0
Cleveland,28,25,28,22,0,0,0,0,Oklahoma City,29,32,23,25,0,0,0,0,20200205,103,109,1,8,3,6,6,212,6,2019,0,2,949,0
Atlanta,36,28,32,31,0,0,0,0,Minnesota,24,32,21,43,0,0,0,0,20200205,127,120,12,8,19,7,7,247,-7,2019,0,2,908,0
Miami,23,35,22,31,0,0,0,0,LA Clippers,25,30,37,36,0,0,0,0,20200205,111,128,2,-3,12,17,17,239,17,2019,0,2,2335,0
Memphis,31,28,41,21,0,0,0,0,Dallas,32,24,22,29,0,0,0,0,20200205,121,107,-1,3,22,14,14,228,-14,2019,0,2,419,0
Golden State,25,22,17,24,0,0,0,0,Brooklyn,40,28,27,34,0,0,0,0,20200205,88,129,15,21,31,41,41,217,41,2019,0,2,2565,0
Orlando,24,32,24,20,0,0,0,0,Boston,32,25,30,29,0,0,0,0,20200205,100,116,8,1,7,16,16,216,16,2019,0,2,1115,0
Phoenix,31,30,25,22,0,0,0,0,Detroit,38,26,25,27,0,0,0,0,20200205,108,116,7,3,3,8,8,224,8,2019,0,2,1687,0
New Orleans,32,40,31,22,0,0,0,0,Chicago,25,37,19,38,0,0,0,0,20200206,125,119,7,10,22,6,6,244,-6,2019,0,3,832,0
Houston,28,35,34,24,0,0,0,0,LA Lakers,29,34,30,18,0,0,0,0,20200206,121,111,-1,0,4,10,10,232,-10,2019,0,3,1371,0
Philadelphia,26,25,23,27,0,0,0,0,Milwaukee,22,32,32,26,0,0,0,0,20200206,101,112,-4,3,12,11,11,213,11,2019,0,3,692,0
Orlando,19,28,36,20,0,0,0,0,New York,30,24,22,29,0,0,0,0,20200206,103,105,11,7,-7,2,2,208,2,2019,0,3,939,0
San Antonio,35,25,32,25,0,0,0,0,Portland,27,32,27,39,0,0,0,0,20200206,117,125,-8,-1,-6,8,8,242,8,2019,0,3,1718,0
Dallas,33,31,29,25,0,0,0,0,Washington,29,33,30,27,0,0,0,0,20200207,118,119,-4,-2,-1,1,1,237,1,2019,0,4,1181,0
Portland,38,34,17,25,0,0,0,0,Utah,32,26,30,29,0,0,0,0,20200207,114,117,-6,-14,-1,3,3,231,3,2019,0,4,634,0
Miami,28,22,26,21,0,0,0,0,Sacramento,30,22,31,22,0,0,0,0,20200207,97,105,2,2,7,8,8,202,8,2019,0,4,2547,0
Houston,26,29,18,18,0,0,0,0,Phoenix,46,19,32,30,0,0,0,0,20200207,91,127,20,10,24,36,36,218,36,2019,0,4,1014,0
Detroit,24,23,21,33,0,0,0,0,Oklahoma City,29,23,26,30,0,0,0,0,20200207,101,108,5,5,10,7,7,209,7,2019,0,4,909,0
Toronto,36,28,23,28,0,0,0,0,Indiana,31,32,20,23,0,0,0,0,20200207,115,106,5,1,4,9,9,221,-9,2019,0,4,438,0
Atlanta,26,29,18,34,0,0,0,0,Boston,28,26,33,25,0,0,0,0,20200207,107,112,2,-1,14,5,5,219,5,2019,0,4,935,0
Memphis,25,19,22,41,0,0,0,0,Philadelphia,26,32,39,22,0,0,0,0,20200207,107,119,1,14,31,12,12,226,12,2019,0,4,878,0
San Antonio,23,26,29,24,0,0,0,0,Sacramento,24,28,37,33,0,0,0,0,20200208,102,122,1,3,11,20,20,224,20,2019,0,5,1456,0
Denver,28,27,28,34,0,0,0,0,Phoenix,37,17,24,30,0,0,0,0,20200208,117,108,-9,1,5,9,9,225,-9,2019,0,5,585,0
Milwaukee,29,33,21,28,0,0,0,0,Orlando,24,22,25,24,0,0,0,0,20200208,111,95,5,16,12,16,16,206,-16,2019,0,5,1065,0
LA Clippers,31,28,29,27,0,0,0,0,Minnesota,40,41,31,30,0,0,0,0,20200208,115,142,9,22,24,27,27,257,27,2019,0,5,1521,0
Brooklyn,36,18,34,30,0,0,0,0,Toronto,33,33,34,19,0,0,0,0,20200208,118,119,-3,12,12,1,1,237,1,2019,0,5,341,0
LA Lakers,33,33,30,29,0,0,0,0,Golden State,25,34,25,36,0,0,0,0,20200208,125,120,8,7,12,5,5,245,-5,2019,0,5,347,0
New York,17,31,19,28,0,0,0,0,Detroit,28,22,17,25,0,0,0,0,20200208,95,92,-11,-2,0,3,3,187,-3,2019,0,5,480,0
Dallas,31,33,30,22,0,0,0,0,Charlotte,10,33,22,35,0,0,0,0,20200208,116,100,21,21,29,16,16,216,-16,2019,0,5,928,0
New Orleans,31,29,28,36,0,0,0,0,Indiana,26,29,30,32,0,0,0,0,20200208,124,117,5,5,3,7,7,241,-7,2019,0,5,713,0
New York,31,32,20,33,10,9,0,0,Atlanta,20,41,33,22,10,14,0,0,20200209,135,140,-11,-2,11,0,5,275,5,2019,2,6,745,0
LA Clippers,36,37,34,26,0,0,0,0,Cleveland,21,29,23,19,0,0,0,0,20200209,133,92,15,23,34,41,41,225,-41,2019,0,6,2044,0
Utah,25,29,27,33,0,0,0,0,Houston,33,25,25,30,0,0,0,0,20200209,114,113,-8,-4,-2,1,1,227,-1,2019,0,6,1199,0
Boston,28,24,32,28,0,0,0,0,Oklahoma City,32,29,23,27,0,0,0,0,20200209,112,111,-4,-9,0,1,1,223,-1,2019,0,6,1492,0
Chicago,25,30,28,28,0,0,0,0,Philadelphia,38,22,23,35,0,0,0,0,20200209,111,118,13,5,0,7,7,229,7,2019,0,6,664,0
Miami,36,24,23,26,0,0,0,0,Portland,38,25,30,22,0,0,0,0,20200209,109,115,2,3,10,6,6,224,6,2019,0,6,2704,0
Memphis,18,29,33,26,0,0,0,0,Washington,30,25,30,14,0,0,0,0,20200209,106,99,-12,-8,-5,7,7,205,-7,2019,0,6,762,0
Sacramento,24,34,32,21,0,0,0,0,Milwaukee,38,19,31,35,0,0,0,0,20200210,111,123,14,-1,-2,12,12,234,12,2019,0,0,1771,0
Minnesota,36,39,19,32,0,0,0,0,Toronto,40,34,32,31,0,0,0,0,20200210,126,137,4,-1,12,11,11,263,11,2019,0,0,691,0
Atlanta,28,33,35,30,0,0,0,0,Orlando,22,34,37,42,0,0,0,0,20200210,126,135,-6,-5,-3,9,9,261,9,2019,0,0,401,0
Phoenix,30,22,23,25,0,0,0,0,LA Lakers,31,30,29,35,0,0,0,0,20200210,100,125,1,9,15,25,25,225,25,2019,0,0,356,0
Miami,24,38,21,30,0,0,0,0,Golden State,20,23,32,26,0,0,0,0,20200210,113,101,4,19,8,12,12,214,-12,2019,0,0,2590,0
Charlotte,21,26,19,21,0,0,0,0,Detroit,11,26,22,17,0,0,0,0,20200210,87,76,10,10,7,11,11,163,-11,2019,0,0,504,0
San Antonio,40,27,26,27,0,0,0,0,Denver,30,23,36,38,0,0,0,0,20200210,120,127,-10,-14,-4,7,7,247,7,2019,0,0,802,0
Utah,32,39,29,23,0,0,0,0,Dallas,24,26,34,35,0,0,0,0,20200210,123,119,8,21,16,4,4,242,-4,2019,0,0,998,0
Brooklyn,30,21,26,29,0,0,0,0,Indiana,28,20,32,25,0,0,0,0,20200210,106,105,2,3,-3,1,1,211,-1,2019,0,0,643,0
Boston,19,30,22,34,0,0,0,0,Houston,23,24,31,38,0,0,0,0,20200211,105,116,4,-2,7,11,11,221,11,2019,0,1,1603,0
Portland,36,29,21,31,0,0,0,0,New Orleans,27,36,41,34,0,0,0,0,20200211,117,138,-9,-2,18,21,21,255,21,2019,0,1,2059,0
San Antonio,25,24,30,35,0,0,0,0,Oklahoma City,14,27,36,29,0,0,0,0,20200211,114,106,11,8,2,8,8,220,-8,2019,0,1,421,0
LA Clippers,22,32,23,26,0,0,0,0,Philadelphia,30,24,27,29,0,0,0,0,20200211,103,110,8,0,4,7,7,213,7,2019,0,1,2388,0
Chicago,26,36,20,32,0,0,0,0,Washington,36,33,31,26,0,0,0,0,20200211,114,126,10,7,18,12,12,240,12,2019,0,1,594,0
Sacramento,28,24,25,34,0,0,0,0,Dallas,32,31,33,34,0,0,0,0,20200212,111,130,4,11,19,19,19,241,19,2019,0,2,1437,0
Miami,28,24,22,27,0,0,0,0,Utah,25,22,32,37,0,0,0,0,20200212,101,116,-3,-5,5,15,15,217,15,2019,0,2,2086,0
Golden State,24,26,26,30,0,0,0,0,Phoenix,34,24,29,25,0,0,0,0,20200212,106,112,10,8,11,6,6,218,6,2019,0,2,652,0
Detroit,20,35,26,27,4,0,0,0,Orlando,32,27,28,21,8,0,0,0,20200212,112,116,12,4,6,0,4,228,4,2019,1,2,957,0
Washington,25,21,31,37,0,0,0,0,New York,24,26,23,23,0,0,0,0,20200212,114,96,1,-4,4,18,18,210,-18,2019,0,2,204,0
Charlotte,28,22,31,34,0,0,0,0,Minnesota,36,30,21,21,0,0,0,0,20200212,115,108,-8,-16,-6,7,7,223,-7,2019,0,2,938,0
Atlanta,19,29,32,25,0,0,0,0,Cleveland,33,32,33,29,0,0,0,0,20200212,105,127,14,17,18,22,22,232,22,2019,0,2,555,0
Milwaukee,20,25,26,40,0,0,0,0,Indiana,34,34,14,36,0,0,0,0,20200212,111,118,14,23,11,7,7,229,7,2019,0,2,243,0
LA Lakers,23,38,23,27,9,0,0,0,Denver,31,24,32,24,5,0,0,0,20200212,120,116,-8,6,-3,0,4,236,-4,2019,1,2,830,0
Toronto,19,21,25,26,0,0,0,0,Brooklyn,23,29,23,26,0,0,0,0,20200212,91,101,4,12,10,10,10,192,10,2019,0,2,341,0
Portland,27,36,19,22,0,0,0,0,Memphis,31,36,25,19,0,0,0,0,20200212,104,111,4,4,10,7,7,215,7,2019,0,2,1845,0
LA Clippers,32,26,29,27,13,6,0,0,Boston,30,30,31,23,13,14,0,0,20200213,133,141,-2,2,4,0,8,274,8,2019,2,3,2590,0
Oklahoma City,29,37,32,25,0,0,0,0,New Orleans,30,28,35,25,0,0,0,0,20200213,123,118,-1,8,5,5,5,241,-5,2019,0,3,576,0
Memphis,35,26,29,35,0,0,0,0,Sacramento,37,33,27,32,0,0,0,0,20200220,125,129,2,9,7,4,4,254,4,2019,0,3,1745,0
Brooklyn,20,32,26,25,1,0,0,0,Philadelphia,26,16,35,26,9,0,0,0,20200220,104,112,6,-10,-1,0,8,216,8,2019,1,3,80,0
Houston,38,34,37,26,0,0,0,0,Golden State,17,33,27,28,0,0,0,0,20200220,135,105,21,22,32,30,30,240,-30,2019,0,3,1642,0
Charlotte,33,27,19,24,0,0,0,0,Chicago,20,24,29,20,0,0,0,0,20200220,103,93,13,16,6,10,10,196,-10,2019,0,3,586,0
Miami,36,28,33,27,0,0,0,0,Atlanta,32,31,27,39,0,0,0,0,20200220,124,129,-4,-1,-7,5,5,253,5,2019,0,3,605,0
Milwaukee,32,38,28,28,0,0,0,0,Detroit,18,23,30,35,0,0,0,0,20200220,126,106,14,29,27,20,20,232,-20,2019,0,3,251,0
San Antonio,27,38,28,20,0,0,0,0,Utah,21,25,29,29,0,0,0,0,20200221,113,104,6,19,18,9,9,217,-9,2019,0,4,1087,0
Memphis,22,19,36,28,0,0,0,0,LA Lakers,28,32,24,33,0,0,0,0,20200221,105,117,6,19,7,12,12,222,12,2019,0,4,1599,0
Boston,24,37,34,32,0,0,0,0,Minnesota,20,33,35,29,0,0,0,0,20200221,127,117,4,8,7,10,10,244,-10,2019,0,4,1120,0
Indiana,15,36,29,26,0,0,0,0,New York,20,24,21,33,0,0,0,0,20200221,106,98,-5,7,15,8,8,204,-8,2019,0,4,643,0
Denver,17,31,29,24,0,0,0,0,Oklahoma City,27,21,30,35,0,0,0,0,20200221,101,113,10,0,1,12,12,214,12,2019,0,4,503,0
Dallas,34,30,27,31,0,0,0,0,Orlando,18,34,32,22,0,0,0,0,20200221,122,106,16,12,7,16,16,228,-16,2019,0,4,961,0
New Orleans,40,33,29,26,0,0,0,0,Portland,35,28,20,32,0,0,0,0,20200221,128,115,5,10,19,13,13,243,-13,2019,0,4,2059,0
Phoenix,23,20,35,23,0,0,0,0,Toronto,31,36,26,25,0,0,0,0,20200221,101,118,8,24,15,17,17,219,17,2019,0,4,1885,0
Cleveland,32,29,20,32,0,0,0,0,Washington,41,25,21,21,0,0,0,0,20200221,113,108,-9,-5,-6,5,5,221,-5,2019,0,4,304,0
Houston,38,24,38,20,0,0,0,0,Utah,36,30,19,25,0,0,0,0,20200222,120,110,2,-4,15,10,10,230,-10,2019,0,5,1199,0
Philadelphia,21,29,23,25,0,0,0,0,Milwaukee,31,25,37,26,0,0,0,0,20200222,98,119,10,6,20,21,21,217,21,2019,0,5,692,0
Cleveland,32,20,26,27,0,0,0,0,Miami,38,44,24,18,0,0,0,0,20200222,105,124,6,30,28,19,19,229,19,2019,0,5,1089,0
Phoenix,22,25,36,29,0,0,0,0,Chicago,24,33,23,24,0,0,0,0,20200222,112,104,-2,-10,3,8,8,216,-8,2019,0,5,1450,0
Brooklyn,30,25,33,27,0,0,0,0,Charlotte,25,20,18,23,0,0,0,0,20200222,115,86,5,10,25,29,29,201,-29,2019,0,5,531,0
Dallas,35,31,20,21,0,0,0,0,Atlanta,21,37,19,34,0,0,0,0,20200222,107,111,-14,-8,-9,4,4,218,4,2019,0,5,719,0
Sacramento,25,29,34,24,0,0,0,0,LA Clippers,13,35,35,20,0,0,0,0,20200222,112,103,12,6,5,9,9,215,-9,2019,0,5,361,0
San Antonio,29,26,18,30,0,0,0,0,Oklahoma City,29,32,37,33,0,0,0,0,20200223,103,131,0,6,25,28,28,234,28,2019,0,6,421,0
Detroit,24,27,34,19,0,0,0,0,Portland,40,13,27,27,0,0,0,0,20200223,104,107,16,2,-5,3,3,211,3,2019,0,6,1964,0
Boston,19,35,33,25,0,0,0,0,LA Lakers,28,28,31,27,0,0,0,0,20200223,112,114,9,2,0,2,2,226,2,2019,0,6,2590,0
Indiana,12,20,23,26,0,0,0,0,Toronto,34,29,22,42,0,0,0,0,20200223,81,127,22,31,30,46,46,208,46,2019,0,6,438,0
Minnesota,38,27,22,29,0,0,0,0,Denver,43,30,24,31,0,0,0,0,20200223,116,128,5,8,10,12,12,244,12,2019,0,6,698,0
Washington,31,27,27,32,0,0,0,0,Chicago,35,38,28,25,0,0,0,0,20200223,117,126,4,15,16,9,9,243,9,2019,0,6,594,0
New Orleans,29,17,31,38,0,0,0,0,Golden State,33,23,21,24,0,0,0,0,20200223,115,101,-4,-10,0,14,14,216,-14,2019,0,6,1921,0
Phoenix,27,35,37,32,0,0,0,0,Utah,35,27,26,23,0,0,0,0,20200224,131,111,-8,0,11,20,20,242,-20,2019,0,0,505,0
Minnesota,27,38,31,27,0,0,0,0,Dallas,41,40,29,29,0,0,0,0,20200224,123,139,14,16,14,16,16,262,16,2019,0,0,863,0
Milwaukee,30,27,38,28,14,0,0,0,Washington,25,22,35,41,11,0,0,0,20200224,137,134,5,10,13,0,3,271,-3,2019,1,0,634,0
Atlanta,24,28,40,20,0,0,0,0,Philadelphia,41,28,22,38,0,0,0,0,20200224,112,129,17,17,-1,17,17,241,17,2019,0,0,665,0
Miami,29,39,31,12,8,0,0,0,Cleveland,21,35,24,31,14,0,0,0,20200224,119,125,-8,-12,-19,0,6,244,6,2019,1,0,1089,0
New York,33,24,29,26,0,0,0,0,Houston,36,36,29,22,0,0,0,0,20200224,112,123,3,15,15,11,11,235,11,2019,0,0,1417,0
Memphis,14,23,29,31,0,0,0,0,LA Clippers,40,26,24,34,0,0,0,0,20200224,97,124,26,29,24,27,27,221,27,2019,0,0,1599,0
Orlando,22,19,40,34,0,0,0,0,Brooklyn,27,27,33,26,0,0,0,0,20200224,115,113,-5,-13,-6,2,2,228,-2,2019,0,0,939,0
Oklahoma City,36,36,19,33,0,0,0,0,Chicago,28,27,38,29,0,0,0,0,20200225,124,122,8,17,-2,2,2,246,-2,2019,0,1,690,0
Detroit,23,23,26,26,0,0,0,0,Denver,29,30,23,33,0,0,0,0,20200225,98,115,6,13,10,17,17,213,17,2019,0,1,1154,0
Sacramento,33,22,26,31,0,0,0,0,Golden State,22,21,30,21,0,0,0,0,20200225,112,94,11,12,8,18,18,206,-18,2019,0,1,75,0
Charlotte,25,19,11,25,0,0,0,0,Indiana,35,34,25,25,0,0,0,0,20200225,80,119,10,25,39,39,39,199,39,2019,0,1,428,0
New Orleans,26,32,28,23,0,0,0,0,LA Lakers,30,34,24,30,0,0,0,0,20200225,109,118,4,6,2,9,9,227,9,2019,0,1,1669,0
Boston,28,28,29,33,0,0,0,0,Portland,24,24,22,36,0,0,0,0,20200225,118,106,4,8,15,12,12,224,-12,2019,0,1,2532,0
Milwaukee,25,25,34,24,0,0,0,0,Toronto,27,25,19,26,0,0,0,0,20200225,108,97,-2,-2,13,11,11,205,-11,2019,0,1,429,0
Brooklyn,17,30,37,22,0,0,0,0,Washington,31,29,21,29,0,0,0,0,20200226,106,110,14,13,-3,4,4,216,4,2019,0,2,204,0
Boston,23,30,32,29,0,0,0,0,Utah,15,36,31,21,0,0,0,0,20200226,114,103,8,2,3,11,11,217,-11,2019,0,2,2093,0
Dallas,36,23,29,21,0,0,0,0,San Antonio,20,29,28,26,0,0,0,0,20200226,109,103,16,10,11,6,6,212,-6,2019,0,2,252,0
LA Clippers,21,33,22,26,0,0,0,0,Phoenix,29,20,17,26,0,0,0,0,20200226,102,92,-8,5,10,10,10,194,-10,2019,0,2,356,0
Memphis,17,30,41,24,0,0,0,0,Houston,35,38,38,29,0,0,0,0,20200226,112,140,18,26,23,28,28,252,28,2019,0,2,484,0
Philadelphia,17,27,24,26,0,0,0,0,Cleveland,28,27,22,31,0,0,0,0,20200226,94,108,11,11,9,14,14,202,14,2019,0,2,358,0
New York,27,19,29,26,0,0,0,0,Charlotte,30,26,29,22,0,0,0,0,20200226,101,107,3,10,10,6,6,208,6,2019,0,2,531,0
Orlando,23,41,39,27,0,0,0,0,Atlanta,27,37,31,25,0,0,0,0,20200226,130,120,-4,0,8,10,10,250,-10,2019,0,2,401,0
Minnesota,29,28,38,34,0,0,0,0,Miami,28,32,34,32,0,0,0,0,20200226,129,126,1,-3,1,3,3,255,-3,2019,0,2,1513,0
LA Lakers,24,30,40,22,0,0,0,0,Golden State,24,28,17,17,0,0,0,0,20200227,116,86,0,2,25,30,30,202,-30,2019,0,3,347,0
Portland,24,25,26,25,0,0,0,0,Indiana,30,13,37,26,0,0,0,0,20200227,100,106,6,-6,5,6,6,206,6,2019,0,3,1880,0
Sacramento,27,34,21,26,0,0,0,0,Oklahoma City,25,25,31,31,0,0,0,0,20200227,108,112,-2,-11,-1,4,4,220,4,2019,0,3,1336,0
New York,21,25,33,27,0,0,0,0,Philadelphia,26,35,26,28,0,0,0,0,20200227,106,115,5,15,8,9,9,221,9,2019,0,3,80,0
Minnesota,35,30,31,29,0,0,0,0,Orlando,35,34,34,33,0,0,0,0,20200228,125,136,0,4,7,11,11,261,11,2019,0,4,1309,0
Charlotte,25,27,21,26,0,0,0,0,Toronto,23,18,25,30,0,0,0,0,20200228,99,96,2,11,7,3,3,195,-3,2019,0,4,585,0
Washington,28,32,21,38,0,0,0,0,Utah,31,27,32,39,0,0,0,0,20200228,119,129,3,-2,9,10,10,248,10,2019,0,4,1841,0
Detroit,29,23,32,29,0,0,0,0,Phoenix,24,29,26,32,0,0,0,0,20200228,113,111,5,-1,5,2,2,224,-2,2019,0,4,1687,0
Cleveland,25,30,28,21,0,0,0,0,New Orleans,43,27,25,21,0,0,0,0,20200228,104,116,18,15,12,12,12,220,12,2019,0,4,924,0
Denver,27,29,23,24,0,0,0,0,LA Clippers,37,29,32,34,0,0,0,0,20200228,103,132,10,10,19,29,29,235,29,2019,0,4,830,0
Dallas,31,24,38,25,0,0,0,0,Miami,31,32,25,38,0,0,0,0,20200228,118,126,0,8,-5,8,8,244,8,2019,0,4,1110,0
Sacramento,21,29,31,23,0,0,0,0,Memphis,30,17,28,26,0,0,0,0,20200228,104,101,-9,3,6,3,3,205,-3,2019,0,4,1745,0
Brooklyn,36,26,36,20,0,0,0,0,Atlanta,29,39,40,33,0,0,0,0,20200228,118,141,-7,6,10,23,23,259,23,2019,0,4,745,0
Oklahoma City,24,23,22,17,0,0,0,0,Milwaukee,31,39,37,26,0,0,0,0,20200228,86,133,7,23,38,47,47,219,47,2019,0,4,732,0
Orlando,27,26,28,32,0,0,0,0,San Antonio,38,23,24,29,0,0,0,0,20200229,113,114,11,8,4,1,1,227,1,2019,0,5,1035,0
Golden State,28,33,31,23,0,0,0,0,Phoenix,41,24,16,18,0,0,0,0,20200229,115,99,-13,-4,11,16,16,214,-16,2019,0,5,652,0
Brooklyn,27,22,31,33,0,0,0,0,Miami,24,33,34,25,0,0,0,0,20200229,113,116,-3,8,11,3,3,229,3,2019,0,5,1091,0
Chicago,25,28,33,29,0,0,0,0,New York,31,35,23,36,0,0,0,0,20200229,115,125,6,13,3,10,10,240,10,2019,0,5,711,0
Indiana,30,26,30,27,0,0,0,0,Cleveland,31,27,28,18,0,0,0,0,20200229,113,104,-1,-2,0,9,9,217,-9,2019,0,5,262,0
Houston,19,26,36,23,7,0,0,0,Boston,28,28,22,26,6,0,0,0,20200229,111,110,-9,-11,3,0,1,221,-1,2019,1,5,1603,0
Portland,28,28,34,27,0,0,0,0,Atlanta,23,40,44,22,0,0,0,0,20200229,117,129,-5,7,17,12,12,246,12,2019,0,5,2168,0
LA Lakers,25,21,20,22,0,0,0,0,Memphis,29,29,28,19,0,0,0,0,20200229,88,105,4,12,20,17,17,193,17,2019,0,5,1599,0
Detroit,31,20,19,30,0,0,0,0,Sacramento,16,34,26,30,0,0,0,0,20200301,100,106,-15,-1,6,6,6,206,6,2019,0,6,2020,0
Milwaukee,26,19,25,23,0,0,0,0,Charlotte,20,23,25,17,0,0,0,0,20200301,93,85,6,2,2,8,8,178,-8,2019,0,6,658,0
Toronto,32,37,27,22,0,0,0,0,Denver,40,33,27,33,0,0,0,0,20200301,118,133,8,4,4,15,15,251,15,2019,0,6,1341,0
Washington,35,28,31,30,0,0,0,0,Golden State,28,29,19,34,0,0,0,0,20200301,124,110,7,6,18,14,14,234,-14,2019,0,6,2435,0
Philadelphia,39,33,24,34,0,0,0,0,LA Clippers,34,36,38,28,0,0,0,0,20200301,130,136,-5,-2,12,6,6,266,6,2019,0,6,2388,0
Dallas,28,35,18,30,0,0,0,0,Minnesota,24,20,21,26,0,0,0,0,20200301,111,91,4,19,16,20,20,202,-20,2019,0,6,863,0
LA Lakers,29,34,30,29,0,0,0,0,New Orleans,33,28,34,19,0,0,0,0,20200301,122,114,-4,2,-2,8,8,236,-8,2019,0,6,1669,0
Portland,35,34,23,38,0,0,0,0,Orlando,28,30,30,19,0,0,0,0,20200302,130,107,7,11,4,23,23,237,-23,2019,0,0,2525,0
Utah,31,28,35,32,0,0,0,0,Cleveland,25,26,31,31,0,0,0,0,20200302,126,113,6,8,12,13,13,239,-13,2019,0,0,1564,0
Indiana,26,40,26,24,0,0,0,0,San Antonio,34,23,27,27,0,0,0,0,20200302,116,111,-8,9,8,5,5,227,-5,2019,0,0,999,0
Houston,31,32,28,32,0,0,0,0,New York,36,37,28,24,0,0,0,0,20200302,123,125,5,10,10,2,2,248,2,2019,0,0,1417,0
Dallas,29,29,17,32,0,0,0,0,Chicago,19,29,33,28,0,0,0,0,20200302,107,109,-10,-10,6,2,2,216,2,2019,0,0,802,0
Milwaukee,26,26,18,19,0,0,0,0,Miami,31,22,28,24,0,0,0,0,20200302,89,105,5,1,11,16,16,194,16,2019,0,0,1269,0
Memphis,24,28,32,43,0,0,0,0,Atlanta,23,26,19,20,0,0,0,0,20200302,127,88,1,3,16,39,39,215,-39,2019,0,0,336,0
Brooklyn,28,15,24,51,11,0,0,0,Boston,33,23,28,34,2,0,0,0,20200303,129,120,-5,-13,-17,0,9,249,-9,2019,1,1,190,0
San Antonio,19,30,28,27,0,0,0,0,Charlotte,36,22,18,27,0,0,0,0,20200303,104,103,-17,-9,1,1,1,207,-1,2019,0,1,1103,0
Golden State,26,23,33,34,0,0,0,0,Denver,25,33,23,19,0,0,0,0,20200303,116,100,1,-9,1,16,16,216,-16,2019,0,1,947,0
Philadelphia,35,19,26,27,0,0,0,0,LA Lakers,28,37,31,24,0,0,0,0,20200303,107,120,-7,11,16,13,13,227,13,2019,0,1,2388,0
Minnesota,28,44,37,30,0,0,0,0,New Orleans,31,37,43,23,0,0,0,0,20200303,139,134,-3,4,-2,5,5,273,-5,2019,0,1,1052,0
LA Clippers,38,21,30,20,0,0,0,0,Oklahoma City,27,20,23,24,0,0,0,0,20200303,109,94,11,12,19,15,15,203,-15,2019,0,1,1178,0
Toronto,30,31,26,36,0,0,0,0,Phoenix,39,29,18,28,0,0,0,0,20200303,123,114,-9,-7,1,9,9,237,-9,2019,0,1,1885,0
Washington,23,26,46,31,0,0,0,0,Sacramento,39,37,19,38,0,0,0,0,20200303,126,133,16,27,0,7,7,259,7,2019,0,1,2371,0
Washington,30,31,18,25,0,0,0,0,Portland,37,35,28,25,0,0,0,0,20200304,104,125,7,11,21,21,21,229,21,2019,0,2,2347,0
Utah,35,29,29,19,0,0,0,0,New York,26,28,24,26,0,0,0,0,20200304,112,104,9,10,15,8,8,216,-8,2019,0,2,1967,0
Chicago,29,29,21,29,0,0,0,0,Minnesota,22,33,33,27,0,0,0,0,20200304,108,115,-7,-3,9,7,7,223,7,2019,0,2,355,0
Indiana,23,33,23,21,0,0,0,0,Milwaukee,36,22,31,30,0,0,0,0,20200304,100,119,13,2,10,19,19,219,19,2019,0,2,243,0
Oklahoma City,38,31,25,20,0,0,0,0,Detroit,32,32,18,25,0,0,0,0,20200304,114,107,6,5,12,7,7,221,-7,2019,0,2,909,0
New Orleans,22,33,30,27,11,0,0,0,Dallas,24,33,30,25,15,0,0,0,20200304,123,127,2,2,2,0,4,250,4,2019,1,2,442,0
Boston,28,30,23,31,0,0,0,0,Cleveland,27,25,25,29,0,0,0,0,20200304,112,106,1,6,4,6,6,218,-6,2019,0,2,549,0
Memphis,22,30,30,36,0,0,0,0,Brooklyn,23,22,20,14,0,0,0,0,20200304,118,79,-1,7,17,39,39,197,-39,2019,0,2,953,0
Orlando,26,29,29,29,0,0,0,0,Miami,30,30,28,28,0,0,0,0,20200304,113,116,4,5,4,3,3,229,3,2019,0,2,204,0
Denver,31,29,20,34,0,0,0,0,Charlotte,34,17,31,30,0,0,0,0,20200305,114,112,-3,9,-2,2,2,226,-2,2019,0,3,1355,0
Toronto,32,30,27,32,0,0,0,0,Golden State,27,28,33,25,0,0,0,0,20200305,121,113,5,7,1,8,8,234,-8,2019,0,3,2263,0
LA Clippers,33,34,23,30,0,0,0,0,Houston,23,21,21,40,0,0,0,0,20200305,120,105,10,23,25,15,15,225,-15,2019,0,3,1371,0
Philadelphia,32,31,33,29,0,0,0,0,Sacramento,30,23,27,28,0,0,0,0,20200305,125,108,2,10,16,17,17,233,-17,2019,0,3,2451,0
Miami,26,25,23,30,0,0,0,0,New Orleans,32,33,24,21,0,0,0,0,20200306,104,110,6,14,15,6,6,214,6,2019,0,4,668,0
Atlanta,34,23,18,37,0,0,0,0,Washington,33,31,29,25,0,0,0,0,20200306,112,118,-1,7,18,6,6,230,6,2019,0,4,541,0
Portland,22,36,24,35,0,0,0,0,Phoenix,34,33,28,32,0,0,0,0,20200306,117,127,12,9,13,10,10,244,10,2019,0,4,1005,0
Oklahoma City,27,34,34,31,0,0,0,0,New York,20,28,30,25,0,0,0,0,20200306,126,103,7,13,17,23,23,229,-23,2019,0,4,1324,0
Orlando,29,36,37,30,0,0,0,0,Minnesota,24,31,28,35,0,0,0,0,20200306,132,118,5,10,19,14,14,250,-14,2019,0,4,1309,0
Indiana,29,33,27,19,0,0,0,0,Chicago,25,21,26,30,0,0,0,0,20200306,108,102,4,16,17,6,6,210,-6,2019,0,4,163,0
Memphis,28,21,16,31,0,0,0,0,Dallas,33,28,34,26,0,0,0,0,20200306,96,121,5,12,30,25,25,217,25,2019,0,4,419,0
San Antonio,22,32,41,25,0,0,0,0,Brooklyn,41,34,45,19,0,0,0,0,20200306,120,139,19,21,25,19,19,259,19,2019,0,4,1581,0
Utah,30,32,17,20,0,0,0,0,Boston,29,20,17,28,0,0,0,0,20200306,99,94,1,13,13,5,5,193,-5,2019,0,4,2093,0
Milwaukee,22,26,28,27,0,0,0,0,LA Lakers,19,29,39,26,0,0,0,0,20200306,103,113,-3,0,11,10,10,216,10,2019,0,4,1741,0
Houston,17,26,33,23,0,0,0,0,Charlotte,30,27,25,26,0,0,0,0,20200307,99,108,13,14,6,9,9,207,9,2019,0,5,925,0
Denver,33,28,22,19,0,0,0,0,Cleveland,23,35,27,19,0,0,0,0,20200307,102,104,-10,-3,2,2,2,206,2,2019,0,5,1223,0
Utah,28,27,24,32,0,0,0,0,Detroit,17,22,34,32,0,0,0,0,20200307,111,105,11,16,6,6,6,216,-6,2019,0,5,1488,0
Philadelphia,26,31,33,24,0,0,0,0,Golden State,21,34,27,36,0,0,0,0,20200307,114,118,-5,-2,-8,4,4,232,4,2019,0,5,2516,0
Atlanta,18,27,33,23,0,0,0,0,Memphis,38,28,27,25,0,0,0,0,20200307,101,118,20,21,15,17,17,219,17,2019,0,5,336,0
Sacramento,40,37,23,23,0,0,0,0,Portland,24,30,26,31,0,0,0,0,20200307,123,111,16,23,20,12,12,234,-12,2019,0,5,483,0
Toronto,22,29,27,40,0,0,0,0,Sacramento,22,28,24,39,0,0,0,0,20200308,118,113,0,1,4,5,5,231,-5,2019,0,6,2195,0
Milwaukee,28,31,32,40,0,0,0,0,Phoenix,47,30,25,38,0,0,0,0,20200308,131,140,19,18,11,9,9,271,9,2019,0,6,1462,0
Detroit,22,25,24,13,0,0,0,0,New York,27,22,23,24,0,0,0,0,20200308,84,96,5,2,1,12,12,180,12,2019,0,6,480,0
New Orleans,36,35,27,22,0,0,0,0,Minnesota,29,34,21,23,0,0,0,0,20200308,120,107,7,8,14,13,13,227,-13,2019,0,6,1052,0
LA Lakers,27,22,36,27,0,0,0,0,LA Clippers,25,28,28,22,0,0,0,0,20200308,112,103,2,-4,4,9,9,215,-9,2019,0,6,0,0
Oklahoma City,29,23,31,22,0,0,0,0,Boston,26,37,21,20,0,0,0,0,20200308,105,104,3,-11,-1,1,1,209,-1,2019,0,6,1492,0
Indiana,31,24,31,26,0,0,0,0,Dallas,26,26,32,25,0,0,0,0,20200308,112,109,5,3,2,3,3,221,-3,2019,0,6,763,0
San Antonio,18,32,41,27,11,0,0,0,Cleveland,35,25,27,31,14,0,0,0,20200308,129,132,17,10,-4,0,3,261,3,2019,1,6,1256,0
Chicago,23,27,20,37,0,0,0,0,Brooklyn,22,36,19,33,0,0,0,0,20200308,107,110,-1,8,7,3,3,217,3,2019,0,6,711,0
Orlando,34,37,34,21,0,0,0,0,Houston,24,22,30,30,0,0,0,0,20200308,126,106,10,25,29,20,20,232,-20,2019,0,6,847,0
Miami,29,28,15,28,0,0,0,0,Washington,23,31,18,17,0,0,0,0,20200308,100,89,6,3,0,11,11,189,-11,2019,0,6,924,0
Toronto,27,30,19,25,0,0,0,0,Utah,22,29,19,22,0,0,0,0,20200309,101,92,5,6,6,9,9,193,-9,2019,0,0,1664,0
Milwaukee,24,30,17,24,0,0,0,0,Denver,39,23,14,33,0,0,0,0,20200309,95,109,15,8,5,14,14,204,14,2019,0,0,912,0
Charlotte,32,31,31,28,9,7,0,0,Atlanta,32,34,32,24,9,12,0,0,20200309,138,143,0,3,4,0,5,281,5,2019,2,0,226,0
Cleveland,29,23,26,25,0,0,0,0,Chicago,27,27,24,30,0,0,0,0,20200310,103,108,-2,2,0,5,5,211,5,2019,0,1,308,0
LA Clippers,35,41,35,20,0,0,0,0,Golden State,26,22,29,30,0,0,0,0,20200310,131,107,9,28,34,24,24,238,-24,2019,0,1,347,0
Minnesota,35,21,24,31,0,0,0,0,Houston,26,26,31,34,0,0,0,0,20200310,111,117,-9,-4,3,6,6,228,6,2019,0,1,1057,0
Boston,30,29,35,20,0,0,0,0,Indiana,22,28,30,31,0,0,0,0,20200310,114,111,8,9,14,3,3,225,-3,2019,0,1,805,0
Brooklyn,27,29,31,17,0,0,0,0,LA Lakers,33,25,22,22,0,0,0,0,20200310,104,102,-6,-2,7,2,2,206,-2,2019,0,1,2445,0
Orlando,27,23,35,35,0,0,0,0,Memphis,35,28,23,29,0,0,0,0,20200310,120,115,-8,-13,-1,5,5,235,-5,2019,0,1,683,0
Phoenix,28,25,25,27,0,0,0,0,Portland,36,18,28,39,0,0,0,0,20200310,105,121,8,1,4,16,16,226,16,2019,0,1,1005,0
Dallas,29,30,26,24,0,0,0,0,San Antonio,27,27,29,36,0,0,0,0,20200310,109,119,-2,-5,-2,10,10,228,10,2019,0,1,252,0
New York,31,39,17,28,0,0,0,0,Washington,36,18,33,35,0,0,0,0,20200310,115,122,5,-16,0,7,7,237,7,2019,0,1,204,0
Charlotte,22,37,28,22,0,0,0,0,Miami,40,11,26,21,0,0,0,0,20200311,109,98,-18,8,10,11,11,207,-11,2019,0,2,654,0
Detroit,29,26,29,22,0,0,0,0,Philadelphia,34,36,29,25,0,0,0,0,20200311,106,124,5,15,15,18,18,230,18,2019,0,2,441,0
New York,33,34,29,22,18,0,0,0,Atlanta,24,26,28,40,13,0,0,0,20200311,136,131,9,17,18,0,5,267,-5,2019,1,2,745,0
Denver,29,21,35,12,0,0,0,0,Dallas,33,24,27,29,0,0,0,0,20200311,97,113,4,7,-1,16,16,210,16,2019,0,2,661,0
LA Clippers,23,29,25,24,0,0,0,0,LA Lakers,35,19,22,27,0,0,0,0,20200730,101,103,12,2,-1,2,2,204,2,2019,0,3,0,0
Utah,23,25,31,27,0,0,0,0,New Orleans,26,34,27,17,0,0,0,0,20200730,106,104,-3,-12,-8,2,2,210,-2,2019,0,3,1432,0
Sacramento,30,35,27,28,0,0,0,0,San Antonio,43,21,32,33,0,0,0,0,20200731,120,129,13,-1,4,9,9,249,9,2019,0,4,1456,0
Orlando,36,34,41,17,0,0,0,0,Brooklyn,39,20,23,36,0,0,0,0,20200731,128,118,-3,11,29,10,10,246,-10,2019,0,4,939,0
Houston,42,33,33,31,14,0,0,0,Dallas,42,43,34,20,10,0,0,0,20200731,153,149,0,-10,-11,0,4,302,-4,2019,1,4,225,0
Boston,25,33,29,25,0,0,0,0,Milwaukee,33,31,23,32,0,0,0,0,20200731,112,119,8,6,0,7,7,231,7,2019,0,4,855,0
Memphis,30,30,36,28,11,0,0,0,Portland,35,33,25,31,16,0,0,0,20200731,135,140,5,8,-3,0,5,275,5,2019,1,4,1845,0
Phoenix,38,29,22,36,0,0,0,0,Washington,31,21,29,31,0,0,0,0,20200731,125,112,7,15,8,13,13,237,-13,2019,0,4,1977,0
Philadelphia,29,26,32,34,0,0,0,0,Indiana,35,26,20,46,0,0,0,0,20200801,121,127,6,6,-6,6,6,248,6,2019,0,5,582,0
LA Lakers,21,23,26,22,0,0,0,0,Toronto,23,18,31,35,0,0,0,0,20200801,92,107,2,-3,2,15,15,199,15,2019,0,5,2170,0
Utah,15,27,20,32,0,0,0,0,Oklahoma City,29,37,20,24,0,0,0,0,20200801,94,110,14,24,24,16,16,204,16,2019,0,5,861,0
Miami,28,28,38,31,0,0,0,0,Denver,26,31,22,26,0,0,0,0,20200801,125,105,2,-1,15,20,20,230,-20,2019,0,5,1724,0
New Orleans,25,20,21,37,0,0,0,0,LA Clippers,37,40,26,23,0,0,0,0,20200801,103,126,12,32,37,23,23,229,23,2019,0,5,1669,0
Portland,24,24,38,38,0,0,0,0,Boston,37,30,27,34,0,0,0,0,20200802,124,128,13,19,8,4,4,252,4,2019,0,6,2532,0
Washington,21,33,31,25,0,0,0,0,Brooklyn,24,30,29,35,0,0,0,0,20200802,110,118,3,0,-2,8,8,228,8,2019,0,6,204,0
Milwaukee,29,25,36,26,0,0,0,0,Houston,32,30,27,31,0,0,0,0,20200802,116,120,3,8,-1,4,4,236,4,2019,0,6,1005,0
San Antonio,31,28,26,23,0,0,0,0,Memphis,25,29,22,30,0,0,0,0,20200802,108,106,6,5,9,2,2,214,-2,2019,0,6,631,0
Sacramento,26,28,24,38,0,0,0,0,Orlando,44,34,35,19,0,0,0,0,20200802,116,132,18,24,35,16,16,248,16,2019,0,6,2390,0
Dallas,35,38,19,23,0,0,0,0,Phoenix,23,37,36,21,0,0,0,0,20200802,115,117,-12,-13,4,2,2,232,2,2019,0,6,884,0
Denver,23,27,28,31,12,0,0,0,Oklahoma City,22,29,30,28,4,0,0,0,20200803,121,113,1,-1,-3,0,8,234,-8,2019,1,0,503,0
Toronto,23,25,36,23,0,0,0,0,Miami,17,27,35,24,0,0,0,0,20200803,107,103,6,4,5,4,4,210,-4,2019,0,0,1234,0
Memphis,22,29,23,25,0,0,0,0,New Orleans,26,32,21,30,0,0,0,0,20200803,99,109,4,7,5,10,10,208,10,2019,0,0,358,0
San Antonio,32,30,25,43,0,0,0,0,Philadelphia,35,29,35,33,0,0,0,0,20200803,130,132,3,2,12,2,2,262,2,2019,0,0,1505,0
LA Lakers,24,34,28,30,0,0,0,0,Utah,24,32,20,32,0,0,0,0,20200803,116,108,0,2,10,8,8,224,-8,2019,0,0,579,0
Indiana,20,36,34,21,0,0,0,0,Washington,21,26,21,32,0,0,0,0,20200803,111,100,-1,9,22,11,11,211,-11,2019,0,0,490,0
Brooklyn,40,33,21,25,0,0,0,0,Milwaukee,34,31,23,28,0,0,0,0,20200804,119,116,6,8,6,3,3,235,-3,2019,0,1,732,0
Boston,28,23,32,23,0,0,0,0,Miami,33,30,28,21,0,0,0,0,20200804,106,112,5,12,8,6,6,218,6,2019,0,1,1257,0
Houston,24,32,24,22,0,0,0,0,Portland,29,32,25,24,0,0,0,0,20200804,102,110,5,5,6,8,8,212,8,2019,0,1,1833,0
Orlando,22,28,26,33,0,0,0,0,Indiana,43,28,21,28,0,0,0,0,20200804,109,120,21,21,16,11,11,229,11,2019,0,1,822,0
Phoenix,27,36,32,22,0,0,0,0,LA Clippers,23,33,35,24,0,0,0,0,20200804,117,115,4,7,4,2,2,232,-2,2019,0,1,356,0
Dallas,27,29,19,20,19,0,0,0,Sacramento,37,23,22,13,15,0,0,0,20200804,114,110,-10,-4,-7,0,4,224,-4,2019,1,1,1437,0
Denver,32,30,27,43,0,0,0,0,San Antonio,28,37,24,37,0,0,0,0,20200805,132,126,4,-3,0,6,6,258,-6,2019,0,2,802,0
Toronto,26,29,23,31,0,0,0,0,Orlando,11,24,33,31,0,0,0,0,20200805,109,99,15,20,10,10,10,208,-10,2019,0,2,1048,0
Memphis,31,24,33,27,0,0,0,0,Utah,25,39,25,35,0,0,0,0,20200805,115,124,-6,9,1,9,9,239,9,2019,0,2,1247,0
Brooklyn,25,27,25,38,0,0,0,0,Boston,34,37,35,43,0,0,0,0,20200805,115,149,9,19,29,34,34,264,34,2019,0,2,190,0
Oklahoma City,26,26,29,24,0,0,0,0,LA Lakers,18,27,21,20,0,0,0,0,20200805,105,86,8,7,15,19,19,191,-19,2019,0,2,1178,0
Philadelphia,26,28,23,30,0,0,0,0,Washington,20,27,27,24,0,0,0,0,20200805,107,98,6,7,3,9,9,205,-9,2019,0,2,123,0
New Orleans,39,31,33,22,0,0,0,0,Sacramento,49,28,40,23,0,0,0,0,20200806,125,140,10,7,14,15,15,265,15,2019,0,3,1879,0
Indiana,23,25,27,24,0,0,0,0,Phoenix,28,24,34,28,0,0,0,0,20200806,99,114,5,4,11,15,15,213,15,2019,0,3,1496,0
Miami,34,39,25,18,0,0,0,0,Milwaukee,25,31,36,38,0,0,0,0,20200806,116,130,-9,-17,-6,14,14,246,14,2019,0,3,1269,0
LA Lakers,26,30,23,18,0,0,0,0,Houston,33,32,29,19,0,0,0,0,20200806,97,113,7,9,15,16,16,210,16,2019,0,3,1371,0
Portland,27,35,30,33,0,0,0,0,Denver,26,23,38,28,0,0,0,0,20200806,125,115,1,13,5,10,10,240,-10,2019,0,3,981,0
LA Clippers,23,36,32,35,0,0,0,0,Dallas,22,36,29,24,0,0,0,0,20200806,126,111,1,1,4,15,15,237,-15,2019,0,3,1237,0
Sacramento,27,26,29,24,0,0,0,0,Brooklyn,24,39,30,26,0,0,0,0,20200807,106,119,-3,10,11,13,13,225,13,2019,0,4,2499,0
Oklahoma City,37,23,18,14,0,0,0,0,Memphis,25,38,32,26,0,0,0,0,20200807,92,121,-12,3,17,29,29,213,29,2019,0,4,421,0
Washington,32,24,25,26,0,0,0,0,New Orleans,28,26,37,27,0,0,0,0,20200807,107,118,-4,-2,10,11,11,225,11,2019,0,4,964,0
Orlando,23,27,29,22,0,0,0,0,Philadelphia,25,23,29,31,0,0,0,0,20200807,101,108,2,-2,-2,7,7,209,7,2019,0,4,864,0
Utah,27,23,34,27,0,0,0,0,San Antonio,36,24,36,23,0,0,0,0,20200807,111,119,9,10,12,8,8,230,8,2019,0,4,1087,0
Boston,21,31,39,31,0,0,0,0,Toronto,14,23,20,43,0,0,0,0,20200807,122,100,7,15,34,22,22,222,-22,2019,0,4,430,0
LA Clippers,34,35,26,27,0,0,0,0,Portland,37,38,21,21,0,0,0,0,20200808,122,117,-3,-6,-1,5,5,239,-5,2019,0,5,826,0
Phoenix,25,35,28,31,0,0,0,0,Miami,32,28,26,26,0,0,0,0,20200808,119,112,-7,0,2,7,7,231,-7,2019,0,5,1978,0
LA Lakers,24,35,22,30,0,0,0,0,Indiana,34,20,33,29,0,0,0,0,20200808,111,116,10,-5,6,5,5,227,5,2019,0,5,1805,0
Utah,29,34,25,17,14,13,0,0,Denver,15,34,30,26,14,15,0,0,20200808,132,134,-14,-14,-9,0,2,266,2,2019,2,5,370,0
Milwaukee,32,39,20,28,13,0,0,0,Dallas,35,27,31,26,17,0,0,0,20200808,132,136,3,-9,2,0,4,268,4,2019,1,5,857,0
Orlando,29,22,35,26,7,0,0,0,Boston,28,27,32,25,10,0,0,0,20200809,119,122,-1,4,1,0,3,241,3,2019,1,6,1115,0
Brooklyn,45,29,24,31,0,0,0,0,LA Clippers,24,39,31,26,0,0,0,0,20200809,129,120,21,11,4,9,9,249,-9,2019,0,6,2445,0
San Antonio,27,35,19,41,0,0,0,0,New Orleans,19,26,32,36,0,0,0,0,20200809,122,113,8,17,4,9,9,235,-9,2019,0,6,506,0
Washington,23,25,27,28,0,0,0,0,Oklahoma City,32,32,26,31,0,0,0,0,20200809,103,121,9,16,15,18,18,224,18,2019,0,6,1149,0
Philadelphia,19,39,34,29,0,0,0,0,Portland,33,34,24,33,0,0,0,0,20200809,121,124,14,9,-1,3,3,245,3,2019,0,6,2405,0
Houston,23,38,32,36,0,0,0,0,Sacramento,36,20,15,41,0,0,0,0,20200809,129,112,-13,5,22,17,17,241,-17,2019,0,6,1606,0
Memphis,25,29,17,28,0,0,0,0,Toronto,20,40,28,20,0,0,0,0,20200809,99,108,-5,6,17,9,9,207,9,2019,0,6,815,0
Dallas,30,24,34,34,0,0,0,0,Utah,38,32,30,14,0,0,0,0,20200810,122,114,-8,-16,-12,8,8,236,-8,2019,0,0,998,0
Toronto,36,31,21,26,0,0,0,0,Milwaukee,31,22,22,31,0,0,0,0,20200810,114,106,5,14,13,8,8,220,-8,2019,0,0,429,0
Oklahoma City,37,27,17,20,0,0,0,0,Phoenix,23,42,33,30,0,0,0,0,20200810,101,128,-14,1,17,27,27,229,27,2019,0,0,840,0
Denver,25,34,29,33,0,0,0,0,LA Lakers,31,33,24,36,0,0,0,0,20200810,121,124,6,5,0,3,3,245,3,2019,0,0,830,0
Indiana,19,29,23,21,0,0,0,0,Miami,23,25,37,29,0,0,0,0,20200810,92,114,4,0,14,22,22,206,22,2019,0,0,1026,0
Portland,38,28,32,36,0,0,0,0,Dallas,31,27,37,36,0,0,0,0,20200811,134,131,7,8,3,3,3,265,-3,2019,0,1,1630,0
Boston,24,32,27,39,0,0,0,0,Memphis,17,23,33,34,0,0,0,0,20200811,122,107,7,16,10,15,15,229,-15,2019,0,1,1134,0
Brooklyn,34,26,25,23,0,0,0,0,Orlando,22,21,29,24,0,0,0,0,20200811,108,96,12,17,13,12,12,204,-12,2019,0,1,939,0
Phoenix,23,40,32,35,0,0,0,0,Philadelphia,27,31,32,27,0,0,0,0,20200811,130,117,-4,5,5,13,13,247,-13,2019,0,1,2078,0
New Orleans,29,32,23,22,0,0,0,0,Sacramento,27,35,32,18,0,0,0,0,20200811,106,112,-2,1,10,6,6,218,6,2019,0,1,1879,0
Houston,25,24,29,27,0,0,0,0,San Antonio,31,35,32,25,0,0,0,0,20200811,105,123,6,17,20,18,18,228,18,2019,0,1,189,0
Milwaukee,24,42,33,27,0,0,0,0,Washington,21,35,28,29,0,0,0,0,20200811,126,113,3,10,15,13,13,239,-13,2019,0,1,634,0
Toronto,25,30,35,35,0,0,0,0,Philadelphia,32,30,26,33,0,0,0,0,20200812,125,121,-7,-7,2,4,4,246,-4,2019,0,2,334,0
Miami,42,24,34,15,0,0,0,0,Oklahoma City,29,33,20,34,0,0,0,0,20200812,115,116,-13,-4,-18,1,1,231,1,2019,0,2,1225,0
LA Clippers,26,24,40,34,0,0,0,0,Denver,25,33,34,19,0,0,0,0,20200812,124,111,1,-8,-2,13,13,235,-13,2019,0,2,830,0
Indiana,29,22,28,29,0,0,0,0,Houston,33,17,27,27,0,0,0,0,20200812,108,104,-4,1,2,4,4,212,-4,2019,0,2,865,0
Washington,26,30,22,18,0,0,0,0,Boston,21,30,26,13,0,0,0,0,20200813,96,90,5,5,1,6,6,186,-6,2019,0,3,394,0
Portland,31,42,24,37,0,0,0,0,Brooklyn,31,36,37,29,0,0,0,0,20200813,134,133,0,6,-7,1,1,267,-1,2019,0,3,2439,0
Sacramento,30,36,41,29,0,0,0,0,LA Lakers,40,16,28,38,0,0,0,0,20200813,136,122,-10,10,23,14,14,258,-14,2019,0,3,361,0
Milwaukee,21,29,24,32,0,0,0,0,Memphis,22,38,33,26,0,0,0,0,20200813,106,119,1,10,19,13,13,225,13,2019,0,3,557,0
New Orleans,31,30,26,40,0,0,0,0,Orlando,34,43,22,34,0,0,0,0,20200813,127,133,3,16,12,6,6,260,6,2019,0,3,533,0
Dallas,25,32,22,23,0,0,0,0,Phoenix,36,40,28,24,0,0,0,0,20200813,102,128,11,19,25,26,26,230,26,2019,0,3,884,0
San Antonio,24,26,27,35,0,0,0,0,Utah,41,20,26,31,0,0,0,0,20200813,112,118,17,11,10,6,6,230,6,2019,0,3,1087,0
Oklahoma City,22,25,16,24,16,0,0,0,LA Clippers,21,16,33,17,20,0,0,0,20200814,103,107,-1,-10,7,0,4,210,4,2019,1,4,1178,0
Philadelphia,39,32,32,31,0,0,0,0,Houston,26,21,30,19,0,0,0,0,20200814,134,96,13,24,26,38,38,230,-38,2019,0,4,1339,0
Miami,13,31,26,22,0,0,0,0,Indiana,28,30,26,25,0,0,0,0,20200814,92,109,15,14,14,17,17,201,17,2019,0,4,1026,0
Denver,23,27,26,33,0,0,0,0,Toronto,31,27,27,32,0,0,0,0,20200814,109,117,8,8,9,8,8,226,8,2019,0,4,1341,0
Memphis,19,33,42,28,0,0,0,0,Portland,31,27,31,37,0,0,0,0,20200815,122,126,12,6,-5,4,4,248,4,2019,0,5,1845,0
Dallas,38,31,13,28,0,0,0,0,LA Clippers,34,32,21,31,0,0,0,0,20200817,110,118,-4,-3,5,8,8,228,8,2019,0,0,1237,1
Brooklyn,20,31,35,24,0,0,0,0,Toronto,37,36,22,39,0,0,0,0,20200817,110,134,17,22,9,24,24,244,24,2019,0,0,341,1
Philadelphia,26,23,30,22,0,0,0,0,Boston,25,30,20,34,0,0,0,0,20200817,101,109,-1,6,-4,8,8,210,8,2019,0,0,270,1
Utah,25,27,31,32,10,0,0,0,Denver,31,28,19,37,20,0,0,0,20200817,125,135,6,7,-5,0,10,260,10,2019,1,0,370,1
Orlando,33,29,30,30,0,0,0,0,Milwaukee,23,29,27,31,0,0,0,0,20200818,122,110,10,10,13,12,12,232,-12,2019,0,1,1065,1
Portland,36,21,21,22,0,0,0,0,LA Lakers,25,31,19,18,0,0,0,0,20200818,100,93,11,1,3,7,7,193,-7,2019,0,1,826,1
Miami,27,29,25,32,0,0,0,0,Indiana,33,19,28,21,0,0,0,0,20200818,113,101,-6,4,1,12,12,214,-12,2019,0,1,1026,1
Oklahoma City,20,32,31,25,0,0,0,0,Houston,28,40,36,19,0,0,0,0,20200818,108,123,8,16,21,15,15,231,15,2019,0,1,413,1
Philadelphia,33,24,18,26,0,0,0,0,Boston,27,38,33,30,0,0,0,0,20200819,101,128,-6,8,23,27,27,229,27,2019,0,2,270,1
Utah,27,34,43,20,0,0,0,0,Denver,25,23,29,28,0,0,0,0,20200819,124,105,2,13,27,19,19,229,-19,2019,0,2,370,1
Dallas,29,32,37,29,0,0,0,0,LA Clippers,25,31,29,29,0,0,0,0,20200819,127,114,4,5,13,13,13,241,-13,2019,0,2,1237,1
Brooklyn,33,20,27,19,0,0,0,0,Toronto,29,21,24,30,0,0,0,0,20200819,99,104,-4,-3,-6,5,5,203,5,2019,0,2,341,1
Oklahoma City,30,29,19,20,0,0,0,0,Houston,35,18,24,34,0,0,0,0,20200820,98,111,5,-6,-1,13,13,209,13,2019,0,3,413,1
Miami,22,29,37,21,0,0,0,0,Indiana,24,22,31,23,0,0,0,0,20200820,109,100,-2,5,11,9,9,209,-9,2019,0,3,1026,1
Portland,19,20,19,30,0,0,0,0,LA Lakers,27,29,32,23,0,0,0,0,20200820,88,111,8,17,30,23,23,199,23,2019,0,3,826,1
Orlando,13,30,30,23,0,0,0,0,Milwaukee,25,39,29,18,0,0,0,0,20200820,96,111,12,21,20,15,15,207,15,2019,0,3,1065,1
Denver,14,28,20,25,0,0,0,0,Utah,25,34,35,30,0,0,0,0,20200821,87,124,11,17,32,37,37,211,37,2019,0,4,370,1
Boston,26,25,25,26,0,0,0,0,Philadelphia,24,25,23,22,0,0,0,0,20200821,102,94,2,2,4,8,8,196,-8,2019,0,4,270,1
LA Clippers,23,45,34,28,0,0,0,0,Dallas,23,31,31,37,0,0,0,0,20200821,130,122,0,14,17,8,8,252,-8,2019,0,4,1237,1
Toronto,24,33,27,33,0,0,0,0,Brooklyn,17,25,26,24,0,0,0,0,20200821,117,92,7,15,16,25,25,209,-25,2019,0,4,341,1
Indiana,27,29,34,25,0,0,0,0,Miami,34,40,20,30,0,0,0,0,20200822,115,124,7,18,4,9,9,239,9,2019,0,5,1026,1
Houston,29,34,19,22,3,0,0,0,Oklahoma City,23,34,21,26,15,0,0,0,20200822,107,119,-6,-6,-4,0,12,226,12,2019,1,5,413,1
Milwaukee,31,39,29,22,0,0,0,0,Orlando,23,20,34,30,0,0,0,0,20200822,121,107,8,27,22,14,14,228,-14,2019,0,5,1065,1
LA Lakers,25,28,40,23,0,0,0,0,Portland,29,28,29,22,0,0,0,0,20200822,116,108,-4,-4,7,8,8,224,-8,2019,0,5,826,1
Toronto,39,38,39,34,0,0,0,0,Brooklyn,32,36,19,35,0,0,0,0,20200823,150,122,7,9,29,28,28,272,-28,2019,0,6,341,1
LA Clippers,34,32,19,36,12,0,0,0,Dallas,24,34,35,28,14,0,0,0,20200823,133,135,-10,-8,8,0,2,268,2,2019,1,6,1237,1
Boston,27,30,32,21,0,0,0,0,Philadelphia,32,26,19,29,0,0,0,0,20200823,110,106,-5,-1,12,4,4,216,-4,2019,0,6,270,1
Denver,36,29,24,38,0,0,0,0,Utah,33,31,33,32,0,0,0,0,20200823,127,129,-3,-1,8,2,2,256,2,2019,0,6,370,1
Milwaukee,22,36,26,37,0,0,0,0,Orlando,18,34,29,25,0,0,0,0,20200824,121,106,4,6,3,15,15,227,-15,2019,0,0,1065,1
LA Lakers,43,37,32,23,0,0,0,0,Portland,25,26,36,28,0,0,0,0,20200824,135,115,18,29,25,20,20,250,-20,2019,0,0,826,1
Indiana,22,20,20,25,0,0,0,0,Miami,21,27,22,29,0,0,0,0,20200824,87,99,-1,6,8,12,12,186,12,2019,0,0,1026,1
Houston,37,23,33,21,0,0,0,0,Oklahoma City,35,25,32,25,0,0,0,0,20200824,114,117,-2,0,-1,3,3,231,3,2019,0,0,413,1
Utah,32,31,23,21,0,0,0,0,Denver,33,21,28,35,0,0,0,0,20200825,107,117,1,-9,-4,10,10,224,10,2019,0,1,370,1
Dallas,22,30,34,25,0,0,0,0,LA Clippers,41,35,35,43,0,0,0,0,20200825,111,154,19,24,25,43,43,265,43,2019,0,1,1237,1
Oklahoma City,14,31,18,17,0,0,0,0,Houston,24,24,37,29,0,0,0,0,20200829,80,114,10,3,22,34,34,194,34,2019,0,5,413,1
Portland,31,37,24,30,0,0,0,0,LA Lakers,35,33,32,31,0,0,0,0,20200829,122,131,4,0,8,9,9,253,9,2019,0,5,826,1
Orlando,21,29,29,25,0,0,0,0,Milwaukee,26,41,23,28,0,0,0,0,20200829,104,118,5,17,11,14,14,222,14,2019,0,5,1065,1
LA Clippers,29,28,28,26,0,0,0,0,Dallas,34,17,23,23,0,0,0,0,20200830,111,97,-5,6,11,14,14,208,-14,2019,0,6,1237,1
Boston,39,20,29,24,0,0,0,0,Toronto,23,19,31,21,0,0,0,0,20200830,112,94,16,17,15,18,18,206,-18,2019,0,6,430,1
Denver,30,31,27,31,0,0,0,0,Utah,36,20,23,28,0,0,0,0,20200830,119,107,-6,5,9,12,12,226,-12,2019,0,6,370,1
Miami,29,31,32,23,0,0,0,0,Milwaukee,40,23,23,18,0,0,0,0,20200831,115,104,-11,-3,6,11,11,219,-11,2019,0,0,1269,1
Houston,25,26,24,25,0,0,0,0,Oklahoma City,24,24,29,27,0,0,0,0,20200831,100,104,-1,-3,2,4,4,204,4,2019,0,0,413,1
Boston,28,22,20,32,0,0,0,0,Toronto,28,20,30,21,0,0,0,0,20200901,102,99,0,2,-8,3,3,201,-3,2019,0,1,430,1
Utah,21,15,24,18,0,0,0,0,Denver,26,24,15,15,0,0,0,0,20200901,78,80,5,14,5,2,2,158,2,2019,0,1,370,1
Miami,38,28,24,26,0,0,0,0,Milwaukee,29,31,26,28,0,0,0,0,20200902,116,114,9,6,4,2,2,230,-2,2019,0,2,1269,1
Oklahoma City,30,29,21,22,0,0,0,0,Houston,29,32,24,19,0,0,0,0,20200902,102,104,-1,2,5,2,2,206,2,2019,0,2,413,1
Toronto,28,19,29,28,0,0,0,0,Boston,33,24,23,23,0,0,0,0,20200903,104,103,-5,-10,-4,1,1,207,-1,2019,0,3,430,1
Denver,31,20,16,30,0,0,0,0,LA Clippers,31,38,22,29,0,0,0,0,20200903,97,120,0,18,24,23,23,217,23,2019,0,3,830,1
Houston,29,34,22,27,0,0,0,0,LA Lakers,28,27,24,18,0,0,0,0,20200904,112,97,1,8,6,15,15,209,-15,2019,0,4,1371,1
Milwaukee,30,27,30,13,0,0,0,0,Miami,29,21,25,40,0,0,0,0,20200904,100,115,-1,-7,-12,15,15,215,15,2019,0,4,1269,1
Toronto,31,18,32,19,0,0,0,0,Boston,27,22,24,20,0,0,0,0,20200905,100,93,4,0,8,7,7,193,-7,2019,0,5,430,1
Denver,44,28,17,21,0,0,0,0,LA Clippers,25,31,21,24,0,0,0,0,20200905,110,101,19,16,12,9,9,211,-9,2019,0,5,830,1
Houston,20,31,41,17,0,0,0,0,LA Lakers,36,31,23,27,0,0,0,0,20200906,109,117,16,16,-2,8,8,226,8,2019,0,6,1371,1
Milwaukee,22,28,35,22,11,0,0,0,Miami,31,17,40,19,8,0,0,0,20200906,118,115,-9,2,-3,0,3,233,-3,2019,1,6,1269,1
Boston,25,37,25,24,0,0,0,0,Toronto,11,24,28,26,0,0,0,0,20200907,111,89,14,27,24,22,22,200,-22,2019,0,0,430,1
LA Clippers,33,24,27,29,0,0,0,0,Denver,32,27,29,19,0,0,0,0,20200907,113,107,1,-2,-4,6,6,220,-6,2019,0,0,830,1
Miami,19,33,21,30,0,0,0,0,Milwaukee,28,18,19,29,0,0,0,0,20200908,103,94,-9,6,8,9,9,197,-9,2019,0,1,1269,1
LA Lakers,32,29,21,30,0,0,0,0,Houston,33,31,18,20,0,0,0,0,20200908,112,102,-1,-3,0,10,10,214,-10,2019,0,1,1371,1
Toronto,21,27,33,17,8,19,0,0,Boston,25,27,25,21,8,16,0,0,20200909,125,122,-4,-4,4,0,3,247,-3,2019,2,2,430,1
LA Clippers,26,22,25,23,0,0,0,0,Denver,12,28,23,22,0,0,0,0,20200909,96,85,14,8,10,11,11,181,-11,2019,0,2,830,1
LA Lakers,26,31,29,24,0,0,0,0,Houston,22,19,29,30,0,0,0,0,20200910,110,100,4,16,16,10,10,210,-10,2019,0,3,1371,1
Denver,23,21,29,38,0,0,0,0,LA Clippers,28,28,24,25,0,0,0,0,20200911,111,105,-5,-12,-7,6,6,216,-6,2019,0,4,830,1
Boston,26,24,22,20,0,0,0,0,Toronto,27,19,25,16,0,0,0,0,20200911,92,87,-1,4,1,5,5,179,-5,2019,0,4,430,1
Houston,20,31,18,27,0,0,0,0,LA Lakers,35,27,33,24,0,0,0,0,20200912,96,119,15,11,26,23,23,215,23,2019,0,5,1371,1
LA Clippers,34,29,16,19,0,0,0,0,Denver,26,21,30,34,0,0,0,0,20200913,98,111,-8,-16,-2,13,13,209,13,2019,0,6,830,1
Miami,18,37,16,35,11,0,0,0,Boston,26,29,28,23,8,0,0,0,20200915,117,114,-8,0,-12,0,3,231,-3,2019,1,1,1257,1
Denver,24,30,28,22,0,0,0,0,LA Clippers,24,32,18,15,0,0,0,0,20200915,104,89,0,-2,8,15,15,193,-15,2019,0,1,830,1
Miami,28,19,37,22,0,0,0,0,Boston,31,29,17,24,0,0,0,0,20200917,106,101,-3,-13,7,5,5,207,-5,2019,0,3,1257,1
Denver,38,21,20,35,0,0,0,0,LA Lakers,36,34,33,23,0,0,0,0,20200918,114,126,-2,11,24,12,12,240,12,2019,0,4,830,1
Boston,31,32,26,28,0,0,0,0,Miami,22,28,24,32,0,0,0,0,20200919,117,106,9,13,15,11,11,223,-11,2019,0,5,1257,1
Denver,21,29,28,25,0,0,0,0,LA Lakers,29,31,22,23,0,0,0,0,20200920,103,105,8,10,4,2,2,208,2,2019,0,6,830,1
LA Lakers,27,26,22,31,0,0,0,0,Denver,29,34,30,21,0,0,0,0,20200922,106,114,2,10,18,8,8,220,8,2019,0,1,830,1
Boston,23,21,32,33,0,0,0,0,Miami,24,26,27,35,0,0,0,0,20200923,109,112,1,6,1,3,3,221,3,2019,0,2,1257,1
LA Lakers,37,23,27,27,0,0,0,0,Denver,30,25,29,24,0,0,0,0,20200924,114,108,7,5,3,6,6,222,-6,2019,0,3,830,1
Miami,26,32,25,25,0,0,0,0,Boston,18,33,41,29,0,0,0,0,20200925,108,121,-8,-7,9,13,13,229,13,2019,0,4,1257,1
Denver,30,21,33,23,0,0,0,0,LA Lakers,33,28,26,30,0,0,0,0,20200926,107,117,3,10,3,10,10,224,10,2019,0,5,830,1
Boston,27,33,26,27,0,0,0,0,Miami,33,29,26,37,0,0,0,0,20200927,113,125,6,2,2,12,12,238,12,2019,0,6,1257,1
Miami,28,20,19,31,0,0,0,0,LA Lakers,31,34,28,23,0,0,0,0,20200930,98,116,3,17,26,18,18,214,18,2019,0,2,2335,1
Miami,23,31,39,21,0,0,0,0,LA Lakers,29,39,35,21,0,0,0,0,20201002,114,124,6,14,10,10,10,238,10,2019,0,4,2335,1
LA Lakers,23,31,26,24,0,0,0,0,Miami,26,32,27,30,0,0,0,0,20201004,104,115,3,4,5,11,11,219,11,2019,0,6,2335,1
LA Lakers,27,22,26,27,0,0,0,0,Miami,22,25,23,26,0,0,0,0,20201006,102,96,5,2,5,6,6,198,-6,2019,0,1,2335,1
Miami,25,35,28,23,0,0,0,0,LA Lakers,24,32,26,26,0,0,0,0,20201009,111,108,1,4,6,3,3,219,-3,2019,0,4,2335,1
LA Lakers,28,36,23,19,0,0,0,0,Miami,20,16,22,35,0,0,0,0,20201011,106,93,8,28,29,13,13,199,-13,2019,0,6,2335,1
LA Clippers,39,17,33,27,0,0,0,0,LA Lakers,19,35,24,31,0,0,0,0,20201222,116,109,20,2,11,7,7,225,-7,2020,0,1,0,1
Golden State,25,20,26,28,0,0,0,0,Brooklyn,40,23,36,26,0,0,0,0,20201222,99,125,15,18,28,26,26,224,26,2020,0,1,2565,1
Milwaukee,34,25,25,37,0,0,0,0,Boston,31,33,37,21,0,0,0,0,20201223,121,122,-3,5,17,1,1,243,1,2020,0,2,855,1
New Orleans,23,27,38,25,0,0,0,0,Toronto,26,31,22,20,0,0,0,0,20201223,113,99,-3,-7,9,14,14,212,-14,2020,0,2,1112,1
Dallas,22,23,26,31,0,0,0,0,Phoenix,23,30,24,29,0,0,0,0,20201223,102,106,1,8,6,4,4,208,4,2020,0,2,884,1
Washington,26,33,24,24,0,0,0,0,Philadelphia,30,28,15,40,0,0,0,0,20201223,107,113,4,-1,-10,6,6,220,6,2020,0,2,123,1
Miami,29,24,30,24,0,0,0,0,Orlando,27,29,23,34,0,0,0,0,20201223,107,113,-2,3,-4,6,6,220,6,2020,0,2,204,1
Detroit,34,23,28,16,0,0,0,0,Minnesota,25,31,24,31,0,0,0,0,20201223,101,111,-9,-1,-5,10,10,212,10,2020,0,2,542,1
Utah,32,33,29,26,0,0,0,0,Portland,25,19,24,32,0,0,0,0,20201223,120,100,7,21,26,20,20,220,-20,2020,0,2,634,1
New York,33,33,16,25,0,0,0,0,Indiana,35,26,27,33,0,0,0,0,20201223,107,121,2,-5,6,14,14,228,14,2020,0,2,643,1
Sacramento,25,28,36,23,12,0,0,0,Denver,31,29,24,28,10,0,0,0,20201223,124,122,-6,-7,5,0,2,246,-2,2020,1,2,886,1
Charlotte,23,21,36,34,0,0,0,0,Cleveland,24,41,28,28,0,0,0,0,20201223,114,121,1,21,13,7,7,235,7,2020,0,2,435,1
Atlanta,42,41,28,13,0,0,0,0,Chicago,29,30,20,25,0,0,0,0,20201223,124,104,13,24,32,20,20,228,-20,2020,0,2,587,1
San Antonio,30,36,33,32,0,0,0,0,Memphis,33,20,35,31,0,0,0,0,20201223,131,119,-3,13,11,12,12,250,-12,2020,0,2,631,1
Brooklyn,26,25,35,37,0,0,0,0,Boston,22,32,23,18,0,0,0,0,20201225,123,95,4,-3,9,28,28,218,-28,2020,0,4,190,1
LA Clippers,32,40,26,23,0,0,0,0,Denver,26,29,24,29,0,0,0,0,20201225,121,108,6,17,19,13,13,229,-13,2020,0,4,830,1
Dallas,30,27,28,30,0,0,0,0,LA Lakers,33,36,30,39,0,0,0,0,20201225,115,138,3,12,14,23,23,253,23,2020,0,4,1237,1
New Orleans,26,27,26,19,0,0,0,0,Miami,29,37,22,23,0,0,0,0,20201225,98,111,3,13,9,13,13,209,13,2020,0,4,668,1
Golden State,25,31,20,23,0,0,0,0,Milwaukee,33,33,34,38,0,0,0,0,20201225,99,138,8,10,24,39,39,237,39,2020,0,4,1838,1
Phoenix,25,29,25,24,0,0,0,0,Sacramento,31,27,25,23,0,0,0,0,20201226,103,106,6,4,4,3,3,209,3,2020,0,5,634,1
Minnesota,31,37,20,28,0,0,0,0,Utah,27,26,26,32,0,0,0,0,20201226,116,111,4,15,9,5,5,227,-5,2020,0,5,984,1
Toronto,39,19,28,28,0,0,0,0,San Antonio,33,28,30,28,0,0,0,0,20201226,114,119,-6,3,5,5,5,233,5,2020,0,5,1438,1
Houston,31,37,17,28,13,0,0,0,Portland,27,31,26,29,15,0,0,0,20201226,126,128,-4,-10,-1,0,2,254,2,2020,1,5,1833,1
Orlando,32,31,29,38,0,0,0,0,Washington,32,27,32,29,0,0,0,0,20201226,130,120,0,4,1,10,10,250,-10,2020,0,5,757,1
Atlanta,27,31,29,35,0,0,0,0,Memphis,22,34,32,24,0,0,0,0,20201226,122,112,5,2,-1,10,10,234,-10,2020,0,5,336,1
Cleveland,26,33,22,20,11,16,0,0,Detroit,26,27,33,15,11,7,0,0,20201226,128,119,0,6,-5,0,9,247,-9,2020,2,5,90,1
Oklahoma City,26,31,23,29,0,0,0,0,Charlotte,28,31,16,32,0,0,0,0,20201226,109,107,-2,-2,5,2,2,216,-2,2020,0,5,938,1
Indiana,27,39,33,26,0,0,0,0,Chicago,28,28,15,35,0,0,0,0,20201226,125,106,-1,10,28,19,19,231,-19,2020,0,5,163,1
Philadelphia,27,33,26,23,0,0,0,0,New York,27,28,14,20,0,0,0,0,20201226,109,89,0,5,17,20,20,198,-20,2020,0,5,80,1
Orlando,29,33,15,43,0,0,0,0,Washington,35,25,34,19,0,0,0,0,20201227,120,113,-6,2,-17,7,7,233,-7,2020,0,6,757,1
Phoenix,28,28,34,26,0,0,0,0,Sacramento,33,20,25,22,0,0,0,0,20201227,116,100,-5,3,12,16,16,216,-16,2020,0,6,634,1
Milwaukee,27,18,30,35,0,0,0,0,New York,30,31,35,34,0,0,0,0,20201227,110,130,3,16,21,20,20,240,20,2020,0,6,732,1
Minnesota,23,22,22,24,0,0,0,0,LA Lakers,40,27,36,24,0,0,0,0,20201227,91,127,17,22,36,36,36,218,36,2020,0,6,1521,1
San Antonio,18,27,26,24,0,0,0,0,New Orleans,16,31,32,19,0,0,0,0,20201227,95,98,-2,2,8,3,3,193,3,2020,0,6,506,1
Boston,23,32,28,24,0,0,0,0,Indiana,19,30,39,20,0,0,0,0,20201227,107,108,-4,-6,5,1,1,215,1,2020,0,6,805,1
Philadelphia,24,26,22,22,0,0,0,0,Cleveland,29,35,29,25,0,0,0,0,20201227,94,118,5,14,21,24,24,212,24,2020,0,6,358,1
Brooklyn,22,28,27,27,0,0,0,0,Charlotte,23,25,34,24,0,0,0,0,20201227,104,106,1,-2,5,2,2,210,2,2020,0,6,531,1
Golden State,24,36,33,36,0,0,0,0,Chicago,27,29,41,31,0,0,0,0,20201227,129,128,-3,4,-4,1,1,257,-1,2020,0,6,1853,1
Dallas,36,41,27,20,0,0,0,0,LA Clippers,13,14,30,16,0,0,0,0,20201227,124,73,23,50,47,51,51,197,-51,2020,0,6,1237,1
Detroit,25,31,31,33,0,0,0,0,Atlanta,33,32,35,28,0,0,0,0,20201228,120,128,8,9,13,8,8,248,8,2020,0,0,597,1
Memphis,32,22,33,19,10,0,0,0,Brooklyn,23,32,30,21,5,0,0,0,20201228,116,111,9,-1,2,0,5,227,-5,2020,1,0,953,1
Houston,26,34,23,28,0,0,0,0,Denver,36,34,36,18,0,0,0,0,20201228,111,124,10,10,23,13,13,235,13,2020,0,0,878,1
Portland,22,36,26,31,0,0,0,0,LA Lakers,30,24,31,22,0,0,0,0,20201228,115,107,-8,4,-1,8,8,222,-8,2020,0,0,826,1
Utah,22,27,35,26,0,0,0,0,Oklahoma City,24,28,35,22,0,0,0,0,20201228,110,109,-2,-3,-3,1,1,219,-1,2020,0,0,861,1
Toronto,28,28,20,17,0,0,0,0,Philadelphia,17,31,28,24,0,0,0,0,20201229,93,100,-11,-8,0,7,7,193,7,2020,0,1,334,1
Denver,34,28,38,15,0,0,0,0,Sacramento,32,42,22,29,0,0,0,0,20201229,115,125,-2,12,-4,10,10,240,10,2020,0,1,886,1
Chicago,31,21,31,32,0,0,0,0,Washington,26,20,27,34,0,0,0,0,20201229,115,107,5,6,10,8,8,222,-8,2020,0,1,594,1
Orlando,34,26,27,31,0,0,0,0,Oklahoma City,27,29,29,22,0,0,0,0,20201229,118,107,7,4,2,11,11,225,-11,2020,0,1,1057,1
New Orleans,29,15,17,25,0,0,0,0,Phoenix,31,35,34,11,0,0,0,0,20201229,86,111,2,22,39,25,25,197,25,2020,0,1,1312,1
Minnesota,29,21,26,25,0,0,0,0,LA Clippers,33,37,35,19,0,0,0,0,20201229,101,124,4,20,29,23,23,225,23,2020,0,1,1521,1
Boston,31,27,25,33,0,0,0,0,Indiana,26,31,37,17,0,0,0,0,20201229,116,111,5,1,-11,5,5,227,-5,2020,0,1,805,1
Golden State,24,24,29,39,0,0,0,0,Detroit,29,22,25,30,0,0,0,0,20201229,116,106,-5,-3,1,10,10,222,-10,2020,0,1,2087,1
New York,29,24,18,24,0,0,0,0,Cleveland,15,31,18,22,0,0,0,0,20201229,95,86,14,7,7,9,9,181,-9,2020,0,1,403,1
Milwaukee,46,37,32,29,0,0,0,0,Miami,26,25,24,22,0,0,0,0,20201229,144,97,20,32,40,47,47,241,-47,2020,0,1,1269,1
Memphis,19,21,31,36,0,0,0,0,Boston,31,35,30,30,0,0,0,0,20201230,107,126,12,26,25,19,19,233,19,2020,0,2,1134,1
Atlanta,41,27,36,37,0,0,0,0,Brooklyn,38,29,35,43,0,0,0,0,20201230,141,145,-3,-1,-2,4,4,286,4,2020,0,2,745,1
Charlotte,36,32,30,20,0,0,0,0,Dallas,29,28,12,30,0,0,0,0,20201230,118,99,7,11,29,19,19,217,-19,2020,0,2,928,1
Portland,26,31,28,20,0,0,0,0,LA Clippers,37,39,31,21,0,0,0,0,20201230,105,128,11,19,22,23,23,233,23,2020,0,2,826,1
Milwaukee,19,37,35,17,0,0,0,0,Miami,25,26,37,31,0,0,0,0,20201230,108,119,6,-5,-3,11,11,227,11,2020,0,2,1269,1
LA Lakers,35,28,29,29,0,0,0,0,San Antonio,27,26,29,25,0,0,0,0,20201230,121,107,8,10,10,14,14,228,-14,2020,0,2,1201,1
Chicago,35,36,36,26,0,0,0,0,Washington,41,27,32,30,0,0,0,0,20201231,133,130,-6,3,7,3,3,263,-3,2020,0,3,594,1
Phoenix,21,32,30,23,0,0,0,0,Utah,22,18,30,25,0,0,0,0,20201231,106,95,-1,13,13,11,11,201,-11,2020,0,3,505,1
New York,18,24,22,19,0,0,0,0,Toronto,22,20,29,29,0,0,0,0,20201231,83,100,4,0,7,17,17,183,17,2020,0,3,341,1
Philadelphia,38,37,23,18,0,0,0,0,Orlando,22,18,29,23,0,0,0,0,20201231,116,92,16,35,29,24,24,208,-24,2020,0,3,864,1
Cleveland,21,30,17,31,0,0,0,0,Indiana,32,25,31,31,0,0,0,0,20201231,99,119,11,6,20,20,20,218,20,2020,0,3,262,1
Sacramento,33,26,27,33,0,0,0,0,Houston,32,31,24,35,0,0,0,0,20201231,119,122,-1,4,1,3,3,241,3,2020,0,3,1606,1
New Orleans,32,26,27,28,0,0,0,0,Oklahoma City,28,19,26,7,0,0,0,0,20201231,113,80,4,11,12,33,33,193,-33,2020,0,3,576,1
Atlanta,29,32,28,25,0,0,0,0,Brooklyn,23,29,21,23,0,0,0,0,20210101,114,96,6,9,16,18,18,210,-18,2020,0,4,745,1
Memphis,23,30,30,25,0,0,0,0,Charlotte,19,28,20,26,0,0,0,0,20210101,108,93,4,6,16,15,15,201,-15,2020,0,4,519,1
Miami,16,15,22,30,0,0,0,0,Dallas,20,26,27,20,0,0,0,0,20210101,83,93,4,15,20,10,10,176,10,2020,0,4,1110,1
Phoenix,34,26,27,19,0,0,0,0,Denver,32,17,29,25,0,0,0,0,20210101,106,103,2,11,9,3,3,209,-3,2020,0,4,585,1
Boston,12,28,33,20,0,0,0,0,Detroit,27,28,24,17,0,0,0,0,20210101,93,96,15,15,6,3,3,189,3,2020,0,4,611,1
Portland,36,31,31,25,0,0,0,0,Golden State,21,34,25,18,0,0,0,0,20210101,123,98,15,12,18,25,25,221,-25,2020,0,4,535,1
Chicago,21,19,35,21,0,0,0,0,Milwaukee,27,35,34,30,0,0,0,0,20210101,96,126,6,22,21,30,30,222,30,2020,0,4,83,1
Washington,37,23,40,30,0,0,0,0,Minnesota,25,32,14,38,0,0,0,0,20210101,130,109,12,3,29,21,21,239,-21,2020,0,4,931,1
LA Lakers,25,33,23,28,0,0,0,0,San Antonio,31,26,28,18,0,0,0,0,20210101,109,103,-6,1,-4,6,6,212,-6,2020,0,4,1201,1
LA Clippers,19,23,23,35,0,0,0,0,Utah,31,20,33,22,0,0,0,0,20210101,100,106,12,9,19,6,6,206,6,2020,0,4,579,1
Oklahoma City,28,24,32,24,0,0,0,0,Orlando,33,18,31,17,0,0,0,0,20210102,108,99,-5,1,2,9,9,207,-9,2020,0,5,1057,1
Toronto,26,34,22,34,0,0,0,0,New Orleans,32,23,32,33,0,0,0,0,20210102,116,120,6,-5,5,4,4,236,4,2020,0,5,1112,1
Charlotte,24,34,32,22,0,0,0,0,Philadelphia,39,34,31,23,0,0,0,0,20210102,112,127,15,15,14,15,15,239,15,2020,0,5,450,1
Sacramento,36,28,17,13,0,0,0,0,Houston,36,28,19,19,0,0,0,0,20210102,94,102,0,0,2,8,8,196,8,2020,0,5,1606,1
Cleveland,25,19,26,26,0,0,0,0,Atlanta,35,21,18,17,0,0,0,0,20210102,96,91,-10,-12,-4,5,5,187,-5,2020,0,5,555,1
New York,26,24,32,24,0,0,0,0,Indiana,28,23,31,20,0,0,0,0,20210102,106,102,-2,-1,0,4,4,208,-4,2020,0,5,643,1
Utah,33,32,33,32,0,0,0,0,San Antonio,23,28,25,33,0,0,0,0,20210103,130,109,10,14,22,21,21,239,-21,2020,0,6,1087,1
Denver,29,26,28,41,0,0,0,0,Minnesota,28,20,36,25,0,0,0,0,20210103,124,109,1,7,-1,15,15,233,-15,2020,0,6,698,1
LA Clippers,37,27,24,24,0,0,0,0,Phoenix,24,20,37,26,0,0,0,0,20210103,112,107,13,20,7,5,5,219,-5,2020,0,6,356,1
LA Lakers,25,31,21,31,0,0,0,0,Memphis,36,18,21,19,0,0,0,0,20210103,108,94,-11,2,2,14,14,202,-14,2020,0,6,1599,1
Washington,29,41,24,29,0,0,0,0,Brooklyn,28,43,22,29,0,0,0,0,20210103,123,122,1,-1,1,1,1,245,-1,2020,0,6,204,1
Boston,31,30,30,31,0,0,0,0,Detroit,33,24,31,32,0,0,0,0,20210103,122,120,-2,4,3,2,2,242,-2,2020,0,6,611,1
Portland,33,21,29,39,0,0,0,0,Golden State,36,30,31,40,0,0,0,0,20210103,122,137,3,12,14,15,15,259,15,2020,0,6,535,1
Dallas,31,29,21,27,0,0,0,0,Chicago,31,28,27,32,0,0,0,0,20210103,108,118,0,-1,5,10,10,226,10,2020,0,6,802,1
Boston,23,38,39,26,0,0,0,0,Toronto,32,14,35,33,0,0,0,0,20210104,126,114,-9,15,19,12,12,240,-12,2020,0,0,430,1
New York,31,23,30,29,0,0,0,0,Atlanta,29,29,30,20,0,0,0,0,20210104,113,108,2,-4,-4,5,5,221,-5,2020,0,0,745,1
Sacramento,20,28,27,31,0,0,0,0,Golden State,37,31,32,37,0,0,0,0,20210104,106,137,17,20,25,31,31,243,31,2020,0,0,75,1
Dallas,33,28,23,29,0,0,0,0,Houston,21,28,28,23,0,0,0,0,20210104,113,100,12,12,7,13,13,213,-13,2020,0,0,225,1
Oklahoma City,26,23,17,24,0,0,0,0,Miami,26,37,28,27,0,0,0,0,20210104,90,118,0,14,25,28,28,208,28,2020,0,0,1225,1
Detroit,26,30,24,35,0,0,0,0,Milwaukee,33,34,30,28,0,0,0,0,20210104,115,125,7,11,17,10,10,240,10,2020,0,0,251,1
Indiana,26,27,26,27,12,0,0,0,New Orleans,24,27,26,29,10,0,0,0,20210104,118,116,2,2,2,0,2,234,-2,2020,1,0,713,1
Cleveland,19,30,18,16,0,0,0,0,Orlando,26,25,38,14,0,0,0,0,20210104,83,103,7,2,22,20,20,186,20,2020,0,0,895,1
Charlotte,20,23,23,35,0,0,0,0,Philadelphia,23,35,24,36,0,0,0,0,20210104,101,118,3,15,16,17,17,219,17,2020,0,0,450,1
Chicago,21,24,36,30,0,0,0,0,Portland,39,15,31,23,0,0,0,0,20210105,111,108,-18,-9,-4,3,3,219,-3,2020,0,1,1754,1
San Antonio,36,27,22,31,0,0,0,0,LA Clippers,27,17,40,29,0,0,0,0,20210105,116,113,9,19,1,3,3,229,-3,2020,0,1,1201,1
LA Lakers,19,26,22,27,0,0,0,0,Memphis,24,25,19,24,0,0,0,0,20210105,94,92,-5,-4,-1,2,2,186,-2,2020,0,1,1599,1
Utah,14,30,29,23,0,0,0,0,Brooklyn,35,28,35,32,0,0,0,0,20210105,96,130,21,19,25,34,34,226,34,2020,0,1,1967,1
Minnesota,22,43,31,20,0,0,0,0,Denver,34,28,31,30,0,0,0,0,20210105,116,123,12,-3,-3,7,7,239,7,2020,0,1,698,1
Utah,27,29,19,25,0,0,0,0,New York,20,24,34,34,0,0,0,0,20210106,100,112,-7,-12,3,12,12,212,12,2020,0,2,1967,1
Chicago,25,34,34,31,0,0,0,0,Sacramento,28,34,31,35,0,0,0,0,20210106,124,128,3,3,0,4,4,252,4,2020,0,2,1788,1
Washington,24,43,39,30,0,0,0,0,Philadelphia,33,49,34,25,0,0,0,0,20210106,136,141,9,15,10,5,5,277,5,2020,0,2,123,1
Cleveland,23,22,19,30,0,0,0,0,Orlando,15,36,32,22,0,0,0,0,20210106,94,105,-8,6,19,11,11,199,11,2020,0,2,895,1
Oklahoma City,26,28,34,23,0,0,0,0,New Orleans,34,25,19,32,0,0,0,0,20210106,111,110,-8,-5,10,1,1,221,-1,2020,0,2,576,1
Toronto,25,29,33,28,0,0,0,0,Phoenix,22,36,38,27,0,0,0,0,20210106,115,123,-3,4,9,8,8,238,8,2020,0,2,1885,1
Boston,34,19,27,27,0,0,0,0,Miami,26,19,35,25,0,0,0,0,20210106,107,105,8,8,0,2,2,212,-2,2020,0,2,1257,1
Houston,30,26,31,20,0,0,0,0,Indiana,35,27,28,24,0,0,0,0,20210106,107,114,5,6,3,7,7,221,7,2020,0,2,865,1
LA Clippers,21,31,31,25,0,0,0,0,Golden State,15,36,26,24,0,0,0,0,20210106,108,101,6,1,6,7,7,209,-7,2020,0,2,347,1
Charlotte,27,32,22,21,0,0,0,0,Atlanta,11,29,27,27,0,0,0,0,20210106,102,94,16,19,14,8,8,196,-8,2020,0,2,226,1
Detroit,33,23,26,33,0,0,0,0,Milwaukee,44,38,26,22,0,0,0,0,20210106,115,130,11,26,26,15,15,245,15,2020,0,2,251,1
Minnesota,29,27,24,37,0,0,0,0,Portland,28,47,36,24,0,0,0,0,20210107,117,135,-1,19,31,18,18,252,18,2020,0,3,1423,1
Cleveland,19,27,21,27,0,0,0,0,Memphis,24,21,24,21,0,0,0,0,20210107,94,90,-5,1,-2,4,4,184,-4,2020,0,3,629,1
Philadelphia,26,25,33,25,0,0,0,0,Brooklyn,28,37,29,28,0,0,0,0,20210107,109,122,2,14,10,13,13,231,13,2020,0,3,80,1
Dallas,22,21,33,33,15,0,0,0,Denver,28,24,26,31,8,0,0,0,20210107,124,117,-6,-9,-2,0,7,241,-7,2020,1,3,661,1
San Antonio,34,31,26,27,0,0,0,0,LA Lakers,26,30,33,20,0,0,0,0,20210107,118,109,8,9,2,9,9,227,-9,2020,0,3,1201,1
Toronto,35,36,40,33,0,0,0,0,Sacramento,43,31,29,20,0,0,0,0,20210108,144,123,-8,-3,8,21,21,267,-21,2020,0,4,2195,1
Charlotte,22,25,35,36,0,0,0,0,New Orleans,38,21,28,23,0,0,0,0,20210108,118,110,-16,-12,-5,8,8,228,-8,2020,0,4,648,1
Utah,34,31,39,27,0,0,0,0,Milwaukee,31,27,38,22,0,0,0,0,20210108,131,118,3,7,8,13,13,249,-13,2020,0,4,1239,1
Brooklyn,28,19,39,24,0,0,0,0,Memphis,40,22,30,23,0,0,0,0,20210108,110,115,12,15,6,5,5,225,5,2020,0,4,953,1
Oklahoma City,15,27,27,32,0,0,0,0,New York,24,18,21,26,0,0,0,0,20210108,101,89,-9,0,6,12,12,190,-12,2020,0,4,1324,1
Orlando,17,16,24,33,0,0,0,0,Houston,32,30,31,39,0,0,0,0,20210108,90,132,15,29,36,42,42,222,42,2020,0,4,847,1
LA Clippers,30,35,22,18,0,0,0,0,Golden State,22,29,30,34,0,0,0,0,20210108,105,115,-8,-14,-6,10,10,220,10,2020,0,4,347,1
Phoenix,29,27,20,17,12,0,0,0,Detroit,20,28,24,21,17,0,0,0,20210108,105,110,-9,-8,-4,0,5,215,5,2020,1,4,1687,1
Washington,28,19,34,26,0,0,0,0,Boston,33,33,30,20,0,0,0,0,20210108,107,116,5,19,15,9,9,223,9,2020,0,4,394,1
Chicago,33,25,30,27,0,0,0,0,LA Lakers,28,31,33,25,0,0,0,0,20210108,115,117,-5,1,4,2,2,232,2,2020,0,4,1741,1
Miami,47,28,28,25,0,0,0,0,Washington,44,27,15,38,0,0,0,0,20210109,128,124,3,4,17,4,4,252,-4,2020,0,5,924,1
Atlanta,29,21,26,29,0,0,0,0,Charlotte,28,31,28,26,0,0,0,0,20210109,105,113,-1,9,11,8,8,218,8,2020,0,5,226,1
Orlando,27,23,25,23,0,0,0,0,Dallas,36,20,29,27,0,0,0,0,20210109,98,112,9,6,10,14,14,210,14,2020,0,5,961,1
Phoenix,30,26,34,35,0,0,0,0,Indiana,32,21,34,30,0,0,0,0,20210109,125,117,-2,3,3,8,8,242,-8,2020,0,5,1496,1
Cleveland,14,23,26,27,0,0,0,0,Milwaukee,27,20,31,22,0,0,0,0,20210109,90,100,13,10,15,10,10,190,10,2020,0,5,334,1
San Antonio,28,32,23,30,12,0,0,0,Minnesota,34,24,27,28,9,0,0,0,20210109,125,122,-6,2,-2,0,3,247,-3,2020,1,5,1112,1
Denver,28,30,35,22,0,0,0,0,Philadelphia,26,25,21,31,0,0,0,0,20210109,115,103,2,7,21,12,12,218,-12,2020,0,5,1574,1
Portland,38,28,27,32,0,0,0,0,Sacramento,24,25,20,30,0,0,0,0,20210109,125,99,14,17,24,26,26,224,-26,2020,0,5,483,1
San Antonio,22,27,20,19,0,0,0,0,Minnesota,25,19,22,30,0,0,0,0,20210110,88,96,3,-5,-3,8,8,184,8,2020,0,6,1112,1
Toronto,24,27,21,33,0,0,0,0,Golden State,31,30,26,19,0,0,0,0,20210110,105,106,7,10,15,1,1,211,1,2020,0,6,2263,1
Denver,28,31,23,32,0,0,0,0,New York,21,17,26,25,0,0,0,0,20210110,114,89,7,21,18,25,25,203,-25,2020,0,6,1627,1
Chicago,31,28,35,33,0,0,0,0,LA Clippers,22,30,42,36,0,0,0,0,20210110,127,130,-9,-7,0,3,3,257,3,2020,0,6,1741,1
Utah,34,23,17,22,0,0,0,0,Detroit,19,21,28,18,0,0,0,0,20210110,96,86,15,17,6,10,10,182,-10,2020,0,6,1488,1
LA Lakers,25,40,23,32,0,0,0,0,Houston,21,25,29,27,0,0,0,0,20210110,120,102,4,19,13,18,18,222,-18,2020,0,6,1371,1
Oklahoma City,29,28,37,35,0,0,0,0,Brooklyn,41,22,18,35,0,0,0,0,20210110,129,116,-12,-6,13,13,13,245,-13,2020,0,6,1324,1
Philadelphia,32,18,15,29,0,0,0,0,Atlanta,28,37,32,15,0,0,0,0,20210111,94,112,-4,15,32,18,18,206,18,2020,0,0,665,1
New York,25,25,18,20,0,0,0,0,Charlotte,31,26,25,27,0,0,0,0,20210111,88,109,6,7,14,21,21,197,21,2020,0,0,531,1
Memphis,24,23,30,24,0,0,0,0,Cleveland,27,19,25,20,0,0,0,0,20210111,101,91,-3,1,6,10,10,192,-10,2020,0,0,629,1
Milwaukee,25,38,23,35,0,0,0,0,Orlando,23,31,28,17,0,0,0,0,20210111,121,99,2,9,4,22,22,220,-22,2020,0,0,1065,1
Toronto,32,28,26,25,0,0,0,0,Portland,21,34,21,36,0,0,0,0,20210111,111,112,-11,-5,-10,1,1,223,1,2020,0,0,2108,1
Indiana,30,34,29,29,0,0,0,0,Sacramento,30,35,32,30,0,0,0,0,20210111,122,127,0,1,4,5,5,249,5,2020,0,0,1882,1
Phoenix,15,27,36,29,0,0,0,0,Washington,29,39,36,24,0,0,0,0,20210111,107,128,14,26,26,21,21,235,21,2020,0,0,1977,1
Miami,25,38,32,25,14,0,0,0,Philadelphia,28,27,41,24,17,0,0,0,20210112,134,137,3,-8,1,0,3,271,3,2020,1,1,1021,1
San Antonio,26,25,29,32,0,0,0,0,Oklahoma City,26,17,30,29,0,0,0,0,20210112,112,102,0,8,7,10,10,214,-10,2020,0,1,421,1
LA Lakers,35,36,26,20,0,0,0,0,Houston,14,34,23,29,0,0,0,0,20210112,117,100,21,23,26,17,17,217,-17,2020,0,1,1371,1
Utah,22,27,38,30,0,0,0,0,Cleveland,18,18,23,28,0,0,0,0,20210112,117,87,4,13,28,30,30,204,-30,2020,0,1,1564,1
Denver,35,35,20,26,0,0,0,0,Brooklyn,27,27,36,32,0,0,0,0,20210112,116,122,-8,-16,0,6,6,238,6,2020,0,1,1627,1
Indiana,19,31,23,31,0,0,0,0,Golden State,28,29,18,20,0,0,0,0,20210112,104,95,-9,-7,-2,9,9,199,-9,2020,0,1,1944,1
Dallas,32,28,27,17,0,0,0,0,Charlotte,16,27,29,21,0,0,0,0,20210113,104,93,16,17,15,11,11,197,-11,2020,0,2,928,1
Milwaukee,27,31,31,21,0,0,0,0,Detroit,13,34,28,26,0,0,0,0,20210113,110,101,14,11,14,9,9,211,-9,2020,0,2,251,1
New Orleans,28,15,28,35,0,0,0,0,LA Clippers,28,33,22,28,0,0,0,0,20210113,106,111,0,18,12,5,5,217,5,2020,0,2,1669,1
Memphis,27,29,24,38,0,0,0,0,Minnesota,29,29,32,17,0,0,0,0,20210113,118,107,-2,-2,-10,11,11,225,-11,2020,0,2,700,1
Brooklyn,26,35,31,24,0,0,0,0,New York,25,20,31,33,0,0,0,0,20210113,116,109,1,16,16,7,7,225,-7,2020,0,2,0,1
LA Lakers,30,28,35,35,0,0,0,0,Oklahoma City,21,25,25,28,0,0,0,0,20210113,128,99,9,12,22,29,29,227,-29,2020,0,2,1178,1
Portland,33,32,35,32,0,0,0,0,Sacramento,43,25,37,21,0,0,0,0,20210113,132,126,-10,-3,-5,6,6,258,-6,2020,0,2,483,1
Houston,30,18,27,34,0,0,0,0,San Antonio,27,18,34,26,0,0,0,0,20210114,109,105,3,3,-4,4,4,214,-4,2020,0,3,189,1
Charlotte,34,28,24,22,0,0,0,0,Toronto,35,36,28,12,0,0,0,0,20210114,108,111,1,9,13,3,3,219,3,2020,0,3,585,1
Indiana,26,33,25,27,0,0,0,0,Portland,26,10,35,16,0,0,0,0,20210114,111,87,0,23,13,24,24,198,-24,2020,0,3,1880,1
Golden State,24,30,22,28,0,0,0,0,Denver,37,28,25,24,0,0,0,0,20210114,104,114,13,11,14,10,10,218,10,2020,0,3,947,1
Miami,30,28,20,30,0,0,0,0,Philadelphia,38,35,25,27,0,0,0,0,20210114,108,125,8,15,20,17,17,233,17,2020,0,3,1021,1
Orlando,28,20,24,25,0,0,0,0,Boston,34,26,28,36,0,0,0,0,20210115,97,124,6,12,16,27,27,221,27,2020,0,4,1115,1
New York,25,30,25,23,0,0,0,0,Cleveland,28,29,23,26,0,0,0,0,20210115,103,106,3,2,0,3,3,209,3,2020,0,4,403,1
New Orleans,28,30,16,21,0,0,0,0,LA Lakers,20,37,27,28,0,0,0,0,20210115,95,112,-8,-1,10,17,17,207,17,2020,0,4,1669,1
Dallas,23,24,34,28,0,0,0,0,Milwaukee,30,25,29,28,0,0,0,0,20210115,109,112,7,8,3,3,3,221,3,2020,0,4,857,1
Chicago,30,38,27,23,7,0,0,0,Oklahoma City,22,28,37,31,9,0,0,0,20210115,125,127,-8,-18,-8,0,2,252,2,2020,1,4,690,1
LA Clippers,34,35,37,32,0,0,0,0,Sacramento,31,30,16,23,0,0,0,0,20210115,138,100,3,8,29,38,38,238,-38,2020,0,4,361,1
Atlanta,23,23,28,18,0,0,0,0,Utah,33,28,26,29,0,0,0,0,20210115,92,116,10,15,13,24,24,208,24,2020,0,4,1580,1
Philadelphia,26,28,22,28,0,0,0,0,Memphis,25,35,28,18,0,0,0,0,20210116,104,106,-1,6,12,2,2,210,2,2020,0,5,878,1
Orlando,26,24,33,32,0,0,0,0,Brooklyn,29,23,32,38,0,0,0,0,20210116,115,122,3,2,1,7,7,237,7,2020,0,5,939,1
Detroit,29,23,38,30,0,0,0,0,Miami,23,33,19,25,0,0,0,0,20210116,120,100,6,-4,15,20,20,220,-20,2020,0,5,1155,1
Atlanta,38,28,20,20,0,0,0,0,Portland,34,25,27,26,0,0,0,0,20210116,106,112,-4,-7,0,6,6,218,6,2020,0,5,2168,1
Houston,30,23,19,19,0,0,0,0,San Antonio,21,29,25,28,0,0,0,0,20210116,91,103,-9,-3,3,12,12,194,12,2020,0,5,189,1
Charlotte,27,37,23,26,0,0,0,0,Toronto,31,35,22,28,0,0,0,0,20210116,113,116,4,2,1,3,3,229,3,2020,0,5,585,1
Indiana,26,29,20,21,0,0,0,0,LA Clippers,36,25,39,29,0,0,0,0,20210117,96,129,10,6,25,33,33,225,33,2020,0,6,1805,1
Utah,32,21,28,28,0,0,0,0,Denver,31,27,21,26,0,0,0,0,20210117,109,105,1,-5,2,4,4,214,-4,2020,0,6,370,1
New Orleans,34,33,30,31,0,0,0,0,Sacramento,25,33,36,29,0,0,0,0,20210117,128,123,9,9,3,5,5,251,-5,2020,0,6,1879,1
New York,28,20,27,30,0,0,0,0,Boston,17,18,15,25,0,0,0,0,20210117,105,75,11,13,25,30,30,180,-30,2020,0,6,190,1
Chicago,27,40,22,28,0,0,0,0,Dallas,23,29,23,26,0,0,0,0,20210117,117,101,4,15,14,16,16,218,-16,2020,0,6,802,1
Orlando,13,25,16,30,0,0,0,0,New York,19,28,19,25,0,0,0,0,20210118,84,91,6,9,12,7,7,175,7,2020,0,0,939,1
Detroit,36,25,19,27,0,0,0,0,Miami,24,31,33,25,0,0,0,0,20210118,107,113,-12,-6,8,6,6,220,6,2020,0,0,1155,1
San Antonio,32,27,28,38,0,0,0,0,Portland,28,26,28,22,0,0,0,0,20210118,125,104,4,5,5,21,21,229,-21,2020,0,0,1718,1
Dallas,18,29,25,21,0,0,0,0,Toronto,22,25,34,35,0,0,0,0,20210118,93,116,4,0,9,23,23,209,23,2020,0,0,1201,1
Golden State,22,26,33,34,0,0,0,0,LA Lakers,34,30,28,21,0,0,0,0,20210118,115,113,-12,-16,-11,2,2,228,-2,2020,0,0,347,1
Houston,16,36,34,34,0,0,0,0,Chicago,28,36,29,32,0,0,0,0,20210118,120,125,12,12,7,5,5,245,5,2020,0,0,939,1
Milwaukee,34,22,33,34,0,0,0,0,Brooklyn,28,29,37,31,0,0,0,0,20210118,123,125,-6,1,5,2,2,248,2,2020,0,0,732,1
Minnesota,25,26,20,26,0,0,0,0,Atlanta,29,29,20,30,0,0,0,0,20210118,97,108,4,7,7,11,11,205,11,2020,0,0,908,1
Phoenix,24,24,27,29,0,0,0,0,Memphis,18,34,25,31,0,0,0,0,20210118,104,108,-6,4,2,4,4,212,4,2020,0,0,1260,1
Oklahoma City,31,21,22,27,0,0,0,0,Denver,31,34,32,22,0,0,0,0,20210119,101,119,0,13,23,18,18,220,18,2020,0,1,503,1
New Orleans,24,25,20,33,0,0,0,0,Utah,29,26,36,27,0,0,0,0,20210119,102,118,5,6,22,16,16,220,16,2020,0,1,1432,1
Miami,29,27,32,23,0,0,0,0,Toronto,23,35,25,19,0,0,0,0,20210120,111,102,6,-2,5,9,9,213,-9,2020,0,2,1234,1
Boston,25,36,31,17,0,0,0,0,Philadelphia,32,26,28,31,0,0,0,0,20210120,109,117,7,-3,-6,8,8,226,8,2020,0,2,270,1
Orlando,25,10,33,29,0,0,0,0,Minnesota,21,30,26,19,0,0,0,0,20210120,97,96,4,-16,-9,1,1,193,-1,2020,0,2,1309,1
Dallas,37,28,28,31,0,0,0,0,Indiana,28,35,29,20,0,0,0,0,20210120,124,112,9,2,1,12,12,236,-12,2020,0,2,763,1
Sacramento,29,27,19,21,0,0,0,0,LA Clippers,25,36,34,20,0,0,0,0,20210120,96,115,-4,5,20,19,19,211,19,2020,0,2,361,1
San Antonio,24,21,26,28,0,0,0,0,Golden State,36,28,26,31,0,0,0,0,20210120,99,121,12,19,19,22,22,220,22,2020,0,2,1487,1
Brooklyn,23,26,29,35,14,8,0,0,Cleveland,28,23,36,26,14,20,0,0,20210120,135,147,5,2,9,0,12,282,12,2020,2,2,403,1
Detroit,31,21,40,14,9,0,0,0,Atlanta,29,16,33,28,17,0,0,0,20210120,115,123,-2,-7,-14,0,8,238,8,2020,1,2,597,1
Phoenix,30,33,26,20,0,0,0,0,Houston,23,28,31,21,0,0,0,0,20210120,109,103,7,12,7,6,6,212,-6,2020,0,2,1014,1
New York,40,23,26,30,0,0,0,0,Golden State,31,26,19,28,0,0,0,0,20210121,119,104,9,6,13,15,15,223,-15,2020,0,3,2565,1
LA Lakers,29,34,23,27,0,0,0,0,Milwaukee,33,24,24,25,0,0,0,0,20210121,113,106,-4,6,5,7,7,219,-7,2020,0,3,1741,1
New Orleans,43,26,23,26,0,0,0,0,Utah,31,39,30,29,0,0,0,0,20210121,118,129,-12,1,8,11,11,247,11,2020,0,3,1432,1
Denver,25,29,37,23,16,0,0,0,Phoenix,34,34,27,19,12,0,0,0,20210122,130,126,-9,-14,-4,0,4,256,-4,2020,1,4,585,1
Miami,20,22,22,17,0,0,0,0,Toronto,37,19,17,28,0,0,0,0,20210122,81,101,17,14,9,20,20,182,20,2020,0,4,1234,1
Dallas,37,31,27,27,0,0,0,0,San Antonio,34,24,27,32,0,0,0,0,20210122,122,117,3,10,10,5,5,239,-5,2020,0,4,252,1
New York,26,28,18,22,0,0,0,0,Sacramento,25,24,27,27,0,0,0,0,20210122,94,103,-1,-5,4,9,9,197,9,2020,0,4,2499,1
Boston,33,19,28,30,0,0,0,0,Philadelphia,25,24,42,31,0,0,0,0,20210122,110,122,-8,-3,11,12,12,232,12,2020,0,4,270,1
Atlanta,25,37,30,24,0,0,0,0,Minnesota,19,24,24,31,0,0,0,0,20210122,116,98,6,19,25,18,18,214,-18,2020,0,4,908,1
Oklahoma City,18,35,25,28,0,0,0,0,LA Clippers,36,34,21,29,0,0,0,0,20210122,106,120,18,17,13,14,14,226,14,2020,0,4,1178,1
Orlando,28,32,27,21,10,0,0,0,Indiana,37,25,26,20,12,0,0,0,20210122,118,120,9,2,1,0,2,238,2,2020,1,4,822,1
Houston,34,21,22,26,0,0,0,0,Detroit,21,26,34,21,0,0,0,0,20210122,103,102,13,8,-4,1,1,205,-1,2020,0,4,1105,1
Brooklyn,33,27,24,29,0,0,0,0,Cleveland,34,27,37,27,0,0,0,0,20210122,113,125,1,1,14,12,12,238,12,2020,0,4,403,1
Chicago,30,31,34,28,0,0,0,0,Charlotte,29,24,30,27,0,0,0,0,20210122,123,110,1,8,12,13,13,233,-13,2020,0,4,586,1
Denver,28,30,15,25,8,14,0,0,Phoenix,30,31,16,21,8,6,0,0,20210123,120,112,-2,-3,-4,0,8,232,-8,2020,2,5,585,1
New Orleans,31,33,14,32,0,0,0,0,Minnesota,28,35,24,33,0,0,0,0,20210123,110,120,-3,-1,9,10,10,230,10,2020,0,5,1052,1
Philadelphia,28,33,33,20,0,0,0,0,Detroit,31,32,25,22,0,0,0,0,20210123,114,110,-3,-2,6,4,4,224,-4,2020,0,5,441,1
Golden State,30,17,25,36,0,0,0,0,Utah,39,38,31,19,0,0,0,0,20210123,108,127,9,30,36,19,19,235,19,2020,0,5,599,1
LA Lakers,29,34,20,18,0,0,0,0,Chicago,17,16,33,24,0,0,0,0,20210123,101,90,12,30,17,11,11,191,-11,2020,0,5,1741,1
Miami,25,31,26,42,0,0,0,0,Brooklyn,36,30,30,32,0,0,0,0,20210123,124,128,11,10,14,4,4,252,4,2020,0,5,1091,1
Houston,38,32,34,29,0,0,0,0,Dallas,27,32,24,25,0,0,0,0,20210123,133,108,11,11,21,25,25,241,-25,2020,0,5,225,1
Cleveland,21,30,27,25,0,0,0,0,Boston,38,35,41,27,0,0,0,0,20210124,103,141,17,22,36,38,38,244,38,2020,0,6,549,1
Toronto,24,34,19,30,0,0,0,0,Indiana,24,23,28,27,0,0,0,0,20210124,107,102,0,11,2,5,5,209,-5,2020,0,6,438,1
Oklahoma City,19,26,28,27,0,0,0,0,LA Clippers,36,20,29,23,0,0,0,0,20210124,100,108,17,11,12,8,8,208,8,2020,0,6,1178,1
Atlanta,15,32,36,32,0,0,0,0,Milwaukee,32,34,28,35,0,0,0,0,20210124,115,129,17,19,11,14,14,244,14,2020,0,6,669,1
Charlotte,24,26,24,33,0,0,0,0,Orlando,29,29,28,18,0,0,0,0,20210124,107,104,-5,-8,-12,3,3,211,-3,2020,0,6,463,1
New York,24,26,27,36,0,0,0,0,Portland,37,33,19,27,0,0,0,0,20210124,113,116,13,20,12,3,3,229,3,2020,0,6,2439,1
Washington,26,21,30,24,0,0,0,0,San Antonio,23,25,37,36,0,0,0,0,20210124,101,121,-3,1,8,20,20,222,20,2020,0,6,1385,1
Minnesota,23,31,29,25,0,0,0,0,Golden State,34,34,25,37,0,0,0,0,20210125,108,130,11,14,10,22,22,238,22,2020,0,0,1581,1
Charlotte,30,24,22,32,0,0,0,0,Orlando,19,36,32,30,0,0,0,0,20210125,108,117,-11,1,11,9,9,225,9,2020,0,0,463,1
Toronto,30,30,37,17,0,0,0,0,Indiana,33,37,28,31,0,0,0,0,20210125,114,129,3,10,1,15,15,243,15,2020,0,0,438,1
Philadelphia,23,27,25,29,0,0,0,0,Detroit,34,30,25,30,0,0,0,0,20210125,104,119,11,14,14,15,15,223,15,2020,0,0,441,1
Oklahoma City,34,35,25,31,0,0,0,0,Portland,24,36,31,31,0,0,0,0,20210125,125,122,10,9,3,3,3,247,-3,2020,0,0,1484,1
LA Lakers,34,31,22,28,0,0,0,0,Cleveland,23,35,31,19,0,0,0,0,20210125,115,108,11,7,-2,7,7,223,-7,2020,0,0,2044,1
Miami,21,24,26,14,0,0,0,0,Brooklyn,15,26,29,28,0,0,0,0,20210125,85,98,-6,-4,-1,13,13,183,13,2020,0,0,1091,1
Denver,38,32,22,25,0,0,0,0,Dallas,31,27,36,19,0,0,0,0,20210125,117,113,7,12,-2,4,4,230,-4,2020,0,0,661,1
Boston,33,27,31,28,0,0,0,0,Chicago,25,25,26,27,0,0,0,0,20210125,119,103,8,10,15,16,16,222,-16,2020,0,0,849,1
LA Clippers,21,27,22,29,0,0,0,0,Atlanta,22,21,33,32,0,0,0,0,20210126,99,108,1,-5,6,9,9,207,9,2020,0,1,1932,1
Washington,29,23,18,18,0,0,0,0,Houston,26,30,19,32,0,0,0,0,20210126,88,107,-3,4,5,19,19,195,19,2020,0,1,1217,1
New York,27,32,22,13,0,0,0,0,Utah,18,28,34,28,0,0,0,0,20210126,94,108,-9,-13,-1,14,14,202,14,2020,0,1,1967,1
Oklahoma City,17,28,28,29,0,0,0,0,Phoenix,32,10,29,26,0,0,0,0,20210127,102,97,-15,3,2,5,5,199,-5,2020,0,2,840,1
Dallas,19,29,30,26,0,0,0,0,Utah,32,37,31,16,0,0,0,0,20210127,104,116,13,21,22,12,12,220,12,2020,0,2,998,1
Milwaukee,33,30,20,32,0,0,0,0,Toronto,33,21,28,26,0,0,0,0,20210127,115,108,0,9,1,7,7,223,-7,2020,0,2,429,1
Boston,30,17,37,22,0,0,0,0,San Antonio,25,36,21,28,0,0,0,0,20210127,106,110,-5,14,-2,4,4,216,4,2020,0,2,1765,1
LA Lakers,24,27,23,32,0,0,0,0,Philadelphia,34,21,26,26,0,0,0,0,20210127,106,107,10,4,7,1,1,213,1,2020,0,2,2388,1
Sacramento,32,33,31,25,0,0,0,0,Orlando,23,27,27,30,0,0,0,0,20210127,121,107,9,15,19,14,14,228,-14,2020,0,2,2390,1
Denver,26,32,16,35,0,0,0,0,Miami,12,21,32,17,0,0,0,0,20210127,109,82,14,25,9,27,27,191,-27,2020,0,2,1724,1
Minnesota,21,30,24,36,0,0,0,0,Golden State,23,35,37,28,0,0,0,0,20210127,111,123,2,7,20,12,12,234,12,2020,0,2,1581,1
Detroit,28,28,26,25,0,0,0,0,Cleveland,32,22,36,32,0,0,0,0,20210127,107,122,4,-2,8,15,15,229,15,2020,0,2,90,1
Indiana,36,23,25,32,0,0,0,0,Charlotte,19,36,25,26,0,0,0,0,20210127,116,106,17,4,4,10,10,222,-10,2020,0,2,428,1
Brooklyn,26,29,28,33,16,0,0,0,Atlanta,27,28,32,29,12,0,0,0,20210127,132,128,-1,0,-4,0,4,260,-4,2020,1,2,745,1
Washington,18,27,35,26,0,0,0,0,New Orleans,35,29,30,30,0,0,0,0,20210127,106,124,17,19,14,18,18,230,18,2020,0,2,964,1
LA Lakers,31,27,20,14,0,0,0,0,Detroit,34,22,26,25,0,0,0,0,20210128,92,107,3,-2,4,15,15,199,15,2020,0,3,1979,1
Portland,32,18,27,24,0,0,0,0,Houston,17,36,33,18,0,0,0,0,20210128,101,104,-15,3,9,3,3,205,3,2020,0,3,1833,1
LA Clippers,19,29,40,21,0,0,0,0,Miami,33,17,19,36,0,0,0,0,20210128,109,105,-14,-2,19,4,4,214,-4,2020,0,3,2335,1
Golden State,29,18,24,22,0,0,0,0,Phoenix,36,16,33,29,0,0,0,0,20210128,93,114,7,5,14,21,21,207,21,2020,0,3,652,1
LA Clippers,26,36,28,26,0,0,0,0,Orlando,26,22,23,19,0,0,0,0,20210129,116,90,0,14,19,26,26,206,-26,2020,0,4,2197,1
Dallas,12,33,23,33,0,0,0,0,Utah,37,24,33,26,0,0,0,0,20210129,101,120,25,16,26,19,19,221,19,2020,0,4,998,1
Sacramento,36,32,36,22,0,0,0,0,Toronto,24,34,33,33,0,0,0,0,20210129,126,124,12,10,13,2,2,250,-2,2020,0,4,2195,1
Denver,30,25,31,23,0,0,0,0,San Antonio,37,24,26,32,0,0,0,0,20210129,109,119,7,6,1,10,10,228,10,2020,0,4,802,1
Atlanta,31,30,28,27,0,0,0,0,Washington,22,28,21,29,0,0,0,0,20210129,116,100,9,11,18,16,16,216,-16,2020,0,4,541,1
Brooklyn,36,40,39,32,0,0,0,0,Oklahoma City,27,32,35,31,0,0,0,0,20210129,147,125,9,17,21,22,22,272,-22,2020,0,4,1324,1
Milwaukee,21,24,44,37,0,0,0,0,New Orleans,35,33,35,28,0,0,0,0,20210129,126,131,14,23,14,5,5,257,5,2020,0,4,911,1
Philadelphia,25,28,35,30,0,0,0,0,Minnesota,25,23,26,20,0,0,0,0,20210129,118,94,0,5,14,24,24,212,-24,2020,0,4,983,1
Indiana,28,32,20,25,0,0,0,0,Charlotte,32,32,25,19,0,0,0,0,20210129,105,108,4,4,9,3,3,213,3,2020,0,4,428,1
Cleveland,17,16,22,26,0,0,0,0,New York,19,28,25,30,0,0,0,0,20210129,81,102,2,14,17,21,21,183,21,2020,0,4,403,1
LA Lakers,28,24,19,25,0,0,0,0,Boston,24,25,29,17,0,0,0,0,20210130,96,95,4,3,-7,1,1,191,-1,2020,0,5,2590,1
Portland,32,32,29,30,0,0,0,0,Chicago,34,19,33,36,0,0,0,0,20210130,123,122,-2,11,7,1,1,245,-1,2020,0,5,1754,1
Milwaukee,31,33,30,20,0,0,0,0,Charlotte,39,29,29,29,0,0,0,0,20210130,114,126,8,4,3,12,12,240,12,2020,0,5,658,1
Phoenix,29,26,22,34,0,0,0,0,Dallas,28,27,27,23,0,0,0,0,20210130,111,105,1,0,-5,6,6,216,-6,2020,0,5,884,1
Detroit,17,28,23,23,0,0,0,0,Golden State,29,35,30,24,0,0,0,0,20210130,91,118,12,19,26,27,27,209,27,2020,0,5,2087,1
Sacramento,35,24,18,27,0,0,0,0,Miami,24,33,27,21,0,0,0,0,20210130,104,105,-11,-2,7,1,1,209,1,2020,0,5,2547,1
Houston,27,48,24,27,0,0,0,0,New Orleans,35,22,27,28,0,0,0,0,20210130,126,112,-8,18,15,14,14,238,-14,2020,0,5,317,1
Memphis,35,29,36,29,0,0,0,0,San Antonio,27,29,34,22,0,0,0,0,20210130,129,112,8,8,10,17,17,241,-17,2020,0,5,631,1
Brooklyn,38,33,37,38,0,0,0,0,Washington,28,37,36,48,0,0,0,0,20210131,146,149,-10,-6,-7,3,3,295,3,2020,0,6,204,1
Orlando,15,29,29,29,0,0,0,0,Toronto,27,31,26,31,0,0,0,0,20210131,102,115,12,14,11,13,13,217,13,2020,0,6,1048,1
LA Clippers,29,37,35,28,0,0,0,0,New York,31,34,26,24,0,0,0,0,20210131,129,115,-2,1,10,14,14,244,-14,2020,0,6,2445,1
Philadelphia,18,36,28,37,0,0,0,0,Indiana,28,35,32,15,0,0,0,0,20210131,119,110,-10,-9,-13,9,9,229,-9,2020,0,6,582,1
Utah,29,25,37,26,0,0,0,0,Denver,43,36,24,25,0,0,0,0,20210131,117,128,14,25,12,11,11,245,11,2020,0,6,370,1
Cleveland,35,26,25,18,0,0,0,0,Minnesota,30,25,33,21,0,0,0,0,20210131,104,109,-5,-6,2,5,5,213,5,2020,0,6,629,1
Houston,48,25,29,34,0,0,0,0,Oklahoma City,24,30,22,30,0,0,0,0,20210201,136,106,24,19,26,30,30,242,-30,2020,0,0,413,1
LA Lakers,28,22,25,32,0,0,0,0,Atlanta,25,21,30,23,0,0,0,0,20210201,107,99,3,4,-1,8,8,206,-8,2020,0,0,1932,1
New York,27,28,26,21,0,0,0,0,Chicago,32,27,25,26,0,0,0,0,20210201,102,110,5,4,3,8,8,212,8,2020,0,0,711,1
Minnesota,29,15,23,31,0,0,0,0,Cleveland,29,23,24,24,0,0,0,0,20210201,98,100,0,8,9,2,2,198,2,2020,0,0,629,1
Phoenix,22,25,30,32,0,0,0,0,Dallas,22,31,29,26,0,0,0,0,20210201,109,108,0,-6,-5,1,1,217,-1,2020,0,0,884,1
Charlotte,28,26,34,25,16,0,0,0,Miami,29,28,25,31,8,0,0,0,20210201,129,121,-1,-3,6,0,8,250,-8,2020,1,0,654,1
Portland,36,20,21,29,0,0,0,0,Milwaukee,46,33,34,21,0,0,0,0,20210201,106,134,10,23,36,28,28,240,28,2020,0,0,1714,1
Sacramento,30,30,27,31,0,0,0,0,New Orleans,33,29,32,15,0,0,0,0,20210201,118,109,-3,-2,-7,9,9,227,-9,2020,0,0,1879,1
Memphis,33,36,27,37,0,0,0,0,San Antonio,31,22,30,19,0,0,0,0,20210201,133,102,2,16,13,31,31,235,-31,2020,0,0,631,1
Detroit,22,24,31,28,0,0,0,0,Utah,33,36,25,23,0,0,0,0,20210202,105,117,11,23,17,12,12,222,12,2020,0,1,1488,1
Toronto,33,31,32,27,0,0,0,0,Orlando,31,29,22,26,0,0,0,0,20210202,123,108,2,4,14,15,15,231,-15,2020,0,1,1048,1
Portland,40,35,31,26,0,0,0,0,Washington,23,40,27,31,0,0,0,0,20210202,132,121,17,12,16,11,11,253,-11,2020,0,1,2347,1
Boston,24,28,34,25,0,0,0,0,Golden State,35,17,33,22,0,0,0,0,20210202,111,107,-11,0,1,4,4,218,-4,2020,0,1,2692,1
LA Clippers,32,26,32,30,0,0,0,0,Brooklyn,24,33,31,36,0,0,0,0,20210202,120,124,-8,-1,-2,4,4,244,4,2020,0,1,2445,1
Memphis,27,23,35,31,0,0,0,0,Indiana,37,34,33,30,0,0,0,0,20210202,116,134,10,21,19,18,18,250,18,2020,0,1,383,1
Minnesota,33,32,25,18,0,0,0,0,San Antonio,29,25,25,32,0,0,0,0,20210203,108,111,-4,-11,-11,3,3,219,3,2020,0,2,1112,1
Boston,26,25,31,29,0,0,0,0,Sacramento,22,30,29,35,0,0,0,0,20210203,111,116,-4,1,-1,5,5,227,5,2020,0,2,2624,1
Phoenix,25,21,28,27,0,0,0,0,New Orleans,28,20,40,35,0,0,0,0,20210203,101,123,3,2,14,22,22,224,22,2020,0,2,1312,1
Indiana,21,30,21,38,0,0,0,0,Milwaukee,29,39,38,24,0,0,0,0,20210203,110,130,8,17,34,20,20,240,20,2020,0,2,243,1
Houston,25,18,15,29,0,0,0,0,Oklahoma City,30,24,27,23,0,0,0,0,20210203,87,104,5,11,23,17,17,191,17,2020,0,2,413,1
LA Clippers,33,19,36,33,0,0,0,0,Cleveland,25,24,25,25,0,0,0,0,20210203,121,99,8,3,14,22,22,220,-22,2020,0,2,2044,1
Philadelphia,30,34,25,29,0,0,0,0,Charlotte,13,29,34,35,0,0,0,0,20210203,118,111,17,22,13,7,7,229,-7,2020,0,2,450,1
New York,34,29,28,16,0,0,0,0,Chicago,17,35,24,27,0,0,0,0,20210203,107,103,17,11,15,4,4,210,-4,2020,0,2,711,1
Dallas,26,27,35,34,0,0,0,0,Atlanta,22,34,27,33,0,0,0,0,20210203,122,116,4,-3,5,6,6,238,-6,2020,0,2,719,1
Washington,31,24,22,26,0,0,0,0,Miami,34,31,17,18,0,0,0,0,20210203,103,100,-3,-10,-5,3,3,203,-3,2020,0,2,924,1
Utah,20,25,35,32,0,0,0,0,Atlanta,16,21,26,28,0,0,0,0,20210204,112,91,4,8,17,21,21,203,-21,2020,0,3,1580,1
Golden State,36,38,36,37,0,0,0,0,Dallas,34,42,20,20,0,0,0,0,20210204,147,116,2,-2,14,31,31,263,-31,2020,0,3,1480,1
Denver,30,28,17,18,0,0,0,0,LA Lakers,27,19,37,31,0,0,0,0,20210204,93,114,-3,-12,8,21,21,207,21,2020,0,3,830,1
Houston,27,33,27,28,0,0,0,0,Memphis,27,20,23,33,0,0,0,0,20210204,115,103,0,13,17,12,12,218,-12,2020,0,3,484,1
Portland,28,29,40,24,0,0,0,0,Philadelphia,28,29,19,29,0,0,0,0,20210204,121,105,0,0,21,16,16,226,-16,2020,0,3,2405,1
Washington,27,16,27,25,0,0,0,0,Miami,40,31,35,16,0,0,0,0,20210205,95,122,13,28,36,27,27,217,27,2020,0,4,924,1
Chicago,31,25,25,38,0,0,0,0,Orlando,33,33,26,31,0,0,0,0,20210205,119,123,2,10,11,4,4,242,4,2020,0,4,984,1
Minnesota,25,26,34,21,0,0,0,0,Oklahoma City,23,32,21,27,0,0,0,0,20210205,106,103,2,-4,9,3,3,209,-3,2020,0,4,694,1
Boston,21,30,38,30,0,0,0,0,LA Clippers,33,29,20,33,0,0,0,0,20210205,119,115,-12,-11,7,4,4,234,-4,2020,0,4,2590,1
Detroit,24,20,24,24,0,0,0,0,Phoenix,27,30,30,22,0,0,0,0,20210205,92,109,3,13,19,17,17,201,17,2020,0,4,1687,1
Milwaukee,26,34,34,29,0,0,0,0,Cleveland,33,30,26,16,0,0,0,0,20210205,123,105,-7,-3,5,18,18,228,-18,2020,0,4,334,1
Utah,30,39,37,32,0,0,0,0,Charlotte,32,22,36,31,0,0,0,0,20210205,138,121,-2,15,16,17,17,259,-17,2020,0,4,1723,1
Toronto,34,33,25,31,0,0,0,0,Brooklyn,23,40,27,27,0,0,0,0,20210205,123,117,11,4,2,6,6,240,-6,2020,0,4,341,1
New Orleans,27,30,29,28,0,0,0,0,Indiana,30,18,27,38,0,0,0,0,20210205,114,113,-3,9,11,1,1,227,-1,2020,0,4,713,1
Denver,25,27,29,33,0,0,0,0,Sacramento,26,27,34,32,0,0,0,0,20210206,114,119,1,1,6,5,5,233,5,2020,0,5,886,1
Brooklyn,29,27,30,22,0,0,0,0,Philadelphia,34,25,43,22,0,0,0,0,20210206,108,124,5,3,16,16,16,232,16,2020,0,5,80,1
Chicago,31,30,34,23,0,0,0,0,Orlando,31,12,21,28,0,0,0,0,20210206,118,92,0,18,31,26,26,210,-26,2020,0,5,984,1
Minnesota,24,38,32,24,0,0,0,0,Oklahoma City,43,40,13,24,0,0,0,0,20210206,118,120,19,21,2,2,2,238,2,2020,0,5,694,1
Portland,31,20,25,23,0,0,0,0,New York,26,31,27,26,0,0,0,0,20210206,99,110,-5,6,8,11,11,209,11,2020,0,5,2439,1
Detroit,29,25,24,28,12,11,0,0,LA Lakers,27,36,25,18,12,17,0,0,20210206,129,135,-2,9,10,0,6,264,6,2020,2,5,1979,1
San Antonio,29,22,33,27,0,0,0,0,Houston,23,24,30,29,0,0,0,0,20210206,111,106,6,4,7,5,5,217,-5,2020,0,5,189,1
Golden State,31,33,37,31,0,0,0,0,Dallas,35,37,34,28,0,0,0,0,20210206,132,134,4,8,5,2,2,266,2,2020,0,5,1480,1
Milwaukee,25,34,35,30,0,0,0,0,Cleveland,22,32,23,22,0,0,0,0,20210206,124,99,3,5,17,25,25,223,-25,2020,0,5,334,1
Toronto,34,29,31,27,0,0,0,0,Atlanta,28,38,35,31,0,0,0,0,20210206,121,132,-6,3,7,11,11,253,11,2020,0,5,733,1
Memphis,33,28,30,18,0,0,0,0,New Orleans,31,29,30,28,0,0,0,0,20210206,109,118,-2,-1,-1,9,9,227,9,2020,0,5,358,1
Boston,19,30,19,23,0,0,0,0,Phoenix,27,25,24,24,0,0,0,0,20210207,91,100,8,3,8,9,9,191,9,2020,0,6,2295,1
Miami,25,35,22,27,0,0,0,0,New York,23,36,18,26,0,0,0,0,20210207,109,103,2,1,5,6,6,212,-6,2020,0,6,1091,1
Washington,31,21,21,24,0,0,0,0,Charlotte,34,35,33,17,0,0,0,0,20210207,97,119,3,17,29,22,22,216,22,2020,0,6,329,1
Utah,25,22,28,28,0,0,0,0,Indiana,20,27,21,27,0,0,0,0,20210207,103,95,5,0,7,8,8,198,-8,2020,0,6,1353,1
Sacramento,22,32,25,34,0,0,0,0,LA Clippers,24,27,29,30,0,0,0,0,20210207,113,110,-2,3,-1,3,3,223,-3,2020,0,6,361,1
Washington,24,34,25,22,0,0,0,0,Chicago,27,21,30,23,0,0,0,0,20210208,105,101,-3,10,5,4,4,206,-4,2020,0,0,594,1
Houston,27,33,27,7,0,0,0,0,Charlotte,32,32,26,29,0,0,0,0,20210208,94,119,5,4,3,25,25,213,25,2020,0,0,925,1
Minnesota,22,29,26,45,0,0,0,0,Dallas,43,28,24,32,0,0,0,0,20210208,122,127,21,20,18,5,5,249,5,2020,0,0,863,1
Milwaukee,37,22,34,32,0,0,0,0,Denver,42,20,26,24,0,0,0,0,20210208,125,112,-5,-3,5,13,13,237,-13,2020,0,0,912,1
Oklahoma City,33,27,24,26,2,0,0,0,LA Lakers,26,30,20,34,9,0,0,0,20210208,112,119,-7,-4,-8,0,7,231,7,2020,1,0,1178,1
Toronto,35,28,31,34,0,0,0,0,Memphis,34,36,27,16,0,0,0,0,20210208,128,113,1,-7,-3,15,15,241,-15,2020,0,0,815,1
Cleveland,28,33,30,22,0,0,0,0,Phoenix,34,30,25,30,0,0,0,0,20210208,113,119,6,3,-2,6,6,232,6,2020,0,0,1745,1
Golden State,36,23,21,20,0,0,0,0,San Antonio,27,27,24,27,0,0,0,0,20210208,100,105,-9,-5,-2,5,5,205,5,2020,0,0,1487,1
Golden State,28,22,36,28,0,0,0,0,San Antonio,26,24,20,21,0,0,0,0,20210209,114,91,2,0,16,23,23,205,-23,2020,0,1,1487,1
Boston,27,20,32,29,0,0,0,0,Utah,24,24,42,32,0,0,0,0,20210209,108,122,-3,1,11,14,14,230,14,2020,0,1,2093,1
Philadelphia,42,24,21,32,0,0,0,0,Sacramento,32,39,20,20,0,0,0,0,20210209,119,111,10,-5,-4,8,8,230,-8,2020,0,1,2451,1
Houston,25,25,31,20,0,0,0,0,New Orleans,30,33,29,38,0,0,0,0,20210209,101,130,5,13,11,29,29,231,29,2020,0,1,317,1
New York,25,30,27,14,0,0,0,0,Miami,27,30,19,22,0,0,0,0,20210209,96,98,2,2,-6,2,2,194,2,2020,0,1,1091,1
Brooklyn,26,28,32,25,0,0,0,0,Detroit,38,25,31,28,0,0,0,0,20210209,111,122,12,9,8,11,11,233,11,2020,0,1,480,1
Orlando,19,24,30,24,0,0,0,0,Portland,31,19,34,22,0,0,0,0,20210209,97,106,12,7,11,9,9,203,9,2020,0,1,2525,1
Milwaukee,32,39,30,23,0,0,0,0,Phoenix,32,27,39,27,0,0,0,0,20210210,124,125,0,-12,-3,1,1,249,1,2020,0,2,1462,1
Toronto,40,34,29,34,0,0,0,0,Washington,28,33,32,22,0,0,0,0,20210210,137,115,12,13,10,22,22,252,-22,2020,0,2,349,1
LA Clippers,27,20,33,39,0,0,0,0,Minnesota,32,21,20,39,0,0,0,0,20210210,119,112,-5,-6,7,7,7,231,-7,2020,0,2,1521,1
Oklahoma City,37,30,17,21,8,0,0,0,LA Lakers,23,34,23,25,9,0,0,0,20210210,113,114,-14,-10,-4,0,1,227,1,2020,1,2,1178,1
Charlotte,38,30,15,31,0,0,0,0,Memphis,34,36,31,29,0,0,0,0,20210210,114,130,-4,2,18,16,16,244,16,2020,0,2,519,1
Atlanta,32,30,28,27,0,0,0,0,Dallas,33,19,29,37,0,0,0,0,20210210,117,118,1,-10,-9,1,1,235,1,2020,0,2,719,1
New Orleans,34,40,14,28,0,0,0,0,Chicago,44,22,40,23,0,0,0,0,20210210,116,129,10,-8,18,13,13,245,13,2020,0,2,832,1
Indiana,18,12,32,32,0,0,0,0,Brooklyn,27,35,20,22,0,0,0,0,20210210,94,104,9,32,20,10,10,198,10,2020,0,2,643,1
Cleveland,17,26,23,29,0,0,0,0,Denver,34,30,36,33,0,0,0,0,20210210,95,133,17,21,34,38,38,228,38,2020,0,2,1223,1
Philadelphia,36,27,30,21,0,0,0,0,Portland,37,23,29,29,0,0,0,0,20210211,114,118,1,-3,-4,4,4,232,4,2020,0,3,2405,1
Toronto,29,27,24,26,0,0,0,0,Boston,34,32,22,32,0,0,0,0,20210211,106,120,5,10,8,14,14,226,14,2020,0,3,430,1
Indiana,28,24,30,29,0,0,0,0,Detroit,19,33,18,25,0,0,0,0,20210211,111,95,9,0,12,16,16,206,-16,2020,0,3,240,1
Orlando,19,36,25,25,0,0,0,0,Golden State,29,18,37,27,0,0,0,0,20210211,105,111,10,-8,4,6,6,216,6,2020,0,3,2437,1
Miami,19,28,28,26,0,0,0,0,Houston,29,24,10,31,0,0,0,0,20210211,101,94,-10,-6,12,7,7,195,-7,2020,0,3,966,1
Milwaukee,31,21,30,33,0,0,0,0,Utah,35,34,27,33,0,0,0,0,20210212,115,129,4,17,14,14,14,244,14,2020,0,4,1239,1
Orlando,33,31,33,26,0,0,0,0,Sacramento,33,26,28,25,0,0,0,0,20210212,123,112,0,5,10,11,11,235,-11,2020,0,4,2390,1
Memphis,31,28,23,23,0,0,0,0,LA Lakers,16,30,41,28,0,0,0,0,20210212,105,115,-15,-13,5,10,10,220,10,2020,0,4,1599,1
New York,30,23,26,30,0,0,0,0,Washington,23,19,22,27,0,0,0,0,20210212,109,91,7,11,15,18,18,200,-18,2020,0,4,204,1
Oklahoma City,28,25,26,16,0,0,0,0,Denver,16,24,30,27,0,0,0,0,20210212,95,97,-12,-13,-9,2,2,192,2,2020,0,4,503,1
Cleveland,23,29,25,33,0,0,0,0,Portland,34,39,27,29,0,0,0,0,20210212,110,129,11,21,23,19,19,239,19,2020,0,4,2049,1
Minnesota,30,29,26,29,0,0,0,0,Charlotte,25,35,30,30,0,0,0,0,20210212,114,120,-5,1,5,6,6,234,6,2020,0,4,938,1
LA Clippers,30,28,32,35,0,0,0,0,Chicago,25,29,24,28,0,0,0,0,20210212,125,106,5,4,12,19,19,231,-19,2020,0,4,1741,1
Detroit,27,27,28,26,0,0,0,0,Boston,23,29,20,30,0,0,0,0,20210212,108,102,4,2,10,6,6,210,-6,2020,0,4,611,1
San Antonio,36,41,33,15,0,0,0,0,Atlanta,29,19,24,42,0,0,0,0,20210212,125,114,7,29,38,11,11,239,-11,2020,0,4,881,1
New Orleans,34,31,36,29,0,0,0,0,Dallas,27,42,39,35,0,0,0,0,20210212,130,143,-7,4,7,13,13,273,13,2020,0,4,442,1
Indiana,27,35,22,41,0,0,0,0,Atlanta,26,32,29,26,0,0,0,0,20210213,125,113,1,4,-3,12,12,238,-12,2020,0,5,427,1
Brooklyn,37,29,42,26,0,0,0,0,Golden State,28,23,31,35,0,0,0,0,20210213,134,117,9,15,26,17,17,251,-17,2020,0,5,2565,1
Houston,25,22,28,24,0,0,0,0,New York,30,33,24,34,0,0,0,0,20210213,99,121,5,16,12,22,22,220,22,2020,0,5,1417,1
Philadelphia,28,25,28,30,0,0,0,0,Phoenix,23,30,33,34,0,0,0,0,20210213,111,120,-5,0,5,9,9,231,9,2020,0,5,2078,1
Miami,21,21,15,37,0,0,0,0,Utah,18,29,31,34,0,0,0,0,20210213,94,112,-3,5,21,18,18,206,18,2020,0,5,2086,1
Boston,22,21,24,24,0,0,0,0,Washington,29,26,34,15,0,0,0,0,20210214,91,104,7,12,22,13,13,195,13,2020,0,6,394,1
Minnesota,27,27,37,25,0,0,0,0,Toronto,26,32,25,29,0,0,0,0,20210214,116,112,1,-4,8,4,4,228,-4,2020,0,6,691,1
Memphis,30,32,37,25,0,0,0,0,Sacramento,22,24,33,31,0,0,0,0,20210214,124,110,8,16,20,14,14,234,-14,2020,0,6,1745,1
Orlando,16,19,25,30,0,0,0,0,Phoenix,28,24,32,25,0,0,0,0,20210214,90,109,12,17,24,19,19,199,19,2020,0,6,1842,1
Milwaukee,24,17,40,28,0,0,0,0,Oklahoma City,24,28,29,33,0,0,0,0,20210214,109,114,0,11,0,5,5,223,5,2020,0,6,732,1
New Orleans,40,22,27,23,0,0,0,0,Detroit,30,34,33,26,0,0,0,0,20210214,112,123,-10,2,8,11,11,235,11,2020,0,6,939,1
LA Lakers,33,28,24,20,0,0,0,0,Denver,33,40,30,19,0,0,0,0,20210214,105,122,0,12,18,17,17,227,17,2020,0,6,830,1
Portland,34,24,45,18,0,0,0,0,Dallas,25,36,30,27,0,0,0,0,20210214,121,118,9,-3,12,3,3,239,-3,2020,0,6,1630,1
San Antonio,17,47,25,33,0,0,0,0,Charlotte,33,26,30,21,0,0,0,0,20210214,122,110,-16,5,0,12,12,232,-12,2020,0,6,1103,1
Cleveland,24,34,30,23,0,0,0,0,LA Clippers,32,38,36,22,0,0,0,0,20210214,111,128,8,12,18,17,17,239,17,2020,0,6,2044,1
Philadelphia,42,24,28,29,0,0,0,0,Utah,35,37,34,28,0,0,0,0,20210215,123,134,-7,6,12,11,11,257,11,2020,0,0,1920,1
Cleveland,32,22,30,14,0,0,0,0,Golden State,32,32,37,28,0,0,0,0,20210215,98,129,0,10,17,31,31,227,31,2020,0,0,2161,1
Chicago,24,25,30,26,15,0,0,0,Indiana,21,23,26,35,7,0,0,0,20210215,120,112,3,5,9,0,8,232,-8,2020,1,0,163,1
Miami,35,27,29,27,0,0,0,0,LA Clippers,33,34,25,33,0,0,0,0,20210215,118,125,-2,5,1,7,7,243,7,2020,0,0,2335,1
Atlanta,28,35,27,22,0,0,0,0,New York,39,27,29,28,0,0,0,0,20210215,112,123,11,3,5,11,11,235,11,2020,0,0,745,1
Brooklyn,36,38,33,29,0,0,0,0,Sacramento,37,31,20,37,0,0,0,0,20210215,136,125,-1,6,19,11,11,261,-11,2020,0,0,2499,1
Houston,34,35,20,30,0,0,0,0,Washington,38,34,28,31,0,0,0,0,20210215,119,131,4,3,11,12,12,250,12,2020,0,0,1217,1
Brooklyn,22,32,34,40,0,0,0,0,Phoenix,33,42,25,24,0,0,0,0,20210216,128,124,-11,-21,-12,4,4,252,-4,2020,0,1,2139,1
Portland,34,30,29,22,0,0,0,0,Oklahoma City,21,29,29,25,0,0,0,0,20210216,115,104,13,14,14,11,11,219,-11,2020,0,1,1484,1
LA Lakers,30,27,29,26,0,0,0,0,Minnesota,27,29,28,20,0,0,0,0,20210216,112,104,3,1,2,8,8,216,-8,2020,0,1,1521,1
New Orleans,29,34,38,43,0,0,0,0,Memphis,32,26,23,32,0,0,0,0,20210216,144,113,-3,5,20,31,31,257,-31,2020,0,1,358,1
Denver,26,28,21,24,0,0,0,0,Boston,30,29,27,26,0,0,0,0,20210216,99,112,4,5,11,13,13,211,13,2020,0,1,1765,1
Toronto,33,31,30,30,0,0,0,0,Milwaukee,33,31,27,22,0,0,0,0,20210216,124,113,0,0,3,11,11,237,-11,2020,0,1,429,1
Portland,35,24,35,32,0,0,0,0,New Orleans,30,39,22,33,0,0,0,0,20210217,126,124,5,-10,3,2,2,250,-2,2020,0,2,2059,1
Atlanta,33,29,28,32,0,0,0,0,Boston,35,21,25,33,0,0,0,0,20210217,122,114,-2,6,9,8,8,236,-8,2020,0,2,935,1
Detroit,35,26,12,29,0,0,0,0,Chicago,27,16,27,35,0,0,0,0,20210217,102,105,-8,-18,-3,3,3,207,3,2020,0,2,238,1
Miami,36,25,25,19,7,0,0,0,Golden State,24,22,30,29,15,0,0,0,20210217,112,120,-12,-15,-10,0,8,232,8,2020,1,2,2590,1
Utah,24,22,35,33,0,0,0,0,LA Clippers,25,26,24,21,0,0,0,0,20210217,114,96,-1,-5,6,18,18,210,-18,2020,0,2,579,1
Oklahoma City,31,25,29,28,0,0,0,0,Memphis,30,27,29,36,0,0,0,0,20210217,113,122,-1,1,1,9,9,235,9,2020,0,2,421,1
Indiana,39,30,17,35,13,0,0,0,Minnesota,33,40,19,29,7,0,0,0,20210217,134,128,6,-4,-6,0,6,262,-6,2020,1,2,510,1
New York,32,24,14,19,0,0,0,0,Orlando,23,30,30,24,0,0,0,0,20210217,89,107,-9,-3,13,18,18,196,18,2020,0,2,939,1
Houston,24,19,36,34,0,0,0,0,Philadelphia,38,31,27,22,0,0,0,0,20210217,113,118,14,26,17,5,5,231,5,2020,0,2,1339,1
Denver,41,23,29,35,0,0,0,0,Washington,24,46,30,30,0,0,0,0,20210217,128,130,-17,6,7,2,2,258,2,2020,0,2,1489,1
Miami,31,26,32,29,0,0,0,0,Sacramento,21,22,36,31,0,0,0,0,20210218,118,110,10,14,10,8,8,228,-8,2020,0,3,2547,1
Brooklyn,31,33,26,19,0,0,0,0,LA Lakers,24,29,21,24,0,0,0,0,20210218,109,98,7,11,16,11,11,207,-11,2020,0,3,2445,1
Toronto,33,25,27,25,0,0,0,0,Milwaukee,26,15,31,24,0,0,0,0,20210218,110,96,7,17,13,14,14,206,-14,2020,0,3,429,1
Toronto,28,17,13,28,0,0,0,0,Minnesota,15,20,29,17,0,0,0,0,20210219,86,81,13,10,-6,5,5,167,-5,2020,0,4,691,1
Chicago,30,23,26,26,0,0,0,0,Philadelphia,32,26,27,27,0,0,0,0,20210219,105,112,2,5,6,7,7,217,7,2020,0,4,664,1
Phoenix,33,26,32,41,0,0,0,0,New Orleans,34,32,36,12,0,0,0,0,20210219,132,114,-1,-7,-11,18,18,246,-18,2020,0,4,1312,1
Oklahoma City,20,22,20,23,0,0,0,0,Milwaukee,16,30,32,20,0,0,0,0,20210219,85,98,-4,4,16,13,13,183,13,2020,0,4,732,1
Golden State,34,17,43,26,0,0,0,0,Orlando,37,27,29,31,0,0,0,0,20210219,120,124,3,13,-1,4,4,244,4,2020,0,4,2437,1
Utah,23,26,26,37,0,0,0,0,LA Clippers,31,26,22,37,0,0,0,0,20210219,112,116,8,8,4,4,4,228,4,2020,0,4,579,1
Denver,33,36,26,25,0,0,0,0,Cleveland,23,27,30,23,0,0,0,0,20210219,120,103,10,19,15,17,17,223,-17,2020,0,4,1223,1
Atlanta,22,19,32,36,0,0,0,0,Boston,33,33,32,23,0,0,0,0,20210219,109,121,11,25,25,12,12,230,12,2020,0,4,935,1
Detroit,17,26,30,22,0,0,0,0,Memphis,35,18,31,25,0,0,0,0,20210219,95,109,18,10,11,14,14,204,14,2020,0,4,622,1
Washington,31,30,28,29,0,0,0,0,Portland,43,12,37,19,0,0,0,0,20210220,118,111,-12,6,-3,7,7,229,-7,2020,0,5,2347,1
Miami,36,23,22,15,0,0,0,0,LA Lakers,23,29,25,17,0,0,0,0,20210220,96,94,13,7,4,2,2,190,-2,2020,0,5,2335,1
Phoenix,28,37,31,32,0,0,0,0,Memphis,15,19,30,33,0,0,0,0,20210220,128,97,13,31,32,31,31,225,-31,2020,0,5,1260,1
Sacramento,21,37,25,31,0,0,0,0,Chicago,28,40,27,27,0,0,0,0,20210220,114,122,7,10,12,8,8,236,8,2020,0,5,1788,1
Golden State,15,32,22,31,0,0,0,0,Charlotte,24,21,24,33,0,0,0,0,20210220,100,102,9,-2,0,2,2,202,2,2020,0,5,2296,1
Detroit,26,22,28,20,0,0,0,0,Orlando,28,28,27,22,0,0,0,0,20210221,96,105,2,8,7,9,9,201,9,2020,0,6,957,1
Minnesota,18,32,21,28,0,0,0,0,New York,30,31,26,16,0,0,0,0,20210221,99,103,12,11,16,4,4,202,4,2020,0,6,1016,1
Boston,30,33,24,21,7,0,0,0,New Orleans,28,19,27,34,12,0,0,0,20210221,115,120,-2,-16,-13,0,5,235,5,2020,1,6,1358,1
Philadelphia,24,31,29,19,0,0,0,0,Toronto,28,24,31,27,0,0,0,0,20210221,103,110,4,-3,-1,7,7,213,7,2020,0,6,334,1
Brooklyn,28,30,31,23,0,0,0,0,LA Clippers,30,21,28,29,0,0,0,0,20210221,112,108,-2,7,10,4,4,220,-4,2020,0,6,2445,1
Oklahoma City,31,31,24,31,0,0,0,0,Cleveland,28,23,24,26,0,0,0,0,20210221,117,101,3,11,11,16,16,218,-16,2020,0,6,949,1
Denver,33,23,20,39,0,0,0,0,Atlanta,27,37,29,30,0,0,0,0,20210221,115,123,-6,8,17,8,8,238,8,2020,0,6,1209,1
Sacramento,25,31,26,33,0,0,0,0,Milwaukee,28,42,29,29,0,0,0,0,20210221,115,128,3,14,17,13,13,243,13,2020,0,6,1771,1
Memphis,13,23,26,30,0,0,0,0,Dallas,26,28,27,21,0,0,0,0,20210222,92,102,13,18,19,10,10,194,10,2020,0,0,419,1
Chicago,29,25,46,20,0,0,0,0,Houston,24,24,26,26,0,0,0,0,20210222,120,100,5,6,26,20,20,220,-20,2020,0,0,939,1
Washington,23,26,31,35,12,0,0,0,LA Lakers,33,30,23,29,9,0,0,0,20210222,127,124,-10,-14,-6,0,3,251,-3,2020,1,0,2294,1
Miami,23,22,34,29,0,0,0,0,Oklahoma City,21,33,23,17,0,0,0,0,20210222,108,94,2,-9,2,14,14,202,-14,2020,0,0,1225,1
Portland,26,28,17,29,0,0,0,0,Phoenix,32,31,37,32,0,0,0,0,20210222,100,132,6,9,29,32,32,232,32,2020,0,0,1005,1
Charlotte,35,32,23,20,0,0,0,0,Utah,35,29,27,41,0,0,0,0,20210222,110,132,0,-3,1,22,22,242,22,2020,0,0,1723,1
Minnesota,36,26,27,23,0,0,0,0,Milwaukee,38,41,34,26,0,0,0,0,20210223,112,139,2,17,24,27,27,251,27,2020,0,1,298,1
Detroit,34,19,26,26,0,0,0,0,Orlando,24,27,14,28,0,0,0,0,20210223,105,93,10,2,14,12,12,198,-12,2020,0,1,957,1
Golden State,36,19,39,20,0,0,0,0,New York,31,28,26,21,0,0,0,0,20210223,114,106,5,-4,9,8,8,220,-8,2020,0,1,2565,1
Washington,20,35,39,22,0,0,0,0,LA Clippers,36,36,27,36,0,0,0,0,20210223,116,135,16,17,5,19,19,251,19,2020,0,1,2294,1
Philadelphia,37,18,24,30,0,0,0,0,Toronto,18,24,23,37,0,0,0,0,20210223,109,102,19,13,14,7,7,211,-7,2020,0,1,334,1
Boston,31,25,20,31,0,0,0,0,Dallas,34,21,25,30,0,0,0,0,20210223,107,110,3,-1,4,3,3,217,3,2020,0,1,1548,1
Atlanta,27,28,29,27,0,0,0,0,Cleveland,28,30,26,28,0,0,0,0,20210223,111,112,1,3,0,1,1,223,1,2020,0,1,555,1
Sacramento,28,38,30,22,0,0,0,0,Brooklyn,42,30,26,29,0,0,0,0,20210223,118,127,14,6,2,9,9,245,9,2020,0,1,2499,1
Portland,25,32,21,28,0,0,0,0,Denver,34,23,21,33,0,0,0,0,20210223,106,111,9,0,0,5,5,217,5,2020,0,1,981,1
LA Lakers,23,24,17,25,0,0,0,0,Utah,24,39,27,24,0,0,0,0,20210224,89,114,1,16,26,25,25,203,25,2020,0,2,579,1
Charlotte,34,32,31,27,0,0,0,0,Phoenix,38,29,24,30,0,0,0,0,20210224,124,121,-4,-1,6,3,3,245,-3,2020,0,2,1778,1
San Antonio,21,24,28,26,0,0,0,0,Oklahoma City,28,12,36,26,0,0,0,0,20210224,99,102,7,-5,3,3,3,201,3,2020,0,2,421,1
Detroit,39,30,27,22,0,0,0,0,New Orleans,33,31,32,32,0,0,0,0,20210224,118,128,-6,-5,0,10,10,246,10,2020,0,2,939,1
Minnesota,34,24,32,29,7,0,0,0,Chicago,32,36,28,23,14,0,0,0,20210224,126,133,-2,10,6,0,7,259,7,2020,1,2,355,1
Golden State,25,31,28,27,0,0,0,0,Indiana,22,36,22,27,0,0,0,0,20210224,111,107,3,-2,4,4,4,218,-4,2020,0,2,1944,1
Houston,17,33,24,22,0,0,0,0,Cleveland,27,21,34,30,0,0,0,0,20210224,96,112,10,-2,8,16,16,208,16,2020,0,2,1113,1
Boston,27,22,29,34,0,0,0,0,Atlanta,40,32,27,28,0,0,0,0,20210224,112,127,13,23,21,15,15,239,15,2020,0,2,935,1
Toronto,35,21,29,23,0,0,0,0,Miami,32,34,26,24,0,0,0,0,20210224,108,116,-3,10,7,8,8,224,8,2020,0,2,1234,1
Orlando,28,19,25,20,0,0,0,0,Brooklyn,24,41,27,37,0,0,0,0,20210225,92,129,-4,18,20,37,37,221,37,2020,0,3,939,1
Washington,26,30,32,24,0,0,0,0,Denver,22,32,34,22,0,0,0,0,20210225,112,110,4,2,0,2,2,222,-2,2020,0,3,1489,1
LA Clippers,27,26,22,19,0,0,0,0,Memphis,24,37,28,33,0,0,0,0,20210225,94,122,-3,8,14,28,28,216,28,2020,0,3,1599,1
New Orleans,31,37,35,22,0,0,0,0,Milwaukee,35,34,34,26,0,0,0,0,20210225,125,129,4,1,0,4,4,254,4,2020,0,3,911,1
Sacramento,29,33,32,27,0,0,0,0,New York,38,39,24,39,0,0,0,0,20210225,121,140,9,15,7,19,19,261,19,2020,0,3,2499,1
Dallas,22,21,25,29,0,0,0,0,Philadelphia,23,36,27,25,0,0,0,0,20210225,97,111,1,16,18,14,14,208,14,2020,0,3,1297,1
Houston,31,28,21,31,0,0,0,0,Toronto,30,37,28,27,0,0,0,0,20210226,111,122,-1,8,15,11,11,233,11,2020,0,4,1299,1
Atlanta,33,22,25,29,0,0,0,0,Oklahoma City,31,32,33,22,0,0,0,0,20210226,109,118,-2,8,16,9,9,227,9,2020,0,4,755,1
Utah,30,23,41,22,0,0,0,0,Miami,26,31,39,28,0,0,0,0,20210226,116,124,-4,4,2,8,8,240,8,2020,0,4,2086,1
LA Clippers,32,31,27,29,0,0,0,0,Memphis,30,17,25,27,0,0,0,0,20210226,119,99,2,16,18,20,20,218,-20,2020,0,4,1599,1
Indiana,31,29,24,28,0,0,0,0,Boston,32,29,31,26,0,0,0,0,20210226,112,118,1,1,8,6,6,230,6,2020,0,4,805,1
Charlotte,28,23,33,37,0,0,0,0,Golden State,36,30,37,27,0,0,0,0,20210226,121,130,8,15,19,9,9,251,9,2020,0,4,2296,1
Sacramento,35,20,20,35,0,0,0,0,Detroit,25,27,28,27,0,0,0,0,20210226,110,107,10,3,-5,3,3,217,-3,2020,0,4,2020,1
Phoenix,26,20,28,32,0,0,0,0,Chicago,26,32,23,16,0,0,0,0,20210226,106,97,0,-12,-7,9,9,203,-9,2020,0,4,1450,1
Portland,29,28,19,17,0,0,0,0,LA Lakers,24,30,31,17,0,0,0,0,20210226,93,102,-5,-3,9,9,9,195,9,2020,0,4,826,1
Minnesota,29,23,29,31,0,0,0,0,Washington,27,27,44,30,0,0,0,0,20210227,112,128,-2,2,17,16,16,240,16,2020,0,5,931,1
New Orleans,32,29,22,31,0,0,0,0,San Antonio,33,34,26,24,0,0,0,0,20210227,114,117,1,6,10,3,3,231,3,2020,0,5,506,1
Utah,22,32,33,37,0,0,0,0,Orlando,21,29,26,33,0,0,0,0,20210227,124,109,1,4,11,15,15,233,-15,2020,0,5,1915,1
Cleveland,28,28,16,20,20,0,0,0,Philadelphia,23,24,23,22,17,0,0,0,20210227,112,109,5,9,2,0,3,221,-3,2020,1,5,358,1
Indiana,32,20,26,29,0,0,0,0,New York,23,31,27,29,0,0,0,0,20210227,107,110,-9,2,3,3,3,217,3,2020,0,5,643,1
Dallas,38,30,26,21,0,0,0,0,Brooklyn,26,38,18,16,0,0,0,0,20210227,115,98,12,4,12,17,17,213,-17,2020,0,5,1370,1
Denver,38,27,34,27,0,0,0,0,Oklahoma City,20,23,26,27,0,0,0,0,20210227,126,96,18,22,30,30,30,222,-30,2020,0,5,503,1
Washington,28,27,21,34,0,0,0,0,Boston,33,27,19,32,0,0,0,0,20210228,110,111,5,5,3,1,1,221,1,2020,0,6,394,1
New York,25,23,35,26,0,0,0,0,Detroit,20,17,27,26,0,0,0,0,20210228,109,90,5,11,19,19,19,199,-19,2020,0,6,480,1
Memphis,25,38,32,38,0,0,0,0,Houston,18,19,23,24,0,0,0,0,20210228,133,84,7,26,35,49,49,217,-49,2020,0,6,484,1
Golden State,21,23,25,22,0,0,0,0,LA Lakers,41,32,26,18,0,0,0,0,20210228,91,117,20,29,30,26,26,208,26,2020,0,6,347,1
Atlanta,21,23,33,22,0,0,0,0,Miami,26,28,24,31,0,0,0,0,20210228,99,109,5,10,1,10,10,208,10,2020,0,6,605,1
LA Clippers,23,25,33,19,0,0,0,0,Milwaukee,27,26,24,28,0,0,0,0,20210228,100,105,4,5,-4,5,5,205,5,2020,0,6,1741,1
Phoenix,30,23,33,32,0,0,0,0,Minnesota,26,22,28,23,0,0,0,0,20210228,118,99,4,5,10,19,19,217,-19,2020,0,6,1278,1
Charlotte,36,30,22,39,0,0,0,0,Sacramento,39,28,29,30,0,0,0,0,20210228,127,126,-3,-1,-8,1,1,253,-1,2020,0,6,2239,1
Brooklyn,27,30,24,27,16,0,0,0,San Antonio,21,33,27,27,5,0,0,0,20210301,124,113,6,3,0,0,11,237,-11,2020,1,0,1581,1
Charlotte,33,26,24,28,0,0,0,0,Portland,27,32,33,31,0,0,0,0,20210301,111,123,-6,0,9,12,12,234,12,2020,0,0,2284,1
Indiana,32,23,22,37,0,0,0,0,Philadelphia,33,39,33,25,0,0,0,0,20210301,114,130,1,17,28,16,16,244,16,2020,0,0,582,1
Cleveland,34,17,23,27,0,0,0,0,Houston,29,21,20,20,0,0,0,0,20210301,101,90,5,1,4,11,11,191,-11,2020,0,0,1113,1
Utah,23,41,24,36,0,0,0,0,New Orleans,26,33,40,30,0,0,0,0,20210301,124,129,3,-5,11,5,5,253,5,2020,0,0,1432,1
Denver,37,25,27,29,0,0,0,0,Chicago,25,30,32,25,0,0,0,0,20210301,118,112,12,7,2,6,6,230,-6,2020,0,0,916,1
Dallas,29,32,34,35,0,0,0,0,Orlando,33,25,28,38,0,0,0,0,20210301,130,124,-4,3,9,6,6,254,-6,2020,0,0,961,1
Memphis,35,36,25,29,0,0,0,0,Washington,33,23,22,33,0,0,0,0,20210302,125,111,2,15,18,14,14,236,-14,2020,0,1,762,1
LA Clippers,32,31,26,23,0,0,0,0,Boston,35,27,26,29,0,0,0,0,20210302,112,117,3,-1,-1,5,5,229,5,2020,0,1,2590,1
Phoenix,29,31,26,28,0,0,0,0,LA Lakers,21,32,30,21,0,0,0,0,20210302,114,104,8,7,3,10,10,218,-10,2020,0,1,356,1
Atlanta,23,21,19,31,0,0,0,0,Miami,17,20,29,14,0,0,0,0,20210302,94,80,6,7,-3,14,14,174,-14,2020,0,1,605,1
Denver,37,27,35,29,0,0,0,0,Milwaukee,23,27,30,17,0,0,0,0,20210302,128,97,14,14,19,31,31,225,-31,2020,0,1,912,1
New York,23,24,21,25,0,0,0,0,San Antonio,25,26,36,32,0,0,0,0,20210302,93,119,2,4,19,26,26,212,26,2020,0,1,1581,1
Golden State,29,27,24,26,0,0,0,0,Portland,28,27,27,26,0,0,0,0,20210303,106,108,-1,-1,2,2,2,214,2,2020,0,2,535,1
Utah,34,27,28,29,5,0,0,0,Philadelphia,26,26,32,34,13,0,0,0,20210303,123,131,-8,-9,-5,0,8,254,8,2020,1,2,1920,1
Detroit,43,26,29,31,0,0,0,0,Toronto,37,23,20,25,0,0,0,0,20210303,129,105,6,9,18,24,24,234,-24,2020,0,2,205,1
LA Lakers,31,30,27,32,0,0,0,0,Sacramento,23,40,24,36,0,0,0,0,20210303,120,123,-8,2,-1,3,3,243,3,2020,0,2,361,1
Atlanta,27,15,36,37,0,0,0,0,Orlando,39,22,29,22,0,0,0,0,20210303,115,112,-12,-19,-12,3,3,227,-3,2020,0,2,401,1
Brooklyn,30,37,34,31,0,0,0,0,Houston,27,27,31,29,0,0,0,0,20210303,132,114,3,13,16,18,18,246,-18,2020,0,2,1417,1
Charlotte,36,26,36,37,0,0,0,0,Minnesota,33,23,20,26,0,0,0,0,20210303,135,102,3,6,22,33,33,237,-33,2020,0,2,938,1
Chicago,26,38,32,32,0,0,0,0,New Orleans,25,20,34,45,0,0,0,0,20210303,128,124,1,19,17,4,4,252,-4,2020,0,2,832,1
Oklahoma City,23,19,19,17,0,0,0,0,Dallas,25,24,26,12,0,0,0,0,20210303,78,87,2,7,14,9,9,165,9,2020,0,2,189,1
Indiana,28,23,31,32,0,0,0,0,Cleveland,28,33,29,21,0,0,0,0,20210303,114,111,0,-10,-8,3,3,225,-3,2020,0,2,262,1
Toronto,34,36,22,33,0,0,0,0,Boston,31,35,35,31,0,0,0,0,20210304,125,132,-3,-4,9,7,7,257,7,2020,0,3,430,1
Denver,28,33,21,31,0,0,0,0,Indiana,29,23,22,29,0,0,0,0,20210304,113,103,-1,9,8,10,10,216,-10,2020,0,3,998,1
Milwaukee,31,30,23,28,0,0,0,0,Memphis,17,34,33,27,0,0,0,0,20210304,112,111,14,10,0,1,1,223,-1,2020,0,3,557,1
Miami,31,24,22,26,0,0,0,0,New Orleans,15,30,25,23,0,0,0,0,20210304,103,93,16,10,7,10,10,196,-10,2020,0,3,668,1
Detroit,27,19,28,30,0,0,0,0,New York,33,26,34,21,0,0,0,0,20210304,104,114,6,13,19,10,10,218,10,2020,0,3,480,1
Golden State,23,28,22,25,0,0,0,0,Phoenix,34,28,25,33,0,0,0,0,20210304,98,120,11,11,14,22,22,218,22,2020,0,3,652,1
Sacramento,27,29,34,29,0,0,0,0,Portland,30,29,30,34,0,0,0,0,20210304,119,123,3,3,-1,4,4,242,4,2020,0,3,483,1
Oklahoma City,27,23,31,26,0,0,0,0,San Antonio,24,37,23,18,0,0,0,0,20210304,107,102,3,-11,-3,5,5,209,-5,2020,0,3,421,1
LA Clippers,22,39,26,30,0,0,0,0,Washington,25,29,33,32,0,0,0,0,20210304,117,119,3,-7,0,2,2,236,2,2020,0,3,2294,1
Washington,26,36,23,27,0,0,0,0,Memphis,35,32,27,33,0,0,0,0,20210310,112,127,9,5,9,15,15,239,15,2020,0,2,762,1
San Antonio,32,27,27,18,0,0,0,0,Dallas,27,25,35,28,0,0,0,0,20210310,104,115,-5,-7,1,11,11,219,11,2020,0,2,252,1
Boston,29,26,31,23,0,0,0,0,Brooklyn,23,35,30,33,0,0,0,0,20210311,109,121,-6,3,2,12,12,230,12,2020,0,3,190,1
Philadelphia,30,34,33,30,0,0,0,0,Chicago,23,34,28,20,0,0,0,0,20210311,127,105,7,7,12,22,22,232,-22,2020,0,3,664,1
Detroit,22,17,33,30,0,0,0,0,Charlotte,30,18,25,32,0,0,0,0,20210311,102,105,8,9,1,3,3,207,3,2020,0,3,504,1
Golden State,26,17,25,36,0,0,0,0,LA Clippers,28,31,45,26,0,0,0,0,20210311,104,130,2,16,36,26,26,234,26,2020,0,3,347,1
Orlando,32,26,24,21,0,0,0,0,Miami,30,33,19,29,0,0,0,0,20210311,103,111,-2,5,0,8,8,214,8,2020,0,3,204,1
New York,27,24,27,23,0,0,0,0,Milwaukee,32,36,29,37,0,0,0,0,20210311,101,134,5,17,19,33,33,235,33,2020,0,3,732,1
Minnesota,27,40,38,30,0,0,0,0,New Orleans,34,26,22,23,0,0,0,0,20210311,135,105,-7,7,23,30,30,240,-30,2020,0,3,1052,1
Dallas,19,28,27,34,0,0,0,0,Oklahoma City,35,27,27,27,0,0,0,0,20210311,108,116,16,15,15,8,8,224,8,2020,0,3,189,1
Phoenix,30,30,30,37,0,0,0,0,Portland,33,27,34,27,0,0,0,0,20210311,127,121,-3,0,-4,6,6,248,-6,2020,0,3,1005,1
Houston,33,18,30,24,0,0,0,0,Sacramento,35,30,30,30,0,0,0,0,20210311,105,125,2,14,14,20,20,230,20,2020,0,3,1606,1
Atlanta,37,27,20,37,0,0,0,0,Toronto,26,33,35,26,0,0,0,0,20210311,121,120,11,5,-10,1,1,241,-1,2020,0,3,733,1
Houston,27,21,31,20,0,0,0,0,Utah,36,29,27,22,0,0,0,0,20210312,99,114,9,17,13,15,15,213,15,2020,0,4,1199,1
Philadelphia,32,31,31,33,0,0,0,0,Washington,15,38,23,25,0,0,0,0,20210312,127,101,17,10,18,26,26,228,-26,2020,0,4,123,1
Orlando,29,10,25,13,0,0,0,0,San Antonio,16,31,27,30,0,0,0,0,20210312,77,104,-13,8,10,27,27,181,27,2020,0,4,1035,1
Miami,29,13,28,31,0,0,0,0,Chicago,21,21,26,22,0,0,0,0,20210312,101,90,8,0,2,11,11,191,-11,2020,0,4,1189,1
Denver,26,27,28,22,0,0,0,0,Memphis,31,24,22,25,0,0,0,0,20210312,103,102,-5,-2,4,1,1,205,-1,2020,0,4,877,1
Indiana,28,26,25,21,0,0,0,0,LA Lakers,20,26,25,34,0,0,0,0,20210312,100,105,-8,-8,-8,5,5,205,5,2020,0,4,1805,1
Cleveland,29,19,9,25,0,0,0,0,New Orleans,34,35,24,23,0,0,0,0,20210312,82,116,5,21,36,34,34,198,34,2020,0,4,924,1
Sacramento,33,18,30,25,0,0,0,0,Atlanta,22,39,37,23,0,0,0,0,20210313,106,121,-11,10,17,15,15,227,15,2020,0,5,2082,1
Detroit,22,24,20,29,0,0,0,0,Brooklyn,26,25,27,22,0,0,0,0,20210313,95,100,4,5,12,5,5,195,5,2020,0,5,480,1
Toronto,24,28,21,31,0,0,0,0,Charlotte,44,23,31,16,0,0,0,0,20210313,104,114,20,15,25,10,10,218,10,2020,0,5,585,1
Dallas,28,34,31,23,0,0,0,0,Denver,29,22,22,30,0,0,0,0,20210313,116,103,-1,11,20,13,13,219,-13,2020,0,5,661,1
Portland,33,33,27,32,0,0,0,0,Minnesota,24,33,37,27,0,0,0,0,20210313,125,121,9,9,-1,4,4,246,-4,2020,0,5,1423,1
New York,22,34,32,31,0,0,0,0,Oklahoma City,31,23,24,19,0,0,0,0,20210313,119,97,-9,2,10,22,22,216,-22,2020,0,5,1324,1
Indiana,29,33,35,25,0,0,0,0,Phoenix,33,24,20,34,0,0,0,0,20210313,122,111,-4,5,20,11,11,233,-11,2020,0,5,1496,1
Milwaukee,36,28,30,31,0,0,0,0,Washington,33,32,30,24,0,0,0,0,20210313,125,119,3,-1,-1,6,6,244,-6,2020,0,5,634,1
San Antonio,22,30,21,26,0,0,0,0,Philadelphia,33,27,46,28,0,0,0,0,20210314,99,134,11,8,33,35,35,233,35,2020,0,6,1505,1
Miami,22,26,25,29,0,0,0,0,Orlando,19,26,32,20,0,0,0,0,20210314,102,97,3,3,-4,5,5,199,-5,2020,0,6,204,1
Memphis,31,31,38,22,0,0,0,0,Oklahoma City,28,27,35,38,0,0,0,0,20210314,122,128,-3,-7,-10,6,6,250,6,2020,0,6,421,1
LA Clippers,24,33,26,32,0,0,0,0,New Orleans,36,31,43,25,0,0,0,0,20210314,115,135,12,10,27,20,20,250,20,2020,0,6,1669,1
Cleveland,22,24,20,16,0,0,0,0,Atlanta,26,23,20,31,0,0,0,0,20210314,82,100,4,3,3,18,18,182,18,2020,0,6,555,1
Boston,38,28,38,30,0,0,0,0,Houston,34,19,19,35,0,0,0,0,20210314,134,107,4,13,32,27,27,241,-27,2020,0,6,1603,1
Utah,22,32,32,33,0,0,0,0,Golden State,33,34,28,36,0,0,0,0,20210314,119,131,11,13,9,12,12,250,12,2020,0,6,599,1
Toronto,22,27,24,22,0,0,0,0,Chicago,28,30,27,33,0,0,0,0,20210314,95,118,6,9,12,23,23,213,23,2020,0,6,436,1
Portland,20,29,23,40,0,0,0,0,Minnesota,24,23,29,38,0,0,0,0,20210314,112,114,4,-2,4,2,2,226,2,2020,0,6,1423,1
Memphis,25,27,25,22,0,0,0,0,Phoenix,24,36,36,26,0,0,0,0,20210315,99,122,-1,8,19,23,23,221,23,2020,0,0,1260,1
Milwaukee,32,37,36,28,0,0,0,0,Washington,23,32,34,33,0,0,0,0,20210315,133,122,9,14,16,11,11,255,-11,2020,0,0,634,1
LA Lakers,29,36,28,35,0,0,0,0,Golden State,26,24,23,24,0,0,0,0,20210315,128,97,3,15,20,31,31,225,-31,2020,0,0,347,1
San Antonio,24,36,35,14,0,0,0,0,Detroit,24,26,25,24,0,0,0,0,20210315,109,99,0,10,20,10,10,208,-10,2020,0,0,1238,1
LA Clippers,31,24,30,24,0,0,0,0,Dallas,23,27,28,21,0,0,0,0,20210315,109,99,8,5,7,10,10,208,-10,2020,0,0,1237,1
Sacramento,37,30,29,20,0,0,0,0,Charlotte,32,29,30,31,0,0,0,0,20210315,116,122,-5,-6,-5,6,6,238,6,2020,0,0,2239,1
New York,30,25,29,28,0,0,0,0,Brooklyn,35,32,29,21,0,0,0,0,20210315,112,117,5,12,12,5,5,229,5,2020,0,0,0,1
Indiana,32,24,35,15,0,0,0,0,Denver,32,33,22,34,0,0,0,0,20210315,106,121,0,9,-4,15,15,227,15,2020,0,0,998,1
Utah,20,34,23,40,0,0,0,0,Boston,22,31,26,30,0,0,0,0,20210316,117,109,-2,1,-2,8,8,226,-8,2020,0,1,2093,1
Oklahoma City,28,35,16,23,0,0,0,0,Chicago,42,29,31,21,0,0,0,0,20210316,102,123,14,8,23,21,21,225,21,2020,0,1,690,1
Atlanta,35,38,20,26,0,0,0,0,Houston,22,36,34,15,0,0,0,0,20210316,119,107,13,15,1,12,12,226,-12,2020,0,1,700,1
Minnesota,30,40,24,27,0,0,0,0,LA Lakers,31,40,31,35,0,0,0,0,20210316,121,137,1,1,8,16,16,258,16,2020,0,1,1521,1
Cleveland,26,22,28,22,0,0,0,0,Miami,37,25,33,18,0,0,0,0,20210316,98,113,11,14,19,15,15,211,15,2020,0,1,1089,1
New York,21,35,26,14,0,0,0,0,Philadelphia,20,28,25,26,0,0,0,0,20210316,96,99,-1,-8,-9,3,3,195,3,2020,0,1,80,1
New Orleans,34,30,31,29,0,0,0,0,Portland,28,22,32,43,0,0,0,0,20210316,124,125,-6,-14,-13,1,1,249,1,2020,0,1,2059,1
Toronto,31,27,23,31,0,0,0,0,Detroit,37,26,25,28,0,0,0,0,20210317,112,116,6,5,7,4,4,228,4,2020,0,2,205,1
Sacramento,34,32,36,19,0,0,0,0,Washington,38,28,27,26,0,0,0,0,20210317,121,119,-4,0,9,2,2,240,-2,2020,0,2,2371,1
Milwaukee,18,13,34,28,16,0,0,0,Philadelphia,25,20,29,19,12,0,0,0,20210317,109,105,-7,-14,-9,0,4,214,-4,2020,1,2,692,1
Miami,22,25,16,22,0,0,0,0,Memphis,25,21,26,17,0,0,0,0,20210317,85,89,3,-1,9,4,4,174,4,2020,0,2,873,1
Brooklyn,25,33,31,35,0,0,0,0,Indiana,40,21,30,24,0,0,0,0,20210317,124,115,-15,-3,-2,9,9,239,-9,2020,0,2,643,1
San Antonio,17,23,27,39,0,0,0,0,Chicago,31,27,22,19,0,0,0,0,20210317,106,99,-14,-18,-13,7,7,205,-7,2020,0,2,1050,1
Charlotte,25,20,22,37,0,0,0,0,Denver,26,31,38,34,0,0,0,0,20210317,104,129,1,12,28,25,25,233,25,2020,0,2,1355,1
LA Clippers,29,22,20,18,0,0,0,0,Dallas,24,32,21,28,0,0,0,0,20210317,89,105,-5,5,6,16,16,194,16,2020,0,2,1237,1
Boston,18,20,36,36,0,0,0,0,Cleveland,26,29,27,35,0,0,0,0,20210317,110,117,8,17,8,7,7,227,7,2020,0,2,549,1
Golden State,31,37,18,22,0,0,0,0,Houston,27,17,27,23,0,0,0,0,20210317,108,94,4,24,15,14,14,202,-14,2020,0,2,1642,1
New Orleans,23,25,22,23,0,0,0,0,Portland,31,26,20,24,0,0,0,0,20210318,93,101,8,9,7,8,8,194,8,2020,0,3,2059,1
Minnesota,25,28,30,40,0,0,0,0,Phoenix,25,33,33,28,0,0,0,0,20210318,123,119,0,-5,-8,4,4,242,-4,2020,0,3,1278,1
Utah,20,26,36,40,0,0,0,0,Washington,31,33,36,31,0,0,0,0,20210318,122,131,11,18,18,9,9,253,9,2020,0,3,1841,1
Charlotte,24,21,34,26,0,0,0,0,LA Lakers,31,29,23,33,0,0,0,0,20210318,105,116,7,15,4,11,11,221,11,2020,0,3,2115,1
Oklahoma City,21,20,26,26,0,0,0,0,Atlanta,31,30,30,25,0,0,0,0,20210318,93,116,10,20,24,23,23,209,23,2020,0,3,755,1
Orlando,26,18,22,27,0,0,0,0,New York,24,21,27,22,0,0,0,0,20210318,93,94,-2,1,6,1,1,187,1,2020,0,3,939,1
Utah,23,32,24,36,0,0,0,0,Toronto,27,27,23,35,0,0,0,0,20210319,115,112,-4,1,2,3,3,227,-3,2020,0,4,1664,1
Brooklyn,29,33,22,29,0,0,0,0,Orlando,35,29,39,18,0,0,0,0,20210319,113,121,6,2,19,8,8,234,8,2020,0,4,939,1
Dallas,33,27,38,21,0,0,0,0,Portland,37,27,29,32,0,0,0,0,20210319,119,125,4,4,-5,6,6,244,6,2020,0,4,1630,1
Minnesota,29,25,24,23,0,0,0,0,Phoenix,34,30,19,30,0,0,0,0,20210319,101,113,5,10,5,12,12,214,12,2020,0,4,1278,1
Indiana,32,36,31,38,0,0,0,0,Miami,30,28,24,28,0,0,0,0,20210319,137,110,2,10,17,27,27,247,-27,2020,0,4,1026,1
Sacramento,28,27,27,25,0,0,0,0,Boston,22,23,36,15,0,0,0,0,20210319,107,96,6,10,1,11,11,203,-11,2020,0,4,2624,1
Detroit,27,28,29,29,0,0,0,0,Houston,28,23,26,23,0,0,0,0,20210319,113,100,-1,4,7,13,13,213,-13,2020,0,4,1105,1
Chicago,30,25,34,27,11,0,0,0,Denver,20,27,34,35,15,0,0,0,20210319,127,131,-10,-8,-8,0,4,258,4,2020,1,4,916,1
San Antonio,25,29,27,35,0,0,0,0,Cleveland,22,20,24,44,0,0,0,0,20210319,116,110,3,12,15,6,6,226,-6,2020,0,4,1256,1
Golden State,34,33,24,25,0,0,0,0,Memphis,26,22,24,31,0,0,0,0,20210319,116,103,8,19,19,13,13,219,-13,2020,0,4,1798,1
Charlotte,21,23,32,22,0,0,0,0,LA Clippers,37,29,32,27,0,0,0,0,20210320,98,125,16,22,22,27,27,223,27,2020,0,5,2115,1
Atlanta,28,24,22,25,0,0,0,0,LA Lakers,25,28,12,29,0,0,0,0,20210320,99,94,3,-1,9,5,5,193,-5,2020,0,5,1932,1
Golden State,24,27,28,24,0,0,0,0,Memphis,28,21,33,29,0,0,0,0,20210320,103,111,4,-2,3,8,8,214,8,2020,0,5,1798,1
San Antonio,33,17,34,29,0,0,0,0,Milwaukee,26,31,31,32,0,0,0,0,20210320,113,120,-7,7,4,7,7,233,7,2020,0,5,1108,1
Sacramento,21,31,28,25,0,0,0,0,Philadelphia,42,31,33,23,0,0,0,0,20210320,105,129,21,21,26,24,24,234,24,2020,0,5,2451,1
LA Lakers,26,18,32,18,0,0,0,0,Phoenix,31,28,29,23,0,0,0,0,20210321,94,111,5,15,12,17,17,205,17,2020,0,6,356,1
Philadelphia,23,20,21,24,13,0,0,0,New York,15,27,22,24,12,0,0,0,20210321,101,100,8,1,0,0,1,201,-1,2020,1,6,80,1
Indiana,32,25,22,19,11,0,0,0,Miami,26,23,21,28,8,0,0,0,20210321,109,106,6,8,9,0,3,215,-3,2020,1,6,1026,1
Oklahoma City,31,35,24,24,0,0,0,0,Houston,22,40,23,27,0,0,0,0,20210321,114,112,9,4,5,2,2,226,-2,2020,0,6,413,1
Orlando,31,17,25,23,0,0,0,0,Boston,27,29,33,23,0,0,0,0,20210321,96,112,-4,8,16,16,16,208,16,2020,0,6,1115,1
New Orleans,22,36,25,30,0,0,0,0,Denver,30,21,29,28,0,0,0,0,20210321,113,108,-8,7,3,5,5,221,-5,2020,0,6,1079,1
Toronto,28,29,18,30,0,0,0,0,Cleveland,23,36,32,25,0,0,0,0,20210321,105,116,-5,2,16,11,11,221,11,2020,0,6,187,1
Washington,30,26,27,23,0,0,0,0,Brooklyn,25,38,25,25,0,0,0,0,20210321,106,113,-5,7,5,7,7,219,7,2020,0,6,204,1
Dallas,27,38,38,29,0,0,0,0,Portland,30,24,15,23,0,0,0,0,20210321,132,92,-3,11,34,40,40,224,-40,2020,0,6,1630,1
Chicago,20,26,29,25,0,0,0,0,Detroit,25,20,20,21,0,0,0,0,20210321,100,86,-5,1,10,14,14,186,-14,2020,0,6,238,1
Oklahoma City,25,32,26,29,0,0,0,0,Minnesota,22,28,26,27,0,0,0,0,20210322,112,103,3,7,7,9,9,215,-9,2020,0,0,694,1
Indiana,26,34,34,19,0,0,0,0,Milwaukee,48,35,27,30,0,0,0,0,20210322,113,140,22,23,16,27,27,253,27,2020,0,0,243,1
Charlotte,31,24,19,26,0,0,0,0,San Antonio,21,24,24,28,0,0,0,0,20210322,100,97,10,10,5,3,3,197,-3,2020,0,0,1103,1
Boston,30,35,21,31,9,0,0,0,Memphis,24,36,34,23,15,0,0,0,20210322,126,132,-6,-5,8,0,6,258,6,2020,1,0,1134,1
Utah,29,27,33,31,0,0,0,0,Chicago,23,19,29,24,0,0,0,0,20210322,120,95,6,14,18,25,25,215,-25,2020,0,0,1256,1
Toronto,28,32,26,13,0,0,0,0,Houston,27,38,23,29,0,0,0,0,20210322,99,117,-1,5,2,18,18,216,18,2020,0,0,1299,1
Sacramento,36,27,27,29,0,0,0,0,Cleveland,35,24,17,29,0,0,0,0,20210322,119,105,1,4,14,14,14,224,-14,2020,0,0,2096,1
Atlanta,29,34,27,20,0,0,0,0,LA Clippers,30,18,34,37,0,0,0,0,20210322,110,119,1,-15,-8,9,9,229,9,2020,0,0,1932,1
Philadelphia,35,24,21,28,0,0,0,0,Golden State,17,28,40,13,0,0,0,0,20210323,108,98,18,14,-5,10,10,206,-10,2020,0,1,2516,1
Phoenix,25,33,27,25,0,0,0,0,Miami,20,23,30,27,0,0,0,0,20210323,110,100,5,15,12,10,10,210,-10,2020,0,1,1978,1
LA Lakers,29,17,30,35,0,0,0,0,New Orleans,32,27,43,26,0,0,0,0,20210323,111,128,3,13,26,17,17,239,17,2020,0,1,1669,1
Washington,31,18,31,33,0,0,0,0,New York,39,30,39,23,0,0,0,0,20210323,113,131,8,20,28,18,18,244,18,2020,0,1,204,1
Denver,30,31,19,30,0,0,0,0,Orlando,15,24,30,30,0,0,0,0,20210323,110,99,15,22,11,11,11,209,-11,2020,0,1,1548,1
Brooklyn,37,28,27,24,0,0,0,0,Portland,41,25,25,21,0,0,0,0,20210323,116,112,-4,-1,1,4,4,228,-4,2020,0,1,2439,1
Brooklyn,17,21,23,27,0,0,0,0,Utah,38,25,27,28,0,0,0,0,20210324,88,118,21,25,29,30,30,206,30,2020,0,2,1967,1
Denver,30,24,27,30,0,0,0,0,Toronto,38,34,26,37,0,0,0,0,20210324,111,135,8,18,17,24,24,246,24,2020,0,2,1341,1
LA Clippers,41,26,35,32,0,0,0,0,San Antonio,29,24,31,17,0,0,0,0,20210324,134,101,12,14,18,33,33,235,-33,2020,0,2,1201,1
Atlanta,27,30,17,34,0,0,0,0,Sacramento,29,28,28,25,0,0,0,0,20210324,108,110,2,0,11,2,2,218,2,2020,0,2,2082,1
Phoenix,32,27,32,20,0,0,0,0,Orlando,24,35,27,26,0,0,0,0,20210324,111,112,-8,0,-5,1,1,223,1,2020,0,2,1842,1
Memphis,26,23,33,34,0,0,0,0,Oklahoma City,21,32,20,34,0,0,0,0,20210324,116,107,5,-4,9,9,9,223,-9,2020,0,2,421,1
Dallas,30,26,32,40,0,0,0,0,Minnesota,33,22,18,35,0,0,0,0,20210324,128,108,-3,1,15,20,20,236,-20,2020,0,2,863,1
Boston,30,29,27,33,0,0,0,0,Milwaukee,35,35,30,21,0,0,0,0,20210324,119,121,5,11,14,2,2,240,2,2020,0,2,855,1
Detroit,24,27,28,32,0,0,0,0,Indiana,21,36,29,30,0,0,0,0,20210324,111,116,-3,6,7,5,5,227,5,2020,0,2,240,1
Charlotte,26,32,35,29,0,0,0,0,Houston,26,29,15,27,0,0,0,0,20210324,122,97,0,3,23,25,25,219,-25,2020,0,2,925,1
Cleveland,25,28,25,25,0,0,0,0,Chicago,25,30,17,22,0,0,0,0,20210324,103,94,0,-2,6,9,9,197,-9,2020,0,2,308,1
Philadelphia,27,27,35,20,0,0,0,0,LA Lakers,24,30,17,30,0,0,0,0,20210325,109,101,3,0,18,8,8,210,-8,2020,0,3,2388,1
Portland,31,28,32,34,0,0,0,0,Miami,24,34,33,31,0,0,0,0,20210325,125,122,7,1,0,3,3,247,-3,2020,0,3,2704,1
Washington,25,35,18,24,0,0,0,0,New York,20,25,22,39,0,0,0,0,20210325,102,106,-5,-15,-11,4,4,208,4,2020,0,3,204,1
Golden State,37,24,25,33,0,0,0,0,Sacramento,35,37,34,35,0,0,0,0,20210325,119,141,-2,11,20,22,22,260,22,2020,0,3,75,1
LA Clippers,30,19,23,26,0,0,0,0,San Antonio,27,28,13,17,0,0,0,0,20210325,98,85,3,-6,4,13,13,183,-13,2020,0,3,1201,1
Memphis,24,26,29,35,0,0,0,0,Utah,38,28,22,29,0,0,0,0,20210326,114,117,14,16,9,3,3,231,3,2020,0,4,1247,1
Phoenix,29,24,30,21,0,0,0,0,Toronto,28,23,26,23,0,0,0,0,20210326,104,100,1,2,6,4,4,204,-4,2020,0,4,1885,1
Portland,35,30,15,32,0,0,0,0,Orlando,32,23,22,28,0,0,0,0,20210326,112,105,3,10,3,7,7,217,-7,2020,0,4,2525,1
Denver,26,28,31,28,0,0,0,0,New Orleans,33,30,23,22,0,0,0,0,20210326,113,108,-7,-9,-1,5,5,221,-5,2020,0,4,1079,1
Houston,29,34,28,10,0,0,0,0,Minnesota,33,21,22,31,0,0,0,0,20210326,101,107,4,-9,-15,6,6,208,6,2020,0,4,1057,1
Indiana,31,30,21,27,0,0,0,0,Dallas,29,19,27,19,0,0,0,0,20210326,109,94,2,13,7,15,15,203,-15,2020,0,4,763,1
Cleveland,24,27,10,25,0,0,0,0,LA Lakers,22,22,28,28,0,0,0,0,20210326,86,100,-2,-7,11,14,14,186,14,2020,0,4,2044,1
Atlanta,33,37,30,24,0,0,0,0,Golden State,26,26,32,24,0,0,0,0,20210326,124,108,7,18,16,16,16,232,-16,2020,0,4,2135,1
Brooklyn,34,25,23,31,0,0,0,0,Detroit,27,23,28,33,0,0,0,0,20210326,113,111,7,9,4,2,2,224,-2,2020,0,4,480,1
Miami,23,26,30,26,0,0,0,0,Charlotte,40,32,20,18,0,0,0,0,20210326,105,110,17,23,13,5,5,215,5,2020,0,4,654,1
Boston,32,28,43,19,0,0,0,0,Milwaukee,26,29,34,25,0,0,0,0,20210326,122,114,6,5,14,8,8,236,-8,2020,0,4,855,1
Detroit,22,19,34,17,0,0,0,0,Washington,33,35,11,27,0,0,0,0,20210327,92,106,11,27,4,14,14,198,14,2020,0,5,394,1
Memphis,19,34,29,28,0,0,0,0,Utah,39,31,30,26,0,0,0,0,20210327,110,126,20,17,18,16,16,236,16,2020,0,5,1247,1
Cleveland,29,19,26,24,0,0,0,0,Sacramento,31,18,22,29,0,0,0,0,20210327,98,100,2,1,-3,2,2,198,2,2020,0,5,2096,1
Boston,21,26,29,35,0,0,0,0,Oklahoma City,25,27,28,14,0,0,0,0,20210327,111,94,-4,-5,-4,17,17,205,-17,2020,0,5,1492,1
Chicago,20,19,34,31,0,0,0,0,San Antonio,33,32,31,24,0,0,0,0,20210327,104,120,13,26,23,16,16,224,16,2020,0,5,1050,1
Houston,41,33,24,31,0,0,0,0,Minnesota,29,19,30,29,0,0,0,0,20210327,129,107,12,26,20,22,22,236,-22,2020,0,5,1057,1
New York,32,25,24,21,0,0,0,0,Milwaukee,25,29,23,19,0,0,0,0,20210327,102,96,7,3,4,6,6,198,-6,2020,0,5,732,1
Philadelphia,30,30,24,28,0,0,0,0,LA Clippers,29,36,32,25,0,0,0,0,20210327,112,122,-1,5,13,10,10,234,10,2020,0,5,2388,1
Dallas,20,33,25,25,0,0,0,0,New Orleans,35,18,27,32,0,0,0,0,20210327,103,112,15,0,2,9,9,215,9,2020,0,5,442,1
Phoenix,26,23,27,14,11,0,0,0,Charlotte,29,20,18,23,7,0,0,0,20210328,101,97,-3,0,9,0,4,198,-4,2020,1,6,1778,1
Atlanta,35,20,24,23,0,0,0,0,Denver,31,34,32,29,0,0,0,0,20210328,102,126,-4,10,18,24,24,228,24,2020,0,6,1209,1
Orlando,21,18,30,24,0,0,0,0,LA Lakers,22,22,25,27,0,0,0,0,20210328,93,96,1,5,0,3,3,189,3,2020,0,6,2197,1
Portland,32,36,23,31,0,0,0,0,Toronto,41,33,10,33,0,0,0,0,20210328,122,117,-9,-6,7,5,5,239,-5,2020,0,6,2108,1
Dallas,33,38,29,27,0,0,0,0,Oklahoma City,24,39,20,23,0,0,0,0,20210329,127,106,9,8,17,21,21,233,-21,2020,0,0,189,1
Cleveland,18,16,18,23,0,0,0,0,Utah,27,26,37,24,0,0,0,0,20210329,75,114,9,19,38,39,39,189,39,2020,0,0,1564,1
Indiana,28,30,34,32,0,0,0,0,Washington,24,33,38,37,0,0,0,0,20210329,124,132,-4,-1,3,8,8,256,8,2020,0,0,490,1
Sacramento,27,41,29,35,0,0,0,0,San Antonio,31,29,31,24,0,0,0,0,20210329,132,115,-4,8,6,17,17,247,-17,2020,0,0,1456,1
Miami,21,15,39,23,0,0,0,0,New York,16,27,21,24,0,0,0,0,20210329,98,88,5,-7,11,10,10,186,-10,2020,0,0,1091,1
Minnesota,25,27,25,30,0,0,0,0,Brooklyn,37,24,26,25,0,0,0,0,20210329,107,112,12,9,10,5,5,219,5,2020,0,0,1016,1
Memphis,23,34,33,30,0,0,0,0,Houston,27,30,34,19,0,0,0,0,20210329,120,110,-4,0,-1,10,10,230,-10,2020,0,0,484,1
Chicago,29,31,25,17,0,0,0,0,Golden State,34,31,31,20,0,0,0,0,20210329,102,116,5,5,11,14,14,218,14,2020,0,0,1853,1
Toronto,27,23,25,29,0,0,0,0,Detroit,35,31,26,26,0,0,0,0,20210329,104,118,8,16,17,14,14,222,14,2020,0,0,205,1
New Orleans,32,32,24,27,0,0,0,0,Boston,27,28,26,28,0,0,0,0,20210329,115,109,5,9,7,6,6,224,-6,2020,0,0,1358,1
Milwaukee,38,17,31,19,0,0,0,0,LA Clippers,26,31,39,33,0,0,0,0,20210329,105,129,-12,2,10,24,24,234,24,2020,0,0,1741,1
Philadelphia,22,23,26,24,0,0,0,0,Denver,44,24,20,16,0,0,0,0,20210330,95,104,22,23,17,9,9,199,9,2020,0,1,1574,1
Orlando,13,24,33,33,0,0,0,0,LA Clippers,26,25,22,23,0,0,0,0,20210330,103,96,-13,-14,-3,7,7,199,-7,2020,0,1,2197,1
Atlanta,27,25,33,25,0,0,0,0,Phoenix,30,34,25,28,0,0,0,0,20210330,110,117,3,12,4,7,7,227,7,2020,0,1,1588,1
Charlotte,32,32,25,25,0,0,0,0,Washington,29,27,25,23,0,0,0,0,20210330,114,104,3,8,8,10,10,218,-10,2020,0,1,329,1
Sacramento,27,26,29,24,0,0,0,0,San Antonio,33,36,28,23,0,0,0,0,20210331,106,120,6,16,15,14,14,226,14,2020,0,2,1456,1
Chicago,37,21,28,30,0,0,0,0,Phoenix,39,28,27,27,0,0,0,0,20210331,116,121,2,9,8,5,5,237,5,2020,0,2,1450,1
Toronto,32,35,22,14,0,0,0,0,Oklahoma City,30,29,28,26,0,0,0,0,20210331,103,113,-2,-8,-2,10,10,216,10,2020,0,2,1114,1
New York,26,25,30,20,0,0,0,0,Minnesota,19,31,20,32,0,0,0,0,20210331,101,102,-7,-1,-11,1,1,203,1,2020,0,2,1016,1
Utah,29,28,18,36,0,0,0,0,Memphis,28,21,27,31,0,0,0,0,20210331,111,107,1,8,-1,4,4,218,-4,2020,0,2,1247,1
Houston,42,26,19,21,0,0,0,0,Brooklyn,29,28,29,34,0,0,0,0,20210331,108,120,-13,-11,-1,12,12,228,12,2020,0,2,1417,1
Miami,23,20,22,27,0,0,0,0,Indiana,28,17,22,20,0,0,0,0,20210331,92,87,-5,-2,-2,5,5,179,-5,2020,0,2,1026,1
Portland,31,20,36,37,0,0,0,0,Detroit,33,19,27,22,0,0,0,0,20210331,124,101,-2,-1,8,23,23,225,-23,2020,0,2,1964,1
Dallas,30,34,26,23,0,0,0,0,Boston,25,20,28,35,0,0,0,0,20210331,113,108,5,19,17,5,5,221,-5,2020,0,2,1548,1
Milwaukee,24,33,32,23,0,0,0,0,LA Lakers,30,19,26,22,0,0,0,0,20210331,112,97,-6,8,14,15,15,209,-15,2020,0,2,1741,1
Atlanta,32,22,30,26,9,15,0,0,San Antonio,22,26,32,30,9,10,0,0,20210401,134,129,10,6,4,0,5,263,-5,2020,2,3,881,1
Orlando,27,25,19,30,14,0,0,0,New Orleans,26,19,31,25,9,0,0,0,20210401,115,110,1,7,-5,0,5,225,-5,2020,1,3,533,1
Denver,31,31,19,20,0,0,0,0,LA Clippers,20,29,21,24,0,0,0,0,20210401,101,94,11,13,11,7,7,195,-7,2020,0,3,830,1
Golden State,24,30,27,28,0,0,0,0,Miami,23,36,27,30,0,0,0,0,20210401,109,116,-1,5,5,7,7,225,7,2020,0,3,2590,1
Philadelphia,31,27,27,29,0,0,0,0,Cleveland,31,25,17,21,0,0,0,0,20210401,114,94,0,2,12,20,20,208,-20,2020,0,3,358,1
Charlotte,11,37,17,24,0,0,0,0,Brooklyn,32,36,24,19,0,0,0,0,20210401,89,111,21,20,27,22,22,200,22,2020,0,3,531,1
Washington,22,22,24,23,0,0,0,0,Detroit,32,31,24,33,0,0,0,0,20210401,91,120,10,19,19,29,29,211,29,2020,0,3,394,1
Chicago,25,24,24,33,0,0,0,0,Utah,26,32,30,25,0,0,0,0,20210402,106,113,1,9,15,7,7,219,7,2020,0,4,1256,1
LA Lakers,29,36,26,24,0,0,0,0,Sacramento,27,26,23,18,0,0,0,0,20210402,115,94,2,12,15,21,21,209,-21,2020,0,4,361,1
Milwaukee,34,26,37,30,0,0,0,0,Portland,21,32,20,36,0,0,0,0,20210402,127,109,13,7,24,18,18,236,-18,2020,0,4,1714,1
Oklahoma City,13,37,26,27,0,0,0,0,Phoenix,43,30,30,37,0,0,0,0,20210402,103,140,30,23,27,37,37,243,37,2020,0,4,840,1
Golden State,26,16,14,21,0,0,0,0,Toronto,27,35,46,22,0,0,0,0,20210402,77,130,1,20,52,53,53,207,53,2020,0,4,2263,1
Atlanta,28,27,39,32,0,0,0,0,New Orleans,34,20,25,24,0,0,0,0,20210402,126,103,-6,1,15,23,23,229,-23,2020,0,4,424,1
Minnesota,28,38,18,24,0,0,0,0,Memphis,30,38,24,28,0,0,0,0,20210402,108,120,2,2,8,12,12,228,12,2020,0,4,700,1
Charlotte,28,32,24,30,0,0,0,0,Indiana,24,25,27,21,0,0,0,0,20210402,114,97,4,11,8,17,17,211,-17,2020,0,4,428,1
Houston,25,19,26,32,0,0,0,0,Boston,33,19,30,36,0,0,0,0,20210402,102,118,8,8,12,16,16,220,16,2020,0,4,1603,1
Dallas,22,27,23,27,0,0,0,0,New York,25,21,23,17,0,0,0,0,20210402,99,86,-3,3,3,13,13,185,-13,2020,0,4,1370,1
New York,41,19,28,37,0,0,0,0,Detroit,15,26,20,20,0,0,0,0,20210403,125,81,26,19,27,44,44,206,-44,2020,0,5,480,1
Cleveland,27,27,19,28,0,0,0,0,Miami,36,31,17,31,0,0,0,0,20210403,101,115,9,13,11,14,14,216,14,2020,0,5,1089,1
Minnesota,29,31,23,30,0,0,0,0,Philadelphia,26,38,33,25,0,0,0,0,20210403,113,122,-3,4,14,9,9,235,9,2020,0,5,983,1
Oklahoma City,19,27,13,26,0,0,0,0,Portland,35,30,39,29,0,0,0,0,20210403,85,133,16,19,45,48,48,218,48,2020,0,5,1484,1
Milwaukee,31,30,38,30,0,0,0,0,Sacramento,28,29,34,37,0,0,0,0,20210403,129,128,3,4,8,1,1,257,-1,2020,0,5,1771,1
Indiana,32,35,31,28,13,0,0,0,San Antonio,33,26,38,29,7,0,0,0,20210403,139,133,-1,8,1,0,6,272,-6,2020,1,5,999,1
Orlando,20,20,32,19,0,0,0,0,Utah,38,40,29,30,0,0,0,0,20210403,91,137,18,38,35,46,46,228,46,2020,0,5,1915,1
Dallas,24,28,23,34,0,0,0,0,Washington,19,28,20,20,0,0,0,0,20210403,109,87,5,5,8,22,22,196,-22,2020,0,5,1181,1
New Orleans,38,32,19,33,0,0,0,0,Houston,27,32,33,23,0,0,0,0,20210404,122,115,11,11,-3,7,7,237,-7,2020,0,6,317,1
Memphis,29,23,45,19,0,0,0,0,Philadelphia,22,20,29,29,0,0,0,0,20210404,116,100,7,10,26,16,16,216,-16,2020,0,6,878,1
Orlando,29,36,21,23,0,0,0,0,Denver,23,24,38,34,0,0,0,0,20210404,109,119,-6,-18,-1,10,10,228,10,2020,0,6,1548,1
LA Lakers,20,18,17,31,0,0,0,0,LA Clippers,27,26,24,27,0,0,0,0,20210404,86,104,7,15,22,18,18,190,18,2020,0,6,0,1
Charlotte,26,17,27,16,0,0,0,0,Boston,25,33,40,18,0,0,0,0,20210404,86,116,-1,15,28,30,30,202,30,2020,0,6,720,1
Golden State,24,35,23,29,0,0,0,0,Atlanta,24,33,22,38,0,0,0,0,20210404,111,117,0,-2,-3,6,6,228,6,2020,0,6,2135,1
Brooklyn,28,18,26,35,0,0,0,0,Chicago,25,32,32,26,0,0,0,0,20210404,107,115,-3,11,17,8,8,222,8,2020,0,6,711,1
New York,34,33,21,24,0,0,0,0,Brooklyn,31,26,32,25,0,0,0,0,20210405,112,114,-3,-10,1,2,2,226,2,2020,0,0,0,1
Utah,25,17,27,34,0,0,0,0,Dallas,27,23,37,24,0,0,0,0,20210405,103,111,2,8,18,8,8,214,8,2020,0,0,998,1
Phoenix,34,36,31,32,0,0,0,0,Houston,34,26,32,38,0,0,0,0,20210405,133,130,0,10,9,3,3,263,-3,2020,0,0,1014,1
Sacramento,29,26,27,24,0,0,0,0,Minnesota,26,29,27,34,0,0,0,0,20210405,106,116,-3,0,0,10,10,222,10,2020,0,0,1511,1
Detroit,30,28,35,39,0,0,0,0,Oklahoma City,19,28,30,31,0,0,0,0,20210405,132,108,11,11,16,24,24,240,-24,2020,0,0,909,1
Cleveland,28,29,43,25,0,0,0,0,San Antonio,26,21,33,21,0,0,0,0,20210405,125,101,2,10,20,24,24,226,-24,2020,0,0,1256,1
Washington,28,33,25,15,0,0,0,0,Toronto,19,32,24,28,0,0,0,0,20210405,101,103,-9,-10,-11,2,2,204,2,2020,0,0,349,1
LA Lakers,40,28,22,20,0,0,0,0,Toronto,28,14,28,31,0,0,0,0,20210406,110,101,12,26,20,9,9,211,-9,2020,0,1,2170,1
Memphis,37,26,33,28,0,0,0,0,Miami,34,23,32,23,0,0,0,0,20210406,124,112,3,6,7,12,12,236,-12,2020,0,1,873,1
Portland,32,34,23,27,0,0,0,0,LA Clippers,47,26,28,32,0,0,0,0,20210406,116,133,15,7,12,17,17,249,17,2020,0,1,826,1
Chicago,30,32,35,16,0,0,0,0,Indiana,28,21,25,23,0,0,0,0,20210406,113,97,2,13,23,16,16,210,-16,2020,0,1,163,1
Detroit,32,24,30,33,0,0,0,0,Denver,39,37,33,25,0,0,0,0,20210406,119,134,7,20,23,15,15,253,15,2020,0,1,1154,1
Philadelphia,25,34,26,21,0,0,0,0,Boston,24,22,24,26,0,0,0,0,20210406,106,96,1,13,15,10,10,202,-10,2020,0,1,270,1
New Orleans,29,32,29,17,0,0,0,0,Atlanta,25,36,46,16,0,0,0,0,20210406,107,123,-4,0,17,16,16,230,16,2020,0,1,424,1
Milwaukee,26,24,38,33,0,0,0,0,Golden State,28,25,30,39,0,0,0,0,20210406,121,122,2,3,-5,1,1,243,1,2020,0,1,1838,1
Memphis,29,38,43,21,0,0,0,0,Atlanta,34,30,23,26,0,0,0,0,20210407,131,113,-5,3,23,18,18,244,-18,2020,0,2,336,1
New York,19,27,27,26,0,0,0,0,Boston,21,26,23,31,0,0,0,0,20210407,99,101,2,1,-3,2,2,200,2,2020,0,2,190,1
New Orleans,33,26,23,29,0,0,0,0,Brooklyn,36,43,36,24,0,0,0,0,20210407,111,139,3,20,33,28,28,250,28,2020,0,2,1168,1
San Antonio,32,18,24,22,0,0,0,0,Denver,30,24,27,25,0,0,0,0,20210407,96,106,-2,4,7,10,10,202,10,2020,0,2,802,1
Dallas,23,19,22,29,0,0,0,0,Houston,24,23,28,27,0,0,0,0,20210407,93,102,1,5,11,9,9,195,9,2020,0,2,225,1
Minnesota,31,25,38,43,0,0,0,0,Indiana,35,42,32,32,0,0,0,0,20210407,137,141,4,21,15,4,4,278,4,2020,0,2,510,1
Charlotte,32,24,29,28,0,0,0,0,Oklahoma City,29,22,26,25,0,0,0,0,20210407,113,102,3,5,8,11,11,215,-11,2020,0,2,938,1
Washington,34,39,27,31,0,0,0,0,Orlando,33,27,30,26,0,0,0,0,20210407,131,116,1,13,10,15,15,247,-15,2020,0,2,757,1
Utah,21,19,38,24,11,0,0,0,Phoenix,20,31,26,25,15,0,0,0,20210407,113,117,-1,11,-1,0,4,230,4,2020,1,2,505,1
Chicago,33,31,33,25,0,0,0,0,Toronto,27,24,28,34,0,0,0,0,20210408,122,113,6,13,18,9,9,235,-9,2020,0,3,436,1
Portland,29,27,19,28,0,0,0,0,Utah,30,23,40,29,0,0,0,0,20210408,103,122,1,-3,18,19,19,225,19,2020,0,3,634,1
Detroit,27,35,27,24,0,0,0,0,Sacramento,23,21,30,27,0,0,0,0,20210408,113,101,4,18,15,12,12,214,-12,2020,0,3,2020,1
Milwaukee,31,25,28,17,0,0,0,0,Dallas,29,26,25,36,0,0,0,0,20210408,101,116,-2,-1,-4,15,15,217,15,2020,0,3,857,1
LA Lakers,27,29,24,24,0,0,0,0,Miami,32,22,29,27,0,0,0,0,20210408,104,110,5,-2,3,6,6,214,6,2020,0,3,2335,1
Phoenix,23,33,25,22,0,0,0,0,LA Clippers,27,27,29,30,0,0,0,0,20210408,103,113,4,-2,2,10,10,216,10,2020,0,3,356,1
Cleveland,38,27,28,36,0,0,0,0,Oklahoma City,38,23,14,27,0,0,0,0,20210408,129,102,0,4,18,27,27,231,-27,2020,0,3,949,1
Memphis,35,25,30,24,15,0,0,0,New York,23,28,32,31,19,0,0,0,20210409,129,133,-12,-9,-7,0,4,262,4,2020,1,4,953,1
Philadelphia,22,28,18,26,0,0,0,0,New Orleans,23,27,26,25,0,0,0,0,20210409,94,101,1,0,8,7,7,195,7,2020,0,4,1088,1
Charlotte,32,34,34,27,0,0,0,0,Milwaukee,27,28,26,38,0,0,0,0,20210409,127,119,5,11,19,8,8,246,-8,2020,0,4,658,1
Houston,36,10,37,26,0,0,0,0,LA Clippers,26,41,27,32,0,0,0,0,20210409,109,126,-10,21,11,17,17,235,17,2020,0,4,1371,1
Indiana,33,31,19,28,0,0,0,0,Orlando,30,21,27,28,0,0,0,0,20210409,111,106,3,13,5,5,5,217,-5,2020,0,4,822,1
San Antonio,26,24,33,36,0,0,0,0,Denver,36,25,35,25,0,0,0,0,20210409,119,121,10,11,13,2,2,240,2,2020,0,4,802,1
Minnesota,39,27,31,27,12,0,0,0,Boston,25,32,35,32,21,0,0,0,20210409,136,145,-14,-9,-5,0,9,281,9,2020,1,4,1120,1
Chicago,33,33,18,24,0,0,0,0,Atlanta,25,28,33,34,0,0,0,0,20210409,108,120,-8,-13,2,12,12,228,12,2020,0,4,587,1
Washington,32,25,28,25,0,0,0,0,Golden State,23,27,29,28,0,0,0,0,20210409,110,107,9,7,6,3,3,217,-3,2020,0,4,2435,1
LA Lakers,33,28,31,34,0,0,0,0,Brooklyn,25,33,19,24,0,0,0,0,20210410,126,101,8,3,15,25,25,227,-25,2020,0,5,2445,1
Toronto,47,40,13,35,0,0,0,0,Cleveland,26,28,29,32,0,0,0,0,20210410,135,115,21,33,17,20,20,250,-20,2020,0,5,187,1
Houston,30,18,32,29,0,0,0,0,Golden State,32,33,29,31,0,0,0,0,20210410,109,125,2,17,14,16,16,234,16,2020,0,5,1642,1
Philadelphia,37,29,24,27,0,0,0,0,Oklahoma City,25,28,23,17,0,0,0,0,20210410,117,93,12,13,14,24,24,210,-24,2020,0,5,1256,1
Washington,29,26,24,27,0,0,0,0,Phoenix,27,30,44,33,0,0,0,0,20210410,106,134,-2,2,22,28,28,240,28,2020,0,5,1977,1
Detroit,23,27,26,27,0,0,0,0,Portland,33,26,36,23,0,0,0,0,20210410,103,118,10,9,19,15,15,221,15,2020,0,5,1964,1
Sacramento,31,34,24,23,0,0,0,0,Utah,34,25,36,33,0,0,0,0,20210410,112,128,3,-6,6,16,16,240,16,2020,0,5,532,1
Chicago,26,29,32,30,0,0,0,0,Minnesota,29,37,25,30,0,0,0,0,20210411,117,121,3,11,4,4,4,238,4,2020,0,6,355,1
Miami,25,31,33,18,0,0,0,0,Portland,31,17,23,27,0,0,0,0,20210411,107,98,-6,8,18,9,9,205,-9,2020,0,6,2704,1
Milwaukee,32,25,28,39,0,0,0,0,Orlando,19,19,29,20,0,0,0,0,20210411,124,87,13,19,18,37,37,211,-37,2020,0,6,1065,1
Toronto,16,26,34,20,0,0,0,0,New York,27,29,22,24,0,0,0,0,20210411,96,102,11,14,2,6,6,198,6,2020,0,6,341,1
Indiana,45,29,32,26,0,0,0,0,Memphis,31,32,34,28,0,0,0,0,20210411,132,125,14,11,9,7,7,257,-7,2020,0,6,383,1
New Orleans,29,33,28,26,0,0,0,0,Cleveland,39,29,26,15,0,0,0,0,20210411,116,109,-10,-6,-4,7,7,225,-7,2020,0,6,924,1
Boston,16,29,29,31,0,0,0,0,Denver,27,24,28,8,0,0,0,0,20210411,105,87,-11,-6,-5,18,18,192,-18,2020,0,6,1765,1
San Antonio,26,25,37,31,0,0,0,0,Dallas,26,30,33,28,0,0,0,0,20210411,119,117,0,-5,-1,2,2,236,-2,2020,0,6,252,1
Atlanta,33,19,23,30,0,0,0,0,Charlotte,20,25,32,24,0,0,0,0,20210411,105,101,13,7,-2,4,4,206,-4,2020,0,6,226,1
Detroit,35,27,37,25,0,0,0,0,LA Clippers,30,33,31,37,0,0,0,0,20210411,124,131,-5,1,-5,7,7,255,7,2020,0,6,1979,1
Philadelphia,30,30,28,25,0,0,0,0,Dallas,26,22,21,26,0,0,0,0,20210412,113,95,4,12,19,18,18,208,-18,2020,0,0,1297,1
Denver,32,29,22,24,0,0,0,0,Golden State,33,23,43,17,0,0,0,0,20210412,107,116,1,-5,16,9,9,223,9,2020,0,0,947,1
Chicago,22,25,27,16,0,0,0,0,Memphis,22,26,22,31,0,0,0,0,20210412,90,101,0,1,-4,11,11,191,11,2020,0,0,480,1
Sacramento,19,26,29,36,0,0,0,0,New Orleans,31,37,18,31,0,0,0,0,20210412,110,117,12,23,12,7,7,227,7,2020,0,0,1879,1
LA Lakers,28,24,16,28,0,0,0,0,New York,26,29,26,30,0,0,0,0,20210412,96,111,-2,3,13,15,15,207,15,2020,0,0,2445,1
San Antonio,28,32,29,31,0,0,0,0,Orlando,16,21,24,36,0,0,0,0,20210412,120,97,12,23,28,23,23,217,-23,2020,0,0,1035,1
Houston,29,29,30,32,0,0,0,0,Phoenix,38,43,22,23,0,0,0,0,20210412,120,126,9,23,15,6,6,246,6,2020,0,0,1014,1
Washington,33,37,28,27,0,0,0,0,Utah,42,23,23,33,0,0,0,0,20210412,125,121,-9,5,10,4,4,246,-4,2020,0,0,1841,1
Oklahoma City,31,22,16,27,0,0,0,0,Utah,22,33,33,18,0,0,0,0,20210413,96,106,-9,2,19,10,10,202,10,2020,0,1,861,1
Atlanta,28,38,24,18,0,0,0,0,Toronto,27,27,24,25,0,0,0,0,20210413,108,103,1,12,12,5,5,211,-5,2020,0,1,733,1
Boston,30,27,35,24,0,0,0,0,Portland,38,22,27,28,0,0,0,0,20210413,116,115,-8,-3,5,1,1,231,-1,2020,0,1,2532,1
LA Lakers,25,27,24,25,0,0,0,0,Charlotte,22,28,16,27,0,0,0,0,20210413,101,93,3,2,10,8,8,194,-8,2020,0,1,2115,1
Brooklyn,33,40,31,23,0,0,0,0,Minnesota,25,27,22,23,0,0,0,0,20210413,127,97,8,21,30,30,30,224,-30,2020,0,1,1016,1
LA Clippers,31,36,33,26,0,0,0,0,Indiana,34,31,32,18,0,0,0,0,20210413,126,115,-3,2,3,11,11,241,-11,2020,0,1,1805,1
Miami,34,16,22,14,0,0,0,0,Phoenix,26,30,27,23,0,0,0,0,20210413,86,106,-8,6,11,20,20,192,20,2020,0,1,1978,1
San Antonio,32,25,25,30,0,0,0,0,Toronto,30,28,27,32,0,0,0,0,20210414,112,117,-2,1,3,5,5,229,5,2020,0,2,1438,1
Washington,42,28,23,30,0,0,0,0,Sacramento,31,29,23,28,0,0,0,0,20210414,123,111,11,10,10,12,12,234,-12,2020,0,2,2371,1
Brooklyn,28,30,26,33,0,0,0,0,Philadelphia,32,33,29,29,0,0,0,0,20210414,117,123,4,7,10,6,6,240,6,2020,0,2,80,1
Golden State,36,39,50,22,0,0,0,0,Oklahoma City,32,22,29,26,0,0,0,0,20210414,147,109,4,21,42,38,38,256,-38,2020,0,2,1386,1
New York,26,27,40,23,0,0,0,0,New Orleans,26,26,37,17,0,0,0,0,20210414,116,106,0,1,4,10,10,222,-10,2020,0,2,1168,1
Milwaukee,24,37,45,24,0,0,0,0,Minnesota,19,25,35,26,0,0,0,0,20210414,130,105,5,17,27,25,25,235,-25,2020,0,2,298,1
Indiana,33,42,31,26,0,0,0,0,Houston,24,31,39,30,0,0,0,0,20210414,132,124,9,20,12,8,8,256,-8,2020,0,2,865,1
LA Clippers,30,23,20,27,0,0,0,0,Detroit,27,22,28,21,0,0,0,0,20210414,100,98,3,4,-4,2,2,198,-2,2020,0,2,1979,1
Miami,31,18,30,27,0,0,0,0,Denver,26,34,36,27,0,0,0,0,20210414,106,123,-5,11,17,17,17,229,17,2020,0,2,1724,1
Cleveland,27,22,26,28,0,0,0,0,Charlotte,23,18,25,24,0,0,0,0,20210414,103,90,4,8,9,13,13,193,-13,2020,0,2,435,1
Orlando,32,22,39,22,0,0,0,0,Chicago,22,31,19,34,0,0,0,0,20210414,115,106,10,1,21,9,9,221,-9,2020,0,2,984,1
Dallas,32,25,26,31,0,0,0,0,Memphis,34,26,29,24,0,0,0,0,20210414,114,113,-2,-3,-6,1,1,227,-1,2020,0,2,419,1
Milwaukee,33,31,30,26,0,0,0,0,Atlanta,29,23,30,27,0,0,0,0,20210415,120,109,4,12,12,11,11,229,-11,2020,0,3,669,1
Golden State,28,35,26,30,0,0,0,0,Cleveland,31,21,27,22,0,0,0,0,20210415,119,101,-3,11,10,18,18,220,-18,2020,0,3,2161,1
Boston,31,30,30,30,0,0,0,0,LA Lakers,23,25,31,34,0,0,0,0,20210415,121,113,8,13,12,8,8,234,-8,2020,0,3,2590,1
Sacramento,28,37,29,20,0,0,0,0,Phoenix,33,34,28,27,0,0,0,0,20210415,114,122,5,2,1,8,8,236,8,2020,0,3,634,1
New Orleans,29,32,28,16,10,0,0,0,Washington,30,32,24,19,12,0,0,0,20210416,115,117,1,1,-3,0,2,232,2,2020,1,4,964,1
Indiana,32,37,20,22,0,0,0,0,Utah,24,32,33,30,0,0,0,0,20210416,111,119,-8,-13,0,8,8,230,8,2020,0,4,1353,1
Orlando,24,27,19,32,0,0,0,0,Toronto,24,23,38,28,0,0,0,0,20210416,102,113,0,-4,15,11,11,215,11,2020,0,4,1048,1
Portland,28,20,35,24,0,0,0,0,San Antonio,31,26,28,21,0,0,0,0,20210416,107,106,-3,-9,-2,1,1,213,-1,2020,0,4,1718,1
LA Clippers,20,27,30,26,0,0,0,0,Philadelphia,31,28,22,25,0,0,0,0,20210416,103,106,11,12,4,3,3,209,3,2020,0,4,2388,1
Memphis,33,24,37,32,0,0,0,0,Chicago,33,24,28,30,0,0,0,0,20210416,126,115,0,0,9,11,11,241,-11,2020,0,4,480,1
Denver,35,34,31,28,0,0,0,0,Houston,28,21,30,20,0,0,0,0,20210416,128,99,7,20,21,29,29,227,-29,2020,0,4,878,1
Oklahoma City,32,24,23,25,0,0,0,0,Detroit,25,31,30,24,0,0,0,0,20210416,104,110,-7,0,7,6,6,214,6,2020,0,4,909,1
New York,34,22,27,34,0,0,0,0,Dallas,25,27,27,30,0,0,0,0,20210416,117,109,9,4,4,8,8,226,-8,2020,0,4,1370,1
Charlotte,35,26,28,26,0,0,0,0,Brooklyn,29,32,33,36,0,0,0,0,20210416,115,130,-6,0,5,15,15,245,15,2020,0,4,531,1
Miami,37,24,32,18,0,0,0,0,Minnesota,26,35,27,31,0,0,0,0,20210416,111,119,-11,0,-5,8,8,230,8,2020,0,4,1513,1
San Antonio,28,36,23,24,0,0,0,0,Phoenix,19,26,23,17,0,0,0,0,20210417,111,85,9,19,19,26,26,196,-26,2020,0,5,846,1
Memphis,35,34,31,28,0,0,0,0,Milwaukee,31,28,30,26,0,0,0,0,20210417,128,115,4,10,11,13,13,243,-13,2020,0,5,557,1
Detroit,27,28,25,20,0,0,0,0,Washington,27,34,32,28,0,0,0,0,20210417,100,121,0,6,13,21,21,221,21,2020,0,5,394,1
Cleveland,24,25,21,26,0,0,0,0,Chicago,29,18,33,26,0,0,0,0,20210417,96,106,5,-2,10,10,10,202,10,2020,0,5,308,1
Utah,35,27,20,28,5,0,0,0,LA Lakers,34,31,29,16,17,0,0,0,20210417,115,127,-1,3,12,0,12,242,12,2020,1,5,579,1
Golden State,33,33,23,25,0,0,0,0,Boston,24,36,29,30,0,0,0,0,20210417,114,119,-9,-6,0,5,5,233,5,2020,0,5,2692,1
Indiana,23,34,33,27,0,0,0,0,Atlanta,35,31,28,35,0,0,0,0,20210418,117,129,12,9,4,12,12,246,12,2020,0,6,427,1
Portland,24,27,21,29,0,0,0,0,Charlotte,44,21,28,16,0,0,0,0,20210418,101,109,20,14,21,8,8,210,8,2020,0,6,2284,1
Sacramento,22,45,20,34,0,0,0,0,Dallas,20,30,27,30,0,0,0,0,20210418,121,107,2,17,10,14,14,228,-14,2020,0,6,1437,1
Minnesota,26,27,16,36,0,0,0,0,LA Clippers,29,43,32,20,0,0,0,0,20210418,105,124,3,19,35,19,19,229,19,2020,0,6,1521,1
Brooklyn,31,29,24,23,0,0,0,0,Miami,32,32,22,23,0,0,0,0,20210418,107,109,1,4,2,2,2,216,2,2020,0,6,1091,1
New Orleans,25,19,35,24,9,0,0,0,New York,21,36,22,24,19,0,0,0,20210418,112,122,-4,13,0,0,10,234,10,2020,1,6,1168,1
Houston,28,25,32,29,0,0,0,0,Orlando,28,31,18,33,0,0,0,0,20210418,114,110,0,-6,8,4,4,224,-4,2020,0,6,847,1
Oklahoma City,31,28,21,26,0,0,0,0,Toronto,28,24,29,31,0,0,0,0,20210418,106,112,-3,-7,1,6,6,218,6,2020,0,6,1114,1
Oklahoma City,25,33,21,28,0,0,0,0,Washington,38,26,24,31,0,0,0,0,20210419,107,119,13,6,9,12,12,226,12,2020,0,0,1149,1
Golden State,24,31,20,32,0,0,0,0,Philadelphia,24,31,15,26,0,0,0,0,20210419,107,96,0,0,5,11,11,203,-11,2020,0,0,2516,1
Phoenix,24,31,28,33,12,0,0,0,Milwaukee,25,29,36,26,11,0,0,0,20210419,128,127,-1,1,-7,0,1,255,-1,2020,1,0,1462,1
Utah,29,23,33,26,0,0,0,0,LA Lakers,23,19,23,32,0,0,0,0,20210419,111,97,6,10,20,14,14,208,-14,2020,0,0,579,1
Houston,28,27,19,17,0,0,0,0,Miami,30,24,35,24,0,0,0,0,20210419,91,113,2,-1,15,22,22,204,22,2020,0,0,966,1
Memphis,35,25,35,21,9,12,0,0,Denver,27,29,31,29,9,14,0,0,20210419,137,139,-8,-4,-8,0,2,276,2,2020,2,0,877,1
Chicago,24,18,32,28,0,0,0,0,Boston,30,18,18,30,0,0,0,0,20210419,102,96,-6,-6,8,6,6,198,-6,2020,0,0,849,1
San Antonio,36,19,27,27,0,0,0,0,Indiana,21,23,22,28,0,0,0,0,20210419,109,94,15,11,16,15,15,203,-15,2020,0,0,999,1
Cleveland,22,31,23,29,0,0,0,0,Detroit,37,25,22,25,0,0,0,0,20210419,105,109,15,9,8,4,4,214,4,2020,0,0,90,1
Minnesota,39,35,25,35,0,0,0,0,Sacramento,43,31,29,17,0,0,0,0,20210420,134,120,-4,0,-4,14,14,254,-14,2020,0,1,1511,1
Orlando,24,24,24,24,0,0,0,0,Atlanta,27,38,15,32,0,0,0,0,20210420,96,112,3,17,8,16,16,208,16,2020,0,1,401,1
Brooklyn,26,31,36,41,0,0,0,0,New Orleans,29,30,33,37,0,0,0,0,20210420,134,129,-3,-2,1,5,5,263,-5,2020,0,1,1168,1
Charlotte,33,33,16,15,0,0,0,0,New York,30,30,31,18,0,0,0,0,20210420,97,109,-3,-6,9,12,12,206,12,2020,0,1,531,1
LA Clippers,30,26,30,27,0,0,0,0,Portland,31,29,22,30,0,0,0,0,20210420,113,112,-1,-4,4,1,1,225,-1,2020,0,1,826,1
Miami,27,24,26,30,0,0,0,0,San Antonio,27,26,19,15,0,0,0,0,20210421,107,87,0,-2,5,20,20,194,-20,2020,0,2,1147,1
Utah,34,27,30,21,0,0,0,0,Houston,27,16,20,26,0,0,0,0,20210421,112,89,7,18,28,23,23,201,-23,2020,0,2,1199,1
Golden State,20,38,35,21,0,0,0,0,Washington,38,22,26,32,0,0,0,0,20210421,114,118,18,2,-7,4,4,232,4,2020,0,2,2435,1
Minnesota,34,25,39,27,0,0,0,0,Sacramento,44,26,25,33,0,0,0,0,20210421,125,128,10,11,-3,3,3,253,3,2020,0,2,1511,1
Brooklyn,36,22,23,22,0,0,0,0,Toronto,23,33,36,22,0,0,0,0,20210421,103,114,-13,-2,11,11,11,217,11,2020,0,2,341,1
Denver,35,25,22,24,0,0,0,0,Portland,36,21,27,21,0,0,0,0,20210421,106,105,-1,3,-2,1,1,211,-1,2020,0,2,981,1
Detroit,36,22,32,27,0,0,0,0,Dallas,33,34,33,27,0,0,0,0,20210421,117,127,-3,9,10,10,10,244,10,2020,0,2,999,1
Atlanta,39,30,28,25,5,0,0,0,New York,34,33,23,32,15,0,0,0,20210421,127,137,-5,-2,-7,0,10,264,10,2020,1,2,745,1
Memphis,39,23,20,23,0,0,0,0,LA Clippers,24,29,34,30,0,0,0,0,20210421,105,117,-15,-9,5,12,12,222,12,2020,0,2,1599,1
Oklahoma City,28,29,29,30,0,0,0,0,Indiana,34,33,26,29,0,0,0,0,20210421,116,122,6,10,7,6,6,238,6,2020,0,2,688,1
Phoenix,28,26,23,39,0,0,0,0,Philadelphia,29,25,22,37,0,0,0,0,20210421,116,113,-1,0,1,3,3,229,-3,2020,0,2,2078,1
Chicago,12,32,28,33,0,0,0,0,Cleveland,34,27,38,22,0,0,0,0,20210421,105,121,22,17,27,16,16,226,16,2020,0,2,308,1
New Orleans,29,45,34,27,0,0,0,0,Orlando,27,25,18,30,0,0,0,0,20210422,135,100,2,22,38,35,35,235,-35,2020,0,3,533,1
Philadelphia,26,34,27,30,0,0,0,0,Milwaukee,40,37,31,16,0,0,0,0,20210422,117,124,14,17,21,7,7,241,7,2020,0,3,692,1
Detroit,25,22,23,21,0,0,0,0,San Antonio,26,31,25,24,0,0,0,0,20210422,91,106,1,10,12,15,15,197,15,2020,0,3,1238,1
Charlotte,23,21,23,24,0,0,0,0,Chicago,34,24,30,20,0,0,0,0,20210422,91,108,11,14,21,17,17,199,17,2020,0,3,586,1
Phoenix,21,16,28,21,0,0,0,0,Boston,26,27,24,22,0,0,0,0,20210422,86,99,5,16,12,13,13,185,13,2020,0,3,2295,1
LA Lakers,26,25,39,20,0,0,0,0,Dallas,31,31,32,21,0,0,0,0,20210422,110,115,5,11,4,5,5,225,5,2020,0,3,1237,1
Miami,30,31,28,14,0,0,0,0,Atlanta,31,31,33,23,0,0,0,0,20210423,103,118,1,1,6,15,15,221,15,2020,0,4,605,1
Boston,25,26,22,31,0,0,0,0,Brooklyn,21,39,28,21,0,0,0,0,20210423,104,109,-4,9,15,5,5,213,5,2020,0,4,190,1
Cleveland,20,35,23,24,0,0,0,0,Charlotte,22,26,30,30,0,0,0,0,20210423,102,108,2,-7,0,6,6,210,6,2020,0,4,435,1
Denver,24,26,24,23,0,0,0,0,Golden State,30,24,32,32,0,0,0,0,20210423,97,118,6,4,12,21,21,215,21,2020,0,4,947,1
LA Clippers,37,28,11,33,0,0,0,0,Houston,36,25,19,24,0,0,0,0,20210423,109,104,1,4,-4,5,5,213,-5,2020,0,4,1371,1
Washington,36,34,30,29,0,0,0,0,Oklahoma City,35,33,22,19,0,0,0,0,20210423,129,109,1,2,10,20,20,238,-20,2020,0,4,1149,1
Memphis,28,34,38,30,0,0,0,0,Portland,23,33,43,29,0,0,0,0,20210423,130,128,5,6,1,2,2,258,-2,2020,0,4,1845,1
San Antonio,31,30,24,25,0,0,0,0,New Orleans,24,28,32,24,0,0,0,0,20210424,110,108,7,9,1,2,2,218,-2,2020,0,5,506,1
Toronto,26,33,24,20,0,0,0,0,New York,30,34,24,32,0,0,0,0,20210424,103,120,4,5,5,17,17,223,17,2020,0,5,341,1
Minnesota,26,26,30,19,0,0,0,0,Utah,40,18,16,22,0,0,0,0,20210424,101,96,-14,-6,8,5,5,197,-5,2020,0,5,984,1
Philadelphia,17,23,23,31,0,0,0,0,Milwaukee,26,24,36,46,0,0,0,0,20210424,94,132,9,10,23,38,38,226,38,2020,0,5,692,1
Detroit,25,36,21,27,0,0,0,0,Indiana,35,23,26,31,0,0,0,0,20210424,109,115,10,-3,2,6,6,224,6,2020,0,5,240,1
Houston,26,24,32,34,0,0,0,0,Denver,36,36,30,27,0,0,0,0,20210424,116,129,10,22,20,13,13,245,13,2020,0,5,878,1
LA Lakers,26,32,21,14,0,0,0,0,Dallas,23,23,33,29,0,0,0,0,20210424,93,108,-3,-12,0,15,15,201,15,2020,0,5,1237,1
Chicago,18,23,22,38,0,0,0,0,Miami,33,28,19,26,0,0,0,0,20210424,101,106,15,20,17,5,5,207,5,2020,0,5,1189,1
Milwaukee,29,22,27,26,0,0,0,0,Atlanta,26,17,27,41,0,0,0,0,20210425,104,111,-3,-8,-8,7,7,215,7,2020,0,6,669,1
Phoenix,32,29,31,27,0,0,0,0,Brooklyn,27,32,38,31,0,0,0,0,20210425,119,128,-5,-2,5,9,9,247,9,2020,0,6,2139,1
Boston,23,29,36,16,0,0,0,0,Charlotte,33,30,37,25,0,0,0,0,20210425,104,125,10,11,12,21,21,229,21,2020,0,6,720,1
Sacramento,39,26,27,21,0,0,0,0,Golden State,32,31,31,23,0,0,0,0,20210425,113,117,-7,-2,2,4,4,230,4,2020,0,6,75,1
Indiana,36,26,41,28,0,0,0,0,Orlando,25,32,20,35,0,0,0,0,20210425,131,112,11,5,26,19,19,243,-19,2020,0,6,822,1
Memphis,23,35,32,30,0,0,0,0,Portland,20,27,31,35,0,0,0,0,20210425,120,113,3,11,12,7,7,233,-7,2020,0,6,1845,1
Cleveland,32,28,33,17,0,0,0,0,Washington,27,36,24,32,0,0,0,0,20210425,110,119,-5,3,-6,9,9,229,9,2020,0,6,304,1
San Antonio,38,27,30,38,13,0,0,0,Washington,34,28,33,38,10,0,0,0,20210426,146,143,4,3,0,0,3,289,-3,2020,1,0,1385,1
Cleveland,23,25,22,26,0,0,0,0,Toronto,33,16,32,31,0,0,0,0,20210426,96,112,10,1,11,16,16,208,16,2020,0,0,187,1
Dallas,17,35,33,21,0,0,0,0,Sacramento,31,28,28,26,0,0,0,0,20210426,106,113,14,7,2,7,7,219,7,2020,0,0,1437,1
Oklahoma City,26,19,21,24,0,0,0,0,Philadelphia,34,26,33,28,0,0,0,0,20210426,90,121,8,15,27,31,31,211,31,2020,0,0,1256,1
LA Lakers,28,22,29,35,0,0,0,0,Orlando,16,40,24,23,0,0,0,0,20210426,114,103,12,-6,-1,11,11,217,-11,2020,0,0,2197,1
Memphis,18,35,22,21,0,0,0,0,Denver,21,37,27,35,0,0,0,0,20210426,96,120,3,5,10,24,24,216,24,2020,0,0,877,1
LA Clippers,20,28,30,25,0,0,0,0,New Orleans,33,29,33,25,0,0,0,0,20210426,103,120,13,14,17,17,17,223,17,2020,0,0,1669,1
Utah,33,14,23,34,0,0,0,0,Minnesota,17,32,34,22,0,0,0,0,20210426,104,105,-16,2,13,1,1,209,1,2020,0,0,984,1
Chicago,20,32,24,34,0,0,0,0,Miami,26,27,29,20,0,0,0,0,20210426,110,102,-6,-1,-6,8,8,212,-8,2020,0,0,1189,1
Atlanta,23,21,23,19,0,0,0,0,Detroit,27,28,19,26,0,0,0,0,20210426,86,100,4,11,7,14,14,186,14,2020,0,0,597,1
Phoenix,29,27,31,31,0,0,0,0,New York,36,27,24,23,0,0,0,0,20210426,118,110,-7,-7,0,8,8,228,-8,2020,0,0,2139,1
Portland,34,39,40,20,0,0,0,0,Indiana,35,27,16,34,0,0,0,0,20210427,133,112,-1,11,35,21,21,245,-21,2020,0,1,1880,1
Minnesota,28,31,19,36,0,0,0,0,Houston,23,27,29,28,0,0,0,0,20210427,114,107,5,9,-1,7,7,221,-7,2020,0,1,1057,1
Brooklyn,26,30,24,36,0,0,0,0,Toronto,28,24,31,20,0,0,0,0,20210427,116,103,-2,4,-3,13,13,219,-13,2020,0,1,341,1
Milwaukee,33,29,25,27,0,0,0,0,Charlotte,28,17,35,24,0,0,0,0,20210427,114,104,5,17,7,10,10,218,-10,2020,0,1,658,1
Oklahoma City,29,26,23,41,0,0,0,0,Boston,24,25,29,37,0,0,0,0,20210427,119,115,5,6,0,4,4,234,-4,2020,0,1,1492,1
Dallas,36,26,41,30,0,0,0,0,Golden State,12,17,35,39,0,0,0,0,20210427,133,103,24,33,39,30,30,236,-30,2020,0,1,1480,1
Charlotte,19,28,33,31,0,0,0,0,Boston,39,19,30,32,0,0,0,0,20210428,111,120,20,11,8,9,9,231,9,2020,0,2,720,1
Orlando,26,24,32,27,0,0,0,0,Cleveland,16,28,17,43,0,0,0,0,20210428,109,104,10,6,21,5,5,213,-5,2020,0,2,895,1
New Orleans,25,26,27,34,0,0,0,0,Denver,35,25,27,27,0,0,0,0,20210428,112,114,10,9,9,2,2,226,2,2020,0,2,1079,1
Portland,38,36,28,28,0,0,0,0,Memphis,23,23,37,26,0,0,0,0,20210428,130,109,15,28,19,21,21,239,-21,2020,0,2,1845,1
San Antonio,20,34,20,37,0,0,0,0,Miami,31,24,27,34,0,0,0,0,20210428,111,116,11,1,8,5,5,227,5,2020,0,2,1147,1
Chicago,19,29,27,19,0,0,0,0,New York,32,20,24,37,0,0,0,0,20210428,94,113,13,4,1,19,19,207,19,2020,0,2,711,1
Atlanta,17,22,24,20,0,0,0,0,Philadelphia,37,30,26,34,0,0,0,0,20210428,83,127,20,28,30,44,44,210,44,2020,0,2,665,1
LA Clippers,31,22,27,21,0,0,0,0,Phoenix,39,24,23,23,0,0,0,0,20210428,101,109,8,10,6,8,8,210,8,2020,0,2,356,1
Utah,30,46,40,38,0,0,0,0,Sacramento,27,17,30,31,0,0,0,0,20210428,154,105,3,32,42,49,49,259,-49,2020,0,2,532,1
LA Lakers,35,20,22,30,0,0,0,0,Washington,31,30,29,26,0,0,0,0,20210428,107,116,-4,6,13,9,9,223,9,2020,0,2,2294,1
New Orleans,31,29,19,30,0,0,0,0,Oklahoma City,20,23,25,27,0,0,0,0,20210429,109,95,11,17,11,14,14,204,-14,2020,0,3,576,1
Golden State,25,33,33,23,0,0,0,0,Minnesota,35,25,29,37,0,0,0,0,20210429,114,126,10,2,-2,12,12,240,12,2020,0,3,1581,1
Brooklyn,35,31,45,19,0,0,0,0,Indiana,28,24,41,20,0,0,0,0,20210429,130,113,7,14,18,17,17,243,-17,2020,0,3,643,1
Milwaukee,38,35,25,38,0,0,0,0,Houston,29,36,39,39,0,0,0,0,20210429,136,143,-9,-8,6,7,7,279,7,2020,0,3,1005,1
Toronto,33,24,28,26,0,0,0,0,Denver,30,29,28,34,0,0,0,0,20210429,111,121,-3,2,2,10,10,232,10,2020,0,3,1341,1
Dallas,26,34,26,29,0,0,0,0,Detroit,26,28,29,22,0,0,0,0,20210429,115,105,0,6,3,10,10,220,-10,2020,0,3,999,1
San Antonio,39,38,26,25,12,0,0,0,Boston,16,32,42,38,15,0,0,0,20210430,140,143,-23,-29,-13,0,3,283,3,2020,1,4,1765,1
Portland,23,36,35,34,0,0,0,0,Brooklyn,25,32,24,28,0,0,0,0,20210430,128,109,-2,2,13,19,19,237,-19,2020,0,4,2439,1
Milwaukee,28,24,28,28,0,0,0,0,Chicago,16,28,19,35,0,0,0,0,20210430,108,98,12,8,17,10,10,206,-10,2020,0,4,83,1
Washington,35,23,33,31,0,0,0,0,Cleveland,30,22,16,25,0,0,0,0,20210430,122,93,5,6,23,29,29,215,-29,2020,0,4,304,1
Sacramento,30,25,23,32,0,0,0,0,LA Lakers,23,33,32,18,0,0,0,0,20210430,110,106,7,-1,-10,4,4,216,-4,2020,0,4,361,1
Orlando,20,23,15,17,0,0,0,0,Memphis,19,20,36,17,0,0,0,0,20210430,75,92,-1,-4,17,17,17,167,17,2020,0,4,683,1
Atlanta,26,20,31,27,0,0,0,0,Philadelphia,23,42,29,32,0,0,0,0,20210430,104,126,-3,19,17,22,22,230,22,2020,0,4,665,1
Utah,23,29,20,28,0,0,0,0,Phoenix,39,29,28,25,0,0,0,0,20210430,100,121,16,16,24,21,21,221,21,2020,0,4,505,1
New Orleans,38,27,33,25,17,0,0,0,Minnesota,30,35,32,26,13,0,0,0,20210501,140,136,8,0,1,0,4,276,-4,2020,1,5,1052,1
Memphis,36,24,25,26,0,0,0,0,Orlando,29,17,30,36,0,0,0,0,20210501,111,112,-7,-14,-9,1,1,223,1,2020,0,5,683,1
Toronto,33,29,27,13,0,0,0,0,Utah,29,27,29,21,0,0,0,0,20210501,102,106,-4,-6,-4,4,4,208,4,2020,0,5,1664,1
Denver,27,25,31,27,0,0,0,0,LA Clippers,28,19,26,31,0,0,0,0,20210501,110,104,-1,5,10,6,6,214,-6,2020,0,5,830,1
Indiana,42,40,44,26,0,0,0,0,Oklahoma City,29,17,24,25,0,0,0,0,20210501,152,95,13,36,56,57,57,247,-57,2020,0,5,688,1
Washington,26,39,32,27,0,0,0,0,Dallas,38,32,19,36,0,0,0,0,20210501,124,125,12,5,-8,1,1,249,1,2020,0,5,1181,1
Miami,29,38,32,25,0,0,0,0,Cleveland,36,24,26,21,0,0,0,0,20210501,124,107,-7,7,13,17,17,231,-17,2020,0,5,1089,1
Detroit,18,24,28,24,0,0,0,0,Charlotte,26,32,21,28,0,0,0,0,20210501,94,107,8,16,9,13,13,201,13,2020,0,5,504,1
Chicago,26,37,12,22,0,0,0,0,Atlanta,31,23,28,26,0,0,0,0,20210501,97,108,5,-9,7,11,11,205,11,2020,0,5,587,1
Golden State,22,27,39,25,0,0,0,0,Houston,24,31,12,20,0,0,0,0,20210501,113,87,-2,-6,21,26,26,200,-26,2020,0,5,1642,1
Philadelphia,37,24,28,18,6,0,0,0,San Antonio,27,25,27,28,4,0,0,0,20210502,113,111,10,9,10,0,2,224,-2,2020,1,6,1505,1
Phoenix,27,37,34,25,0,0,0,0,Oklahoma City,33,24,28,35,0,0,0,0,20210502,123,120,-6,7,13,3,3,243,-3,2020,0,6,840,1
Brooklyn,37,22,31,24,0,0,0,0,Milwaukee,28,34,28,27,0,0,0,0,20210502,114,117,-9,3,0,3,3,231,3,2020,0,6,732,1
Toronto,32,40,27,22,0,0,0,0,LA Lakers,38,21,25,30,0,0,0,0,20210502,121,114,-6,13,15,7,7,235,-7,2020,0,6,2170,1
New York,34,25,34,29,0,0,0,0,Houston,24,20,27,26,0,0,0,0,20210502,122,97,10,15,22,25,25,219,-25,2020,0,6,1417,1
Sacramento,36,25,26,24,0,0,0,0,Dallas,26,28,18,27,0,0,0,0,20210502,111,99,10,7,15,12,12,210,-12,2020,0,6,1437,1
Miami,35,30,35,21,0,0,0,0,Charlotte,32,26,22,31,0,0,0,0,20210502,121,111,3,7,20,10,10,232,-10,2020,0,6,654,1
Portland,34,37,32,26,0,0,0,0,Boston,32,39,27,21,0,0,0,0,20210502,129,119,2,0,5,10,10,248,-10,2020,0,6,2532,1
Indiana,31,35,36,39,0,0,0,0,Washington,36,46,40,32,0,0,0,0,20210503,141,154,5,16,20,13,13,295,13,2020,0,0,490,1
San Antonio,22,21,29,27,0,0,0,0,Utah,31,29,29,21,0,0,0,0,20210503,99,110,9,17,17,11,11,209,11,2020,0,0,1087,1
Golden State,39,27,29,28,0,0,0,0,New Orleans,21,33,26,28,0,0,0,0,20210503,123,108,18,12,15,15,15,231,-15,2020,0,0,1921,1
New York,25,44,28,21,0,0,0,0,Memphis,22,36,22,24,0,0,0,0,20210503,118,104,3,11,17,14,14,222,-14,2020,0,0,953,1
Orlando,21,30,37,31,0,0,0,0,Detroit,26,22,30,34,0,0,0,0,20210503,119,112,-5,3,10,7,7,231,-7,2020,0,0,957,1
Philadelphia,34,26,23,23,0,0,0,0,Chicago,20,23,20,31,0,0,0,0,20210503,106,94,14,17,20,12,12,200,-12,2020,0,0,664,1
Portland,31,31,33,19,0,0,0,0,Atlanta,32,36,34,21,0,0,0,0,20210503,114,123,1,6,7,9,9,237,9,2020,0,0,2168,1
Denver,24,18,23,24,0,0,0,0,LA Lakers,20,25,25,23,0,0,0,0,20210503,89,93,-4,3,5,4,4,182,4,2020,0,0,830,1
Phoenix,30,29,31,24,20,0,0,0,Cleveland,24,29,35,26,4,0,0,0,20210504,134,118,6,6,2,0,16,252,-16,2020,1,1,1745,1
Charlotte,30,23,25,24,0,0,0,0,Detroit,28,21,23,27,0,0,0,0,20210504,102,99,2,4,6,3,3,201,-3,2020,0,1,504,1
Toronto,30,24,28,18,0,0,0,0,LA Clippers,26,22,34,23,0,0,0,0,20210504,100,105,-4,-6,0,5,5,205,5,2020,0,1,2170,1
Dallas,30,33,35,29,0,0,0,0,Miami,39,15,23,36,0,0,0,0,20210504,127,113,-9,9,21,14,14,240,-14,2020,0,1,1110,1
Brooklyn,33,25,36,24,0,0,0,0,Milwaukee,34,32,26,32,0,0,0,0,20210504,118,124,1,8,-2,6,6,242,6,2020,0,1,732,1
Golden State,34,23,22,24,0,0,0,0,New Orleans,32,24,19,33,0,0,0,0,20210504,103,108,-2,-1,-4,5,5,211,5,2020,0,1,1921,1
Sacramento,25,31,25,22,0,0,0,0,Oklahoma City,20,26,23,30,0,0,0,0,20210504,103,99,5,10,12,4,4,202,-4,2020,0,1,1336,1
Memphis,33,40,34,32,0,0,0,0,Minnesota,29,34,40,32,0,0,0,0,20210505,139,135,4,10,4,4,4,274,-4,2020,0,2,700,1
San Antonio,26,16,21,31,0,0,0,0,Utah,38,28,34,26,0,0,0,0,20210505,94,126,12,24,37,32,32,220,32,2020,0,2,1087,1
Boston,39,24,37,32,0,0,0,0,Orlando,27,18,30,21,0,0,0,0,20210505,132,96,12,18,25,36,36,228,-36,2020,0,2,1115,1
Washington,37,34,24,39,0,0,0,0,Milwaukee,29,42,32,32,0,0,0,0,20210505,134,135,-8,0,8,1,1,269,1,2020,0,2,634,1
Phoenix,38,27,23,15,0,0,0,0,Atlanta,42,25,30,38,0,0,0,0,20210505,103,135,4,2,9,32,32,238,32,2020,0,2,1588,1
Philadelphia,39,36,33,27,0,0,0,0,Houston,30,33,28,24,0,0,0,0,20210505,135,115,9,12,17,20,20,250,-20,2020,0,2,1339,1
New York,12,31,26,28,0,0,0,0,Denver,34,30,25,24,0,0,0,0,20210505,97,113,22,21,20,16,16,210,16,2020,0,2,1627,1
Portland,29,38,35,39,0,0,0,0,Cleveland,28,29,23,25,0,0,0,0,20210505,141,105,1,10,22,36,36,246,-36,2020,0,2,2049,1
Sacramento,30,26,29,19,0,0,0,0,Indiana,26,21,21,25,0,0,0,0,20210505,104,93,4,9,17,11,11,197,-11,2020,0,2,1882,1
Chicago,34,25,37,24,0,0,0,0,Charlotte,24,29,21,25,0,0,0,0,20210506,120,99,10,6,22,21,21,219,-21,2020,0,3,586,1
Brooklyn,32,30,21,26,0,0,0,0,Dallas,37,26,19,31,0,0,0,0,20210506,109,113,5,1,-1,4,4,222,4,2020,0,3,1370,1
Memphis,32,17,21,27,0,0,0,0,Detroit,31,27,20,33,0,0,0,0,20210506,97,111,-1,9,8,14,14,208,14,2020,0,3,622,1
Oklahoma City,24,25,23,25,0,0,0,0,Golden State,31,30,27,30,0,0,0,0,20210506,97,118,7,12,16,21,21,215,21,2020,0,3,1386,1
Atlanta,26,32,38,30,0,0,0,0,Indiana,36,36,38,23,0,0,0,0,20210506,126,133,10,14,14,7,7,259,7,2020,0,3,427,1
LA Lakers,20,22,29,23,0,0,0,0,LA Clippers,29,36,27,26,0,0,0,0,20210506,94,118,9,23,21,24,24,212,24,2020,0,3,0,1
Washington,31,20,31,33,16,0,0,0,Toronto,33,27,26,29,14,0,0,0,20210506,131,129,-2,-9,-4,0,2,260,-2,2020,1,3,349,1
Denver,41,32,26,21,0,0,0,0,Utah,40,29,29,29,0,0,0,0,20210507,120,127,-1,-4,-1,7,7,247,7,2020,0,4,370,1
San Antonio,25,27,26,35,0,0,0,0,Sacramento,21,28,32,23,0,0,0,0,20210507,113,104,4,3,-3,9,9,217,-9,2020,0,4,1456,1
LA Lakers,22,33,23,23,0,0,0,0,Portland,34,25,23,24,0,0,0,0,20210507,101,106,12,4,4,5,5,207,5,2020,0,4,826,1
New York,33,30,25,17,0,0,0,0,Phoenix,30,26,34,38,0,0,0,0,20210507,105,128,-3,-7,2,23,23,233,23,2020,0,4,2139,1
New Orleans,21,33,37,16,0,0,0,0,Philadelphia,32,38,18,21,0,0,0,0,20210507,107,109,11,16,-3,2,2,216,2,2020,0,4,1088,1
Boston,28,18,28,25,0,0,0,0,Chicago,30,30,34,27,0,0,0,0,20210507,99,121,2,14,20,22,22,220,22,2020,0,4,849,1
Minnesota,32,22,24,34,0,0,0,0,Miami,28,31,30,32,0,0,0,0,20210507,112,121,-4,5,11,9,9,233,9,2020,0,4,1513,1
Cleveland,19,18,28,25,0,0,0,0,Dallas,33,29,24,24,0,0,0,0,20210507,90,110,14,25,21,20,20,200,20,2020,0,4,1024,1
Orlando,31,31,27,23,0,0,0,0,Charlotte,26,34,34,28,0,0,0,0,20210507,112,122,-5,-2,5,10,10,234,10,2020,0,4,463,1
Houston,34,29,29,41,0,0,0,0,Milwaukee,34,30,43,34,0,0,0,0,20210507,133,141,0,1,15,8,8,274,8,2020,0,4,1005,1
Houston,32,28,23,33,0,0,0,0,Utah,32,34,30,28,0,0,0,0,20210508,116,124,0,6,13,8,8,240,8,2020,0,5,1199,1
Memphis,26,21,34,28,0,0,0,0,Toronto,26,20,26,27,0,0,0,0,20210508,109,99,0,1,9,10,10,208,-10,2020,0,5,815,1
San Antonio,26,21,28,27,0,0,0,0,Portland,27,30,33,34,0,0,0,0,20210508,102,124,1,10,15,22,22,226,22,2020,0,5,1718,1
Oklahoma City,25,23,19,30,0,0,0,0,Golden State,37,36,33,30,0,0,0,0,20210508,97,136,12,25,39,39,39,233,39,2020,0,5,1386,1
Washington,33,30,29,32,9,0,0,0,Indiana,32,30,39,23,8,0,0,0,20210508,133,132,1,1,-9,0,1,265,-1,2020,1,5,490,1
Brooklyn,24,32,41,28,0,0,0,0,Denver,37,34,33,15,0,0,0,0,20210508,125,119,-13,-15,-7,6,6,244,-6,2020,0,5,1627,1
Detroit,17,26,30,31,0,0,0,0,Philadelphia,34,22,33,29,0,0,0,0,20210508,104,118,17,13,16,14,14,222,14,2020,0,5,441,1
Minnesota,34,40,33,21,0,0,0,0,Orlando,19,25,25,27,0,0,0,0,20210509,128,96,15,30,38,32,32,224,-32,2020,0,6,1309,1
Phoenix,19,28,30,33,0,0,0,0,LA Lakers,30,29,39,25,0,0,0,0,20210509,110,123,11,12,21,13,13,233,13,2020,0,6,356,1
New York,26,30,23,27,0,0,0,0,LA Clippers,29,25,20,26,0,0,0,0,20210509,106,100,-3,2,5,6,6,206,-6,2020,0,6,2445,1
Oklahoma City,25,26,20,27,0,0,0,0,Sacramento,33,38,35,20,0,0,0,0,20210509,98,126,8,20,35,28,28,224,28,2020,0,6,1336,1
Dallas,39,25,34,26,0,0,0,0,Cleveland,30,23,19,25,0,0,0,0,20210509,124,97,9,11,26,27,27,221,-27,2020,0,6,1024,1
New Orleans,34,23,32,23,0,0,0,0,Charlotte,25,42,29,14,0,0,0,0,20210509,112,110,9,-10,-7,2,2,222,-2,2020,0,6,648,1
Miami,36,43,26,25,0,0,0,0,Boston,23,30,31,40,0,0,0,0,20210509,130,124,13,26,21,6,6,254,-6,2020,0,6,1257,1
Chicago,28,29,26,25,0,0,0,0,Detroit,18,21,29,28,0,0,0,0,20210509,108,96,10,18,15,12,12,204,-12,2020,0,6,238,1
Washington,32,30,17,45,0,0,0,0,Atlanta,34,27,35,29,0,0,0,0,20210510,124,125,2,-1,17,1,1,249,1,2020,0,0,541,1
Indiana,27,26,26,32,0,0,0,0,Cleveland,28,32,17,25,0,0,0,0,20210510,111,102,-1,-7,2,9,9,213,-9,2020,0,0,262,1
Utah,30,19,26,41,0,0,0,0,Golden State,31,23,35,30,0,0,0,0,20210510,116,119,1,5,14,3,3,235,3,2020,0,0,599,1
New Orleans,31,28,29,22,0,0,0,0,Memphis,36,35,15,29,0,0,0,0,20210510,110,115,5,12,-2,5,5,225,5,2020,0,0,358,1
Houston,33,30,37,29,0,0,0,0,Portland,50,29,32,29,0,0,0,0,20210510,129,140,17,16,11,11,11,269,11,2020,0,0,1833,1
Milwaukee,36,28,29,32,0,0,0,0,San Antonio,45,42,26,33,0,0,0,0,20210510,125,146,9,23,20,21,21,271,21,2020,0,0,1108,1
New York,25,31,20,15,8,0,0,0,LA Lakers,24,31,18,18,10,0,0,0,20210511,99,101,-1,-1,-3,0,2,200,2,2020,1,1,2445,1
LA Clippers,27,33,25,30,0,0,0,0,Toronto,19,33,19,25,0,0,0,0,20210511,115,96,8,8,14,19,19,211,-19,2020,0,1,2170,1
Orlando,22,26,23,31,0,0,0,0,Milwaukee,29,30,20,35,0,0,0,0,20210511,102,114,7,11,8,12,12,216,12,2020,0,1,1065,1
Dallas,27,30,25,22,0,0,0,0,Memphis,28,32,36,37,0,0,0,0,20210511,104,133,1,3,14,29,29,237,29,2020,0,1,419,1
Philadelphia,33,29,13,19,0,0,0,0,Indiana,26,25,24,28,0,0,0,0,20210511,94,103,-7,-11,0,9,9,197,9,2020,0,1,582,1
Oklahoma City,32,33,18,23,0,0,0,0,Sacramento,27,35,41,19,0,0,0,0,20210511,106,122,-5,-3,20,16,16,228,16,2020,0,1,1336,1
Minnesota,30,32,24,33,0,0,0,0,Detroit,20,20,25,35,0,0,0,0,20210511,119,100,10,22,21,19,19,219,-19,2020,0,1,542,1
Denver,38,25,28,26,0,0,0,0,Charlotte,26,34,26,26,0,0,0,0,20210511,117,112,12,3,5,5,5,229,-5,2020,0,1,1355,1
Brooklyn,32,32,29,22,0,0,0,0,Chicago,23,28,23,33,0,0,0,0,20210511,115,107,9,13,19,8,8,222,-8,2020,0,1,711,1
Miami,28,34,31,36,0,0,0,0,Boston,28,28,23,42,0,0,0,0,20210511,129,121,0,6,14,8,8,250,-8,2020,0,1,1257,1
Phoenix,38,28,32,18,0,0,0,0,Golden State,29,29,34,30,0,0,0,0,20210511,116,122,-9,-8,-6,6,6,238,6,2020,0,1,652,1
Washington,30,29,32,25,0,0,0,0,Atlanta,35,21,27,37,0,0,0,0,20210512,116,120,5,-3,-8,4,4,236,4,2020,0,2,541,1
San Antonio,20,31,30,35,0,0,0,0,Brooklyn,35,22,39,32,0,0,0,0,20210512,116,128,15,6,15,12,12,244,12,2020,0,2,1581,1
Boston,17,22,30,25,0,0,0,0,Cleveland,22,20,25,35,0,0,0,0,20210512,94,102,5,3,-2,8,8,196,8,2020,0,2,549,1
New Orleans,30,28,22,27,0,0,0,0,Dallas,32,45,34,14,0,0,0,0,20210512,107,125,2,19,31,18,18,232,18,2020,0,2,442,1
Houston,26,27,43,26,0,0,0,0,LA Lakers,34,25,41,24,0,0,0,0,20210512,122,124,8,6,4,2,2,246,2,2020,0,2,1371,1
Portland,24,35,25,21,0,0,0,0,Utah,31,25,20,22,0,0,0,0,20210512,105,98,-7,3,8,7,7,203,-7,2020,0,2,634,1
Portland,26,27,24,40,0,0,0,0,Phoenix,26,26,33,33,0,0,0,0,20210513,117,118,0,-1,8,1,1,235,1,2020,0,3,1005,1
San Antonio,18,25,34,21,0,0,0,0,New York,20,26,27,29,0,0,0,0,20210513,98,102,2,3,-4,4,4,200,4,2020,0,3,1581,1
Denver,35,28,29,22,0,0,0,0,Minnesota,26,26,37,14,0,0,0,0,20210513,114,103,9,11,3,11,11,217,-11,2020,0,3,698,1
Philadelphia,22,19,26,27,0,0,0,0,Miami,38,22,29,17,0,0,0,0,20210513,94,106,16,19,22,12,12,200,12,2020,0,3,1021,1
Sacramento,32,28,23,27,0,0,0,0,Memphis,36,23,30,27,0,0,0,0,20210513,110,116,4,-1,6,6,6,226,6,2020,0,3,1745,1
LA Clippers,31,13,40,29,0,0,0,0,Charlotte,23,24,30,13,0,0,0,0,20210513,113,90,8,-3,7,23,23,203,-23,2020,0,3,2115,1
Toronto,27,20,29,26,0,0,0,0,Chicago,30,36,22,26,0,0,0,0,20210513,102,114,3,19,12,12,12,216,12,2020,0,3,436,1
Orlando,16,25,30,22,0,0,0,0,Atlanta,29,32,32,23,0,0,0,0,20210513,93,116,13,20,22,23,23,209,23,2020,0,3,401,1
Milwaukee,39,30,40,33,0,0,0,0,Indiana,38,28,30,37,0,0,0,0,20210513,142,133,1,3,13,9,9,275,-9,2020,0,3,243,1
Toronto,26,26,31,27,0,0,0,0,Dallas,31,35,26,22,0,0,0,0,20210514,110,114,5,14,9,4,4,224,4,2020,0,4,1201,1
Denver,29,28,30,17,0,0,0,0,Detroit,25,28,21,17,0,0,0,0,20210514,104,91,4,4,13,13,13,195,-13,2020,0,4,1154,1
New Orleans,32,25,33,32,0,0,0,0,Golden State,41,34,24,26,0,0,0,0,20210514,122,125,9,18,9,3,3,247,3,2020,0,4,1921,1
LA Clippers,33,36,24,22,0,0,0,0,Houston,30,43,32,17,0,0,0,0,20210514,115,122,-3,4,12,7,7,237,7,2020,0,4,1371,1
Sacramento,25,32,19,30,0,0,0,0,Memphis,29,24,26,28,0,0,0,0,20210514,106,107,4,-4,3,1,1,213,1,2020,0,4,1745,1
Utah,30,31,31,17,0,0,0,0,Oklahoma City,20,27,19,27,0,0,0,0,20210514,109,93,10,14,26,16,16,202,-16,2020,0,4,861,1
Orlando,24,19,26,28,0,0,0,0,Philadelphia,27,39,30,26,0,0,0,0,20210514,97,122,3,23,27,25,25,219,25,2020,0,4,864,1
Cleveland,33,23,20,29,0,0,0,0,Washington,31,27,33,29,0,0,0,0,20210514,105,120,-2,2,15,15,15,225,15,2020,0,4,304,1
Phoenix,34,34,41,31,0,0,0,0,San Antonio,17,30,23,33,0,0,0,0,20210515,140,103,17,21,39,37,37,243,-37,2020,0,5,846,1
Charlotte,27,27,32,18,5,0,0,0,New York,36,27,26,15,14,0,0,0,20210515,109,118,9,9,3,0,9,227,9,2020,1,5,531,1
Boston,37,29,23,35,0,0,0,0,Minnesota,26,21,27,34,0,0,0,0,20210515,124,108,11,19,15,16,16,232,-16,2020,0,5,1120,1
LA Lakers,36,28,32,26,0,0,0,0,Indiana,28,28,32,27,0,0,0,0,20210515,122,115,8,8,8,7,7,237,-7,2020,0,5,1805,1
Chicago,29,22,20,20,0,0,0,0,Brooklyn,28,33,18,26,0,0,0,0,20210515,91,105,-1,10,8,14,14,196,14,2020,0,5,711,1
Miami,28,23,30,27,0,0,0,0,Milwaukee,44,26,29,23,0,0,0,0,20210515,108,122,16,19,18,14,14,230,14,2020,0,5,1269,1
Houston,33,21,18,23,0,0,0,0,Atlanta,36,36,27,25,0,0,0,0,20210516,95,124,3,18,27,29,29,219,29,2020,0,6,700,1
Charlotte,36,20,34,20,0,0,0,0,Washington,22,30,27,36,0,0,0,0,20210516,110,115,-14,-4,-11,5,5,225,5,2020,0,6,329,1
Indiana,31,37,26,31,0,0,0,0,Toronto,30,25,28,30,0,0,0,0,20210516,125,113,1,13,11,12,12,238,-12,2020,0,6,438,1
Phoenix,27,25,37,34,0,0,0,0,San Antonio,23,38,24,36,0,0,0,0,20210516,123,121,4,-9,4,2,2,244,-2,2020,0,6,846,1
Utah,28,36,33,24,0,0,0,0,Sacramento,25,24,24,26,0,0,0,0,20210516,121,99,3,15,24,22,22,220,-22,2020,0,6,532,1
Orlando,26,39,25,27,0,0,0,0,Philadelphia,32,28,39,29,0,0,0,0,20210516,117,128,6,-5,9,11,11,245,11,2020,0,6,864,1
LA Clippers,26,34,28,24,0,0,0,0,Oklahoma City,35,27,24,31,0,0,0,0,20210516,112,117,9,2,-2,5,5,229,5,2020,0,6,1178,1
Denver,22,33,29,32,0,0,0,0,Portland,43,29,35,25,0,0,0,0,20210516,116,132,21,17,23,16,16,248,16,2020,0,6,981,1
LA Lakers,36,27,28,19,0,0,0,0,New Orleans,28,31,17,22,0,0,0,0,20210516,110,98,8,4,15,12,12,208,-12,2020,0,6,1669,1
Dallas,22,38,35,26,0,0,0,0,Minnesota,38,38,37,23,0,0,0,0,20210516,121,136,16,16,18,15,15,257,15,2020,0,6,863,1
Memphis,29,20,20,32,0,0,0,0,Golden State,30,25,31,27,0,0,0,0,20210516,101,113,1,6,17,12,12,214,12,2020,0,6,1798,1
Miami,32,37,26,25,0,0,0,0,Detroit,13,34,24,36,0,0,0,0,20210516,120,107,19,22,24,13,13,227,-13,2020,0,6,1155,1
Milwaukee,23,31,31,27,0,0,0,0,Chicago,33,22,36,27,0,0,0,0,20210516,112,118,10,1,6,6,6,230,6,2020,0,6,83,1
Cleveland,24,32,20,33,0,0,0,0,Brooklyn,34,33,32,24,0,0,0,0,20210516,109,123,10,11,23,14,14,232,14,2020,0,6,403,1
Boston,24,15,26,27,0,0,0,0,New York,23,31,23,19,0,0,0,0,20210516,92,96,-1,15,12,4,4,188,4,2020,0,6,190,1
Washington,21,33,26,20,0,0,0,0,Boston,27,25,38,28,0,0,0,0,20210518,100,118,6,-2,10,18,18,218,18,2020,0,1,394,1
Charlotte,24,21,33,39,0,0,0,0,Indiana,40,29,39,36,0,0,0,0,20210518,117,144,16,24,30,27,27,261,27,2020,0,1,428,1
Golden State,28,27,24,21,0,0,0,0,LA Lakers,22,20,35,26,0,0,0,0,20210519,100,103,-6,-13,-2,3,3,203,3,2020,0,2,347,1
San Antonio,19,30,16,31,0,0,0,0,Memphis,38,18,16,28,0,0,0,0,20210519,96,100,19,7,7,4,4,196,4,2020,0,2,631,1
Indiana,29,23,31,32,0,0,0,0,Washington,30,36,48,28,0,0,0,0,20210520,115,142,1,14,31,27,27,257,27,2020,0,3,490,1
Memphis,30,32,16,21,18,0,0,0,Golden State,29,20,24,26,13,0,0,0,20210521,117,112,1,13,5,0,5,229,-5,2020,1,4,1798,1
Dallas,33,27,26,27,0,0,0,0,LA Clippers,30,25,25,23,0,0,0,0,20210522,113,103,3,5,6,10,10,216,-10,2020,0,5,1237,1
Miami,24,26,28,21,8,0,0,0,Milwaukee,22,31,27,19,10,0,0,0,20210522,107,109,-2,3,2,0,2,216,2,2020,1,5,1269,1
Boston,21,32,20,20,0,0,0,0,Brooklyn,16,31,31,26,0,0,0,0,20210522,93,104,-5,-6,5,11,11,197,11,2020,0,5,190,1
Portland,35,23,38,27,0,0,0,0,Denver,30,31,25,23,0,0,0,0,20210522,123,109,5,-3,10,14,14,232,-14,2020,0,5,981,1
Memphis,17,32,34,29,0,0,0,0,Utah,24,19,31,35,0,0,0,0,20210523,112,109,-7,6,9,3,3,221,-3,2020,0,6,1247,1
LA Lakers,25,20,23,22,0,0,0,0,Phoenix,32,21,28,18,0,0,0,0,20210523,90,99,7,8,13,9,9,189,9,2020,0,6,356,1
Atlanta,24,28,19,36,0,0,0,0,New York,16,34,23,32,0,0,0,0,20210523,107,105,8,2,-2,2,2,212,-2,2020,0,6,745,1
Washington,28,34,31,25,0,0,0,0,Philadelphia,27,34,38,26,0,0,0,0,20210523,118,125,-1,-1,6,7,7,243,7,2020,0,6,123,1
Portland,25,36,26,22,0,0,0,0,Denver,31,42,28,27,0,0,0,0,20210524,109,128,6,12,14,19,19,237,19,2020,0,0,981,1
Miami,20,31,27,20,0,0,0,0,Milwaukee,46,32,29,25,0,0,0,0,20210524,98,132,26,27,29,34,34,230,34,2020,0,0,1269,1
Boston,26,21,35,26,0,0,0,0,Brooklyn,40,31,38,21,0,0,0,0,20210525,108,130,14,24,27,22,22,238,22,2020,0,1,190,1
Dallas,35,36,30,26,0,0,0,0,LA Clippers,33,40,19,29,0,0,0,0,20210525,127,121,2,-2,9,6,6,248,-6,2020,0,1,1237,1
LA Lakers,30,23,26,30,0,0,0,0,Phoenix,24,23,25,30,0,0,0,0,20210525,109,102,6,6,7,7,7,211,-7,2020,0,1,356,1
Atlanta,27,30,18,17,0,0,0,0,New York,20,24,32,25,0,0,0,0,20210526,92,101,-7,-13,1,9,9,193,9,2020,0,2,745,1
Washington,24,33,23,15,0,0,0,0,Philadelphia,35,36,23,26,0,0,0,0,20210526,95,120,11,14,14,25,25,215,25,2020,0,2,123,1
Memphis,27,27,43,32,0,0,0,0,Utah,36,38,29,38,0,0,0,0,20210526,129,141,9,20,6,12,12,270,12,2020,0,2,1247,1
Denver,39,25,20,36,0,0,0,0,Portland,30,29,20,36,0,0,0,0,20210527,120,115,9,5,5,5,5,235,-5,2020,0,3,981,1
Phoenix,28,12,23,32,0,0,0,0,LA Lakers,27,16,33,33,0,0,0,0,20210527,95,109,-1,3,13,14,14,204,14,2020,0,3,356,1
Milwaukee,26,23,37,27,0,0,0,0,Miami,14,22,24,24,0,0,0,0,20210527,113,84,12,13,26,29,29,197,-29,2020,0,3,1269,1
New York,31,13,28,22,0,0,0,0,Atlanta,29,29,28,19,0,0,0,0,20210528,94,105,-2,14,14,11,11,199,11,2020,0,4,745,1
Brooklyn,32,25,27,35,0,0,0,0,Boston,33,28,35,29,0,0,0,0,20210528,119,125,1,4,12,6,6,244,6,2020,0,4,190,1
LA Clippers,31,32,26,29,0,0,0,0,Dallas,34,27,25,22,0,0,0,0,20210528,118,108,-3,2,3,10,10,226,-10,2020,0,4,1237,1
Utah,34,28,34,25,0,0,0,0,Memphis,22,29,34,26,0,0,0,0,20210529,121,111,12,11,11,10,10,232,-10,2020,0,5,1247,1
Milwaukee,22,35,34,29,0,0,0,0,Miami,26,38,21,18,0,0,0,0,20210529,120,103,-4,-7,6,17,17,223,-17,2020,0,5,1269,1
Denver,24,23,19,29,0,0,0,0,Portland,32,25,36,22,0,0,0,0,20210529,95,115,8,10,27,20,20,210,20,2020,0,5,981,1
Philadelphia,36,36,37,23,0,0,0,0,Washington,28,30,28,17,0,0,0,0,20210529,132,103,8,14,23,29,29,235,-29,2020,0,5,123,1
Phoenix,23,31,27,19,0,0,0,0,LA Lakers,24,26,15,27,0,0,0,0,20210530,100,92,-1,4,16,8,8,192,-8,2020,0,6,356,1
New York,26,23,22,25,0,0,0,0,Atlanta,25,28,35,25,0,0,0,0,20210530,96,113,-1,4,17,17,17,209,17,2020,0,6,745,1
Brooklyn,33,40,39,29,0,0,0,0,Boston,34,26,31,35,0,0,0,0,20210530,141,126,-1,13,21,15,15,267,-15,2020,0,6,190,1
LA Clippers,31,30,21,24,0,0,0,0,Dallas,22,23,15,21,0,0,0,0,20210530,106,81,9,16,22,25,25,187,-25,2020,0,6,1237,1
Philadelphia,31,30,19,34,0,0,0,0,Washington,28,32,32,30,0,0,0,0,20210531,114,122,-3,-1,12,8,8,236,8,2020,0,0,123,1
Utah,34,25,41,20,0,0,0,0,Memphis,31,23,33,26,0,0,0,0,20210531,120,113,3,5,13,7,7,233,-7,2020,0,0,1247,1
Boston,24,27,28,30,0,0,0,0,Brooklyn,31,28,27,37,0,0,0,0,20210601,109,123,7,8,7,14,14,232,14,2020,0,1,190,1
Portland,25,37,32,27,14,5,0,0,Denver,38,27,27,29,14,12,0,0,20210601,140,147,13,3,-2,0,7,287,7,2020,2,1,981,1
LA Lakers,26,10,27,22,0,0,0,0,Phoenix,34,32,26,23,0,0,0,0,20210601,85,115,8,30,29,30,30,200,30,2020,0,1,356,1
Dallas,35,21,33,16,0,0,0,0,LA Clippers,28,26,21,25,0,0,0,0,20210602,105,100,7,2,14,5,5,205,-5,2020,0,2,1237,1
Atlanta,21,31,22,29,0,0,0,0,New York,21,26,15,27,0,0,0,0,20210602,103,89,0,5,12,14,14,192,-14,2020,0,2,745,1
Washington,29,34,31,18,0,0,0,0,Philadelphia,29,36,38,26,0,0,0,0,20210602,112,129,0,2,9,17,17,241,17,2020,0,2,123,1
Memphis,27,24,25,34,0,0,0,0,Utah,47,28,31,20,0,0,0,0,20210602,110,126,20,24,30,16,16,236,16,2020,0,2,1247,1
Phoenix,36,26,27,24,0,0,0,0,LA Lakers,14,27,35,24,0,0,0,0,20210603,113,100,22,21,13,13,13,213,-13,2020,0,3,356,1
Denver,29,32,37,28,0,0,0,0,Portland,33,35,33,14,0,0,0,0,20210603,126,115,-4,-7,-3,11,11,241,-11,2020,0,3,981,1
LA Clippers,26,22,25,31,0,0,0,0,Dallas,28,17,32,20,0,0,0,0,20210604,104,97,-2,3,-4,7,7,201,-7,2020,0,4,1237,1
Milwaukee,32,29,23,23,0,0,0,0,Brooklyn,30,33,35,17,0,0,0,0,20210605,107,115,-2,2,14,8,8,222,8,2020,0,5,732,1
Atlanta,42,32,25,29,0,0,0,0,Philadelphia,27,27,29,41,0,0,0,0,20210606,128,124,15,20,16,4,4,252,-4,2020,0,6,665,1
Dallas,38,24,23,26,0,0,0,0,LA Clippers,35,35,30,26,0,0,0,0,20210606,111,126,-3,8,15,15,15,237,15,2020,0,6,1237,1
Milwaukee,19,22,24,21,0,0,0,0,Brooklyn,36,29,30,30,0,0,0,0,20210607,86,125,17,24,30,39,39,211,39,2020,0,0,732,1
Denver,28,30,21,26,0,0,0,0,Phoenix,28,29,31,34,0,0,0,0,20210607,105,122,0,-1,9,17,17,227,17,2020,0,0,585,1
Atlanta,20,35,29,18,0,0,0,0,Philadelphia,33,24,34,27,0,0,0,0,20210608,102,118,13,2,7,16,16,220,16,2020,0,1,665,1
LA Clippers,25,35,19,30,0,0,0,0,Utah,18,29,32,33,0,0,0,0,20210608,109,112,-7,-13,0,3,3,221,3,2020,0,1,579,1
Denver,21,21,25,31,0,0,0,0,Phoenix,25,27,34,37,0,0,0,0,20210609,98,123,4,10,19,25,25,221,25,2020,0,2,585,1
Brooklyn,11,31,23,18,0,0,0,0,Milwaukee,30,15,22,19,0,0,0,0,20210610,83,86,19,3,2,3,3,169,3,2020,0,3,732,1
LA Clippers,29,24,33,25,0,0,0,0,Utah,30,36,27,24,0,0,0,0,20210610,111,117,1,13,7,6,6,228,6,2020,0,3,579,1
Philadelphia,28,33,34,32,0,0,0,0,Atlanta,20,36,19,36,0,0,0,0,20210611,127,111,8,5,20,16,16,238,-16,2020,0,4,665,1
Phoenix,37,22,31,26,0,0,0,0,Denver,27,28,21,26,0,0,0,0,20210611,116,102,10,4,14,14,14,218,-14,2020,0,4,585,1
Utah,23,26,34,23,0,0,0,0,LA Clippers,27,37,30,38,0,0,0,0,20210612,106,132,4,15,11,26,26,238,26,2020,0,5,579,1
Phoenix,28,35,33,29,0,0,0,0,Denver,22,33,28,35,0,0,0,0,20210613,125,118,6,8,13,7,7,243,-7,2020,0,6,585,1
Brooklyn,26,22,21,27,0,0,0,0,Milwaukee,23,30,28,26,0,0,0,0,20210613,96,107,-3,5,12,11,11,203,11,2020,0,6,732,1
Utah,13,31,29,31,0,0,0,0,LA Clippers,30,38,26,24,0,0,0,0,20210614,104,118,17,24,21,14,14,222,14,2020,0,0,579,1
Philadelphia,28,34,20,18,0,0,0,0,Atlanta,20,29,31,23,0,0,0,0,20210614,100,103,-8,-13,-2,3,3,203,3,2020,0,0,665,1
Milwaukee,29,30,28,21,0,0,0,0,Brooklyn,15,28,38,33,0,0,0,0,20210615,108,114,-14,-16,-6,6,6,222,6,2020,0,1,732,1
Atlanta,24,16,29,40,0,0,0,0,Philadelphia,38,24,25,19,0,0,0,0,20210616,109,106,-14,-22,-18,3,3,215,-3,2020,0,2,665,1
LA Clippers,36,24,32,27,0,0,0,0,Utah,37,28,18,28,0,0,0,0,20210616,119,111,-1,-5,9,8,8,230,-8,2020,0,2,579,1
Brooklyn,19,29,19,22,0,0,0,0,Milwaukee,26,33,19,26,0,0,0,0,20210617,89,104,7,11,11,15,15,193,15,2020,0,3,732,1
Philadelphia,22,25,33,24,0,0,0,0,Atlanta,29,22,25,23,0,0,0,0,20210618,104,99,-7,-4,4,5,5,203,-5,2020,0,4,665,1
Utah,33,39,22,25,0,0,0,0,LA Clippers,31,19,41,40,0,0,0,0,20210618,119,131,-2,-22,-3,12,12,250,12,2020,0,4,579,1
Milwaukee,25,22,35,27,6,0,0,0,Brooklyn,28,25,28,28,2,0,0,0,20210619,115,111,-3,-6,1,0,4,226,-4,2020,1,5,732,1
Atlanta,25,23,28,27,0,0,0,0,Philadelphia,28,18,25,25,0,0,0,0,20210620,103,96,-3,2,5,7,7,199,-7,2020,0,6,665,1
LA Clippers,21,33,39,21,0,0,0,0,Phoenix,21,36,36,27,0,0,0,0,20210620,114,120,0,3,0,6,6,234,6,2020,0,6,356,1
LA Clippers,22,25,24,32,0,0,0,0,Phoenix,25,23,27,29,0,0,0,0,20210622,103,104,3,1,4,1,1,207,1,2020,0,1,356,1
Atlanta,25,29,34,28,0,0,0,0,Milwaukee,28,31,26,28,0,0,0,0,20210623,116,113,-3,-5,3,3,3,229,-3,2020,0,2,669,1
Phoenix,21,27,21,23,0,0,0,0,LA Clippers,29,17,34,26,0,0,0,0,20210624,92,106,8,-2,11,14,14,198,14,2020,0,3,356,1
Atlanta,28,17,18,28,0,0,0,0,Milwaukee,34,43,26,22,0,0,0,0,20210625,91,125,6,32,40,34,34,216,34,2020,0,4,669,1
Phoenix,29,21,19,15,0,0,0,0,LA Clippers,20,16,30,14,0,0,0,0,20210626,84,80,9,14,3,4,4,164,-4,2020,0,5,356,1
Milwaukee,27,29,27,30,0,0,0,0,Atlanta,32,24,29,17,0,0,0,0,20210627,113,102,-5,0,-2,11,11,215,-11,2020,0,6,669,1
LA Clippers,36,23,32,25,0,0,0,0,Phoenix,26,26,26,24,0,0,0,0,20210628,116,102,10,7,13,14,14,218,-14,2020,0,0,356,1
Milwaukee,22,16,24,26,0,0,0,0,Atlanta,25,26,36,23,0,0,0,0,20210629,88,110,3,13,25,22,22,198,22,2020,0,1,669,1
Phoenix,33,33,31,33,0,0,0,0,LA Clippers,29,28,26,20,0,0,0,0,20210630,130,103,4,9,14,27,27,233,-27,2020,0,2,356,1
Atlanta,22,34,22,34,0,0,0,0,Milwaukee,36,29,26,32,0,0,0,0,20210701,112,123,14,9,13,11,11,235,11,2020,0,3,669,1
Milwaukee,28,19,44,27,0,0,0,0,Atlanta,24,19,29,35,0,0,0,0,20210703,118,107,4,4,19,11,11,225,-11,2020,0,5,669,1
Milwaukee,26,23,27,29,0,0,0,0,Phoenix,30,27,35,26,0,0,0,0,20210706,105,118,4,8,16,13,13,223,13,2020,0,1,1462,1
Milwaukee,29,16,33,30,0,0,0,0,Phoenix,26,30,32,30,0,0,0,0,20210708,108,118,-3,11,10,10,10,226,10,2020,0,3,1462,1
Phoenix,28,17,31,24,0,0,0,0,Milwaukee,25,35,38,22,0,0,0,0,20210711,100,120,-3,15,22,20,20,220,20,2020,0,6,1462,1
Phoenix,23,29,30,21,0,0,0,0,Milwaukee,20,32,24,33,0,0,0,0,20210714,103,109,-3,0,-6,6,6,212,6,2020,0,2,1462,1
Milwaukee,21,43,36,23,0,0,0,0,Phoenix,37,24,29,29,0,0,0,0,20210717,123,119,-16,3,10,4,4,242,-4,2020,0,5,1462,1
Phoenix,16,31,30,21,0,0,0,0,Milwaukee,29,13,35,28,0,0,0,0,20210720,98,105,13,-5,0,7,7,203,7,2020,0,1,1462,1
