Away,AQ1,AQ2,AQ3,AQ4,AOT1,AOT2,Away_Final,Home,HQ1,HQ2,HQ3,HQ4,HOT1,HOT2,Home_Final,Date,Q1M,Q2M,Q3M,FinalMargin,FinalTotal,HomeMargin,AwayELO,HomeELO,Season,Week,Playoffs,AwayBye,HomeBye,Intraconference,Intradivision,TravelDist
Vikings,0,9,0,0,0,0,9,Saints,7,0,7,0,0,0,14,201001,7,-2,5,5,23,5,1584.199,1635.077,2010,1,0,0,0,1,0,1052
Chargers,7,0,7,0,0,0,14,Chiefs,7,14,0,0,0,0,21,201001,0,14,7,7,35,7,1614.113,1400.114,2010,1,0,0,0,1,1,1334
Ravens,0,7,3,0,0,0,10,Jets,3,3,0,3,0,0,9,201001,-3,1,4,1,19,-1,1580.034,1586.636,2010,1,0,0,0,1,0,169
Cowboys,0,0,7,0,0,0,7,Washington,3,7,0,3,0,0,13,201001,3,10,3,6,20,6,1592.462,1430.5,2010,1,0,0,0,1,1,1181
49ers,3,3,0,0,0,0,6,Seahawks,0,14,14,3,0,0,31,201001,-3,8,22,25,37,25,1498.466,1401.591,2010,1,0,0,0,1,1,679
Cardinals,0,10,0,7,0,0,17,Rams,0,10,3,0,0,0,13,201001,0,0,-3,4,30,-4,1533.868,1316.472,2010,1,0,0,0,1,1,1270
Colts,0,10,0,14,0,0,24,Texans,6,7,7,14,0,0,34,201001,6,3,10,10,58,10,1608.682,1546.211,2010,1,0,0,0,1,1,865
Broncos,0,7,7,3,0,0,17,Jaguars,0,7,10,7,0,0,24,201001,0,0,3,7,41,7,1467.711,1441.55,2010,1,0,0,0,1,0,1465
Packers,0,13,14,0,0,0,27,Eagles,3,0,7,10,0,0,20,201001,-3,10,17,7,47,-7,1571.948,1577.744,2010,1,0,0,0,1,0,728
Falcons,0,3,3,3,0,0,9,Steelers,3,0,3,3,6,0,15,201001,3,0,0,6,24,6,1538.437,1562.39,2010,1,0,0,0,0,0,521
Panthers,3,13,0,2,0,0,18,Giants,7,7,10,7,0,0,31,201001,4,-2,8,13,49,13,1565.042,1499.755,2010,1,0,0,0,1,0,531
Bengals,0,3,14,7,0,0,24,Patriots,10,14,7,7,0,0,38,201001,10,21,14,14,62,14,1499.37,1566.741,2010,1,0,0,0,1,0,732
Raiders,3,3,0,7,0,0,13,Titans,10,14,7,7,0,0,38,201001,7,18,25,25,51,25,1383.262,1535.313,2010,1,0,0,0,1,0,1950
Lions,7,7,0,0,0,0,14,Bears,3,10,0,6,0,0,19,201001,-4,-1,-1,5,33,5,1310.527,1476.273,2010,1,0,0,0,1,1,238
Dolphins,3,7,0,5,0,0,15,Bills,0,3,0,7,0,0,10,201001,3,7,7,5,25,-5,1482.581,1476.435,2010,1,0,0,0,1,1,1184
Browns,7,7,0,0,0,0,14,Buccaneers,3,7,0,7,0,0,17,201001,-4,-4,-4,3,31,3,1436.429,1428.762,2010,1,0,0,0,0,0,937
Seahawks,0,0,7,7,0,0,14,Broncos,7,10,7,7,0,0,31,201002,7,17,17,17,45,17,1437.675,1449.552,2010,2,0,0,0,0,0,1019
Saints,9,0,7,9,0,0,25,49ers,0,7,7,8,0,0,22,201002,9,2,2,3,47,-3,1646.623,1462.382,2010,2,0,0,0,1,0,1921
Giants,0,0,7,7,0,0,14,Colts,7,17,7,7,0,0,38,201002,7,24,24,24,52,24,1526.171,1584.905,2010,2,0,0,0,0,0,643
Texans,0,7,10,10,3,0,30,Washington,6,14,7,0,0,0,27,201002,-6,-13,-10,3,57,-3,1569.988,1456.394,2010,2,0,0,0,0,0,1217
Jaguars,3,3,0,7,0,0,13,Chargers,7,14,3,14,0,0,38,201002,4,15,18,25,51,25,1459.709,1582.788,2010,2,0,0,0,1,0,2087
Rams,0,7,0,7,0,0,14,Raiders,0,3,10,3,0,0,16,201002,0,-4,6,2,30,2,1307.629,1370.048,2010,2,0,0,0,0,0,1733
Buccaneers,7,7,3,3,0,0,20,Panthers,0,7,0,0,0,0,7,201002,7,7,10,13,27,-13,1440.063,1538.626,2010,2,0,0,0,1,1,511
Patriots,0,14,0,0,0,0,14,Jets,0,10,11,7,0,0,28,201002,0,-4,7,14,42,14,1582.998,1578.015,2010,2,0,0,0,1,1,181
Steelers,7,6,0,6,0,0,19,Titans,3,0,0,8,0,0,11,201002,4,10,10,8,30,-8,1576.407,1548.527,2010,2,0,0,0,1,0,471
Bills,0,7,0,0,0,0,7,Packers,13,0,14,7,0,0,34,201002,13,6,20,27,41,27,1454.936,1597.752,2010,2,0,0,0,0,0,470
Eagles,7,14,7,7,0,0,35,Lions,7,10,0,15,0,0,32,201002,0,4,11,3,67,-3,1551.939,1303.734,2010,2,0,0,0,1,0,441
Bears,10,10,0,7,0,0,27,Cowboys,7,7,3,3,0,0,20,201002,3,6,3,7,47,-7,1483.066,1566.568,2010,2,0,0,0,1,0,802
Chiefs,3,7,3,3,0,0,16,Browns,0,14,0,0,0,0,14,201002,3,-4,-1,2,30,-2,1431.439,1425.127,2010,2,0,0,0,1,0,698
Ravens,0,0,7,3,0,0,10,Bengals,0,6,3,6,0,0,15,201002,0,6,2,5,25,5,1588.655,1483.113,2010,2,0,0,0,1,1,419
Cardinals,0,7,0,0,0,0,7,Falcons,7,17,10,7,0,0,41,201002,7,17,27,34,48,34,1542.711,1524.421,2010,2,0,0,0,1,0,1588
Dolphins,7,0,7,0,0,0,14,Vikings,0,0,7,3,0,0,10,201002,7,7,7,4,24,-4,1504.08,1572.653,2010,2,0,0,0,0,0,1513
Packers,7,3,0,7,0,0,17,Bears,0,7,0,13,0,0,20,201003,-7,-3,-3,3,37,3,1611.887,1514.356,2010,3,0,0,0,1,1,185
Jets,7,7,7,10,0,0,31,Dolphins,0,10,10,3,0,0,23,201003,7,4,1,8,54,-8,1599.867,1527.496,2010,3,0,0,0,1,1,1091
Chargers,0,0,12,8,0,0,20,Seahawks,0,10,7,10,0,0,27,201003,0,10,5,7,47,7,1597.976,1415.828,2010,3,0,0,0,0,0,1063
Raiders,13,7,0,3,0,0,23,Cardinals,10,7,7,0,0,0,24,201003,-3,-3,4,1,47,1,1376.786,1512.549,2010,3,0,0,0,0,0,646
Colts,6,7,7,7,0,0,27,Broncos,0,3,10,0,0,0,13,201003,6,10,7,14,40,-14,1604.963,1471.4,2010,3,0,0,0,1,0,998
Eagles,7,7,14,0,0,0,28,Jaguars,0,3,0,0,0,0,3,201003,7,11,25,25,31,-25,1558.551,1444.521,2010,3,0,0,0,0,0,758
Washington,0,13,3,0,0,0,16,Rams,14,0,7,9,0,0,30,201003,14,1,5,14,46,14,1444.715,1300.891,2010,3,0,0,0,1,0,708
Cowboys,0,10,7,10,0,0,27,Texans,0,3,0,10,0,0,13,201003,0,7,14,14,40,-14,1535.278,1581.667,2010,3,0,0,0,0,0,225
Browns,3,7,0,7,0,0,17,Ravens,7,7,0,10,0,0,24,201003,4,4,4,7,41,7,1411.951,1568.281,2010,3,0,0,0,1,1,307
Steelers,7,21,3,7,0,0,38,Buccaneers,3,3,0,7,0,0,13,201003,4,22,25,25,51,-25,1601.135,1481.084,2010,3,0,0,0,0,0,874
Titans,3,7,9,10,0,0,29,Giants,0,10,0,0,0,0,10,201003,3,0,9,19,39,-19,1523.799,1506.112,2010,3,0,0,0,0,0,758
Falcons,7,7,3,7,3,0,27,Saints,14,0,7,3,0,0,24,201003,-7,0,-4,3,51,-3,1554.582,1655.429,2010,3,0,0,0,1,1,424
Bills,3,13,7,7,0,0,30,Patriots,7,10,14,7,0,0,38,201003,4,1,8,8,68,8,1440.801,1561.145,2010,3,0,0,0,1,1,404
Lions,7,3,0,0,0,0,10,Vikings,7,7,10,0,0,0,24,201003,0,4,14,14,34,14,1297.121,1549.238,2010,3,0,0,0,1,1,542
49ers,0,3,0,7,0,0,10,Chiefs,0,10,14,7,0,0,31,201003,0,7,21,21,41,21,1453.576,1444.615,2010,3,0,0,0,0,0,1503
Bengals,7,3,0,10,0,0,20,Panthers,0,0,7,0,0,0,7,201003,7,10,3,13,27,-13,1503.487,1497.605,2010,3,0,0,0,0,0,336
Texans,14,0,10,7,0,0,31,Raiders,7,7,0,10,0,0,24,201004,7,0,10,7,55,-7,1544.298,1373.744,2010,4,0,0,0,1,0,1635
Patriots,0,6,21,14,0,0,41,Dolphins,7,0,7,0,0,0,14,201004,-7,-1,13,27,55,-27,1571.521,1506.062,2010,4,0,0,0,1,1,1241
Bears,0,0,0,3,0,0,3,Giants,3,0,7,7,0,0,17,201004,3,3,10,14,20,14,1529.741,1471.353,2010,4,0,0,0,1,0,711
Cardinals,0,7,0,3,0,0,10,Chargers,7,21,10,3,0,0,41,201004,7,21,31,31,51,31,1515.591,1568.875,2010,4,0,0,0,0,0,298
Washington,14,3,0,0,0,0,17,Eagles,0,6,0,6,0,0,12,201004,14,11,11,5,29,-5,1410.363,1585.954,2010,4,0,0,0,1,1,123
Colts,7,7,0,14,0,0,28,Jaguars,7,7,7,10,0,0,31,201004,0,0,7,3,59,3,1626.109,1417.119,2010,4,0,0,0,1,1,699
Ravens,0,10,0,7,0,0,17,Steelers,7,0,0,7,0,0,14,201004,-7,3,3,3,31,-3,1576.539,1627.926,2010,4,0,0,0,1,1,196
49ers,14,0,0,0,0,0,14,Falcons,0,10,3,3,0,0,16,201004,-14,-4,-1,2,30,2,1428.253,1576.234,2010,4,0,0,0,1,0,2135
Seahawks,0,3,0,0,0,0,3,Rams,7,3,7,3,0,0,20,201004,7,7,14,17,23,17,1444.929,1335.243,2010,4,0,0,0,1,1,1720
Broncos,0,10,6,10,0,0,26,Titans,0,10,10,0,0,0,20,201004,0,0,-4,6,46,-6,1450.254,1558.558,2010,4,0,0,0,1,0,1019
Lions,0,14,6,6,0,0,26,Packers,7,14,7,0,0,0,28,201004,7,7,8,2,54,2,1290.552,1596.503,2010,4,0,0,0,1,1,291
Bengals,0,10,3,7,0,0,20,Browns,3,10,10,0,0,0,23,201004,3,3,10,3,43,3,1535.177,1403.692,2010,4,0,0,0,1,1,217
Jets,7,10,21,0,0,0,38,Bills,0,7,0,7,0,0,14,201004,7,10,31,24,52,-24,1621.302,1430.426,2010,4,0,0,0,1,1,292
Panthers,0,7,7,0,0,0,14,Saints,0,10,3,3,0,0,16,201004,0,3,-1,2,30,2,1465.915,1633.777,2010,4,0,0,0,1,1,648
Vikings,0,0,7,13,0,0,20,Jets,3,6,6,14,0,0,29,201005,3,9,8,9,49,9,1555.807,1641.176,2010,5,0,1,0,0,0,1016
Eagles,7,10,0,10,0,0,27,49ers,7,3,0,14,0,0,24,201005,0,7,7,3,51,-3,1553.775,1423.708,2010,5,0,0,0,1,0,2516
Chargers,0,17,7,3,0,0,27,Raiders,12,3,7,13,0,0,35,201005,12,-2,-2,8,62,8,1590.98,1359.751,2010,5,0,0,0,1,1,454
Titans,10,7,3,14,0,0,34,Cowboys,3,7,7,10,0,0,27,201005,7,7,3,7,61,-7,1527.694,1572.647,2010,5,0,0,1,0,0,616
Saints,10,3,0,7,0,0,20,Cardinals,0,10,3,17,0,0,30,201005,-10,-3,0,10,50,10,1637.898,1493.485,2010,5,0,0,0,1,0,1312
Giants,14,10,3,7,0,0,34,Texans,0,3,7,0,0,0,10,201005,14,21,17,24,44,-24,1497.839,1558.291,2010,5,0,0,0,0,0,1417
Broncos,0,7,0,10,0,0,17,Ravens,7,10,0,14,0,0,31,201005,7,10,10,14,48,14,1481.119,1595.904,2010,5,0,0,0,1,0,1506
Packers,7,3,3,0,0,0,13,Washington,0,3,0,10,3,0,16,201005,-7,-7,-10,3,29,3,1598.49,1442.543,2010,5,0,0,0,1,0,686
Chiefs,0,3,6,0,0,0,9,Colts,3,3,3,10,0,0,19,201005,3,3,0,10,28,10,1469.937,1605.457,2010,5,0,1,0,1,0,451
Rams,3,3,0,0,0,0,6,Lions,3,21,7,13,0,0,44,201005,0,18,25,38,50,38,1368.52,1288.565,2010,5,0,0,0,1,0,454
Falcons,0,6,7,7,0,0,20,Browns,0,7,3,0,0,0,10,201005,0,-1,3,10,30,-10,1580.779,1420.69,2010,5,0,0,0,0,0,555
Buccaneers,0,7,7,10,0,0,24,Bengals,7,3,3,8,0,0,21,201005,-7,-3,1,3,45,-3,1454.293,1518.18,2010,5,0,1,0,0,0,783
Jaguars,3,10,14,9,0,0,36,Bills,10,3,7,6,0,0,26,201005,-7,0,7,10,62,-10,1437.771,1410.551,2010,5,0,0,0,1,0,880
Bears,17,0,0,6,0,0,23,Panthers,3,0,3,0,0,0,6,201005,14,14,11,17,29,-17,1503.255,1461.794,2010,5,0,0,0,1,0,586
Chiefs,7,7,10,7,0,0,31,Texans,0,7,7,21,0,0,35,201006,-7,-7,-10,4,66,4,1459.402,1512.339,2010,6,0,0,0,1,0,646
Titans,7,10,3,10,0,0,30,Jaguars,0,0,3,0,0,0,3,201006,7,17,17,27,33,-27,1556.287,1464.811,2010,6,0,0,0,1,1,500
Colts,7,10,7,3,0,0,27,Washington,7,0,10,7,0,0,24,201006,0,10,7,3,51,-3,1615.992,1460.705,2010,6,0,0,0,0,0,490
Cowboys,7,7,0,7,0,0,21,Vikings,7,0,14,3,0,0,24,201006,0,-7,7,3,45,3,1544.054,1543.04,2010,6,0,0,0,1,0,863
Raiders,3,3,0,3,0,0,9,49ers,0,3,7,7,0,0,17,201006,-3,-3,4,8,26,8,1394.096,1412.736,2010,6,0,0,0,0,0,8
Jets,0,7,3,14,0,0,24,Broncos,0,10,7,3,0,0,20,201006,0,-3,-7,4,44,-4,1653.943,1467.994,2010,6,0,0,0,1,0,1627
Saints,7,10,7,7,0,0,31,Buccaneers,0,0,0,6,0,0,6,201006,7,17,24,25,37,-25,1607.432,1474.244,2010,6,0,0,0,1,1,480
Seahawks,7,7,2,7,0,0,23,Bears,7,6,0,7,0,0,20,201006,0,1,3,3,43,-3,1411.653,1534.448,2010,6,0,1,0,1,0,1732
Falcons,0,7,3,7,0,0,17,Eagles,14,7,7,3,0,0,31,201006,14,14,18,14,48,14,1597.626,1564.747,2010,6,0,0,0,1,0,665
Lions,7,3,0,10,0,0,20,Giants,7,7,7,7,0,0,28,201006,0,4,11,8,48,8,1327.038,1543.79,2010,6,0,0,0,1,0,480
Ravens,3,7,7,3,0,0,20,Patriots,7,0,3,10,3,0,23,201006,4,-3,-7,3,43,3,1609.029,1604.792,2010,6,0,0,1,1,0,350
Chargers,0,3,7,7,0,0,17,Rams,10,7,0,3,0,0,20,201006,10,14,7,3,37,3,1556.635,1330.047,2010,6,0,0,0,0,0,1561
Dolphins,7,3,3,7,3,0,23,Packers,10,0,0,10,0,0,20,201006,-3,0,3,3,43,-3,1472.791,1580.328,2010,6,0,1,0,0,0,1366
Browns,3,0,0,7,0,0,10,Steelers,0,7,7,14,0,0,28,201006,-3,4,11,18,38,18,1403.843,1608.561,2010,6,0,0,1,1,1,114
Bills,10,14,0,10,0,0,34,Ravens,3,17,14,0,3,0,37,201007,-7,-4,10,3,71,3,1383.511,1597.874,2010,7,0,1,0,1,0,275
Giants,7,17,14,3,0,0,41,Cowboys,10,10,0,15,0,0,35,201007,-3,4,18,6,76,-6,1550.216,1533.036,2010,7,0,0,0,1,1,1370
Vikings,7,10,7,0,0,0,24,Packers,7,7,14,0,0,0,28,201007,0,-3,4,4,52,4,1554.058,1558.374,2010,7,0,0,0,1,1,259
Patriots,7,6,7,3,0,0,23,Chargers,3,0,0,17,0,0,20,201007,4,10,17,3,43,-3,1615.947,1535.177,2010,7,0,0,0,1,0,2580
Raiders,24,14,21,0,0,0,59,Broncos,0,7,7,0,0,0,14,201007,24,31,45,45,73,-45,1377.928,1457.844,2010,7,0,0,0,1,1,939
Cardinals,0,0,7,3,0,0,10,Seahawks,3,7,9,3,0,0,22,201007,3,10,12,12,32,12,1523.951,1434.287,2010,7,0,1,0,1,1,1114
49ers,7,3,0,10,0,0,20,Panthers,3,7,3,10,0,0,23,201007,-4,0,3,3,43,3,1428.904,1430.601,2010,7,0,0,1,1,0,2296
Washington,7,3,7,0,0,0,17,Bears,7,7,0,0,0,0,14,201007,0,-4,3,3,31,-3,1450.773,1511.813,2010,7,0,0,0,1,0,594
Browns,10,10,0,10,0,0,30,Saints,0,3,0,14,0,0,17,201007,10,17,17,13,47,-13,1394.678,1632.91,2010,7,0,0,0,0,0,924
Steelers,0,17,3,3,0,0,23,Dolphins,6,10,3,3,0,0,22,201007,-6,1,1,1,45,-1,1617.725,1494.745,2010,7,0,0,0,1,0,1013
Jaguars,3,10,7,0,0,0,20,Chiefs,7,7,14,14,0,0,42,201007,4,1,8,22,62,22,1434.39,1449.121,2010,7,0,0,0,1,0,949
Eagles,0,13,3,3,0,0,19,Titans,0,7,3,27,0,0,37,201007,0,-6,-6,18,56,18,1588.977,1586.708,2010,7,0,0,0,0,0,683
Rams,0,17,0,0,0,0,17,Buccaneers,3,3,6,6,0,0,18,201007,3,-11,-5,1,35,1,1351.505,1448.766,2010,7,0,0,0,1,0,861
Bengals,3,0,22,7,0,0,32,Falcons,7,17,0,15,0,0,39,201007,4,21,-1,7,71,7,1498.229,1573.396,2010,7,0,1,0,0,0,374
Steelers,0,3,0,7,0,0,10,Saints,0,3,3,14,0,0,20,201008,0,0,3,10,30,10,1623.362,1580.789,2010,8,0,0,0,0,0,919
Buccaneers,7,17,7,7,0,0,38,Cardinals,7,7,14,7,0,0,35,201008,0,10,3,3,73,-3,1452.409,1496.173,2010,8,0,0,0,1,0,1793
Vikings,0,7,3,8,0,0,18,Patriots,0,7,14,7,0,0,28,201008,0,0,11,10,46,10,1541.528,1629.086,2010,8,0,0,0,0,0,1128
Seahawks,0,0,0,3,0,0,3,Raiders,3,7,3,20,0,0,33,201008,3,10,13,30,36,30,1462.066,1435.083,2010,8,0,0,0,0,0,677
Titans,5,14,0,6,0,0,25,Chargers,7,7,10,9,0,0,33,201008,2,-5,5,8,58,8,1610.223,1522.037,2010,8,0,0,0,1,0,1739
Broncos,0,0,7,9,0,0,16,49ers,3,0,0,21,0,0,24,201008,3,3,-4,8,40,8,1418.001,1400.69,2010,8,0,0,0,0,0,947
Texans,0,3,7,7,0,0,17,Colts,7,10,10,3,0,0,30,201008,7,14,17,13,47,13,1522.62,1625.924,2010,8,0,1,1,1,1,865
Panthers,0,3,0,7,0,0,10,Rams,0,10,0,10,0,0,20,201008,0,7,7,10,30,10,1441.505,1347.863,2010,8,0,0,0,1,0,567
Bills,0,0,3,7,0,0,10,Chiefs,0,7,0,3,3,0,13,201008,0,7,4,3,23,3,1379.406,1472.555,2010,8,0,0,0,1,0,858
Washington,0,13,0,12,0,0,25,Lions,0,7,7,23,0,0,37,201008,0,-6,1,12,62,12,1470.591,1320.612,2010,8,0,0,1,1,0,394
Jaguars,7,7,14,7,0,0,35,Cowboys,3,0,0,14,0,0,17,201008,4,11,25,18,52,-18,1410.956,1510.424,2010,8,0,0,0,0,0,906
Dolphins,3,9,3,7,0,0,22,Bengals,7,7,0,0,0,0,14,201008,-4,-2,1,8,36,-8,1489.108,1486.165,2010,8,0,0,0,1,0,957
Packers,3,0,0,6,0,0,9,Jets,0,0,0,0,0,0,0,201008,3,3,3,9,9,-9,1570.905,1664.092,2010,8,0,0,1,0,0,758
Steelers,10,10,0,7,0,0,27,Bengals,0,7,0,14,0,0,21,201009,10,13,13,6,48,-6,1601.155,1459.559,2010,9,0,0,0,1,1,252
Cowboys,0,7,0,0,0,0,7,Packers,0,28,7,10,0,0,45,201009,0,21,28,38,52,38,1464.569,1606.29,2010,9,0,0,0,1,0,937
Colts,0,17,0,7,0,0,24,Eagles,13,3,3,7,0,0,26,201009,13,-1,2,2,50,2,1639.413,1565.462,2010,9,0,0,1,0,0,582
Chiefs,0,10,3,7,0,0,20,Raiders,0,0,14,6,3,0,23,201009,0,-10,1,3,43,3,1479.977,1465.16,2010,9,0,0,0,1,1,1495
Giants,21,14,6,0,0,0,41,Seahawks,0,0,0,7,0,0,7,201009,21,35,41,34,48,-34,1572.828,1431.989,2010,9,0,1,0,1,0,2401
Chargers,14,0,7,8,0,0,29,Texans,10,10,3,0,0,0,23,201009,4,-6,-2,6,52,-6,1545.723,1509.131,2010,9,0,0,0,1,0,1301
Dolphins,7,3,0,0,0,0,10,Ravens,7,6,7,6,0,0,26,201009,0,3,10,16,36,16,1515.714,1601.979,2010,9,0,0,1,1,0,956
Cardinals,0,14,7,3,0,0,24,Vikings,0,10,0,14,3,0,27,201009,0,-4,-11,3,51,3,1477.167,1528.363,2010,9,0,0,0,1,0,1278
Jets,0,10,0,10,3,0,23,Lions,7,0,6,7,0,0,20,201009,-7,3,-3,3,43,-3,1628.707,1353.691,2010,9,0,0,0,0,0,480
Patriots,0,7,0,7,0,0,14,Browns,10,7,7,10,0,0,34,201009,10,10,17,20,48,20,1642.252,1446.799,2010,9,0,0,1,1,0,551
Bears,0,7,7,8,0,0,22,Bills,0,7,6,6,0,0,19,201009,0,0,1,3,41,-3,1491.995,1371.984,2010,9,0,1,0,0,0,453
Buccaneers,0,14,7,0,0,0,21,Falcons,7,10,10,0,0,0,27,201009,7,3,6,6,48,6,1471.415,1585.46,2010,9,0,0,1,1,1,416
Saints,7,10,10,7,0,0,34,Panthers,3,0,0,0,0,0,3,201009,4,14,24,31,37,-31,1602.996,1415.211,2010,9,0,0,0,1,1,648
Chiefs,0,10,7,12,0,0,29,Broncos,21,14,7,7,0,0,49,201010,21,25,25,20,78,20,1468.367,1379.974,2010,10,0,0,1,1,1,556
Patriots,10,0,13,16,0,0,39,Steelers,0,3,0,23,0,0,26,201010,10,7,20,13,65,-13,1598.276,1615.88,2010,10,0,0,0,1,0,479
Rams,3,7,7,3,0,0,20,49ers,7,3,0,10,3,0,23,201010,4,0,-7,3,43,3,1374.157,1438.716,2010,10,0,1,1,1,1,1741
Eagles,28,17,14,0,0,0,59,Washington,0,14,7,7,0,0,28,201010,28,31,38,31,87,-31,1576.778,1437.512,2010,10,0,0,1,1,1,123
Cowboys,6,13,14,0,0,0,33,Giants,3,3,14,0,0,0,20,201010,3,13,13,13,53,-13,1448.945,1599.811,2010,10,0,0,0,1,1,1370
Texans,3,0,14,7,0,0,24,Jaguars,3,14,0,14,0,0,31,201010,0,14,0,7,55,7,1487.809,1456.811,2010,10,0,0,1,1,1,820
Seahawks,7,10,9,10,0,0,36,Cardinals,7,3,0,8,0,0,18,201010,0,7,16,18,54,-18,1405.005,1468.246,2010,10,0,0,0,1,1,1114
Titans,10,0,7,0,0,0,17,Dolphins,7,3,10,9,0,0,29,201010,-3,0,3,12,46,12,1586.537,1500.068,2010,10,0,1,0,1,0,816
Bengals,0,10,0,7,0,0,17,Colts,10,10,0,3,0,0,23,201010,10,10,10,6,40,6,1444.834,1628.098,2010,10,0,0,0,1,0,99
Jets,3,14,0,3,6,0,26,Browns,10,3,0,7,0,0,20,201010,-7,4,4,6,46,-6,1634.526,1490.775,2010,10,0,0,0,1,0,403
Vikings,3,7,3,0,0,0,13,Bears,0,14,6,7,0,0,27,201010,-3,4,7,14,40,14,1537.283,1503.396,2010,10,0,0,0,1,1,355
Lions,0,3,0,9,0,0,12,Bills,0,7,7,0,0,0,14,201010,0,4,11,2,26,2,1347.872,1360.583,2010,10,0,0,0,0,0,215
Ravens,0,0,7,14,0,0,21,Falcons,0,10,3,13,0,0,26,201010,0,10,6,5,47,5,1617.625,1594.924,2010,10,0,0,0,0,0,576
Panthers,3,7,6,0,0,0,16,Buccaneers,7,14,0,10,0,0,31,201010,4,11,5,15,47,15,1393.526,1461.951,2010,10,0,0,0,1,1,511
Broncos,7,0,0,7,0,0,14,Chargers,7,14,7,7,0,0,35,201011,0,14,21,21,49,21,1412.815,1567.045,2010,11,0,0,1,1,1,832
Giants,0,3,7,7,0,0,17,Eagles,7,6,3,11,0,0,27,201011,7,10,6,10,44,10,1554.396,1603.244,2010,11,0,0,0,1,1,80
Colts,0,14,0,14,0,0,28,Patriots,7,14,7,3,0,0,31,201011,7,7,14,3,59,3,1634.856,1632.095,2010,11,0,0,0,1,0,805
Buccaneers,0,7,7,7,0,0,21,49ers,0,0,0,0,0,0,0,201011,0,7,14,21,21,-21,1478.519,1447.14,2010,11,0,0,0,1,0,2396
Seahawks,3,13,0,3,0,0,19,Saints,7,20,7,0,0,0,34,201011,4,11,18,15,53,15,1447.316,1624.68,2010,11,0,0,1,1,0,2098
Falcons,3,13,7,11,0,0,34,Rams,7,3,7,0,0,0,17,201011,-4,6,6,17,51,-17,1610.374,1365.732,2010,11,0,0,0,1,0,467
Browns,0,7,10,3,0,0,20,Jaguars,3,7,0,14,0,0,24,201011,3,3,-7,4,44,4,1476.175,1475.291,2010,11,0,0,0,1,0,771
Ravens,10,7,3,17,0,0,37,Panthers,0,3,3,7,0,0,13,201011,10,14,14,24,50,-24,1602.175,1376.958,2010,11,0,0,0,0,0,364
Texans,0,7,0,20,0,0,27,Jets,3,10,7,10,0,0,30,201011,3,6,13,3,57,3,1469.329,1649.126,2010,11,0,0,0,1,0,1417
Packers,0,17,7,7,0,0,31,Vikings,3,0,0,0,0,0,3,201011,-3,14,21,28,34,-28,1621.913,1512.965,2010,11,0,1,0,1,1,259
Cardinals,3,0,3,7,0,0,13,Chiefs,0,14,7,10,0,0,31,201011,-3,11,15,18,44,18,1425.935,1435.526,2010,11,0,0,0,0,0,1047
Washington,7,3,3,3,3,0,19,Titans,7,3,3,3,0,0,16,201011,0,0,0,3,35,-3,1411.046,1559.036,2010,11,0,0,0,0,0,566
Lions,0,10,9,0,0,0,19,Cowboys,7,0,14,14,0,0,35,201011,7,-3,2,16,54,16,1339.596,1494.361,2010,11,0,0,0,1,0,999
Bills,7,7,14,21,0,0,49,Bengals,7,24,0,0,0,0,31,201011,0,-17,-3,18,80,-18,1368.86,1438.076,2010,11,0,0,0,1,0,388
Bears,3,3,10,0,0,0,16,Dolphins,0,0,0,0,0,0,0,201011,3,6,16,16,16,-16,1527.714,1527.569,2010,11,0,0,0,0,0,1189
Raiders,3,0,0,0,0,0,3,Steelers,0,21,0,14,0,0,35,201011,-3,18,18,32,38,32,1476.77,1582.061,2010,11,0,1,0,1,0,2251
Dolphins,10,3,10,10,0,0,33,Raiders,7,7,0,3,0,0,17,201012,3,-1,9,16,50,-16,1492.989,1459.061,2010,12,0,0,0,1,0,2582
49ers,14,7,3,3,0,0,27,Cardinals,3,3,0,0,0,0,6,201012,11,15,18,21,33,-21,1412.722,1403.478,2010,12,0,0,0,1,1,652
Chargers,10,6,10,10,0,0,36,Colts,7,7,0,0,0,0,14,201012,3,2,12,22,50,-22,1579.448,1623.764,2010,12,0,0,0,1,0,1784
Buccaneers,0,3,0,7,0,0,10,Ravens,0,17,0,0,0,0,17,201012,0,14,14,7,27,7,1512.937,1619.247,2010,12,0,0,0,0,0,852
Rams,7,19,7,3,0,0,36,Broncos,10,3,0,20,0,0,33,201012,-3,13,20,3,69,-3,1351.715,1400.412,2010,12,0,0,0,0,0,794
Eagles,3,10,0,13,0,0,26,Bears,14,7,10,0,0,0,31,201012,11,8,18,5,57,5,1618.829,1562.294,2010,12,0,0,0,1,0,664
Chiefs,7,14,0,21,0,0,42,Seahawks,7,3,7,7,0,0,24,201012,0,11,4,18,66,-18,1457.983,1437.397,2010,12,0,0,0,0,0,1502
Titans,0,0,0,0,0,0,0,Texans,0,14,3,3,0,0,20,201012,0,14,17,20,20,20,1535.303,1464.43,2010,12,0,0,0,1,1,665
Patriots,3,7,14,21,0,0,45,Lions,7,10,7,0,0,0,24,201012,-4,-7,0,21,69,-21,1643.187,1328.257,2010,12,0,0,0,0,0,615
Jaguars,7,10,0,3,0,0,20,Giants,3,3,3,15,0,0,24,201012,-4,-11,-8,4,44,4,1488.076,1538.811,2010,12,0,0,0,0,0,835
Panthers,7,6,7,3,0,0,23,Browns,14,7,0,3,0,0,24,201012,7,8,1,1,47,1,1359.887,1463.39,2010,12,0,0,0,0,0,435
Steelers,7,6,0,3,3,0,19,Bills,0,0,7,9,0,0,16,201012,7,13,6,3,35,-3,1599.77,1411.762,2010,12,0,0,0,1,0,178
Packers,3,0,7,7,0,0,17,Falcons,3,7,0,10,0,0,20,201012,0,7,0,3,37,3,1650.773,1624.391,2010,12,0,0,0,1,0,768
Bengals,0,7,0,3,0,0,10,Jets,0,3,14,9,0,0,26,201012,0,-4,10,16,36,16,1395.174,1654.025,2010,12,0,0,0,1,0,563
Saints,17,3,3,7,0,0,30,Cowboys,0,6,14,7,0,0,27,201012,17,14,3,3,57,-3,1634.6,1505.7,2010,12,0,0,0,1,0,442
Vikings,7,0,10,0,0,0,17,Washington,7,0,0,6,0,0,13,201012,0,0,10,4,30,-4,1484.106,1434.779,2010,12,0,0,0,1,0,931
Raiders,14,7,0,7,0,0,28,Chargers,0,3,3,7,0,0,13,201013,14,18,15,15,41,-15,1427.76,1622.494,2010,13,0,0,0,1,1,454
Jets,0,3,0,0,0,0,3,Patriots,17,7,7,14,0,0,45,201013,17,21,28,42,48,42,1660.654,1653.832,2010,13,0,0,0,1,1,181
Steelers,0,0,3,10,0,0,13,Ravens,7,0,3,0,0,0,10,201013,-7,-7,-7,3,23,-3,1608.435,1629.729,2010,13,0,0,0,1,1,196
Falcons,7,7,0,14,0,0,28,Buccaneers,7,7,3,7,0,0,24,201013,0,0,-3,4,52,-4,1636.507,1502.455,2010,13,0,0,0,1,1,416
Panthers,7,7,0,0,0,0,14,Seahawks,0,3,21,7,0,0,31,201013,-7,-11,10,17,45,17,1356.347,1403.525,2010,13,0,0,0,1,0,2280
Rams,3,6,7,3,0,0,19,Cardinals,6,0,0,0,0,0,6,201013,-3,3,10,13,25,-13,1370.953,1366.718,2010,13,0,0,0,1,1,1270
Cowboys,10,7,10,8,3,0,38,Colts,0,7,7,21,0,0,35,201013,10,10,13,3,73,-3,1494.678,1580.718,2010,13,0,0,0,0,0,763
Washington,0,0,7,0,0,0,7,Giants,14,7,7,3,0,0,31,201013,14,21,21,24,38,24,1417.839,1549.188,2010,13,0,0,0,1,1,204
Broncos,0,3,0,3,0,0,6,Chiefs,7,3,0,0,0,0,10,201013,7,7,7,4,16,4,1381.173,1491.855,2010,13,0,0,0,1,1,556
Browns,0,3,7,3,0,0,13,Dolphins,0,3,0,7,0,0,10,201013,0,0,7,3,23,-3,1466.93,1524.291,2010,13,0,0,0,1,0,1089
Bills,7,0,0,7,0,0,14,Vikings,7,24,0,7,0,0,38,201013,0,24,24,24,52,24,1403.097,1501.046,2010,13,0,0,0,0,0,729
Jaguars,7,10,0,0,0,0,17,Titans,0,0,3,3,0,0,6,201013,7,17,14,11,23,-11,1477.699,1504.26,2010,13,0,0,0,1,1,500
49ers,3,10,3,0,0,0,16,Packers,0,14,14,6,0,0,34,201013,-3,1,12,18,50,18,1449.482,1638.657,2010,13,0,0,0,1,0,1834
Bears,7,7,3,7,0,0,24,Lions,7,10,3,0,0,0,20,201013,0,-3,-3,4,44,-4,1579.708,1317.612,2010,13,0,0,0,1,1,238
Saints,3,10,7,14,0,0,34,Bengals,0,6,6,18,0,0,30,201013,3,7,8,4,64,-4,1645.621,1388.545,2010,13,0,0,0,0,0,711
Texans,3,7,14,0,0,0,24,Eagles,7,13,0,14,0,0,34,201013,4,10,-4,10,58,10,1495.472,1601.415,2010,13,0,0,0,0,0,1339
Ravens,7,14,7,0,6,0,34,Texans,0,7,6,15,0,0,28,201014,7,14,15,6,62,-6,1611.788,1483.364,2010,14,0,0,0,1,0,1250
Giants,0,14,7,0,0,0,21,Vikings,3,0,0,0,0,0,3,201014,-3,11,18,18,24,-18,1517.907,1563.616,2010,14,0,0,0,1,0,1016
Eagles,7,7,3,13,0,0,30,Cowboys,7,3,10,7,0,0,27,201014,0,4,-3,3,57,-3,1613.523,1515.655,2010,14,0,0,0,1,1,1297
Chiefs,0,0,0,0,0,0,0,Chargers,7,14,0,10,0,0,31,201014,7,21,21,31,31,31,1499.805,1571.135,2010,14,0,0,0,1,1,1334
Broncos,3,0,0,10,0,0,13,Cardinals,3,13,3,24,0,0,43,201014,0,13,16,30,56,30,1373.223,1334.879,2010,14,0,0,0,0,0,585
Dolphins,10,0,0,0,0,0,10,Jets,0,3,0,3,0,0,6,201014,10,7,7,4,16,-4,1504.645,1630.09,2010,14,0,0,0,1,1,1091
Patriots,7,26,3,0,0,0,36,Bears,0,0,7,0,0,0,7,201014,7,33,29,29,43,-29,1684.396,1586.896,2010,14,0,0,0,0,0,853
Seahawks,7,0,7,7,0,0,21,49ers,10,20,10,0,0,0,40,201014,3,23,26,19,61,19,1422.443,1439.559,2010,14,0,0,0,1,1,679
Raiders,7,10,7,7,0,0,31,Jaguars,0,7,21,10,0,0,38,201014,-7,-10,4,7,69,7,1479.119,1510.306,2010,14,0,0,0,1,0,2361
Falcons,14,3,7,7,0,0,31,Panthers,0,0,7,3,0,0,10,201014,14,17,17,21,41,-21,1649.05,1337.429,2010,14,0,0,0,1,1,226
Buccaneers,0,3,6,8,0,0,17,Washington,0,10,0,6,0,0,16,201014,0,-7,-1,1,33,-1,1489.911,1403.411,2010,14,0,0,0,1,0,818
Bengals,7,0,0,0,0,0,7,Steelers,0,10,3,10,0,0,23,201014,-7,3,6,16,30,16,1381.183,1626.376,2010,14,0,0,0,1,1,252
Packers,0,0,3,0,0,0,3,Lions,0,0,0,7,0,0,7,201014,0,0,-3,4,10,4,1648.581,1310.424,2010,14,0,0,0,1,1,291
Browns,3,3,0,0,0,0,6,Bills,0,10,0,3,0,0,13,201014,-3,4,4,7,19,7,1486.575,1386.236,2010,14,0,0,0,1,0,173
Colts,7,14,3,6,0,0,30,Titans,0,7,7,14,0,0,28,201014,7,14,10,2,58,-2,1559.741,1471.653,2010,14,0,0,0,1,1,251
Rams,0,6,0,7,0,0,13,Saints,14,7,7,3,0,0,31,201014,14,15,22,18,44,18,1402.792,1652.983,2010,14,0,0,0,1,0,599
Cardinals,0,3,0,9,0,0,12,Panthers,6,7,6,0,0,0,19,201015,6,10,16,7,31,7,1366.209,1326.605,2010,15,0,0,0,1,0,1778
Bears,10,7,20,3,0,0,40,Vikings,7,0,7,0,0,0,14,201015,3,10,23,26,54,-26,1556.505,1492.835,2010,15,0,0,0,1,1,355
Packers,3,14,7,3,0,0,27,Patriots,7,7,7,10,0,0,31,201015,4,-3,-3,4,58,4,1618.146,1714.786,2010,15,0,0,0,0,0,869
Jets,7,3,7,5,0,0,22,Steelers,0,10,7,0,0,0,17,201015,7,0,0,5,39,-5,1603.676,1633.508,2010,15,0,0,0,1,0,314
Broncos,14,3,3,3,0,0,23,Raiders,14,3,6,16,0,0,39,201015,0,0,3,16,62,16,1341.892,1464.575,2010,15,0,0,0,1,1,939
Falcons,0,17,17,0,0,0,34,Seahawks,7,3,0,8,0,0,18,201015,-7,7,24,16,52,-16,1659.874,1400.265,2010,15,0,0,0,1,0,2178
Saints,7,7,3,7,0,0,24,Ravens,7,14,3,6,0,0,30,201015,0,7,7,6,54,6,1660.2,1627.287,2010,15,0,0,0,0,0,999
Lions,7,3,7,3,3,0,23,Buccaneers,0,14,0,6,0,0,20,201015,7,-4,3,3,43,-3,1340.859,1496.351,2010,15,0,0,0,1,0,994
49ers,0,0,0,7,0,0,7,Chargers,7,10,7,10,0,0,34,201015,7,17,24,27,41,27,1461.737,1591.584,2010,15,0,0,0,0,0,458
Bills,0,10,7,0,0,0,17,Dolphins,0,7,0,7,0,0,14,201015,0,3,10,3,31,-3,1409.512,1531.059,2010,15,0,0,0,1,1,1184
Chiefs,0,14,3,10,0,0,27,Rams,6,0,0,7,0,0,13,201015,-6,8,11,14,40,-14,1479.357,1395.575,2010,15,0,0,0,0,0,237
Jaguars,0,10,7,7,0,0,24,Colts,7,7,10,10,0,0,34,201015,7,4,7,10,58,10,1524.851,1569.892,2010,15,0,0,0,1,1,699
Texans,0,3,7,7,0,0,17,Titans,21,3,7,0,0,0,31,201015,21,21,21,14,48,14,1467.865,1461.502,2010,15,0,0,0,1,1,665
Washington,0,7,7,16,0,0,30,Cowboys,10,10,10,3,0,0,33,201015,10,13,16,3,63,3,1396.971,1503.284,2010,15,0,0,0,1,1,1181
Browns,7,0,0,10,0,0,17,Bengals,0,10,6,3,0,0,19,201015,-7,3,9,2,36,2,1463.299,1374.051,2010,15,0,0,0,1,1,217
Eagles,0,3,7,28,0,0,38,Giants,7,17,0,7,0,0,31,201015,-7,-21,-14,7,69,-7,1625.894,1588.688,2010,15,0,0,0,1,1,80
Chargers,0,3,7,10,0,0,20,Bengals,7,6,0,21,0,0,34,201016,7,10,3,14,54,14,1606.626,1385.934,2010,16,0,0,0,1,0,1871
Saints,3,7,0,7,0,0,17,Falcons,0,7,0,7,0,0,14,201016,3,3,3,3,31,-3,1642.787,1672.679,2010,16,0,0,0,1,1,424
Seahawks,7,0,0,8,0,0,15,Buccaneers,3,14,14,7,0,0,38,201016,-4,10,24,23,53,23,1387.46,1472.297,2010,16,0,0,0,1,0,2526
Giants,0,14,3,0,0,0,17,Packers,14,7,10,14,0,0,45,201016,14,7,14,28,62,28,1565.946,1609.665,2010,16,0,0,0,1,0,758
Colts,7,10,7,7,0,0,31,Raiders,7,6,3,10,0,0,26,201016,0,4,8,5,57,-5,1585.728,1477.807,2010,16,0,0,0,1,0,1936
Texans,7,10,6,0,0,0,23,Broncos,0,0,10,14,0,0,24,201016,-7,-17,-13,1,47,1,1445.898,1328.66,2010,16,0,0,0,1,0,878
Vikings,0,7,10,7,0,0,24,Eagles,7,0,0,7,0,0,14,201016,-7,0,10,10,38,-10,1459.731,1648.635,2010,16,0,0,0,1,0,983
Washington,10,0,0,7,3,0,20,Jaguars,0,7,3,7,0,0,17,201016,10,3,0,3,37,-3,1389.983,1509.014,2010,16,0,0,0,0,0,647
Titans,0,7,7,0,0,0,14,Chiefs,14,17,3,0,0,0,34,201016,14,24,20,20,48,20,1483.47,1504.758,2010,16,0,0,0,1,0,471
49ers,0,14,0,3,0,0,17,Rams,9,3,3,10,0,0,25,201016,9,-2,1,8,42,8,1446.694,1370.174,2010,16,0,0,0,1,1,1741
Ravens,0,13,7,0,0,0,20,Browns,7,3,0,0,0,0,10,201016,-7,3,10,10,30,-10,1644.7,1451.417,2010,16,0,0,0,1,1,307
Jets,0,24,7,3,0,0,34,Bears,10,7,21,0,0,0,38,201016,10,-7,7,4,72,4,1627.388,1589.61,2010,16,0,0,0,0,0,711
Patriots,7,17,7,3,0,0,34,Bills,3,0,0,0,0,0,3,201016,4,21,28,31,37,-31,1723.267,1432.092,2010,16,0,0,0,1,1,404
Cowboys,0,10,10,6,0,0,26,Cardinals,14,7,0,6,0,0,27,201016,14,11,1,1,53,1,1510.273,1347.152,2010,16,0,0,0,1,0,884
Panthers,0,0,0,3,0,0,3,Steelers,3,17,7,0,0,0,27,201016,3,20,27,24,30,24,1345.662,1609.796,2010,16,0,0,0,0,0,363
Lions,3,7,7,17,0,0,34,Dolphins,3,14,7,3,0,0,27,201016,0,-7,-7,7,61,-7,1364.913,1508.48,2010,16,0,0,0,0,0,1155
Rams,0,3,3,0,0,0,6,Seahawks,7,0,3,6,0,0,16,201017,7,4,4,10,22,10,1392.994,1369.798,2010,17,0,0,0,1,1,1720
Jaguars,0,17,0,0,0,0,17,Texans,10,10,7,7,0,0,34,201017,10,3,10,17,51,17,1486.546,1437.738,2010,17,0,0,0,1,1,820
Cardinals,0,7,0,0,0,0,7,49ers,7,3,21,7,0,0,38,201017,7,3,24,31,45,31,1356.403,1423.874,2010,17,0,0,0,1,1,652
Cowboys,0,7,0,7,0,0,14,Eagles,0,7,0,6,0,0,13,201017,0,0,0,1,27,-1,1501.021,1604.625,2010,17,0,0,0,1,1,1297
Titans,3,3,14,0,0,0,20,Colts,3,10,7,3,0,0,23,201017,0,7,0,3,43,3,1461.303,1601.142,2010,17,0,0,0,1,1,251
Bears,0,3,0,0,0,0,3,Packers,0,0,3,7,0,0,10,201017,0,-3,0,7,13,7,1604.265,1632.027,2010,17,0,0,0,1,1,185
Chargers,0,16,10,7,0,0,33,Broncos,7,0,7,14,0,0,28,201017,-7,9,12,5,61,-5,1565.233,1336.82,2010,17,0,0,0,1,1,832
Giants,3,7,7,0,0,0,17,Washington,0,7,0,7,0,0,14,201017,3,3,10,3,31,-3,1543.584,1412.451,2010,17,0,0,0,1,1,204
Bills,0,0,7,0,0,0,7,Jets,3,14,7,14,0,0,38,201017,3,17,17,31,45,31,1418.651,1612.734,2010,17,0,0,0,1,1,292
Buccaneers,3,7,10,3,0,0,23,Saints,7,0,3,3,0,0,13,201017,-4,3,10,10,36,-10,1489.96,1661.136,2010,17,0,0,0,1,1,480
Dolphins,0,0,0,7,0,0,7,Patriots,14,10,14,0,0,0,38,201017,14,24,38,31,45,31,1473.165,1736.707,2010,17,0,0,0,1,1,1241
Raiders,0,10,7,14,0,0,31,Chiefs,3,0,7,0,0,0,10,201017,-3,7,7,21,41,-21,1462.392,1526.924,2010,17,0,0,0,1,1,1495
Vikings,0,0,7,6,0,0,13,Lions,0,10,3,7,0,0,20,201017,0,10,6,7,33,7,1503.741,1400.228,2010,17,0,0,0,1,1,542
Steelers,14,17,7,3,0,0,41,Browns,0,3,0,6,0,0,9,201017,14,28,35,32,50,-32,1617.116,1436.764,2010,17,0,0,0,1,1,114
Panthers,0,0,3,7,0,0,10,Falcons,14,7,10,0,0,0,31,201017,14,21,28,21,41,21,1338.342,1654.33,2010,17,0,0,0,1,1,226
Bengals,0,0,0,7,0,0,7,Ravens,3,3,7,0,0,0,13,201017,3,6,13,6,20,6,1427.327,1659.353,2010,17,0,0,0,1,1,419
Saints,10,10,0,16,0,0,36,Seahawks,7,17,10,7,0,0,41,201018,-3,4,14,5,77,5,1618.388,1390.512,2010,18,1,0,0,1,0,2098
Jets,0,0,7,10,0,0,17,Colts,0,7,3,6,0,0,16,201018,0,-7,-3,1,33,-1,1624.126,1607.108,2010,18,1,0,0,1,0,643
Ravens,3,7,13,7,0,0,30,Chiefs,7,0,0,0,0,0,7,201018,-4,3,16,23,37,-23,1664.605,1482.372,2010,18,1,0,0,1,0,960
Packers,7,7,7,0,0,0,21,Eagles,0,3,7,6,0,0,16,201018,7,11,11,5,37,-5,1646.776,1593.737,2010,18,1,0,0,1,0,728
Jets,0,14,0,14,0,0,28,Patriots,3,0,8,10,0,0,21,201019,-3,11,3,7,49,-7,1632.185,1744.614,2010,19,1,0,1,1,1,181
Seahawks,0,0,3,21,0,0,24,Bears,14,7,7,7,0,0,35,201019,14,21,25,11,59,11,1418.322,1589.516,2010,19,1,0,1,1,0,1732
Packers,0,28,14,6,0,0,48,Falcons,7,7,0,7,0,0,21,201019,-7,14,28,27,69,-27,1665.411,1659.619,2010,19,1,0,1,1,0,768
Ravens,14,7,0,3,0,0,24,Steelers,7,0,14,10,0,0,31,201019,-7,-14,0,7,55,7,1684.967,1639.697,2010,19,1,0,1,1,1,196
Packers,7,7,0,7,0,0,21,Bears,0,0,0,14,0,0,14,201020,7,14,14,7,35,-7,1705.434,1598.685,2010,20,1,0,0,1,1,185
Jets,0,3,7,9,0,0,19,Steelers,7,17,0,0,0,0,24,201020,7,21,14,5,43,5,1665.445,1659.137,2010,20,1,0,0,1,0,314
Steelers,0,10,7,8,0,0,25,Packers,14,7,0,10,0,0,31,201022,14,11,4,6,56,6,1723.401,1673.669,2010,22,1,1,1,0,0,496
Raiders,0,16,0,7,0,0,23,Broncos,3,0,10,7,0,0,20,201101,-3,13,3,3,43,-3,1506.296,1386.636,2011,1,0,0,0,1,1,939
Patriots,7,7,14,10,0,0,38,Dolphins,7,0,10,7,0,0,24,201101,0,7,11,14,62,-14,1642.569,1478.506,2011,1,0,0,0,1,1,1241
Cowboys,7,3,7,7,0,0,24,Jets,0,7,3,17,0,0,27,201101,-7,-3,-7,3,51,3,1509.606,1602.275,2011,1,0,0,0,0,0,1370
Giants,7,7,0,0,0,0,14,Washington,0,14,7,7,0,0,28,201101,-7,0,7,14,42,14,1538.007,1436.016,2011,1,0,0,0,1,1,204
Seahawks,0,0,7,10,0,0,17,49ers,0,16,0,17,0,0,33,201101,0,16,9,16,50,16,1441.102,1464.78,2011,1,0,0,0,1,1,679
Vikings,7,10,0,0,0,0,17,Chargers,7,0,7,10,0,0,24,201101,0,-10,-3,7,41,7,1488.493,1551.399,2011,1,0,0,0,0,0,1530
Panthers,7,7,7,0,0,0,21,Cardinals,7,0,7,14,0,0,28,201101,0,-7,-7,7,49,7,1390.369,1392.072,2011,1,0,0,0,1,0,1778
Colts,0,0,0,7,0,0,7,Texans,17,17,0,0,0,0,34,201101,17,34,34,27,41,27,1567.7,1478.396,2011,1,0,0,0,1,1,865
Titans,0,0,7,7,0,0,14,Jaguars,7,3,3,3,0,0,16,201101,7,10,6,2,30,2,1471.892,1474.46,2011,1,0,0,0,1,1,500
Lions,6,14,7,0,0,0,27,Buccaneers,10,3,0,7,0,0,20,201101,-4,7,14,7,47,-7,1450.819,1523.472,2011,1,0,0,0,1,0,994
Eagles,14,3,7,7,0,0,31,Rams,7,3,3,0,0,0,13,201101,7,7,11,18,44,-18,1551.734,1416.52,2011,1,0,0,0,1,0,808
Bills,14,6,14,7,0,0,41,Chiefs,0,7,0,0,0,0,7,201101,14,13,27,34,48,-34,1439.839,1476.341,2011,1,0,0,0,1,0,858
Bengals,10,3,0,14,0,0,27,Browns,0,14,3,0,0,0,17,201101,10,-1,-4,10,44,-10,1449.716,1444.456,2011,1,0,0,0,1,1,217
Falcons,3,0,3,6,0,0,12,Bears,10,6,14,0,0,0,30,201101,7,13,24,18,42,18,1581.397,1555.479,2011,1,0,0,0,1,0,587
Saints,7,10,10,7,0,0,34,Packers,21,7,7,7,0,0,42,201101,14,11,8,8,76,8,1562.051,1661.483,2011,1,0,0,0,1,0,1012
Steelers,0,7,0,0,0,0,7,Ravens,14,7,11,3,0,0,35,201101,14,14,25,28,42,28,1606.563,1612.017,2011,1,0,0,0,1,1,196
Rams,6,0,10,0,0,0,16,Giants,7,14,7,0,0,0,28,201102,1,15,12,12,44,12,1393.676,1507.542,2011,2,0,0,0,1,0,871
Eagles,0,10,21,0,0,0,31,Falcons,7,7,7,14,0,0,35,201102,7,4,-10,4,66,4,1574.579,1555.707,2011,2,0,0,0,1,0,665
Chargers,7,0,0,14,0,0,21,Patriots,7,13,0,15,0,0,35,201102,0,13,13,14,56,14,1564.126,1661.288,2011,2,0,0,0,1,0,2580
Texans,6,10,0,7,0,0,23,Dolphins,3,0,7,3,0,0,13,201102,3,13,6,10,36,-10,1514.444,1459.787,2011,2,0,0,0,1,0,966
Bengals,0,3,12,7,0,0,22,Broncos,7,3,7,7,0,0,24,201102,7,7,2,2,46,2,1478.561,1375.22,2011,2,0,0,0,1,0,1093
Cowboys,0,7,7,10,3,0,27,49ers,0,14,7,3,0,0,24,201102,0,-7,-7,3,51,-3,1502.169,1485.21,2011,2,0,0,0,1,0,1480
Packers,0,7,16,7,0,0,30,Panthers,10,3,0,10,0,0,23,201102,-10,-6,10,7,53,-7,1672.915,1374.014,2011,2,0,0,0,1,0,745
Cardinals,7,0,7,7,0,0,21,Washington,0,10,0,12,0,0,22,201102,-7,3,-4,1,43,1,1408.426,1466.481,2011,2,0,0,0,1,0,1977
Jaguars,3,0,0,0,0,0,3,Jets,9,6,14,3,0,0,32,201102,6,12,26,29,35,29,1483.072,1609.713,2011,2,0,0,0,1,0,835
Bears,7,3,3,0,0,0,13,Saints,3,13,7,7,0,0,30,201102,-4,6,10,17,43,17,1581.168,1550.62,2011,2,0,0,0,1,0,832
Buccaneers,0,0,10,14,0,0,24,Vikings,7,10,0,3,0,0,20,201102,-7,-17,-7,4,44,-4,1492.934,1475.766,2011,2,0,0,0,1,0,1318
Browns,0,14,0,13,0,0,27,Colts,3,6,3,7,0,0,19,201102,-3,5,2,8,46,-8,1415.61,1531.652,2011,2,0,0,0,1,0,262
Ravens,0,10,0,3,0,0,13,Titans,0,10,10,6,0,0,26,201102,0,0,10,13,39,13,1638.118,1463.28,2011,2,0,0,0,1,0,595
Chiefs,3,0,0,0,0,0,3,Lions,7,13,7,21,0,0,48,201102,4,17,24,45,51,45,1428.478,1481.358,2011,2,0,0,0,0,0,643
Raiders,0,21,0,14,0,0,35,Bills,0,3,14,21,0,0,38,201102,0,-18,-4,3,73,3,1517.712,1487.702,2011,2,0,0,0,1,0,2286
Seahawks,0,0,0,0,0,0,0,Steelers,7,10,7,0,0,0,24,201102,7,17,24,24,24,24,1420.672,1580.463,2011,2,0,0,0,0,0,2132
Ravens,21,6,3,7,0,0,37,Rams,0,0,7,0,0,0,7,201103,21,27,23,30,44,-30,1601.841,1381.191,2011,3,0,0,0,0,0,730
Washington,6,3,7,0,0,0,16,Cowboys,3,6,3,6,0,0,18,201103,-3,0,-4,2,34,2,1470.813,1518.288,2011,3,0,0,0,1,1,1181
Steelers,10,0,0,13,0,0,23,Colts,0,13,0,7,0,0,20,201103,10,-3,-3,3,43,-3,1593.031,1496.253,2011,3,0,0,0,1,0,328
Falcons,0,3,0,10,0,0,13,Buccaneers,3,10,3,0,0,0,16,201103,3,10,13,3,29,3,1569.39,1511.637,2011,3,0,0,0,1,1,416
Cardinals,0,10,0,0,0,0,10,Seahawks,3,3,7,0,0,0,13,201103,3,-4,3,3,23,3,1404.094,1408.104,2011,3,0,0,0,1,1,1114
Packers,7,10,3,7,0,0,27,Bears,0,10,0,7,0,0,17,201103,7,7,10,10,44,-10,1680.676,1555.523,2011,3,0,0,0,1,1,185
Chiefs,0,0,7,10,0,0,17,Chargers,0,10,7,3,0,0,20,201103,0,10,10,3,37,3,1404.016,1549.89,2011,3,0,0,0,1,1,1334
Jets,7,10,0,7,0,0,24,Raiders,7,10,7,10,0,0,34,201103,0,0,7,10,58,10,1625.303,1505.436,2011,3,0,0,0,1,0,2557
Patriots,14,7,3,7,0,0,31,Bills,0,10,7,17,0,0,34,201103,-14,-11,-7,3,65,3,1675.524,1499.978,2011,3,0,0,0,1,1,404
Giants,14,0,0,15,0,0,29,Eagles,0,13,3,0,0,0,16,201103,14,1,-2,13,45,-13,1520.027,1560.895,2011,3,0,0,0,1,1,80
Texans,10,6,3,14,0,0,33,Saints,0,10,7,23,0,0,40,201103,-10,-6,-2,7,73,7,1539.253,1576.265,2011,3,0,0,0,0,0,317
Lions,0,0,10,13,3,0,26,Vikings,6,14,0,3,0,0,23,201103,-6,-20,-10,3,49,-3,1505.82,1457.063,2011,3,0,0,0,1,1,542
Broncos,7,0,7,0,0,0,14,Titans,0,10,0,7,0,0,17,201103,-7,3,-4,3,31,3,1387.63,1499.558,2011,3,0,0,0,1,0,1019
Dolphins,7,3,3,3,0,0,16,Browns,0,7,3,7,0,0,17,201103,-7,-3,-3,1,33,1,1434.978,1451.01,2011,3,0,0,0,1,0,1089
49ers,0,0,3,10,0,0,13,Bengals,3,0,0,5,0,0,8,201103,-3,-3,0,5,21,-5,1469.091,1466.151,2011,3,0,0,0,0,0,2040
Jaguars,0,10,0,0,0,0,10,Panthers,2,3,3,8,0,0,16,201103,2,-5,-2,6,26,6,1467.482,1366.253,2011,3,0,0,0,0,0,341
Giants,0,10,0,21,0,0,31,Cardinals,3,3,14,7,0,0,27,201104,-3,4,-10,4,58,-4,1555.948,1393.288,2011,4,0,0,0,1,0,2139
Jets,7,10,0,0,0,0,17,Ravens,17,10,7,0,0,0,34,201104,10,10,17,17,51,17,1596.859,1620.434,2011,4,0,0,0,1,0,169
Dolphins,7,3,3,3,0,0,16,Chargers,7,6,10,3,0,0,26,201104,0,3,10,10,42,10,1429.824,1555.685,2011,4,0,0,0,1,0,2267
Patriots,7,10,7,7,0,0,31,Raiders,3,7,3,6,0,0,19,201104,4,7,11,12,50,-12,1656.434,1533.88,2011,4,0,0,0,1,0,2690
Broncos,3,14,0,6,0,0,23,Packers,14,14,14,7,0,0,49,201104,11,11,25,26,72,26,1380.821,1700.015,2011,4,0,0,0,0,0,927
Colts,3,7,7,0,0,0,17,Buccaneers,0,7,10,7,0,0,24,201104,-3,-3,0,7,41,7,1483.834,1525.166,2011,4,0,0,0,0,0,843
Falcons,7,17,3,3,0,0,30,Seahawks,0,7,14,7,0,0,28,201104,7,17,6,2,58,-2,1555.861,1418.91,2011,4,0,0,0,1,0,2178
Steelers,0,0,7,3,0,0,10,Texans,7,3,0,7,0,0,17,201104,7,10,3,7,27,7,1605.45,1525.053,2011,4,0,0,0,1,0,1136
Vikings,7,0,3,7,0,0,17,Chiefs,3,6,6,7,0,0,22,201104,-4,2,5,5,39,5,1442.444,1398.222,2011,4,0,0,0,0,0,411
49ers,0,3,14,7,0,0,24,Eagles,7,13,3,0,0,0,23,201104,-7,-17,-6,1,47,-1,1490.787,1524.975,2011,4,0,0,0,1,0,2516
Washington,7,7,3,0,0,0,17,Rams,0,0,0,10,0,0,10,201104,7,14,17,7,27,-7,1463.631,1362.598,2011,4,0,0,0,1,0,708
Lions,0,3,14,17,0,0,34,Cowboys,7,13,10,0,0,0,30,201104,-7,-17,-13,4,64,-4,1520.438,1525.47,2011,4,0,0,0,1,0,999
Titans,7,14,10,0,0,0,31,Browns,3,3,0,7,0,0,13,201104,4,15,25,18,44,-18,1506.367,1456.164,2011,4,0,0,0,1,0,458
Bills,0,17,0,3,0,0,20,Bengals,3,0,10,10,0,0,23,201104,3,-14,-4,3,43,3,1519.068,1444.455,2011,4,0,0,0,1,0,388
Panthers,3,17,0,9,0,0,29,Bears,10,14,0,10,0,0,34,201104,7,4,4,5,63,5,1388.094,1536.183,2011,4,0,0,0,1,0,586
Saints,7,7,6,3,0,0,23,Jaguars,0,10,0,0,0,0,10,201104,7,4,10,13,33,-13,1590.465,1445.641,2011,4,0,0,0,0,0,503
Packers,0,6,9,10,0,0,25,Falcons,7,7,0,0,0,0,14,201105,-7,-8,1,11,39,-11,1705.555,1564.327,2011,5,0,0,0,1,0,768
Jets,0,7,7,7,0,0,21,Patriots,7,3,14,6,0,0,30,201105,7,3,10,9,51,9,1576.008,1677.326,2011,5,0,0,0,1,1,181
Chargers,6,17,0,6,0,0,29,Broncos,7,3,0,14,0,0,24,201105,-1,13,13,5,53,-5,1566.716,1375.282,2011,5,0,0,0,1,1,832
Buccaneers,3,0,0,0,0,0,3,49ers,7,17,10,14,0,0,48,201105,4,21,31,45,51,45,1539.114,1500.064,2011,5,0,0,0,1,0,2396
Raiders,3,9,3,10,0,0,25,Texans,7,7,3,3,0,0,20,201105,-4,-2,-2,5,45,-5,1512.987,1546.921,2011,5,0,0,0,1,0,1635
Bengals,7,6,0,17,0,0,30,Jaguars,7,6,0,7,0,0,20,201105,0,0,0,10,50,-10,1458.764,1425.925,2011,5,0,0,0,1,0,630
Bears,0,10,0,3,0,0,13,Lions,0,7,14,3,0,0,24,201105,0,-3,11,11,37,11,1543.592,1540.368,2011,5,0,0,0,1,1,238
Titans,3,0,7,7,0,0,17,Steelers,7,14,7,10,0,0,38,201105,4,18,18,21,55,21,1537.272,1583.582,2011,5,0,0,0,1,0,471
Seahawks,14,0,2,20,0,0,36,Giants,7,7,0,11,0,0,25,201105,7,0,2,11,61,-11,1410.444,1567.137,2011,5,0,0,0,1,0,2401
Cardinals,0,3,7,0,0,0,10,Vikings,28,0,3,3,0,0,34,201105,28,25,21,24,44,24,1382.099,1425.755,2011,5,0,0,0,1,0,1278
Chiefs,0,14,7,7,0,0,28,Colts,7,17,0,0,0,0,24,201105,-7,-10,-3,4,52,-4,1414.911,1469.886,2011,5,0,0,0,1,0,451
Eagles,0,7,7,10,0,0,24,Bills,7,14,10,0,0,0,31,201105,7,14,17,7,55,7,1515.698,1504.759,2011,5,0,0,0,0,0,279
Saints,10,10,3,7,0,0,30,Panthers,6,7,7,7,0,0,27,201105,4,7,3,3,57,-3,1610.182,1380.685,2011,5,0,0,0,1,1,648
Dolphins,3,3,0,0,0,0,6,Jets,7,7,3,7,0,0,24,201106,4,8,11,18,30,18,1418.792,1564.131,2011,6,0,1,0,1,1,1091
Vikings,0,3,7,0,0,0,10,Bears,16,10,10,3,0,0,39,201106,16,23,26,29,49,29,1447.137,1523.675,2011,6,0,0,0,1,1,355
Saints,7,3,3,7,0,0,20,Buccaneers,3,17,3,3,0,0,26,201106,-4,10,10,6,46,6,1617.392,1504.095,2011,6,0,0,0,1,1,480
Cowboys,3,7,3,3,0,0,16,Patriots,3,10,0,7,0,0,20,201106,0,3,0,4,36,4,1505.54,1689.203,2011,6,0,1,0,0,0,1545
Texans,0,7,7,0,0,0,14,Ravens,7,3,6,13,0,0,29,201106,7,3,2,15,43,15,1522.957,1641.285,2011,6,0,0,1,1,0,1250
Browns,0,7,0,10,0,0,17,Raiders,7,7,10,0,0,0,24,201106,7,7,17,7,41,7,1425.258,1536.951,2011,6,0,1,0,1,0,2153
Eagles,7,13,0,0,0,0,20,Washington,0,3,3,7,0,0,13,201106,7,17,14,7,33,-7,1498.535,1481.976,2011,6,0,0,1,1,1,123
Bills,14,3,0,7,0,0,24,Giants,7,10,7,3,0,0,27,201106,-7,0,7,3,51,3,1521.922,1523.929,2011,6,0,0,0,0,0,292
Rams,0,3,0,0,0,0,3,Packers,3,21,0,0,0,0,24,201106,3,21,21,21,27,21,1344.253,1724.385,2011,6,0,1,0,1,0,422
49ers,0,12,3,10,0,0,25,Lions,10,0,3,6,0,0,19,201106,-10,2,2,6,44,-6,1535.083,1560.286,2011,6,0,0,0,1,0,2087
Colts,0,7,0,10,0,0,17,Bengals,7,3,10,7,0,0,27,201106,7,3,13,10,44,10,1447.208,1485.345,2011,6,0,0,0,1,0,99
Panthers,3,7,7,0,0,0,17,Falcons,7,7,0,17,0,0,31,201106,4,4,-3,14,48,14,1373.475,1545.496,2011,6,0,0,0,1,1,226
Jaguars,0,3,7,3,0,0,13,Steelers,7,10,0,0,0,0,17,201106,7,14,7,4,30,4,1399.344,1603.887,2011,6,0,0,0,1,0,704
Chiefs,14,0,7,7,0,0,28,Raiders,0,0,0,0,0,0,0,201107,14,14,21,28,28,-28,1437.589,1547.175,2011,7,0,1,0,1,1,1495
Ravens,0,0,0,7,0,0,7,Jaguars,3,3,3,3,0,0,12,201107,3,6,9,5,19,5,1654.501,1394.33,2011,7,0,0,0,1,0,681
Colts,0,7,0,0,0,0,7,Saints,21,13,14,14,0,0,62,201107,21,27,41,55,69,55,1430.909,1594.748,2011,7,0,0,0,0,0,713
Packers,7,6,20,0,0,0,33,Vikings,7,10,0,10,0,0,27,201107,0,-4,16,6,60,-6,1728.067,1427.523,2011,7,0,0,0,1,1,259
Steelers,7,10,9,6,0,0,32,Cardinals,0,7,7,6,0,0,20,201107,7,10,12,12,52,-12,1608.901,1360.717,2011,7,0,0,1,0,0,1824
Washington,0,6,7,7,0,0,20,Panthers,3,6,14,10,0,0,33,201107,3,3,10,13,53,13,1457.768,1363.524,2011,7,0,0,0,1,0,329
Rams,0,7,0,0,0,0,7,Cowboys,7,10,3,14,0,0,34,201107,7,10,13,27,41,27,1340.572,1499.962,2011,7,0,0,0,1,0,547
Chargers,7,14,0,0,0,0,21,Jets,3,7,7,10,0,0,27,201107,-4,-11,-4,6,48,6,1577.753,1576.47,2011,7,0,1,0,1,0,2427
Broncos,0,0,0,15,3,0,18,Dolphins,0,6,0,9,0,0,15,201107,0,-6,-6,3,33,-3,1364.245,1406.453,2011,7,0,1,0,1,0,1724
Bears,7,7,7,3,0,0,24,Buccaneers,2,3,0,13,0,0,18,201107,5,9,16,6,42,-6,1526.739,1543.288,2011,7,0,0,0,1,0,1004
Texans,3,17,7,14,0,0,41,Titans,0,0,7,0,0,0,7,201107,3,20,20,34,48,-34,1509.741,1516.966,2011,7,0,0,1,1,1,665
Falcons,10,7,3,3,0,0,23,Lions,3,3,10,0,0,0,16,201107,7,11,4,7,39,-7,1555.447,1534.842,2011,7,0,0,0,1,0,597
Seahawks,0,0,3,0,0,0,3,Browns,0,3,0,3,0,0,6,201107,0,3,0,3,9,3,1453.651,1415.034,2011,7,0,1,0,0,0,2020
Chargers,0,3,9,8,0,0,20,Chiefs,10,3,0,7,3,0,23,201108,10,10,1,3,43,3,1562.271,1491.139,2011,8,0,0,0,1,1,1334
Cowboys,0,0,0,7,0,0,7,Eagles,14,10,3,7,0,0,34,201108,14,24,27,27,41,27,1512.999,1522.743,2011,8,0,0,1,1,1,1297
Bengals,10,7,0,17,0,0,34,Seahawks,0,3,3,6,0,0,12,201108,10,14,11,22,46,-22,1501.643,1440.991,2011,8,0,1,0,0,0,1967
Browns,0,3,0,7,0,0,10,49ers,10,7,0,3,0,0,20,201108,10,14,14,10,30,10,1427.695,1560.527,2011,8,0,0,1,0,0,2161
Patriots,0,10,0,7,0,0,17,Steelers,7,10,3,5,0,0,25,201108,7,7,10,8,42,8,1694.781,1621.136,2011,8,0,1,0,1,0,479
Lions,7,17,14,7,0,0,45,Broncos,3,0,0,7,0,0,10,201108,4,21,35,35,55,-35,1510.922,1383.178,2011,8,0,0,0,0,0,1154
Washington,0,0,0,0,0,0,0,Bills,7,6,7,3,0,0,23,201108,7,13,20,23,23,23,1428.776,1511.032,2011,8,0,0,1,0,0,292
Jaguars,0,7,0,7,0,0,14,Texans,7,0,7,10,0,0,24,201108,7,0,7,10,38,10,1424.005,1554.035,2011,8,0,0,0,1,1,820
Cardinals,3,21,0,3,0,0,27,Ravens,0,6,14,10,0,0,30,201108,-3,-18,-4,3,57,3,1348.482,1624.826,2011,8,0,0,0,0,0,2000
Vikings,7,7,7,3,0,0,24,Panthers,0,14,7,0,0,0,21,201108,7,0,0,3,45,-3,1420.32,1392.516,2011,8,0,0,0,1,0,938
Dolphins,7,7,3,0,0,0,17,Giants,3,7,0,10,0,0,20,201108,-4,-4,-7,3,37,3,1387.521,1534.819,2011,8,0,0,1,0,0,1091
Saints,0,0,7,14,0,0,21,Rams,0,17,7,7,0,0,31,201108,0,17,17,10,52,10,1610.154,1327.535,2011,8,0,0,0,1,0,599
Colts,0,0,3,7,0,0,10,Titans,3,17,0,7,0,0,27,201108,3,20,17,17,37,17,1415.503,1472.673,2011,8,0,0,0,1,1,251
Bears,7,10,3,10,0,0,30,Eagles,0,10,14,0,0,0,24,201109,7,7,-4,6,54,-6,1561.682,1548.142,2011,9,0,1,0,1,0,664
Ravens,3,6,7,7,0,0,23,Steelers,0,6,0,14,0,0,20,201109,3,3,10,3,43,-3,1627.777,1643.744,2011,9,0,0,0,1,1,196
Packers,21,7,3,14,0,0,45,Chargers,7,10,7,14,0,0,38,201109,14,11,7,7,83,-7,1735.27,1548.124,2011,9,0,1,0,0,0,1758
Rams,3,6,4,0,0,0,13,Cardinals,3,0,3,7,6,0,19,201109,0,-6,-7,6,32,6,1368.93,1345.531,2011,9,0,0,0,1,1,1270
Giants,0,0,10,14,0,0,24,Patriots,0,0,3,17,0,0,20,201109,0,0,7,4,44,-4,1540.574,1672.174,2011,9,0,0,0,0,0,181
Broncos,7,0,17,14,0,0,38,Raiders,3,14,7,0,0,0,24,201109,4,-10,0,14,62,-14,1354.561,1493.626,2011,9,0,0,1,1,1,939
Bengals,0,7,7,10,0,0,24,Titans,3,14,0,0,0,0,17,201109,-3,-10,-3,7,41,-7,1533.453,1490.805,2011,9,0,0,0,1,0,243
Jets,0,3,17,7,0,0,27,Bills,0,0,3,8,0,0,11,201109,0,3,17,16,38,-16,1591.951,1528.899,2011,9,0,1,0,1,1,292
49ers,0,13,3,3,0,0,19,Washington,0,3,0,8,0,0,11,201109,0,10,13,8,30,-8,1571.199,1410.909,2011,9,0,0,0,1,0,2435
Buccaneers,0,3,3,10,0,0,16,Saints,7,10,7,3,0,0,27,201109,7,14,18,11,43,11,1508.344,1568.759,2011,9,0,1,0,1,1,480
Dolphins,7,7,14,3,0,0,31,Chiefs,3,0,0,0,0,0,3,201109,4,11,25,28,34,-28,1381.767,1505.286,2011,9,0,0,0,1,0,1242
Falcons,14,7,7,3,0,0,31,Colts,0,7,0,0,0,0,7,201109,14,14,21,24,38,-24,1579.367,1397.371,2011,9,0,1,0,0,0,427
Seahawks,3,3,0,7,0,0,13,Cowboys,3,3,7,10,0,0,23,201109,0,0,7,10,36,10,1409.181,1487.6,2011,9,0,0,0,1,0,1679
Browns,3,0,3,6,0,0,12,Texans,14,10,3,3,0,0,30,201109,11,21,21,18,42,18,1417.023,1564.85,2011,9,0,0,0,1,0,1113
Titans,14,3,3,10,0,0,30,Panthers,0,0,3,0,0,0,3,201110,14,17,17,27,33,-27,1468.448,1376.91,2011,10,0,0,1,0,0,339
Vikings,0,0,7,0,0,0,7,Packers,14,3,14,14,0,0,45,201110,14,17,24,38,52,38,1435.925,1748.317,2011,10,0,1,0,1,1,259
Patriots,6,7,10,14,0,0,37,Jets,0,9,0,7,0,0,16,201110,6,4,14,21,53,-21,1645.445,1620.468,2011,10,0,0,0,1,1,181
Giants,3,3,7,7,0,0,20,49ers,3,6,3,15,0,0,27,201110,0,3,-1,7,47,7,1567.302,1586.623,2011,10,0,0,0,1,0,2565
Lions,0,6,0,7,0,0,13,Bears,10,10,17,0,0,0,37,201110,10,14,31,24,50,24,1539.539,1584.537,2011,10,0,1,0,1,1,238
Ravens,0,7,3,7,0,0,17,Seahawks,10,9,3,0,0,0,22,201110,10,12,12,5,39,5,1645.464,1395.468,2011,10,0,0,0,0,0,2328
Cardinals,0,7,0,14,0,0,21,Eagles,0,14,0,3,0,0,17,201110,0,-7,-7,4,38,-4,1362.353,1525.287,2011,10,0,0,0,1,0,2078
Texans,9,7,14,7,0,0,37,Buccaneers,0,3,0,6,0,0,9,201110,9,13,27,28,46,-28,1577.041,1492.971,2011,10,0,0,0,0,0,790
Broncos,7,3,0,7,0,0,17,Chiefs,0,0,7,3,0,0,10,201110,7,10,3,7,27,-7,1400.17,1450.228,2011,10,0,0,0,1,1,556
Washington,3,3,3,0,0,0,9,Dolphins,7,3,3,7,0,0,20,201110,4,4,4,11,29,11,1395.484,1436.824,2011,10,0,0,0,0,0,924
Jaguars,3,0,7,7,0,0,17,Colts,0,3,0,0,0,0,3,201110,3,0,7,14,20,-14,1413.19,1376.727,2011,10,0,1,0,1,1,699
Bills,0,7,0,0,0,0,7,Cowboys,14,14,6,10,0,0,44,201110,14,21,27,37,51,37,1500.383,1501.313,2011,10,0,0,0,0,0,1197
Rams,0,10,0,3,0,0,13,Browns,3,6,3,0,0,0,12,201110,-3,1,-2,1,25,-1,1352.108,1404.832,2011,10,0,0,0,0,0,491
Steelers,14,3,7,0,0,0,24,Bengals,7,3,7,0,0,0,17,201110,7,7,7,7,41,-7,1626.057,1555.811,2011,10,0,0,0,1,1,252
Saints,3,7,7,6,3,0,26,Falcons,3,3,7,10,0,0,23,201110,0,4,4,3,49,-3,1584.132,1600.011,2011,10,0,0,0,1,1,424
Raiders,7,10,7,0,0,0,24,Chargers,3,0,14,0,0,0,17,201110,4,14,7,7,41,-7,1448.017,1535.078,2011,10,0,0,0,1,1,454
Chiefs,3,0,0,0,0,0,3,Patriots,0,10,17,7,0,0,34,201111,-3,7,24,31,37,31,1421.274,1680.539,2011,11,0,0,0,1,0,1249
Eagles,0,10,0,7,0,0,17,Giants,0,3,0,7,0,0,10,201111,0,7,7,7,27,-7,1496.996,1552.042,2011,11,0,0,0,1,1,80
Chargers,3,7,7,3,0,0,20,Bears,3,14,14,0,0,0,31,201111,0,7,14,11,51,11,1503.542,1605.799,2011,11,0,0,0,0,0,1729
Titans,0,3,7,7,0,0,17,Falcons,7,6,10,0,0,0,23,201111,7,10,13,6,40,6,1498.863,1582.328,2011,11,0,0,0,0,0,215
Cardinals,0,0,0,7,0,0,7,49ers,6,3,14,0,0,0,23,201111,6,9,23,16,30,16,1390.645,1601.883,2011,11,0,0,0,1,1,652
Seahawks,0,10,7,7,0,0,24,Rams,7,0,0,0,0,0,7,201111,-7,3,10,17,31,-17,1424.563,1361.822,2011,11,0,0,0,1,1,1720
Bengals,7,0,7,10,0,0,24,Ravens,0,14,10,7,0,0,31,201111,-7,7,10,7,55,7,1535.379,1616.37,2011,11,0,0,0,1,1,419
Cowboys,7,3,0,14,3,0,27,Washington,0,14,3,7,0,0,24,201111,7,-4,-7,3,51,-3,1530.008,1378.817,2011,11,0,0,0,1,1,1181
Raiders,3,21,3,0,0,0,27,Vikings,7,0,0,14,0,0,21,201111,-4,17,20,6,48,-6,1479.552,1429.53,2011,11,0,0,0,0,0,1573
Bills,3,3,0,2,0,0,8,Dolphins,14,14,7,0,0,0,35,201111,11,22,29,27,43,27,1471.688,1453.491,2011,11,0,0,0,1,1,1184
Buccaneers,0,10,3,13,0,0,26,Packers,7,14,0,14,0,0,35,201111,7,11,8,9,61,9,1461.418,1754.712,2011,11,0,0,0,1,0,1185
Panthers,10,17,0,8,0,0,35,Lions,0,14,14,21,0,0,49,201111,-10,-13,1,14,84,14,1346.495,1518.277,2011,11,0,0,0,1,0,504
Jaguars,0,7,0,3,0,0,10,Browns,0,7,0,7,0,0,14,201111,0,0,0,4,24,4,1442.875,1395.118,2011,11,0,0,0,1,0,771
Jets,0,3,7,3,0,0,13,Broncos,3,0,7,7,0,0,17,201111,3,0,0,4,30,4,1585.374,1429.124,2011,11,0,0,0,1,0,1627
Giants,0,3,7,14,0,0,24,Saints,0,21,14,14,0,0,49,201112,0,18,25,25,73,25,1522.737,1601.815,2011,12,0,0,1,1,0,1168
Steelers,0,13,0,0,0,0,13,Chiefs,3,3,0,3,0,0,9,201112,-3,7,7,4,22,-4,1646.488,1413.183,2011,12,0,1,0,1,0,779
Broncos,0,7,3,3,3,0,16,Chargers,3,7,3,0,0,0,13,201112,-3,-3,-3,3,29,-3,1450.226,1490.78,2011,12,0,0,0,1,1,832
Patriots,7,17,7,7,0,0,38,Eagles,10,3,0,7,0,0,20,201112,-3,11,18,18,58,-18,1688.63,1526.301,2011,12,0,0,0,0,0,261
Washington,7,0,0,16,0,0,23,Seahawks,0,7,3,7,0,0,17,201112,7,0,-3,6,40,-6,1368.72,1453.684,2011,12,0,0,0,1,0,2322
Bears,0,7,0,13,0,0,20,Raiders,6,6,6,7,0,0,25,201112,6,5,11,5,45,5,1618.562,1499.989,2011,12,0,0,0,0,0,1845
Texans,7,13,0,0,0,0,20,Jaguars,7,3,0,3,0,0,13,201112,0,10,10,7,33,-7,1608.594,1427.697,2011,12,0,1,0,1,1,820
Bills,7,7,7,3,0,0,24,Jets,0,14,7,7,0,0,28,201112,-7,0,0,4,52,4,1443.429,1564.272,2011,12,0,0,0,1,1,292
Packers,0,7,17,3,0,0,27,Lions,0,0,0,15,0,0,15,201112,0,7,24,12,42,-12,1759.179,1528.24,2011,12,0,0,0,1,1,291
Panthers,3,7,7,10,0,0,27,Colts,0,10,3,6,0,0,19,201112,3,0,4,8,46,-8,1336.532,1347.042,2011,12,0,0,1,0,0,428
Buccaneers,3,7,7,0,0,0,17,Titans,7,3,0,13,0,0,23,201112,4,0,-7,6,40,6,1456.951,1487.981,2011,12,0,0,0,0,0,621
Browns,7,10,3,0,0,0,20,Bengals,7,0,10,6,0,0,23,201112,0,-10,-3,3,43,3,1410.295,1523.622,2011,12,0,0,0,1,1,217
Vikings,0,0,7,7,0,0,14,Falcons,7,10,0,7,0,0,24,201112,7,17,10,10,38,10,1409.094,1593.209,2011,12,0,0,0,1,0,908
49ers,3,0,3,0,0,0,6,Ravens,3,3,0,10,0,0,16,201112,0,3,0,10,22,10,1610.409,1628.126,2011,12,0,0,0,0,0,2451
Dolphins,3,3,10,3,0,0,19,Cowboys,0,10,0,10,0,0,20,201112,-3,4,-6,1,39,1,1481.75,1540.105,2011,12,0,0,0,0,0,1110
Cardinals,3,0,17,3,0,0,23,Rams,7,3,0,10,0,0,20,201112,-4,-7,10,3,43,-3,1382.119,1332.7,2011,12,0,0,0,1,1,1270
Ravens,0,10,7,7,0,0,24,Browns,0,0,3,7,0,0,10,201113,0,10,14,14,34,-14,1645.836,1403.531,2011,13,0,0,0,1,1,307
Chargers,10,14,7,7,0,0,38,Jaguars,0,14,0,0,0,0,14,201113,10,10,17,24,52,-24,1471.926,1414.299,2011,13,0,0,0,1,0,2087
Lions,0,7,10,0,0,0,17,Saints,3,21,0,7,0,0,31,201113,3,17,7,14,48,14,1514.987,1620.393,2011,13,0,0,0,1,0,939
Rams,0,0,0,0,0,0,0,49ers,3,6,10,7,0,0,26,201113,3,9,19,26,26,26,1318.113,1592.699,2011,13,0,0,0,1,1,1741
Cowboys,0,10,3,0,0,0,13,Cardinals,3,0,3,7,6,0,19,201113,3,-7,-7,6,32,6,1544.431,1396.706,2011,13,0,0,0,1,0,884
Packers,7,14,7,10,0,0,38,Giants,10,7,7,11,0,0,35,201113,-3,4,4,3,73,-3,1772.432,1504.159,2011,13,0,0,0,1,0,758
Jets,7,3,3,21,0,0,34,Washington,7,6,0,6,0,0,19,201113,0,-3,0,15,53,-15,1571.854,1398.095,2011,13,0,0,0,0,0,204
Falcons,0,3,7,0,0,0,10,Texans,3,7,0,7,0,0,17,201113,3,7,0,7,27,7,1601.501,1621.992,2011,13,0,0,0,0,0,700
Bengals,0,7,0,0,0,0,7,Steelers,0,28,7,0,0,0,35,201113,0,21,28,28,42,28,1530.387,1654.715,2011,13,0,0,0,1,1,252
Panthers,14,10,7,7,0,0,38,Buccaneers,3,9,0,7,0,0,19,201113,11,12,19,19,57,-19,1364.154,1443.332,2011,13,0,0,0,1,1,511
Colts,0,3,0,21,0,0,24,Patriots,3,14,14,0,0,0,31,201113,3,14,28,7,55,7,1319.42,1709.128,2011,13,0,0,0,1,0,805
Broncos,7,0,14,14,0,0,35,Vikings,5,10,7,10,0,0,32,201113,2,-8,-1,3,67,-3,1469.08,1400.802,2011,13,0,0,0,0,0,698
Raiders,0,0,0,14,0,0,14,Dolphins,6,7,21,0,0,0,34,201113,6,13,34,20,48,20,1521.163,1477.424,2011,13,0,0,0,1,0,2582
Chiefs,0,7,3,0,0,0,10,Bears,0,3,0,0,0,0,3,201113,0,4,7,7,13,-7,1404.957,1597.387,2011,13,0,0,0,0,0,410
Titans,10,7,3,3,0,0,23,Bills,7,3,0,7,0,0,17,201113,3,7,10,6,40,-6,1501.6,1435.847,2011,13,0,0,0,1,0,626
Eagles,0,7,0,7,0,0,14,Seahawks,7,10,7,7,0,0,31,201113,7,10,17,17,45,17,1505.803,1424.309,2011,13,0,0,0,1,0,2373
Giants,5,10,7,15,0,0,37,Cowboys,7,10,3,14,0,0,34,201114,-2,-2,2,3,71,-3,1498.148,1519.487,2011,14,0,0,0,1,1,1370
Bills,0,0,10,0,0,0,10,Chargers,7,9,14,7,0,0,37,201114,7,16,20,27,47,27,1416.437,1504.908,2011,14,0,0,0,1,0,2183
Raiders,0,0,7,9,0,0,16,Packers,14,17,12,3,0,0,46,201114,14,31,36,30,62,30,1492.852,1778.443,2011,14,0,0,0,0,0,1826
49ers,3,9,7,0,0,0,19,Cardinals,0,7,7,7,0,0,21,201114,-3,-5,-5,2,40,2,1599.782,1421.651,2011,14,0,0,0,1,1,652
Bears,0,0,7,3,0,0,10,Broncos,0,0,0,10,3,0,13,201114,0,0,-7,3,23,3,1559.007,1482.792,2011,14,0,0,0,0,0,916
Colts,0,3,0,7,0,0,10,Ravens,10,7,7,0,0,0,24,201114,10,14,21,14,34,14,1317.076,1659.113,2011,14,0,0,0,1,0,509
Buccaneers,7,7,0,0,0,0,14,Jaguars,0,28,0,13,0,0,41,201114,-7,14,14,27,55,27,1398.685,1381.317,2011,14,0,0,0,0,0,171
Rams,0,3,3,7,0,0,13,Seahawks,10,0,10,10,0,0,30,201114,10,7,14,17,43,17,1311.03,1454.813,2011,14,0,0,0,1,1,1720
Patriots,14,6,14,0,0,0,34,Washington,10,10,7,0,0,0,27,201114,4,0,7,7,61,-7,1711.473,1379.686,2011,14,0,0,0,0,0,385
Chiefs,3,0,0,7,0,0,10,Jets,7,21,7,2,0,0,37,201114,4,25,32,27,47,27,1443.337,1590.263,2011,14,0,0,0,1,0,1093
Eagles,0,24,0,2,0,0,26,Dolphins,7,0,3,0,0,0,10,201114,-7,17,14,16,36,-16,1475.3,1505.735,2011,14,0,0,0,0,0,1021
Saints,3,3,3,13,0,0,22,Titans,0,3,7,7,0,0,17,201114,3,3,-1,5,39,-5,1634.102,1521.011,2011,14,0,0,0,0,0,469
Vikings,7,7,7,7,0,0,28,Lions,21,10,0,3,0,0,34,201114,14,17,10,6,62,6,1387.09,1501.278,2011,14,0,0,0,1,1,542
Texans,3,0,7,10,0,0,20,Bengals,6,10,3,0,0,0,19,201114,-3,-13,-9,1,39,-1,1637.181,1514.782,2011,14,0,0,0,1,0,897
Browns,3,0,0,0,0,0,3,Steelers,7,0,0,7,0,0,14,201114,4,4,4,11,17,11,1390.254,1670.319,2011,14,0,0,0,1,1,114
Falcons,7,0,10,14,0,0,31,Panthers,7,16,0,0,0,0,23,201114,0,-16,-6,8,54,-8,1586.312,1408.802,2011,14,0,0,0,1,1,226
Steelers,0,0,3,0,0,0,3,49ers,3,3,7,7,0,0,20,201115,3,6,10,17,23,17,1675.502,1584.557,2011,15,0,0,0,0,0,2260
Ravens,0,7,0,7,0,0,14,Chargers,7,10,14,3,0,0,34,201115,7,10,24,20,48,20,1663.118,1523.128,2011,15,0,0,0,1,0,2291
Browns,7,3,7,0,0,0,17,Cardinals,0,7,0,10,3,0,20,201115,-7,-3,-10,3,37,3,1385.071,1436.876,2011,15,0,0,0,0,0,1745
Jets,0,13,0,6,0,0,19,Eagles,14,14,10,7,0,0,45,201115,14,15,25,26,64,26,1604.12,1512.853,2011,15,0,0,0,0,0,80
Patriots,7,20,7,7,0,0,41,Broncos,13,3,0,7,0,0,23,201115,-6,11,18,18,64,-18,1718.044,1497.175,2011,15,0,0,0,1,0,1769
Lions,7,7,0,14,0,0,28,Raiders,7,10,0,10,0,0,27,201115,0,-3,-3,1,55,-1,1510.736,1485.903,2011,15,0,0,0,0,0,2078
Panthers,7,14,0,7,0,0,28,Texans,0,0,6,7,0,0,13,201115,7,21,15,15,41,-15,1394.44,1642.83,2011,15,0,0,0,0,0,925
Washington,3,14,3,3,0,0,23,Giants,0,3,0,7,0,0,10,201115,3,14,17,13,33,-13,1373.115,1516.091,2011,15,0,0,0,1,1,204
Saints,7,14,14,7,0,0,42,Vikings,3,10,0,7,0,0,20,201115,4,8,22,22,62,-22,1649.224,1377.633,2011,15,0,0,0,1,0,1052
Packers,0,0,7,7,0,0,14,Chiefs,6,0,3,10,0,0,19,201115,6,6,2,5,33,5,1785.392,1429.481,2011,15,0,0,0,0,0,503
Titans,0,6,0,7,0,0,13,Colts,3,0,14,10,0,0,27,201115,3,-3,11,14,40,14,1505.888,1313.072,2011,15,0,0,0,1,1,251
Seahawks,7,0,17,14,0,0,38,Bears,7,7,0,0,0,0,14,201115,0,-7,10,24,52,-24,1467.016,1544.624,2011,15,0,0,0,1,0,1732
Dolphins,0,13,7,10,0,0,30,Bills,7,0,0,16,0,0,23,201115,-7,6,13,7,53,-7,1468.181,1398.217,2011,15,0,0,0,1,1,1184
Cowboys,14,14,3,0,0,0,31,Buccaneers,0,0,15,0,0,0,15,201115,14,28,16,16,46,-16,1501.544,1370.513,2011,15,0,0,0,1,0,916
Jaguars,0,0,7,7,0,0,14,Falcons,10,17,14,0,0,0,41,201115,10,27,34,27,55,27,1409.489,1600.674,2011,15,0,0,0,0,0,285
Bengals,3,0,10,7,0,0,20,Rams,0,6,0,7,0,0,13,201115,3,-3,7,7,33,-7,1509.133,1298.826,2011,15,0,0,0,0,0,310
Buccaneers,0,10,0,6,0,0,16,Panthers,10,10,21,7,0,0,48,201116,10,10,31,32,64,32,1348.172,1449.962,2011,16,0,0,0,1,1,511
Bears,0,3,7,11,0,0,21,Packers,7,7,14,7,0,0,35,201116,7,11,18,14,56,14,1496.819,1750.613,2011,16,0,0,0,1,1,185
49ers,0,3,10,6,0,0,19,Seahawks,7,3,0,7,0,0,17,201116,-7,-7,3,2,36,-2,1615.985,1514.821,2011,16,0,0,0,1,1,679
Eagles,7,7,3,3,0,0,20,Cowboys,0,0,0,7,0,0,7,201116,7,14,17,13,27,-13,1548.727,1523.885,2011,16,0,0,0,1,1,1297
Chargers,0,0,10,0,0,0,10,Lions,10,14,7,7,0,0,38,201116,10,24,21,28,48,28,1561.347,1518.609,2011,16,0,0,0,0,0,1968
Falcons,10,0,3,3,0,0,16,Saints,7,14,10,14,0,0,45,201116,-3,11,18,29,61,29,1611.79,1662.604,2011,16,0,0,0,1,1,424
Browns,0,0,7,7,0,0,14,Ravens,10,7,3,0,0,0,20,201116,10,17,13,6,34,6,1376.173,1624.899,2011,16,0,0,0,1,1,307
Vikings,3,7,13,10,0,0,33,Washington,0,10,10,6,0,0,26,201116,3,0,3,7,59,-7,1364.253,1417.885,2011,16,0,0,0,1,0,931
Raiders,3,0,7,3,3,0,16,Chiefs,3,0,3,7,0,0,13,201116,0,0,4,3,29,-3,1478.03,1464.26,2011,16,0,0,0,1,1,1495
Giants,0,10,7,12,0,0,29,Jets,7,0,0,7,0,0,14,201116,-7,3,10,15,43,-15,1471.321,1568.246,2011,16,0,0,0,0,0,0
Dolphins,3,14,0,7,0,0,24,Patriots,0,0,17,10,0,0,27,201116,-3,-17,0,3,51,3,1488.632,1733.97,2011,16,0,0,0,1,1,1241
Jaguars,7,3,0,7,0,0,17,Titans,10,7,3,3,0,0,23,201116,3,7,10,6,40,6,1398.372,1467.013,2011,16,0,0,0,1,1,500
Cardinals,0,0,0,16,0,0,16,Bengals,10,10,3,0,0,0,23,201116,10,20,23,7,39,7,1445.774,1520.926,2011,16,0,0,0,0,0,1580
Broncos,7,0,7,0,0,0,14,Bills,0,17,6,17,0,0,40,201116,-7,10,9,26,54,26,1481.249,1377.766,2011,16,0,0,0,1,0,1366
Texans,10,0,3,3,0,0,16,Colts,3,3,3,10,0,0,19,201116,-7,-4,-4,3,35,3,1587.308,1351.947,2011,16,0,0,0,1,1,865
Rams,0,0,0,0,0,0,0,Steelers,3,7,3,14,0,0,27,201116,3,10,13,27,27,27,1287.034,1644.073,2011,16,0,0,0,0,0,557
Cowboys,0,0,7,7,0,0,14,Giants,7,14,0,10,0,0,31,201117,7,21,14,17,45,17,1493.91,1514.269,2011,17,0,0,0,1,1,1370
Seahawks,0,3,7,10,0,0,20,Cardinals,7,3,7,3,3,0,23,201117,7,7,7,3,43,3,1505.133,1433.709,2011,17,0,0,0,1,1,1114
Chiefs,7,0,0,0,0,0,7,Broncos,0,0,3,0,0,0,3,201117,7,7,4,4,10,-4,1447.988,1444.003,2011,17,0,0,0,1,1,556
Steelers,0,3,10,0,0,0,13,Browns,0,6,3,0,0,0,9,201117,0,-3,4,4,22,-4,1648.6,1371.366,2011,17,0,0,0,1,1,114
Ravens,10,7,0,7,0,0,24,Bengals,3,0,7,6,0,0,16,201117,7,14,7,8,40,-8,1629.706,1532.991,2011,17,0,0,0,1,1,419
Buccaneers,0,7,11,6,0,0,24,Falcons,21,21,0,3,0,0,45,201117,21,35,24,21,69,21,1330.176,1589.868,2011,17,0,0,0,1,1,416
Titans,0,13,3,7,0,0,23,Texans,7,3,3,9,0,0,22,201117,-7,3,3,1,45,-1,1478.63,1565.452,2011,17,0,0,0,1,1,665
Chargers,7,17,7,7,0,0,38,Raiders,7,6,6,7,0,0,26,201117,0,11,12,12,64,-12,1530.144,1494.301,2011,17,0,0,0,1,1,454
Washington,0,0,7,3,0,0,10,Eagles,3,7,3,21,0,0,34,201117,3,10,6,24,44,24,1388.679,1578.701,2011,17,0,0,0,1,1,123
Panthers,7,10,0,0,0,0,17,Saints,14,10,14,7,0,0,45,201117,7,7,21,28,62,28,1467.958,1684.526,2011,17,0,0,0,1,1,648
Bills,21,0,0,0,0,0,21,Patriots,0,14,14,21,0,0,49,201117,-21,-7,7,28,70,28,1415.011,1737.457,2011,17,0,0,0,1,1,404
Bears,0,14,0,3,0,0,17,Vikings,10,3,0,0,0,0,13,201117,-10,1,1,4,30,-4,1490.309,1393.459,2011,17,0,0,0,1,1,355
Jets,7,3,0,7,0,0,17,Dolphins,3,3,0,13,0,0,19,201117,-4,-4,-4,2,36,2,1525.298,1485.145,2011,17,0,0,0,1,1,1091
49ers,7,13,7,7,0,0,34,Rams,7,0,3,17,0,0,27,201117,0,13,17,7,61,-7,1625.673,1282.507,2011,17,0,0,0,1,1,1741
Lions,9,10,15,7,0,0,41,Packers,10,14,7,14,0,0,45,201117,1,5,-3,4,86,4,1549.811,1757.124,2011,17,0,0,0,1,1,291
Colts,0,3,3,7,0,0,13,Jaguars,7,3,6,3,0,0,19,201117,7,7,10,6,32,6,1373.803,1386.755,2011,17,0,0,0,1,1,699
Bengals,7,3,0,0,0,0,10,Texans,7,10,7,7,0,0,31,201118,0,7,14,21,41,21,1513.302,1554.946,2011,18,1,0,0,1,0,897
Lions,7,7,7,7,0,0,28,Saints,0,10,14,21,0,0,45,201118,-7,-4,3,17,73,17,1544.868,1694.383,2011,18,1,0,0,1,0,939
Falcons,0,2,0,0,0,0,2,Giants,0,7,10,7,0,0,24,201118,0,5,15,22,26,22,1597.067,1535.392,2011,18,1,0,0,1,0,745
Steelers,6,0,7,10,0,0,23,Broncos,0,20,0,3,6,0,29,201118,-6,14,7,6,52,6,1655.282,1424.572,2011,18,1,0,0,1,0,1317
Giants,10,10,0,17,0,0,37,Packers,3,7,3,7,0,0,20,201119,7,10,7,17,57,-17,1566.4,1762.067,2011,19,1,0,1,1,0,758
Texans,3,10,0,0,0,0,13,Ravens,17,0,0,3,0,0,20,201119,14,4,4,7,33,7,1575.652,1649.394,2011,19,1,0,1,1,0,1250
Saints,0,14,0,18,0,0,32,49ers,14,3,3,16,0,0,36,201119,14,3,6,4,68,4,1706.252,1631.868,2011,19,1,0,1,1,0,1921
Broncos,0,7,3,0,0,0,10,Patriots,14,21,7,3,0,0,45,201119,14,28,32,35,55,35,1454.956,1743.015,2011,19,1,0,1,1,0,1769
Ravens,0,10,10,0,0,0,20,Patriots,3,10,3,7,0,0,23,201120,3,3,-4,3,43,3,1661.534,1750.17,2011,20,1,0,0,1,0,350
Giants,0,10,0,7,3,0,20,49ers,7,0,7,3,0,0,17,201120,-7,3,-4,3,37,-3,1620.019,1648.468,2011,20,1,0,0,1,0,2565
Giants,9,0,6,6,0,0,21,Patriots,0,10,7,0,0,0,17,201122,9,-1,-2,4,38,-4,1757.744,1638.3,2011,22,1,1,1,0,0,181
Dolphins,3,0,7,0,0,0,10,Texans,0,24,3,3,0,0,30,201201,-3,21,17,20,40,20,1498.489,1544.008,2012,1,0,0,0,1,0,966
Chargers,3,7,6,6,0,0,22,Raiders,3,3,0,8,0,0,14,201201,0,4,10,8,36,-8,1540.543,1479.087,2012,1,0,0,0,1,1,454
Steelers,0,10,3,6,0,0,19,Broncos,0,7,7,17,0,0,31,201201,0,-3,1,12,50,12,1584.932,1466.868,2012,1,0,0,0,1,0,1317
Panthers,0,0,7,3,0,0,10,Buccaneers,10,3,0,3,0,0,16,201201,10,13,6,6,26,6,1473.735,1383.651,2012,1,0,0,0,1,1,511
Seahawks,3,0,10,3,0,0,16,Cardinals,3,7,3,7,0,0,20,201201,0,7,0,4,36,4,1495.649,1466.913,2012,1,0,0,0,1,1,1114
49ers,3,13,7,7,0,0,30,Packers,0,7,0,15,0,0,22,201201,3,9,16,8,52,-8,1588.458,1640.631,2012,1,0,0,0,1,0,1834
Bills,0,7,7,14,0,0,28,Jets,7,20,14,7,0,0,48,201201,7,20,27,20,76,20,1441.302,1511.807,2012,1,0,0,0,1,1,292
Bengals,0,10,3,0,0,0,13,Ravens,10,7,17,10,0,0,44,201201,10,7,21,31,57,31,1496.731,1604.306,2012,1,0,0,0,1,1,419
Jaguars,3,6,3,11,0,0,23,Vikings,0,7,7,9,3,0,26,201201,-3,-2,2,3,49,3,1435.934,1421.03,2012,1,0,0,0,0,0,1192
Falcons,10,10,14,6,0,0,40,Chiefs,3,14,0,7,0,0,24,201201,7,3,17,16,64,-16,1545.706,1479.946,2012,1,0,0,0,0,0,675
Patriots,7,14,7,6,0,0,34,Titans,3,0,7,3,0,0,13,201201,4,18,18,21,47,-21,1658.397,1494.424,2012,1,0,0,0,1,0,936
Rams,3,10,0,10,0,0,23,Lions,0,10,3,14,0,0,27,201201,-3,-3,0,4,50,4,1352.541,1523.667,2012,1,0,0,0,1,0,454
Eagles,0,10,0,7,0,0,17,Browns,3,0,3,10,0,0,16,201201,-3,7,4,1,33,-1,1561.336,1411.456,2012,1,0,0,0,0,0,358
Colts,7,7,0,7,0,0,21,Bears,7,17,10,7,0,0,41,201201,0,10,20,20,62,20,1407.771,1504.815,2012,1,0,0,0,0,0,163
Cowboys,0,7,10,7,0,0,24,Giants,0,3,7,7,0,0,17,201201,0,4,7,7,41,-7,1483.525,1608.966,2012,1,0,0,0,1,1,1370
Washington,10,10,10,10,0,0,40,Saints,7,7,3,15,0,0,32,201201,3,6,13,8,72,-8,1420.251,1628.101,2012,1,0,0,0,1,0,964
Lions,6,0,3,10,0,0,19,49ers,7,7,3,10,0,0,27,201202,1,8,8,8,46,8,1529.607,1619.21,2012,2,0,0,0,1,0,2087
Titans,0,3,7,0,0,0,10,Chargers,14,3,7,14,0,0,38,201202,14,14,14,28,48,28,1473.05,1562.775,2012,2,0,0,0,1,0,1739
Jets,7,3,0,0,0,0,10,Steelers,3,10,7,7,0,0,27,201202,-4,3,10,17,37,17,1529.835,1554.666,2012,2,0,0,0,1,0,314
Cowboys,0,7,0,0,0,0,7,Seahawks,10,3,7,7,0,0,27,201202,10,6,13,20,34,20,1517.653,1481.462,2012,2,0,0,0,1,0,1679
Washington,14,7,7,0,0,0,28,Rams,3,13,7,8,0,0,31,201202,-11,-5,-5,3,59,3,1461.783,1346.6,2012,2,0,0,0,1,0,708
Texans,10,7,7,3,0,0,27,Jaguars,0,0,7,0,0,0,7,201202,10,17,17,20,34,-20,1564.074,1424.321,2012,2,0,0,0,1,1,820
Saints,10,3,0,14,0,0,27,Panthers,7,14,7,7,0,0,35,201202,-3,8,15,8,62,8,1586.57,1452.632,2012,2,0,0,0,1,1,648
Broncos,0,7,0,14,0,0,21,Falcons,10,10,7,0,0,0,27,201202,10,13,20,6,48,6,1497.134,1573.966,2012,2,0,0,0,0,0,1209
Buccaneers,3,21,3,7,0,0,34,Giants,6,7,3,25,0,0,41,201202,3,-11,-11,7,75,7,1404.753,1574.838,2012,2,0,0,0,1,0,1004
Cardinals,6,0,7,7,0,0,20,Patriots,3,3,3,9,0,0,18,201202,3,0,4,2,38,-2,1481.1,1679.771,2012,2,0,0,0,0,0,2296
Raiders,7,3,0,3,0,0,13,Dolphins,7,0,14,14,0,0,35,201202,0,-3,11,22,48,22,1456.855,1478.422,2012,2,0,0,0,1,0,2582
Vikings,3,3,0,14,0,0,20,Colts,7,10,3,3,0,0,23,201202,4,11,14,3,43,3,1432.643,1391.758,2012,2,0,0,0,0,0,510
Browns,3,7,7,10,0,0,27,Bengals,7,10,7,10,0,0,34,201202,4,7,7,7,61,7,1406.38,1479.362,2012,2,0,0,0,1,1,217
Chiefs,0,0,3,14,0,0,17,Bills,7,14,14,0,0,0,35,201202,7,21,32,18,52,18,1451.686,1423.274,2012,2,0,0,0,1,0,858
Bears,0,0,3,7,0,0,10,Packers,0,13,0,10,0,0,23,201202,0,13,10,13,33,13,1520.829,1609.88,2012,2,0,0,0,1,1,185
Ravens,7,10,0,6,0,0,23,Eagles,7,0,10,7,0,0,24,201202,0,-10,0,1,47,1,1621.675,1566.411,2012,2,0,0,0,0,0,89
Packers,0,0,6,6,0,0,12,Seahawks,0,7,0,7,0,0,14,201203,0,7,1,2,26,2,1624.272,1509.027,2012,3,0,0,0,1,0,1645
Patriots,13,7,7,3,0,0,30,Ravens,0,14,7,10,0,0,31,201203,-13,-6,-6,1,61,1,1659.295,1614.968,2012,3,0,0,0,1,0,350
Steelers,14,3,14,0,0,0,31,Raiders,7,7,7,13,0,0,34,201203,-7,-3,-10,3,65,3,1575.411,1434.052,2012,3,0,0,0,1,0,2251
Texans,7,14,10,0,0,0,31,Broncos,5,6,0,14,0,0,25,201203,2,10,20,6,56,-6,1587.28,1485.928,2012,3,0,0,0,1,0,878
Falcons,6,14,0,7,0,0,27,Chargers,0,0,3,0,0,0,3,201203,6,20,17,24,30,-24,1585.173,1581.083,2012,3,0,0,0,0,0,1887
Eagles,0,0,6,0,0,0,6,Cardinals,10,14,0,3,0,0,27,201203,10,24,18,21,33,21,1573.118,1501.576,2012,3,0,0,0,1,0,2078
Bengals,14,10,0,14,0,0,38,Washington,7,3,14,7,0,0,31,201203,7,14,0,7,69,-7,1491.543,1445.561,2012,3,0,0,0,0,0,398
Chiefs,3,3,7,11,3,0,27,Saints,7,3,14,0,0,0,24,201203,-4,-4,-11,3,51,-3,1425.762,1559.444,2012,3,0,0,0,0,0,681
49ers,0,3,10,0,0,0,13,Vikings,7,10,0,7,0,0,24,201203,7,14,4,11,37,11,1631.163,1419.881,2012,3,0,0,0,1,0,1581
Jaguars,3,0,10,9,0,0,22,Colts,7,7,0,3,0,0,17,201203,-4,-11,-1,5,39,-5,1401.115,1404.52,2012,3,0,0,0,1,1,699
Lions,6,3,7,25,0,0,41,Titans,10,10,0,21,3,0,44,201203,4,11,4,3,85,3,1517.654,1454.742,2012,3,0,0,0,0,0,470
Buccaneers,7,0,0,3,0,0,10,Cowboys,7,3,0,6,0,0,16,201203,0,3,3,6,26,6,1397.037,1490.087,2012,3,0,0,0,1,0,916
Bills,14,0,3,7,0,0,24,Browns,0,7,7,0,0,0,14,201203,14,7,3,10,38,-10,1449.198,1394.2,2012,3,0,0,0,1,0,173
Rams,0,3,3,0,0,0,6,Bears,3,7,0,13,0,0,23,201203,3,7,4,17,29,17,1362.822,1506.436,2012,3,0,0,0,1,0,260
Giants,10,10,6,10,0,0,36,Panthers,0,0,7,0,0,0,7,201203,10,20,19,29,43,-29,1582.554,1479.758,2012,3,0,0,0,1,0,531
Jets,0,3,7,10,3,0,23,Dolphins,7,3,7,3,0,0,20,201203,-7,-7,-7,3,43,-3,1509.089,1501.225,2012,3,0,0,0,1,1,1091
Dolphins,0,13,0,8,0,0,21,Cardinals,0,0,7,14,3,0,24,201204,0,-13,-6,3,45,3,1484.673,1533.162,2012,4,0,0,0,0,0,1978
Bears,0,10,14,10,0,0,34,Cowboys,0,7,3,8,0,0,18,201204,0,3,14,16,52,-16,1518.65,1500.509,2012,4,0,0,0,1,0,802
Giants,0,3,7,7,0,0,17,Eagles,0,7,6,6,0,0,19,201204,0,4,3,2,36,2,1612.368,1541.532,2012,4,0,0,0,1,1,80
Washington,7,14,0,3,0,0,24,Buccaneers,3,3,7,9,0,0,22,201204,4,15,8,2,46,-2,1423.438,1386.615,2012,4,0,0,0,1,0,818
Saints,7,7,10,3,0,0,27,Packers,7,14,0,7,0,0,28,201204,0,7,-3,1,55,1,1536.331,1611.415,2012,4,0,0,0,1,0,1012
Bengals,3,14,0,10,0,0,27,Jaguars,0,7,3,0,0,0,10,201204,3,10,7,17,37,-17,1513.665,1423.203,2012,4,0,0,0,1,0,630
Raiders,3,3,0,0,0,0,6,Broncos,10,0,21,6,0,0,37,201204,7,4,25,31,43,31,1451.52,1468.781,2012,4,0,0,0,1,1,939
Chargers,17,10,0,10,0,0,37,Chiefs,0,6,7,7,0,0,20,201204,17,21,14,17,57,-17,1542.233,1448.876,2012,4,0,0,0,1,1,1334
49ers,0,10,7,17,0,0,34,Jets,0,0,0,0,0,0,0,201204,0,10,17,34,34,-34,1593.955,1525.642,2012,4,0,0,0,0,0,2565
Seahawks,7,0,3,3,0,0,13,Rams,3,10,3,3,0,0,19,201204,-4,6,6,6,32,6,1521.885,1350.608,2012,4,0,0,0,1,1,1720
Titans,0,7,0,7,0,0,14,Texans,14,0,14,10,0,0,38,201204,14,7,21,24,52,24,1468.508,1604.427,2012,4,0,0,0,1,1,665
Vikings,10,3,7,0,0,0,20,Lions,3,3,0,7,0,0,13,201204,7,7,14,7,33,-7,1457.089,1503.887,2012,4,0,0,0,1,1,542
Patriots,7,0,14,31,0,0,52,Bills,0,14,7,7,0,0,28,201204,7,-7,0,24,80,-24,1652.836,1473.98,2012,4,0,0,0,1,1,404
Panthers,7,7,7,7,0,0,28,Falcons,7,10,7,6,0,0,30,201204,0,3,3,2,58,2,1449.944,1624.024,2012,4,0,0,0,1,1,226
Browns,0,7,3,6,0,0,16,Ravens,0,9,14,0,0,0,23,201204,0,2,13,7,39,7,1369.418,1621.426,2012,4,0,0,0,1,1,307
Chargers,7,10,7,0,0,0,24,Saints,7,7,7,10,0,0,31,201205,0,-3,-3,7,55,7,1568.445,1532.308,2012,5,0,0,0,0,0,1605
Bills,0,3,0,0,0,0,3,49ers,3,14,7,21,0,0,45,201205,3,14,21,42,48,42,1453.06,1629.116,2012,5,0,0,0,0,0,2294
Broncos,0,7,7,7,0,0,21,Patriots,7,10,14,0,0,0,31,201205,7,10,17,10,52,10,1494.423,1673.756,2012,5,0,0,0,1,0,1769
Titans,0,0,0,7,0,0,7,Vikings,7,6,10,7,0,0,30,201205,7,13,23,23,37,23,1454.393,1485.812,2012,5,0,0,0,0,0,696
Bears,3,0,10,28,0,0,41,Jaguars,0,3,0,0,0,0,3,201205,3,0,10,38,44,-38,1551.48,1396.72,2012,5,0,0,0,0,0,862
Seahawks,3,3,7,3,0,0,16,Panthers,0,3,7,2,0,0,12,201205,3,3,3,4,28,-4,1495.372,1445.948,2012,5,0,0,0,1,0,2280
Texans,7,10,6,0,0,0,23,Jets,7,0,7,3,0,0,17,201205,0,10,9,6,40,-6,1618.543,1490.48,2012,5,0,0,0,1,0,1417
Eagles,0,0,7,7,0,0,14,Steelers,0,10,0,6,0,0,16,201205,0,10,3,2,30,2,1552.732,1557.943,2012,5,0,0,1,0,0,257
Browns,14,3,3,7,0,0,27,Giants,7,20,7,7,0,0,41,201205,-7,10,14,14,68,14,1364.371,1601.168,2012,5,0,0,0,0,0,403
Ravens,3,0,6,0,0,0,9,Chiefs,0,3,0,3,0,0,6,201205,3,0,6,3,15,-3,1626.474,1422.664,2012,5,0,0,0,1,0,960
Packers,7,14,0,6,0,0,27,Colts,0,3,16,11,0,0,30,201205,-7,-18,-2,3,57,3,1615.437,1382.433,2012,5,0,0,1,0,0,341
Dolphins,0,7,10,0,0,0,17,Bengals,6,0,0,7,0,0,13,201205,-6,1,11,4,30,-4,1475.649,1540.148,2012,5,0,0,0,1,0,957
Cardinals,3,0,0,0,0,0,3,Rams,7,3,0,7,0,0,17,201205,4,7,7,14,20,14,1542.186,1377.121,2012,5,0,0,0,1,1,1270
Falcons,0,7,0,17,0,0,24,Washington,0,7,3,7,0,0,17,201205,0,0,-3,7,41,-7,1628.019,1435.468,2012,5,0,0,0,1,0,541
Broncos,0,0,14,21,0,0,35,Chargers,10,14,0,0,0,0,24,201206,-10,-24,-10,11,59,-11,1485.929,1549.621,2012,6,0,0,0,1,1,832
Packers,14,7,7,14,0,0,42,Texans,0,10,7,7,0,0,24,201206,14,11,11,18,66,-18,1593.688,1634.063,2012,6,0,0,0,0,0,1095
Vikings,9,0,3,14,0,0,26,Washington,0,17,7,14,0,0,38,201206,-9,8,12,12,64,12,1508.02,1422.721,2012,6,0,0,0,1,0,931
Giants,0,10,13,3,0,0,26,49ers,3,0,0,0,0,0,3,201206,-3,7,20,23,29,-23,1608.295,1642.661,2012,6,0,0,0,1,0,2565
Patriots,7,10,3,3,0,0,23,Seahawks,10,0,0,14,0,0,24,201206,3,-7,-10,1,47,1,1682.25,1512.307,2012,6,0,0,0,0,0,2495
Bills,9,0,7,0,3,0,19,Cardinals,3,7,3,3,0,0,16,201206,6,-1,3,3,35,-3,1439.515,1505.863,2012,6,0,0,0,0,0,1902
Cowboys,7,3,10,9,0,0,29,Ravens,3,14,7,7,0,0,31,201206,-4,7,4,2,60,2,1467.68,1634.565,2012,6,0,1,0,0,0,1210
Chiefs,0,3,0,7,0,0,10,Buccaneers,7,0,14,17,0,0,38,201206,7,4,18,28,48,28,1414.573,1374.586,2012,6,0,0,1,0,0,1037
Colts,3,3,0,3,0,0,9,Jets,0,21,7,7,0,0,35,201206,-3,15,22,26,44,26,1404.183,1474.96,2012,6,0,0,0,1,0,643
Rams,6,0,0,8,0,0,14,Dolphins,0,10,7,0,0,0,17,201206,-6,4,11,3,31,3,1413.445,1498.845,2012,6,0,0,0,0,0,1061
Bengals,7,7,0,10,0,0,24,Browns,0,7,6,21,0,0,34,201206,-7,-7,-1,10,58,10,1516.953,1357.243,2012,6,0,0,0,1,1,217
Raiders,3,10,0,7,0,0,20,Falcons,0,7,6,10,0,0,23,201206,-3,-6,0,3,43,3,1425.877,1640.766,2012,6,0,1,0,0,0,2127
Steelers,10,0,3,10,0,0,23,Titans,6,10,0,10,0,0,26,201206,-4,6,3,3,49,3,1566.467,1432.185,2012,6,0,0,0,1,0,471
Lions,6,0,0,17,3,0,26,Eagles,0,7,6,10,0,0,23,201206,6,-1,-7,3,49,-3,1475.164,1544.209,2012,6,0,1,0,1,0,441
Cowboys,0,3,10,6,0,0,19,Panthers,0,7,0,7,0,0,14,201207,0,-4,6,5,33,-5,1463.538,1429.013,2012,7,0,0,1,1,0,928
Steelers,3,11,3,7,0,0,24,Bengals,7,7,3,0,0,0,17,201207,-4,0,0,7,41,-7,1549.336,1485.229,2012,7,0,0,0,1,1,252
Jets,7,3,3,13,0,0,26,Patriots,14,2,7,3,3,0,29,201207,7,6,10,3,55,3,1494.453,1672.837,2012,7,0,0,0,1,1,181
Jaguars,7,10,3,3,0,0,23,Raiders,3,3,7,10,3,0,26,201207,-4,-11,-7,3,49,3,1370.417,1421.784,2012,7,0,1,0,1,0,2361
Ravens,3,0,7,3,0,0,13,Texans,9,20,7,7,0,0,43,201207,6,26,26,30,56,30,1638.706,1594.035,2012,7,0,0,0,1,0,1250
Saints,7,21,0,7,0,0,35,Buccaneers,14,7,0,7,0,0,28,201207,-7,7,7,7,63,-7,1551.132,1405.487,2012,7,0,1,0,1,1,480
Lions,0,0,0,7,0,0,7,Bears,10,0,3,0,0,0,13,201207,10,10,13,6,20,6,1495.355,1577.782,2012,7,0,0,1,1,1,238
Cardinals,0,7,0,7,0,0,14,Vikings,7,7,7,0,0,0,21,201207,7,7,14,7,35,7,1485.797,1480.62,2012,7,0,0,0,1,0,1278
Packers,10,0,7,13,0,0,30,Rams,3,3,0,14,0,0,20,201207,7,4,11,10,50,-10,1633.716,1405.76,2012,7,0,0,0,1,0,422
Browns,0,6,7,0,0,0,13,Colts,7,7,3,0,0,0,17,201207,7,8,4,4,30,4,1388.967,1384.689,2012,7,0,0,0,1,0,262
Titans,14,7,7,7,0,0,35,Bills,14,6,14,0,0,0,34,201207,0,1,-6,1,69,-1,1449.316,1459.581,2012,7,0,0,0,1,0,626
Seahawks,3,3,0,0,0,0,6,49ers,3,0,7,3,0,0,13,201207,0,-3,4,7,19,7,1521.72,1600.109,2012,7,0,0,0,1,1,679
Washington,3,10,0,10,0,0,23,Giants,0,13,0,14,0,0,27,201207,-3,0,0,4,50,4,1450.12,1650.847,2012,7,0,0,0,1,1,204
49ers,7,10,7,0,0,0,24,Cardinals,0,0,3,0,0,0,3,201208,7,17,21,21,27,-21,1612.003,1469.005,2012,8,0,0,0,1,1,652
Saints,0,7,0,7,0,0,14,Broncos,7,10,7,10,0,0,34,201208,7,10,17,20,48,20,1566.617,1521.674,2012,8,0,0,1,0,0,1079
Giants,13,10,0,6,0,0,29,Cowboys,0,10,14,0,0,0,24,201208,13,13,-1,5,53,-5,1655.96,1483.297,2012,8,0,0,0,1,1,1370
Raiders,3,10,10,3,0,0,26,Chiefs,0,6,3,7,0,0,16,201208,3,7,14,10,42,-10,1430.698,1383.671,2012,8,0,0,1,1,1,1495
Washington,0,6,3,3,0,0,12,Steelers,10,10,7,0,0,0,27,201208,10,14,18,15,39,15,1445.007,1570.193,2012,8,0,0,0,0,0,190
Falcons,14,10,3,3,0,0,30,Eagles,0,7,3,7,0,0,17,201208,14,17,17,13,47,-13,1644.859,1524.017,2012,8,0,1,1,1,0,665
Dolphins,10,10,7,3,0,0,30,Jets,0,0,3,6,0,0,9,201208,10,20,24,21,39,-21,1506.53,1489.519,2012,8,0,1,0,1,1,1091
Patriots,7,21,10,7,0,0,45,Rams,7,0,0,0,0,0,7,201208,0,21,31,38,52,-38,1393.2,1677.772,2012,8,0,0,0,0,0,1035
Colts,3,0,3,7,6,0,19,Titans,3,7,0,3,0,0,13,201208,0,-7,-4,6,32,-6,1397.642,1458.024,2012,8,0,0,0,1,1,251
Jaguars,3,9,0,3,0,0,15,Packers,7,7,0,10,0,0,24,201208,4,2,2,9,39,9,1361.503,1646.276,2012,8,0,0,0,0,0,1039
Seahawks,3,14,0,7,0,0,24,Lions,7,7,0,14,0,0,28,201208,4,-3,-3,4,52,4,1509.826,1484.423,2012,8,0,0,0,1,0,1933
Chargers,0,3,3,0,0,0,6,Browns,7,0,0,0,0,0,7,201208,7,4,1,1,13,1,1513.876,1376.015,2012,8,0,1,0,1,0,2030
Panthers,3,10,6,3,0,0,22,Bears,7,0,0,16,0,0,23,201208,4,-6,-12,1,45,1,1409.254,1588.714,2012,8,0,0,0,1,0,586
Buccaneers,10,10,10,6,0,0,36,Vikings,0,10,7,0,0,0,17,201208,10,10,13,19,53,-19,1390.003,1497.413,2012,8,0,0,0,1,0,1318
Eagles,0,3,10,0,0,0,13,Saints,7,14,7,0,0,0,28,201209,7,18,15,15,41,15,1502.382,1538.186,2012,9,0,0,0,1,0,1088
Cowboys,6,0,0,7,0,0,13,Falcons,0,6,0,13,0,0,19,201209,-6,0,0,6,32,6,1471.345,1666.495,2012,9,0,0,0,1,0,719
Steelers,0,10,0,14,0,0,24,Giants,0,14,6,0,0,0,20,201209,0,-4,-10,4,44,-4,1582.989,1667.912,2012,9,0,0,0,0,0,314
Vikings,7,10,3,0,0,0,20,Seahawks,14,6,7,3,0,0,30,201209,7,3,7,10,50,10,1449.983,1495.811,2012,9,0,0,0,1,0,1391
Buccaneers,0,7,21,14,0,0,42,Raiders,3,7,0,22,0,0,32,201209,-3,-3,18,10,74,-10,1437.432,1456.124,2012,9,0,0,0,0,0,2388
Bills,0,6,3,0,0,0,9,Texans,7,0,7,7,0,0,21,201209,7,1,5,12,30,12,1450.873,1626.072,2012,9,0,1,1,1,0,1285
Lions,0,21,0,10,0,0,31,Jaguars,0,0,0,14,0,0,14,201209,0,21,21,17,45,-17,1498.439,1356.822,2012,9,0,0,0,0,0,832
Dolphins,3,14,0,3,0,0,20,Colts,7,6,7,3,0,0,23,201209,4,-4,3,3,43,3,1542.467,1425.416,2012,9,0,0,0,1,0,1026
Bears,28,3,6,14,0,0,51,Titans,2,3,7,8,0,0,20,201209,26,26,25,31,71,-31,1591.168,1430.249,2012,9,0,0,0,0,0,395
Cardinals,0,7,10,0,0,0,17,Packers,7,14,10,0,0,0,31,201209,7,14,14,14,48,14,1445.744,1650.956,2012,9,0,0,0,1,0,1492
Ravens,14,0,0,11,0,0,25,Browns,0,9,3,3,0,0,15,201209,14,5,2,10,40,-10,1606.669,1384.665,2012,9,0,1,0,1,1,307
Broncos,3,7,7,14,0,0,31,Bengals,0,3,10,10,0,0,23,201209,3,7,4,8,54,-8,1550.105,1464.372,2012,9,0,0,1,1,0,1093
Chiefs,0,3,3,7,0,0,13,Chargers,7,3,0,21,0,0,31,201209,7,7,4,18,44,18,1358.245,1505.225,2012,9,0,0,0,1,1,1334
Panthers,7,7,0,7,0,0,21,Washington,3,0,3,7,0,0,13,201209,4,11,8,8,34,-8,1406.8,1432.21,2012,9,0,0,0,1,0,329
Chargers,14,7,0,3,0,0,24,Buccaneers,7,10,7,10,0,0,34,201210,-7,-4,3,10,58,10,1517.466,1468.25,2012,10,0,0,0,0,0,2085
Chiefs,7,3,0,3,0,0,13,Steelers,0,10,0,3,3,0,16,201210,-7,0,0,3,29,3,1346.004,1607.283,2012,10,0,0,0,1,0,779
Texans,3,7,0,3,0,0,13,Bears,0,3,3,0,0,0,6,201210,3,7,4,7,19,-7,1635.349,1615.435,2012,10,0,0,0,0,0,939
Rams,14,0,3,7,0,0,24,49ers,0,7,0,17,0,0,24,201210,14,7,10,0,48,0,1382.642,1635.263,2012,10,0,1,1,1,1,1741
Cowboys,7,3,7,21,0,0,38,Eagles,7,0,10,6,0,0,23,201210,0,3,0,15,61,-15,1464.984,1483.354,2012,10,0,0,0,1,1,1297
Jets,7,0,0,0,0,0,7,Seahawks,7,7,0,14,0,0,28,201210,0,7,7,21,35,21,1453.582,1511.595,2012,10,0,1,0,0,0,2401
Raiders,0,10,7,3,0,0,20,Ravens,10,17,21,7,0,0,55,201210,10,17,31,35,75,35,1425.306,1619.574,2012,10,0,0,0,1,0,2442
Bills,0,17,7,7,0,0,31,Patriots,10,14,7,6,0,0,37,201210,10,7,7,6,68,6,1441.597,1688.329,2012,10,0,0,1,1,1,404
Falcons,10,7,0,10,0,0,27,Saints,7,14,7,3,0,0,31,201210,-3,4,11,4,58,4,1672.857,1557.214,2012,10,0,0,0,1,1,424
Lions,0,3,7,14,0,0,24,Vikings,10,3,3,18,0,0,34,201210,10,10,6,10,58,10,1520.309,1434.199,2012,10,0,0,0,1,1,542
Titans,14,10,7,6,0,0,37,Dolphins,0,3,0,0,0,0,3,201210,14,21,28,34,40,-34,1405.982,1526.156,2012,10,0,0,0,1,0,816
Giants,3,3,0,7,0,0,13,Bengals,14,3,14,0,0,0,31,201210,11,11,25,18,44,18,1643.618,1443.903,2012,10,0,0,0,0,0,563
Colts,3,14,7,3,0,0,27,Jaguars,0,3,0,7,0,0,10,201210,3,14,21,17,37,-17,1441.727,1334.952,2012,10,0,0,0,1,1,699
Broncos,7,10,7,12,0,0,36,Panthers,7,0,0,7,0,0,14,201210,0,10,17,22,50,-22,1570.575,1435.546,2012,10,0,0,0,0,0,1355
Saints,14,7,14,3,0,0,38,Raiders,0,7,3,7,0,0,17,201211,14,14,25,21,55,-21,1576.072,1413.537,2012,11,0,0,0,0,0,1914
Chargers,7,0,9,7,0,0,23,Broncos,0,17,7,6,0,0,30,201211,-7,10,8,7,53,7,1494.739,1594.919,2012,11,0,0,0,1,1,832
Jaguars,7,10,10,7,3,0,37,Texans,7,10,3,14,9,0,43,201211,0,0,-7,6,80,6,1309.982,1659.318,2012,11,0,0,0,1,1,820
Colts,14,3,0,7,0,0,24,Patriots,7,17,14,21,0,0,59,201211,-7,7,21,35,83,35,1466.698,1693.187,2012,11,0,0,0,1,0,805
Ravens,10,0,3,0,0,0,13,Steelers,7,0,3,0,0,0,10,201211,3,3,3,3,23,-3,1631.342,1610.484,2012,11,0,0,0,1,1,196
Bears,0,0,7,0,0,0,7,49ers,10,10,7,5,0,0,32,201211,10,20,20,25,39,25,1591.466,1624.236,2012,11,0,0,0,1,0,1853
Buccaneers,10,0,0,11,6,0,27,Panthers,7,7,0,7,0,0,21,201211,3,-4,-4,6,48,-6,1490.977,1411.201,2012,11,0,0,0,1,1,511
Browns,7,6,0,7,0,0,20,Cowboys,0,0,3,17,3,0,23,201211,-7,-13,-10,3,43,3,1371.761,1500.587,2012,11,0,1,0,0,0,1024
Jets,3,10,0,14,0,0,27,Rams,7,0,0,6,0,0,13,201211,-4,6,6,14,40,-14,1434.26,1393.67,2012,11,0,0,0,0,0,871
Bengals,7,14,0,7,0,0,28,Chiefs,3,3,0,0,0,0,6,201211,4,15,15,22,34,-22,1486.854,1342.803,2012,11,0,0,0,1,0,542
Packers,0,7,7,10,0,0,24,Lions,3,7,7,3,0,0,20,201211,-3,-3,-3,4,44,-4,1659.364,1494.628,2012,11,0,1,0,1,1,291
Cardinals,13,3,0,3,0,0,19,Falcons,0,16,0,7,0,0,23,201211,-13,0,0,4,42,4,1437.336,1653.999,2012,11,0,1,0,1,0,1588
Dolphins,7,0,0,7,0,0,14,Bills,13,6,0,0,0,0,19,201211,6,12,12,5,33,5,1468.404,1436.738,2012,11,0,0,0,1,1,1184
Eagles,0,3,3,0,0,0,6,Washington,7,10,7,7,0,0,31,201211,7,14,18,25,37,25,1447.75,1403.465,2012,11,0,0,1,1,1,123
Panthers,14,0,7,9,0,0,30,Eagles,3,12,7,0,0,0,22,201212,11,-1,-1,8,52,-8,1392.693,1417.395,2012,12,0,0,0,1,0,450
Packers,7,3,0,0,0,0,10,Giants,17,14,7,0,0,0,38,201212,10,21,28,28,48,28,1670.458,1600.667,2012,12,0,0,1,1,0,758
Rams,0,14,14,3,0,0,31,Cardinals,7,10,0,0,0,0,17,201212,-7,-3,11,14,48,-14,1364.365,1432.628,2012,12,0,0,0,1,1,1270
49ers,7,7,14,3,0,0,31,Saints,7,7,7,0,0,0,21,201212,0,0,7,10,52,-10,1646.877,1597.573,2012,12,0,0,0,1,0,1921
Ravens,0,0,3,10,3,0,16,Chargers,0,10,0,3,0,0,13,201212,0,-10,-7,3,29,-3,1647.276,1483.957,2012,12,0,0,0,1,0,2291
Titans,3,3,3,10,0,0,19,Jaguars,7,0,7,10,0,0,24,201212,4,1,5,5,43,5,1463.734,1307.22,2012,12,0,1,0,1,1,500
Falcons,3,7,7,7,0,0,24,Buccaneers,7,3,3,10,0,0,23,201212,-4,0,4,1,47,-1,1658.708,1509.485,2012,12,0,0,0,1,1,416
Seahawks,0,7,7,7,0,0,21,Dolphins,0,7,0,17,0,0,24,201212,0,0,-7,3,45,3,1530.916,1452.442,2012,12,0,1,0,0,0,2730
Bills,3,3,0,7,0,0,13,Colts,7,6,7,0,0,0,20,201212,4,7,14,7,33,7,1452.7,1456.739,2012,12,0,0,0,1,0,434
Steelers,7,7,0,0,0,0,14,Browns,3,10,7,0,0,0,20,201212,-4,-1,6,6,34,6,1594.55,1365.472,2012,12,0,0,0,1,1,114
Raiders,0,0,10,0,0,0,10,Bengals,14,10,0,10,0,0,34,201212,14,24,14,24,44,24,1392.037,1510.351,2012,12,0,0,0,1,0,2032
Vikings,3,0,7,0,0,0,10,Bears,10,15,3,0,0,0,28,201212,7,22,18,18,38,18,1459.88,1568.825,2012,12,0,1,0,1,1,355
Patriots,0,35,0,14,0,0,49,Jets,0,3,9,7,0,0,19,201212,0,32,23,30,68,-30,1703.146,1463.566,2012,12,0,0,0,1,1,181
Washington,0,28,0,10,0,0,38,Cowboys,3,0,10,18,0,0,31,201212,-3,25,15,7,69,-7,1433.82,1506.876,2012,12,0,0,0,1,1,1181
Texans,0,14,10,7,3,0,34,Lions,7,14,3,7,0,0,31,201212,-7,-7,0,3,65,-3,1662.079,1483.534,2012,12,0,0,0,0,0,1105
Broncos,0,7,7,3,0,0,17,Chiefs,6,0,3,0,0,0,9,201212,-6,1,5,8,26,-8,1605.701,1319.306,2012,12,0,0,0,1,1,556
Cardinals,0,3,0,3,0,0,6,Jets,0,0,0,7,0,0,7,201213,0,-3,-3,1,13,1,1393.256,1446.515,2012,13,0,0,0,0,0,2139
Giants,3,10,3,0,0,0,16,Washington,7,3,0,7,0,0,17,201213,4,-3,-6,1,33,1,1634.879,1464.386,2012,13,0,0,0,1,1,204
Eagles,7,10,7,9,0,0,33,Cowboys,0,10,7,21,0,0,38,201213,-7,-7,-7,5,71,5,1388.703,1476.309,2012,13,0,0,0,1,1,1297
Steelers,3,3,7,10,0,0,23,Ravens,0,13,7,0,0,0,20,201213,3,-7,-7,3,43,-3,1564.27,1656.888,2012,13,0,0,0,1,1,196
Bengals,7,3,0,10,0,0,20,Chargers,0,13,0,0,0,0,13,201213,7,-3,-3,7,33,-7,1525.696,1474.345,2012,13,0,0,0,1,0,1871
Browns,0,10,3,7,0,0,20,Raiders,0,3,7,7,0,0,17,201213,0,7,3,3,37,-3,1395.752,1376.692,2012,13,0,0,0,1,0,2153
Buccaneers,10,0,0,13,0,0,23,Broncos,7,0,21,3,0,0,31,201213,-3,-3,18,8,54,8,1504.397,1614.425,2012,13,0,0,0,0,0,1521
Patriots,7,10,0,6,0,0,23,Dolphins,3,7,0,6,0,0,16,201213,4,7,7,7,39,-7,1720.197,1466.931,2012,13,0,0,0,1,1,1241
Saints,0,7,6,0,0,0,13,Falcons,7,10,0,6,0,0,23,201213,7,10,4,10,36,10,1572.332,1663.796,2012,13,0,0,0,1,1,424
Panthers,7,7,0,7,0,0,21,Chiefs,10,7,7,3,0,0,27,201213,3,3,10,6,48,6,1421.386,1310.582,2012,13,0,0,0,0,0,801
Texans,14,7,3,0,0,0,24,Titans,3,0,7,0,0,0,10,201213,11,18,14,14,34,-14,1671.101,1440.226,2012,13,0,0,0,1,1,665
Vikings,0,14,0,0,0,0,14,Packers,10,0,10,3,0,0,23,201213,10,-4,6,9,37,9,1445.217,1636.246,2012,13,0,0,0,1,1,259
Colts,7,7,7,14,0,0,35,Lions,10,13,7,3,0,0,33,201213,-3,-9,-9,2,68,-2,1472.946,1474.512,2012,13,0,0,0,0,0,240
Seahawks,0,10,0,7,6,0,23,Bears,7,0,7,3,0,0,17,201213,-7,3,-4,6,40,-6,1516.427,1583.488,2012,13,0,0,0,1,0,1732
Jaguars,0,10,0,8,0,0,18,Bills,7,10,10,7,0,0,34,201213,7,7,17,16,52,16,1330.729,1436.493,2012,13,0,0,0,1,0,880
49ers,7,0,0,6,0,0,13,Rams,0,0,2,11,3,0,16,201213,-7,-7,-5,3,29,3,1672.119,1403.736,2012,13,0,0,0,1,1,1741
Falcons,0,0,7,13,0,0,20,Panthers,7,9,7,7,0,0,30,201214,7,16,16,10,50,10,1676.732,1398.908,2012,14,0,0,0,1,1,226
Texans,0,0,7,7,0,0,14,Patriots,14,7,7,14,0,0,42,201214,14,21,21,28,56,28,1685.097,1729.882,2012,14,0,0,0,1,0,1597
Lions,7,7,3,3,0,0,20,Packers,0,10,7,10,0,0,27,201214,-7,-4,0,7,47,7,1461.039,1643.934,2012,14,0,0,0,1,1,291
Cardinals,0,0,0,0,0,0,0,Seahawks,10,28,13,7,0,0,58,201214,10,38,51,58,58,58,1388.835,1544.639,2012,14,0,0,0,1,1,1114
Saints,7,6,14,0,0,0,27,Giants,14,7,14,17,0,0,52,201214,7,8,8,25,79,25,1559.396,1625.453,2012,14,0,0,0,1,0,1168
Dolphins,0,3,3,7,0,0,13,49ers,0,6,7,14,0,0,27,201214,0,3,7,14,40,14,1457.247,1648.8,2012,14,0,0,0,0,0,2590
Ravens,7,14,0,7,0,0,28,Washington,14,0,6,8,3,0,31,201214,7,-7,-1,3,59,3,1635.61,1473.812,2012,14,0,0,0,0,0,35
Jets,0,0,10,7,0,0,17,Jaguars,0,3,0,7,0,0,10,201214,0,-3,7,7,27,-7,1450.936,1316.411,2012,14,0,0,0,1,0,835
Chargers,3,10,14,7,0,0,34,Steelers,0,3,7,14,0,0,24,201214,3,10,17,10,58,-10,1452.599,1585.548,2012,14,0,0,0,1,0,2113
Bears,0,7,0,7,0,0,14,Vikings,14,0,7,0,0,0,21,201214,14,7,14,7,35,7,1555.276,1437.529,2012,14,0,0,0,1,1,355
Eagles,0,10,0,13,0,0,23,Buccaneers,0,0,7,14,0,0,21,201214,0,10,3,2,44,-2,1378.868,1493.509,2012,14,0,0,0,1,0,928
Titans,7,13,0,3,0,0,23,Colts,7,0,14,6,0,0,27,201214,0,-13,1,4,50,4,1426.229,1486.419,2012,14,0,0,0,1,1,251
Chiefs,7,0,0,0,0,0,7,Browns,3,7,10,10,0,0,30,201214,-4,3,13,23,37,23,1333.06,1411.772,2012,14,0,0,0,1,0,698
Cowboys,3,7,0,10,0,0,20,Bengals,10,3,6,0,0,0,19,201214,-7,-3,-9,1,39,-1,1486.145,1547.442,2012,14,0,0,0,0,0,817
Rams,0,0,7,8,0,0,15,Bills,3,3,6,0,0,0,12,201214,-3,-6,-5,3,27,-3,1427.054,1450.811,2012,14,0,0,0,0,0,660
Broncos,10,3,13,0,0,0,26,Raiders,0,7,0,6,0,0,13,201214,10,6,19,13,39,-13,1625.312,1360.672,2012,14,0,0,0,1,1,939
49ers,7,10,14,10,0,0,41,Patriots,0,3,7,24,0,0,34,201215,7,14,21,7,75,-7,1657.818,1752.144,2012,15,0,0,0,0,0,2698
Chiefs,0,0,0,0,0,0,0,Raiders,3,6,3,3,0,0,15,201215,3,9,12,15,15,15,1314.909,1349.028,2012,15,0,0,0,1,1,1495
Steelers,0,10,7,7,0,0,24,Cowboys,3,7,7,7,3,0,27,201215,3,0,0,3,51,3,1545.623,1496.06,2012,15,0,0,0,0,0,1069
Panthers,21,3,7,0,0,0,31,Chargers,0,0,0,7,0,0,7,201215,21,24,31,24,38,-24,1439.948,1492.524,2012,15,0,0,0,0,0,2076
Lions,0,7,3,0,0,0,10,Cardinals,0,21,3,14,0,0,38,201215,0,14,14,28,48,28,1453.804,1372.598,2012,15,0,0,0,1,0,1687
Seahawks,14,17,16,3,0,0,50,Bills,7,10,0,0,0,0,17,201215,7,14,30,33,67,-33,1560.876,1432.753,2012,15,0,0,0,0,0,2110
Colts,0,10,7,0,0,0,17,Texans,10,10,3,6,0,0,29,201215,10,10,6,12,46,12,1496.386,1662.835,2012,15,0,0,0,1,1,865
Jets,3,0,7,0,0,0,10,Titans,0,7,7,0,0,0,14,201215,-3,4,4,4,24,4,1467.113,1416.262,2012,15,0,0,0,1,0,758
Buccaneers,0,0,0,0,0,0,0,Saints,7,17,7,10,0,0,41,201215,7,24,31,41,41,41,1475.859,1539.725,2012,15,0,0,0,1,1,480
Jaguars,3,0,0,0,0,0,3,Dolphins,3,7,6,8,0,0,24,201215,0,7,13,21,27,21,1300.234,1448.229,2012,15,0,0,0,1,0,327
Vikings,7,23,3,3,0,0,36,Rams,0,7,0,15,0,0,22,201215,7,23,26,14,58,-14,1462.044,1445.112,2012,15,0,0,0,1,0,466
Washington,7,3,14,14,0,0,38,Browns,7,7,0,7,0,0,21,201215,0,-4,10,17,59,-17,1492.251,1429.923,2012,15,0,0,0,0,0,304
Packers,0,14,7,0,0,0,21,Bears,0,7,3,3,0,0,13,201215,0,7,11,8,34,-8,1651.169,1530.761,2012,15,0,0,0,1,1,185
Giants,0,0,0,0,0,0,0,Falcons,14,3,10,7,0,0,34,201215,14,17,27,34,34,34,1645.124,1635.692,2012,15,0,0,0,1,0,745
Bengals,10,0,14,10,0,0,34,Eagles,0,13,0,0,0,0,13,201215,10,-3,11,21,47,-21,1537.527,1396.518,2012,15,0,0,0,0,0,497
Broncos,3,14,14,3,0,0,34,Ravens,0,0,3,14,0,0,17,201215,3,17,28,17,51,-17,1636.956,1617.171,2012,15,0,0,0,1,0,1506
49ers,0,6,0,7,0,0,13,Seahawks,14,14,7,7,0,0,42,201216,14,22,29,29,55,29,1689.851,1588.995,2012,16,0,0,0,1,1,679
Giants,7,0,0,7,0,0,14,Ravens,14,10,3,6,0,0,33,201216,7,17,20,19,47,19,1615.946,1583.842,2012,16,0,0,0,0,0,169
Bears,7,14,7,0,0,0,28,Cardinals,3,3,0,7,0,0,13,201216,4,15,22,15,41,-15,1512.718,1408.102,2012,16,0,0,0,1,0,1450
Browns,3,0,3,6,0,0,12,Broncos,7,7,7,13,0,0,34,201216,4,11,15,22,46,22,1400.762,1670.285,2012,16,0,0,0,1,0,1223
Vikings,7,6,3,7,0,0,23,Texans,3,0,3,0,0,0,6,201216,4,10,10,17,29,-17,1493.536,1672.525,2012,16,0,0,0,0,0,1057
Patriots,3,10,3,7,0,0,23,Jaguars,10,3,0,3,0,0,16,201216,-7,0,3,7,39,-7,1720.111,1287.447,2012,16,0,0,0,1,0,1003
Raiders,0,3,0,3,0,0,6,Panthers,7,7,0,3,0,0,17,201216,7,11,11,11,23,11,1368.188,1485.042,2012,16,0,0,0,0,0,2288
Rams,0,14,14,0,0,0,28,Buccaneers,3,3,7,0,0,0,13,201216,-3,8,15,15,41,-15,1413.621,1453.077,2012,16,0,0,0,1,0,861
Bengals,7,3,0,3,0,0,13,Steelers,0,7,3,0,0,0,10,201216,7,3,0,3,23,-3,1560.971,1532.468,2012,16,0,0,0,1,1,252
Chargers,7,3,14,3,0,0,27,Jets,14,0,0,3,0,0,17,201216,-7,-4,10,10,44,-10,1447.43,1451.772,2012,16,0,0,0,1,0,2427
Bills,0,3,0,7,0,0,10,Dolphins,7,7,10,0,0,0,24,201216,7,11,21,14,34,14,1404.633,1461.016,2012,16,0,0,0,1,1,1184
Colts,7,6,0,7,0,0,20,Chiefs,3,0,10,0,0,0,13,201216,4,10,0,7,33,-7,1486.695,1295.748,2012,16,0,0,0,1,0,451
Titans,0,0,0,7,0,0,7,Packers,14,6,14,21,0,0,55,201216,14,20,34,48,62,48,1431.603,1669.212,2012,16,0,0,0,0,0,580
Saints,7,10,7,7,3,0,34,Cowboys,0,14,3,14,0,0,31,201216,7,3,7,3,65,-3,1562.507,1509.215,2012,16,0,0,0,1,0,442
Falcons,7,14,0,10,0,0,31,Lions,3,3,7,5,0,0,18,201216,4,15,8,13,49,-13,1664.87,1418.3,2012,16,0,0,0,1,0,597
Washington,0,13,14,0,0,0,27,Eagles,7,3,3,7,0,0,20,201216,-7,3,14,7,47,-7,1521.413,1373.074,2012,16,0,0,0,1,1,123
Chiefs,0,3,0,0,0,0,3,Broncos,7,14,14,3,0,0,38,201217,7,18,32,35,41,35,1282.913,1677.211,2012,17,0,0,0,1,1,556
Cowboys,0,7,0,11,0,0,18,Washington,0,7,7,14,0,0,28,201217,0,0,7,10,46,10,1494.808,1536.732,2012,17,0,0,0,1,1,1181
Rams,0,7,3,3,0,0,13,Seahawks,0,3,10,7,0,0,20,201217,0,-4,3,7,33,7,1451.226,1627.126,2012,17,0,0,0,1,1,1720
Cardinals,3,3,0,7,0,0,13,49ers,0,7,10,10,0,0,27,201217,-3,1,11,14,40,14,1383.959,1651.72,2012,17,0,0,0,1,1,652
Raiders,0,7,0,14,0,0,21,Chargers,10,7,7,0,0,0,24,201217,10,10,17,3,45,3,1356.261,1477.066,2012,17,0,0,0,1,1,454
Dolphins,0,0,0,0,0,0,0,Patriots,7,14,0,7,0,0,28,201217,7,21,21,28,28,28,1478.062,1723.941,2012,17,0,0,0,1,1,1241
Packers,0,10,14,10,0,0,34,Vikings,10,10,7,10,0,0,37,201217,10,10,3,3,71,3,1679.412,1545.739,2012,17,0,0,0,1,1,259
Browns,0,3,7,0,0,0,10,Steelers,0,10,7,7,0,0,24,201217,0,7,7,14,34,14,1393.836,1516.896,2012,17,0,0,0,1,1,114
Texans,3,3,10,0,0,0,16,Colts,7,7,7,7,0,0,28,201217,4,8,5,12,44,12,1620.322,1499.531,2012,17,0,0,0,1,1,865
Panthers,3,10,14,17,0,0,44,Saints,0,17,7,14,0,0,38,201217,3,-4,3,6,82,-6,1496.969,1576.913,2012,17,0,0,0,1,1,648
Eagles,0,7,0,0,0,0,7,Giants,21,14,0,7,0,0,42,201217,21,28,28,35,49,35,1357.755,1589.216,2012,17,0,0,0,1,1,80
Jaguars,7,7,0,6,0,0,20,Titans,7,14,14,3,0,0,38,201217,0,7,21,18,58,18,1283.616,1421.403,2012,17,0,0,0,1,1,500
Bears,10,10,3,3,0,0,26,Lions,3,7,7,7,0,0,24,201217,7,10,6,2,50,-2,1536.861,1405.616,2012,17,0,0,0,1,1,238
Ravens,7,0,0,10,0,0,17,Bengals,0,7,6,10,0,0,23,201217,-7,0,6,6,40,6,1610.571,1576.543,2012,17,0,0,0,1,1,419
Jets,3,6,0,0,0,0,9,Bills,7,7,0,14,0,0,28,201217,4,5,5,19,37,19,1422.136,1387.587,2012,17,0,0,0,1,1,292
Buccaneers,3,10,9,0,0,0,22,Falcons,3,0,7,7,0,0,17,201217,0,10,12,5,39,-5,1415.473,1677.554,2012,17,0,0,0,1,1,416
Bengals,0,7,3,3,0,0,13,Texans,3,6,7,3,0,0,19,201218,3,2,6,6,32,6,1594.026,1589.815,2012,18,1,0,0,1,0,897
Vikings,3,0,0,7,0,0,10,Packers,7,10,7,0,0,0,24,201218,4,14,21,14,34,14,1562.84,1662.31,2012,18,1,0,0,1,1,259
Colts,0,6,3,0,0,0,9,Ravens,0,10,7,7,0,0,24,201218,0,4,8,15,33,15,1530.037,1593.088,2012,18,1,0,0,1,0,509
Seahawks,0,13,0,11,0,0,24,Washington,14,0,0,0,0,0,14,201218,-14,-1,-1,10,38,-10,1634.621,1552.776,2012,18,1,0,0,1,0,2322
Texans,3,10,0,15,0,0,28,Patriots,7,10,14,10,0,0,41,201219,4,4,18,13,69,13,1605.471,1732.387,2012,19,1,0,1,1,0,1597
Seahawks,0,0,7,21,0,0,28,Falcons,10,10,7,3,0,0,30,201219,10,20,20,2,58,2,1657.265,1641.02,2012,19,1,0,1,1,0,2178
Packers,14,7,3,7,0,0,31,49ers,7,17,7,14,0,0,45,201219,-7,3,7,14,76,14,1676.397,1657.759,2012,19,1,0,1,1,0,1834
Ravens,14,7,7,7,0,3,38,Broncos,14,7,7,7,0,0,35,201219,0,0,0,3,73,-3,1610.047,1681.145,2012,19,1,0,1,1,0,1506
49ers,0,14,7,7,0,0,28,Falcons,10,14,0,0,0,0,24,201220,-10,-10,-3,4,52,-4,1680.762,1650.269,2012,20,1,0,0,1,0,2135
Ravens,0,7,7,14,0,0,28,Patriots,3,10,0,0,0,0,13,201220,-3,-6,1,15,41,-15,1630.334,1744.468,2012,20,1,0,0,1,0,350
Ravens,7,14,7,6,0,0,34,49ers,3,3,17,8,0,0,31,201222,4,15,5,3,65,-3,1698.732,1674.833,2012,22,1,1,1,0,0,2451
Eagles,12,14,7,0,0,0,33,Washington,7,0,7,13,0,0,27,201301,5,19,19,6,60,-6,1400.368,1521.755,2013,1,0,0,0,1,1,123
Giants,3,7,7,14,0,0,31,Cowboys,3,10,14,9,0,0,36,201301,0,3,10,5,67,5,1567.612,1487.509,2013,1,0,0,0,1,1,1370
Texans,7,0,7,17,0,0,31,Chargers,7,14,7,0,0,0,28,201301,0,-14,-14,3,59,-3,1563.927,1490.732,2013,1,0,0,0,1,0,1301
Packers,7,7,7,7,0,0,28,49ers,7,7,7,13,0,0,34,201301,0,0,0,6,62,6,1603.929,1624.169,2013,1,0,0,0,1,0,1834
Cardinals,0,10,14,0,0,0,24,Rams,0,10,3,14,0,0,27,201301,0,0,-11,3,51,3,1420.28,1464.154,2013,1,0,0,0,1,1,1270
Chiefs,14,7,0,7,0,0,28,Jaguars,2,0,0,0,0,0,2,201301,12,19,19,26,30,-26,1354.319,1348.879,2013,1,0,0,0,1,0,949
Seahawks,0,3,3,6,0,0,12,Panthers,0,7,0,0,0,0,7,201301,0,-4,-1,5,19,-5,1600.343,1519.013,2013,1,0,0,0,1,0,2280
Titans,0,7,3,6,0,0,16,Steelers,2,0,0,7,0,0,9,201301,-2,5,8,7,25,-7,1457.8,1521.347,2013,1,0,0,0,1,0,471
Bengals,7,7,7,0,0,0,21,Bears,7,3,7,7,0,0,24,201301,0,-4,-4,3,45,3,1553.913,1532.011,2013,1,0,0,0,0,0,250
Falcons,10,0,7,0,0,0,17,Saints,0,13,7,3,0,0,23,201301,-10,3,3,6,40,6,1589.867,1533.575,2013,1,0,0,0,1,1,424
Raiders,0,7,3,7,0,0,17,Colts,7,7,0,7,0,0,21,201301,7,7,4,4,38,4,1401.486,1510.386,2013,1,0,0,0,1,0,1936
Vikings,7,7,10,0,0,0,24,Lions,3,10,14,7,0,0,34,201301,-4,-1,3,10,58,10,1534.169,1432.974,2013,1,0,0,0,1,1,542
Dolphins,3,3,7,10,0,0,23,Browns,0,7,3,0,0,0,10,201301,3,-1,3,13,33,-13,1481.411,1422.474,2013,1,0,0,0,1,0,1089
Patriots,10,7,0,6,0,0,23,Bills,0,14,7,0,0,0,21,201301,10,3,-4,2,44,-2,1634.979,1444.702,2013,1,0,0,0,1,1,404
Ravens,7,10,0,10,0,0,27,Broncos,0,14,21,14,0,0,49,201301,-7,-3,18,22,76,22,1628.207,1608.906,2013,1,0,0,0,1,0,1506
Buccaneers,7,7,0,3,0,0,17,Jets,2,10,0,6,0,0,18,201301,-5,-2,-2,1,35,1,1469.671,1431.781,2013,1,0,0,0,0,0,1004
Titans,7,3,0,14,0,0,24,Texans,7,0,7,10,6,0,30,201302,0,-3,4,6,54,6,1487.703,1577.413,2013,2,0,0,0,1,1,665
Steelers,3,7,0,0,0,0,10,Bengals,7,3,7,3,0,0,20,201302,4,0,7,10,30,10,1491.445,1541.995,2013,2,0,0,0,1,1,252
49ers,0,0,3,0,0,0,3,Seahawks,0,5,7,17,0,0,29,201302,0,5,9,26,32,26,1638.397,1617.294,2013,2,0,0,0,1,1,679
Broncos,0,10,14,17,0,0,41,Giants,3,6,7,7,0,0,23,201302,-3,1,8,18,64,-18,1635.606,1548.787,2013,2,0,0,0,0,0,1627
Jaguars,0,3,0,6,0,0,9,Raiders,7,3,3,6,0,0,19,201302,7,7,10,10,28,10,1309.253,1393.469,2013,2,0,0,0,1,0,2361
Saints,10,0,3,3,0,0,16,Buccaneers,7,0,0,7,0,0,14,201302,3,3,6,2,30,-2,1552.472,1463.357,2013,2,0,0,0,1,1,480
Lions,0,14,7,0,0,0,21,Cardinals,0,10,6,9,0,0,25,201302,0,-4,-5,4,46,4,1459.884,1411.08,2013,2,0,0,0,1,0,1687
Browns,3,3,0,0,0,0,6,Ravens,0,0,7,7,0,0,14,201302,-3,-6,1,8,20,8,1395.549,1601.508,2013,2,0,0,0,1,1,307
Cowboys,10,0,3,3,0,0,16,Chiefs,7,0,7,3,0,0,17,201302,-3,-3,1,1,33,1,1506.335,1393.945,2013,2,0,0,0,0,0,453
Dolphins,14,3,7,0,0,0,24,Colts,3,14,3,0,0,0,20,201302,11,0,4,4,44,-4,1508.336,1518.402,2013,2,0,0,0,1,0,1026
Washington,0,0,7,13,0,0,20,Packers,10,14,14,0,0,0,38,201302,10,24,31,18,58,18,1490.071,1589.702,2013,2,0,0,0,1,0,686
Vikings,7,14,3,6,0,0,30,Bears,14,10,0,7,0,0,31,201302,7,3,0,1,61,1,1507.258,1543.93,2013,2,0,0,0,1,1,355
Panthers,0,7,7,9,0,0,23,Bills,0,3,11,10,0,0,24,201302,0,-4,0,1,47,1,1502.063,1437.901,2013,2,0,0,0,0,0,539
Rams,0,3,7,14,0,0,24,Falcons,14,10,0,7,0,0,31,201302,14,21,14,7,55,7,1473.355,1570.97,2013,2,0,0,0,1,0,467
Jets,3,0,7,0,0,0,10,Patriots,10,3,0,0,0,0,13,201302,7,10,3,3,23,3,1438.095,1641.78,2013,2,0,0,0,1,1,181
Chargers,3,10,7,13,0,0,33,Eagles,3,7,10,10,0,0,30,201302,0,3,0,3,63,-3,1477.246,1432.053,2013,2,0,0,0,0,0,2367
Raiders,0,7,7,7,0,0,21,Broncos,10,17,3,7,0,0,37,201303,10,20,16,16,58,16,1406.833,1662.932,2013,3,0,0,0,1,1,939
Bears,17,7,3,13,0,0,40,Steelers,0,10,10,3,0,0,23,201303,17,14,7,17,63,-17,1548.67,1475.972,2013,3,0,0,0,0,0,409
Jaguars,0,0,10,7,0,0,17,Seahawks,7,17,14,7,0,0,45,201303,7,24,28,28,62,28,1295.889,1645.546,2013,3,0,0,0,0,0,2451
Bills,0,6,6,8,0,0,20,Jets,7,10,3,7,0,0,27,201303,7,11,8,7,47,7,1444.813,1433.757,2013,3,0,0,0,1,1,292
Falcons,7,6,7,3,0,0,23,Dolphins,0,10,10,7,0,0,27,201303,-7,-3,0,4,50,4,1581.879,1528.544,2013,3,0,0,0,0,0,605
Texans,3,6,0,0,0,0,9,Ravens,0,17,7,6,0,0,30,201303,-3,8,15,21,39,21,1587.994,1608.303,2013,3,0,0,0,1,0,1250
Giants,0,0,0,0,0,0,0,Panthers,7,10,14,7,0,0,38,201303,7,17,31,38,38,38,1521.46,1495.151,2013,3,0,0,0,1,0,531
Colts,7,3,3,14,0,0,27,49ers,7,0,0,0,0,0,7,201303,0,3,6,20,34,-20,1498.194,1610.144,2013,3,0,0,0,0,0,1944
Cardinals,7,0,0,0,0,0,7,Saints,7,7,3,14,0,0,31,201303,0,7,10,24,38,24,1426.312,1562.586,2013,3,0,0,0,1,0,1312
Buccaneers,3,0,0,0,0,0,3,Patriots,0,17,3,3,0,0,23,201303,-3,14,17,20,26,20,1453.243,1646.118,2013,3,0,0,0,0,0,1169
Browns,7,17,0,7,0,0,31,Vikings,7,10,7,3,0,0,27,201303,0,7,0,4,58,-4,1388.754,1502.518,2013,3,0,0,0,0,0,629
Chargers,7,3,7,0,0,0,17,Titans,0,10,0,10,0,0,20,201303,-7,0,-7,3,37,3,1492.032,1477.122,2013,3,0,0,0,1,0,1739
Rams,0,0,7,0,0,0,7,Cowboys,10,7,7,7,0,0,31,201303,10,17,17,24,38,24,1462.446,1498.29,2013,3,0,0,0,1,0,547
Packers,0,16,14,0,0,0,30,Bengals,14,0,7,13,0,0,34,201303,14,-2,-9,4,64,4,1605.007,1557.468,2013,3,0,0,0,0,0,412
Chiefs,10,6,0,10,0,0,26,Eagles,6,0,3,7,0,0,16,201303,4,10,7,10,42,-10,1401.99,1417.267,2013,3,0,0,0,0,0,1034
Lions,7,10,0,10,0,0,27,Washington,7,7,3,3,0,0,20,201303,0,3,0,7,47,-7,1444.652,1474.765,2013,3,0,0,0,1,0,394
Dolphins,3,7,0,7,0,0,17,Saints,7,14,14,3,0,0,38,201304,4,11,25,21,55,21,1544.017,1576.677,2013,4,0,0,0,0,0,668
Patriots,0,10,3,17,0,0,30,Falcons,3,7,0,13,0,0,23,201304,-3,0,3,7,53,-7,1656.187,1566.407,2013,4,0,0,0,0,0,926
Cowboys,0,21,0,0,0,0,21,Chargers,7,6,7,10,0,0,30,201304,7,-8,-1,9,51,9,1520.377,1480.418,2013,4,0,0,0,0,0,1181
Washington,0,10,7,7,0,0,24,Raiders,14,0,0,0,0,0,14,201304,-14,-4,3,10,38,-10,1447.226,1400.105,2013,4,0,0,0,0,0,2426
Eagles,3,10,0,7,0,0,20,Broncos,14,7,21,10,0,0,52,201304,11,8,29,32,72,32,1386.73,1669.66,2013,4,0,0,0,0,0,1574
Jets,0,6,0,7,0,0,13,Titans,10,14,0,14,0,0,38,201304,10,18,18,25,51,25,1450.927,1488.736,2013,4,0,0,0,1,0,758
Seahawks,3,0,3,14,3,0,23,Texans,0,20,0,0,0,0,20,201304,3,-17,-14,3,43,-3,1650.316,1565.4,2013,4,0,0,0,0,0,1889
Giants,0,7,0,0,0,0,7,Chiefs,0,10,7,14,0,0,31,201304,0,3,10,24,38,24,1489.45,1432.527,2013,4,0,0,0,0,0,1093
Cardinals,0,0,0,13,0,0,13,Buccaneers,7,3,0,0,0,0,10,201304,-7,-10,-10,3,23,-3,1412.221,1443.174,2013,4,0,0,0,1,0,1793
Steelers,7,3,7,10,0,0,27,Vikings,10,10,14,0,0,0,34,201304,3,10,17,7,61,7,1476.706,1447.807,2013,4,0,0,0,0,0,741
Bears,3,10,3,16,0,0,32,Lions,3,27,7,3,0,0,40,201304,0,17,21,8,72,8,1576.835,1472.191,2013,4,0,0,0,1,1,238
Bengals,0,3,3,0,0,0,6,Browns,7,0,3,7,0,0,17,201304,7,4,4,11,23,11,1572.634,1414.565,2013,4,0,0,0,1,1,217
Ravens,0,7,7,6,0,0,20,Bills,6,14,3,0,0,0,23,201304,6,13,9,3,43,3,1630.896,1427.643,2013,4,0,0,0,1,0,275
49ers,0,14,7,14,0,0,35,Rams,3,0,0,8,0,0,11,201304,-3,11,18,24,46,-24,1561.495,1440.358,2013,4,0,0,0,1,1,1741
Colts,0,20,14,3,0,0,37,Jaguars,3,0,0,0,0,0,3,201304,-3,17,31,34,40,-34,1546.843,1291.119,2013,4,0,0,0,1,1,699
Panthers,3,3,0,0,0,0,6,Cardinals,0,3,9,10,0,0,22,201305,-3,-3,6,16,28,16,1527.161,1430.62,2013,5,0,1,0,1,0,1778
Broncos,7,21,10,13,0,0,51,Cowboys,14,6,13,15,0,0,48,201305,-7,8,5,3,99,-3,1676.84,1499.249,2013,5,0,0,0,0,0,661
Seahawks,12,7,9,0,0,0,28,Colts,7,10,6,11,0,0,34,201305,-5,-2,-5,6,62,6,1663.268,1563.211,2013,5,0,0,0,0,0,1867
Chargers,0,0,3,14,0,0,17,Raiders,14,3,7,3,0,0,27,201305,14,17,21,10,44,10,1501.547,1374.687,2013,5,0,0,0,1,1,454
Jets,3,14,3,10,0,0,30,Falcons,0,7,7,14,0,0,28,201305,3,10,6,2,58,-2,1428.751,1547.308,2013,5,0,0,0,0,0,745
Texans,0,0,3,0,0,0,3,49ers,14,7,3,10,0,0,34,201305,14,21,21,31,37,31,1552.448,1587.855,2013,5,0,0,0,0,0,1642
Eagles,3,16,3,14,0,0,36,Giants,7,0,14,0,0,0,21,201305,-4,12,1,15,57,-15,1379.551,1458.125,2013,5,0,0,0,1,1,80
Lions,0,3,0,6,0,0,9,Packers,3,3,10,6,0,0,22,201305,3,3,13,13,31,13,1497.109,1589.841,2013,5,0,0,1,1,1,291
Jaguars,10,0,3,7,0,0,20,Rams,7,17,0,10,0,0,34,201305,-3,14,11,14,54,14,1274.752,1413.998,2013,5,0,0,0,0,0,751
Chiefs,7,6,0,13,0,0,26,Titans,0,0,10,7,0,0,17,201305,7,13,3,9,43,-9,1463.852,1510.911,2013,5,0,0,0,1,0,471
Patriots,0,3,0,3,0,0,6,Bengals,0,3,3,7,0,0,13,201305,0,0,3,7,19,7,1675.286,1539.898,2013,5,0,0,0,1,0,732
Saints,6,14,3,3,0,0,26,Bears,0,7,3,8,0,0,18,201305,6,13,13,8,44,-8,1598.167,1551.917,2013,5,0,0,0,1,0,832
Bills,10,0,14,0,0,0,24,Browns,0,17,7,13,0,0,37,201305,-10,7,0,13,61,13,1448.029,1447.301,2013,5,0,0,0,1,0,173
Ravens,3,3,10,10,0,0,26,Dolphins,3,10,0,10,0,0,23,201305,0,-7,3,3,49,-3,1610.51,1522.527,2013,5,0,0,0,1,0,956
Colts,3,3,0,3,0,0,9,Chargers,0,10,3,6,0,0,19,201306,-3,4,7,10,28,10,1584.973,1472.527,2013,6,0,0,0,1,0,1784
Washington,3,3,10,0,0,0,16,Cowboys,7,7,7,10,0,0,31,201306,4,8,5,15,47,15,1472.644,1490.191,2013,6,0,1,0,1,1,1181
Saints,7,0,10,10,0,0,27,Patriots,3,14,3,10,0,0,30,201306,-4,10,3,3,57,3,1621.523,1649.511,2013,6,0,0,0,0,0,1349
Titans,3,7,0,3,0,0,13,Seahawks,0,7,3,10,0,0,20,201306,-3,-3,0,7,33,7,1479.085,1641.505,2013,6,0,0,0,0,0,1970
Jaguars,0,12,7,0,0,0,19,Broncos,14,0,14,7,0,0,35,201306,14,2,9,16,54,16,1263.065,1685.898,2013,6,0,0,0,1,0,1465
Rams,7,10,21,0,0,0,38,Texans,0,6,0,7,0,0,13,201306,7,11,32,25,51,-25,1425.686,1528.624,2013,6,0,0,0,0,0,679
Packers,3,3,10,3,0,0,19,Ravens,0,0,3,14,0,0,17,201306,3,6,13,2,36,-2,1603.996,1623.323,2013,6,0,0,0,0,0,687
Cardinals,7,7,6,0,0,0,20,49ers,6,16,0,10,0,0,32,201306,-1,8,2,12,52,12,1461.967,1611.679,2013,6,0,0,0,1,1,652
Steelers,0,9,7,3,0,0,19,Jets,3,3,0,0,0,0,6,201306,-3,3,10,13,25,-13,1428.985,1446.54,2013,6,0,1,0,1,0,314
Panthers,7,7,14,7,0,0,35,Vikings,0,3,0,7,0,0,10,201306,7,11,25,25,45,-25,1495.814,1495.528,2013,6,0,0,1,1,0,938
Raiders,0,7,0,0,0,0,7,Chiefs,0,7,7,10,0,0,24,201306,0,0,7,17,31,17,1403.707,1495.679,2013,6,0,0,0,1,1,1495
Lions,7,0,7,17,0,0,31,Browns,0,17,0,0,0,0,17,201306,7,-10,-3,14,48,-14,1482.954,1468.252,2013,6,0,0,0,0,0,90
Bengals,10,7,7,0,3,0,27,Bills,7,3,0,14,0,0,24,201306,3,7,14,3,51,-3,1565.673,1427.078,2013,6,0,0,0,1,0,388
Giants,7,7,7,0,0,0,21,Bears,7,17,3,0,0,0,27,201306,0,10,6,6,48,6,1416.859,1528.561,2013,6,0,0,0,1,0,711
Eagles,7,7,7,10,0,0,31,Buccaneers,3,14,0,3,0,0,20,201306,4,-3,4,11,51,-11,1420.816,1424.774,2013,6,0,0,1,1,0,928
Vikings,7,0,0,0,0,0,7,Giants,3,7,7,6,0,0,23,201307,-4,3,10,16,30,16,1455.778,1407.291,2013,7,0,0,0,1,0,1016
Broncos,7,7,3,16,0,0,33,Colts,10,16,7,6,0,0,39,201307,3,12,16,6,72,6,1688.536,1557.14,2013,7,0,0,0,1,0,998
Ravens,3,3,0,10,0,0,16,Steelers,7,3,3,6,0,0,19,201307,4,4,7,3,35,3,1609.18,1462.8,2013,7,0,0,0,1,1,196
Texans,3,7,6,0,0,0,16,Chiefs,7,7,3,0,0,0,17,201307,4,4,1,1,33,1,1477.515,1511.235,2013,7,0,0,0,1,0,646
Browns,0,3,3,7,0,0,13,Packers,14,3,0,14,0,0,31,201307,14,14,11,18,44,18,1436.554,1618.14,2013,7,0,0,0,0,0,381
49ers,3,14,7,7,0,0,31,Titans,0,0,0,17,0,0,17,201307,3,17,24,14,48,-14,1622.201,1471.07,2013,7,0,0,0,0,0,1958
Chargers,7,7,3,7,0,0,24,Jaguars,0,3,3,0,0,0,6,201307,7,11,11,18,30,-18,1500.361,1260.427,2013,7,0,0,0,1,0,2087
Patriots,14,7,0,6,0,0,27,Jets,7,3,17,0,3,0,30,201307,-7,-11,6,3,57,3,1659.334,1412.725,2013,7,0,0,0,1,1,181
Bears,10,7,7,17,0,0,41,Washington,3,21,7,14,0,0,45,201307,-7,7,7,4,86,4,1538.129,1452.153,2013,7,0,0,0,1,0,594
Cowboys,0,3,7,7,0,0,17,Eagles,0,0,0,3,0,0,3,201307,0,3,10,14,20,-14,1510.682,1451.495,2013,7,0,0,0,1,1,1297
Bills,14,3,0,6,0,0,23,Dolphins,0,14,7,0,0,0,21,201307,14,3,-4,2,44,-2,1416.463,1509.714,2013,7,0,0,1,1,1,1184
Bengals,7,7,10,3,0,0,27,Lions,7,3,7,7,0,0,24,201307,0,4,7,3,51,-3,1576.288,1514.652,2013,7,0,0,0,0,0,231
Buccaneers,0,10,7,6,0,0,23,Falcons,7,17,0,7,0,0,31,201307,7,14,7,8,54,8,1394.095,1529.519,2013,7,0,0,1,1,1,416
Seahawks,7,10,14,3,0,0,34,Cardinals,0,10,3,9,0,0,22,201307,7,7,18,12,56,-12,1649.52,1451.444,2013,7,0,0,0,1,1,1114
Rams,2,3,7,3,0,0,15,Panthers,7,10,10,3,0,0,30,201307,5,12,15,15,45,15,1476.795,1535.564,2013,7,0,0,0,1,0,567
Steelers,0,3,0,15,0,0,18,Raiders,14,7,0,0,0,0,21,201308,14,18,18,3,39,3,1480.507,1388.15,2013,8,0,0,1,1,0,2251
Washington,0,7,14,0,0,0,21,Broncos,7,0,7,31,0,0,45,201308,7,0,-7,24,66,24,1469.382,1664.683,2013,8,0,0,0,0,0,1489
Jets,0,6,3,0,0,0,9,Bengals,14,14,14,7,0,0,49,201308,14,22,33,40,58,40,1435.085,1590.306,2013,8,0,0,0,1,0,563
Packers,7,17,7,13,0,0,44,Vikings,7,10,0,14,0,0,31,201308,0,7,14,13,75,-13,1628.452,1428.993,2013,8,0,0,0,1,1,259
Falcons,3,3,0,7,0,0,13,Cardinals,0,21,3,3,0,0,27,201308,-3,15,18,14,40,14,1539.178,1436.094,2013,8,0,0,0,1,0,1588
49ers,14,14,7,7,0,0,42,Jaguars,0,3,7,0,0,0,10,201308,14,25,25,32,52,-32,1245.831,1641.93,2013,8,0,0,0,0,0,2370
Seahawks,0,7,7,0,0,0,14,Rams,3,0,3,3,0,0,9,201308,-3,4,8,5,23,-5,1664.87,1459.52,2013,8,0,0,0,1,1,1720
Bills,0,10,0,7,0,0,17,Saints,7,14,7,7,0,0,35,201308,7,11,18,18,52,18,1433.348,1611.699,2013,8,0,0,1,0,0,1086
Dolphins,7,10,0,0,0,0,17,Patriots,0,3,17,7,0,0,27,201308,-7,-14,3,10,44,10,1492.828,1636.974,2013,8,0,0,0,1,1,1241
Browns,0,10,7,0,0,0,17,Chiefs,6,14,0,3,0,0,23,201308,6,10,3,6,40,6,1426.241,1516.033,2013,8,0,0,0,1,0,698
Cowboys,0,10,3,17,0,0,30,Lions,7,0,0,24,0,0,31,201308,7,-3,-6,1,61,1,1538.288,1500.634,2013,8,0,0,0,1,0,999
Panthers,7,7,7,10,0,0,31,Buccaneers,3,3,0,7,0,0,13,201308,4,8,15,18,44,-18,1552.838,1384.437,2013,8,0,0,0,1,1,511
Giants,6,6,0,3,0,0,15,Eagles,0,0,0,7,0,0,7,201308,6,12,12,8,22,-8,1434.077,1423.889,2013,8,0,0,0,1,1,80
Bears,7,10,7,3,0,0,27,Packers,10,0,10,0,0,0,20,201309,-3,7,4,7,47,-7,1520.899,1644.151,2013,9,0,1,0,1,1,185
Colts,0,3,9,15,0,0,27,Texans,14,7,3,0,0,0,24,201309,-14,-18,-12,3,51,-3,1580.993,1472.717,2013,9,0,1,1,1,1,865
Steelers,0,10,14,7,0,0,31,Patriots,7,17,3,28,0,0,55,201309,7,14,3,24,86,24,1465.367,1647.081,2013,9,0,0,0,1,0,479
Ravens,3,7,0,8,0,0,18,Browns,7,7,7,3,0,0,24,201309,4,4,11,6,42,6,1591.473,1415.665,2013,9,0,1,0,1,1,307
Buccaneers,0,21,3,0,0,0,24,Seahawks,0,7,7,10,3,0,27,201309,0,-14,-10,3,51,3,1364.445,1675.257,2013,9,0,0,0,1,0,2526
Eagles,7,21,21,0,0,0,49,Raiders,3,10,0,7,0,0,20,201309,4,15,36,29,69,-29,1397.829,1403.291,2013,9,0,0,0,0,0,2508
Falcons,0,10,0,0,0,0,10,Panthers,7,7,3,17,0,0,34,201309,7,4,7,24,44,24,1508.612,1572.83,2013,9,0,0,0,1,1,226
Chargers,0,14,0,10,0,0,24,Washington,0,7,7,10,6,0,30,201309,0,-7,0,6,54,6,1514.957,1458.867,2013,9,0,1,0,0,0,2269
Saints,7,7,3,3,0,0,20,Jets,3,17,3,3,0,0,26,201309,-4,6,6,6,46,6,1622.181,1420.256,2013,9,0,0,0,0,0,1168
Titans,7,0,7,14,0,0,28,Rams,0,7,7,7,0,0,21,201309,7,0,0,7,49,-7,1451.341,1449.133,2013,9,0,1,0,0,0,253
Vikings,3,7,7,6,0,0,23,Cowboys,3,3,14,7,0,0,27,201309,0,-4,3,4,50,4,1413.294,1531.98,2013,9,0,0,0,1,0,863
Chiefs,0,3,10,10,0,0,23,Bills,7,3,3,0,0,0,13,201309,-7,-7,0,10,36,-10,1526.61,1422.867,2013,9,0,0,0,1,0,858
Bengals,0,3,7,10,0,0,20,Dolphins,0,10,7,3,2,0,22,201309,0,7,7,2,42,2,1605.136,1482.722,2013,9,0,0,0,1,0,957
Dolphins,0,7,12,0,0,0,19,Buccaneers,10,5,0,7,0,0,22,201310,10,8,-4,3,41,3,1495.85,1362.004,2013,10,0,0,0,0,0,205
Cowboys,3,7,7,0,0,0,17,Saints,7,21,7,14,0,0,49,201310,4,18,18,32,66,32,1539.639,1593.652,2013,10,0,0,0,1,0,442
Broncos,7,14,7,0,0,0,28,Chargers,0,6,7,7,0,0,20,201310,7,15,15,8,48,-8,1675.198,1496.073,2013,10,0,1,0,1,1,832
Texans,7,10,0,7,0,0,24,Cardinals,7,7,6,7,0,0,27,201310,0,-3,3,3,51,3,1460.806,1466.66,2013,10,0,0,1,0,0,1014
Panthers,0,7,0,3,0,0,10,49ers,3,6,0,0,0,0,9,201310,-3,-2,-2,1,19,-1,1592.42,1647.429,2013,10,0,0,1,1,0,2296
Bills,3,0,0,7,0,0,10,Steelers,0,10,7,6,0,0,23,201310,-3,7,14,13,33,13,1401.919,1454.1,2013,10,0,0,0,1,0,178
Bengals,0,0,3,14,0,0,17,Ravens,10,7,0,0,3,0,20,201310,10,17,14,3,37,3,1592.008,1564.659,2013,10,0,0,0,1,1,419
Rams,7,21,10,0,0,0,38,Colts,0,0,8,0,0,0,8,201310,7,28,30,30,46,-30,1423.901,1592.904,2013,10,0,0,0,0,0,230
Jaguars,10,3,7,9,0,0,29,Titans,0,7,3,17,0,0,27,201310,10,6,10,2,56,-2,1240.332,1476.574,2013,10,0,1,0,1,1,500
Eagles,7,3,17,0,0,0,27,Packers,0,3,7,3,0,0,13,201310,7,7,17,14,40,-14,1439.997,1610.169,2013,10,0,0,0,1,0,728
Lions,7,0,7,7,0,0,21,Bears,7,0,3,9,0,0,19,201310,0,0,4,2,40,-2,1506.942,1554.882,2013,10,0,1,0,1,1,238
Seahawks,3,20,3,7,0,0,33,Falcons,0,3,7,0,0,0,10,201310,3,20,16,23,43,-23,1677.698,1489.022,2013,10,0,0,0,1,0,2178
Washington,10,14,3,0,0,0,27,Vikings,7,7,14,6,0,0,34,201310,-3,-10,1,7,61,7,1477.751,1405.635,2013,10,0,0,0,1,0,931
Raiders,10,7,3,0,0,0,20,Giants,7,7,7,3,0,0,24,201310,-3,-3,1,4,44,4,1361.123,1460.136,2013,10,0,0,1,0,0,2557
Patriots,0,3,7,10,0,0,20,Panthers,7,3,7,7,0,0,24,201311,7,7,7,4,44,4,1658.347,1602.187,2013,11,0,1,0,0,0,710
Chiefs,0,10,0,7,0,0,17,Broncos,10,7,7,3,0,0,27,201311,10,7,14,10,44,10,1547.557,1689.462,2013,11,0,1,0,1,1,556
Vikings,3,10,0,7,0,0,20,Seahawks,10,14,0,17,0,0,41,201311,7,11,11,21,61,21,1426.924,1697.507,2013,11,0,0,0,1,0,1391
Packers,0,6,0,7,0,0,13,Giants,7,3,10,7,0,0,27,201311,7,4,14,14,40,14,1561.973,1468.526,2013,11,0,0,0,1,0,758
49ers,0,10,7,3,0,0,20,Saints,7,7,0,9,0,0,23,201311,7,4,-3,3,43,3,1637.661,1615.884,2013,11,0,0,0,1,0,1921
Chargers,7,3,3,3,0,0,16,Dolphins,3,7,7,3,0,0,20,201311,-4,0,4,4,36,4,1481.809,1478.74,2013,11,0,0,0,1,0,2267
Raiders,14,0,14,0,0,0,28,Texans,0,17,0,6,0,0,23,201311,14,-3,11,5,51,-5,1352.734,1450.077,2013,11,0,0,0,1,0,1635
Cardinals,7,7,10,3,0,0,27,Jaguars,14,0,0,0,0,0,14,201311,-7,0,10,13,41,-13,1477.389,1261.97,2013,11,0,0,0,0,0,1791
Lions,0,27,0,0,0,0,27,Steelers,14,6,3,14,0,0,37,201311,14,-7,-4,10,64,10,1522.16,1471.012,2013,11,0,0,0,0,0,205
Washington,0,0,0,16,0,0,16,Eagles,7,10,7,0,0,0,24,201311,7,17,24,8,40,8,1456.462,1488.193,2013,11,0,0,0,1,1,123
Browns,13,0,7,0,0,0,20,Bengals,0,31,0,10,0,0,41,201311,-13,18,11,21,61,21,1442.478,1579.85,2013,11,0,1,0,1,1,217
Ravens,10,7,0,3,0,0,20,Bears,0,13,0,7,3,0,23,201311,-10,-4,-4,3,43,3,1576.817,1539.664,2013,11,0,0,0,0,0,605
Jets,0,0,7,7,0,0,14,Bills,0,20,14,3,0,0,37,201311,0,20,27,23,51,23,1448.786,1385.008,2013,11,0,1,0,1,1,292
Colts,0,6,17,7,0,0,30,Titans,14,3,0,10,0,0,27,201311,-14,-11,6,3,57,-3,1531.909,1454.936,2013,11,0,0,0,1,1,251
Falcons,0,6,7,15,0,0,28,Buccaneers,3,21,14,3,0,0,41,201311,3,18,25,13,69,13,1469.213,1379.114,2013,11,0,0,0,1,1,416
Jaguars,7,3,0,3,0,0,13,Texans,0,3,3,0,0,0,6,201312,7,7,4,7,19,-7,1247.341,1422.298,2013,12,0,0,0,1,1,820
49ers,7,3,14,3,0,0,27,Washington,0,6,0,0,0,0,6,201312,7,4,18,21,33,-21,1625.748,1441.128,2013,12,0,0,0,1,0,2435
Broncos,17,7,0,7,0,0,31,Patriots,0,0,21,10,3,0,34,201312,-17,-24,-3,3,65,3,1699.679,1642.725,2013,12,0,0,0,1,0,1769
Cowboys,7,7,7,3,0,0,24,Giants,0,6,7,8,0,0,21,201312,7,8,8,3,45,-3,1517.406,1498.202,2013,12,0,1,0,1,1,1370
Colts,3,0,0,8,0,0,11,Cardinals,7,20,7,6,0,0,40,201312,4,24,31,29,51,29,1545.222,1492.018,2013,12,0,0,0,0,0,1496
Titans,3,3,7,10,0,0,23,Raiders,3,6,3,7,0,0,19,201312,0,-3,1,4,42,-4,1441.623,1380.513,2013,12,0,0,0,1,0,1950
Jets,3,0,0,0,0,0,3,Ravens,3,6,10,0,0,0,19,201312,0,6,16,16,22,16,1417.135,1564.223,2013,12,0,0,0,1,0,169
Buccaneers,3,14,0,7,0,0,24,Lions,0,14,7,0,0,0,21,201312,3,3,-4,3,45,-3,1407.734,1499.281,2013,12,0,0,0,1,0,994
Bears,7,7,0,7,0,0,21,Rams,21,3,3,15,0,0,42,201312,14,10,13,21,63,21,1552.259,1484.896,2013,12,0,0,1,1,0,260
Chargers,3,7,14,17,0,0,41,Chiefs,7,7,14,10,0,0,38,201312,-4,-4,-4,3,79,-3,1468.917,1537.34,2013,12,0,0,0,1,1,1334
Vikings,3,10,7,3,3,0,26,Packers,7,0,0,16,3,0,26,201312,-4,6,13,0,52,0,1420.136,1532.296,2013,12,0,0,0,1,1,259
Panthers,3,3,7,7,0,0,20,Dolphins,7,9,0,0,0,0,16,201312,-4,-10,-3,4,36,-4,1617.809,1491.632,2013,12,0,0,0,0,0,654
Steelers,3,10,7,7,0,0,27,Browns,3,0,0,8,0,0,11,201312,0,10,17,16,38,-16,1493.891,1429.017,2013,12,0,0,0,1,1,114
Saints,7,7,3,0,0,0,17,Falcons,7,6,0,0,0,0,13,201312,0,1,4,4,30,-4,1627.797,1440.593,2013,12,0,0,0,1,1,424
Saints,0,7,0,0,0,0,7,Seahawks,17,10,7,0,0,0,34,201313,17,20,27,27,41,27,1637.892,1704.295,2013,13,0,0,1,1,0,2098
Giants,0,14,0,10,0,0,24,Washington,7,7,3,0,0,0,17,201313,-7,0,-3,7,41,-7,1482.189,1421.524,2013,13,0,0,0,1,1,204
Bengals,0,7,7,3,0,0,17,Chargers,0,7,0,3,0,0,10,201313,0,0,7,7,27,-7,1593.31,1489.079,2013,13,0,1,0,1,0,1871
Broncos,0,14,14,7,0,0,35,Chiefs,7,14,0,7,0,0,28,201313,-7,-7,7,7,63,-7,1686.186,1517.178,2013,13,0,0,0,1,1,556
Rams,0,3,3,7,0,0,13,49ers,3,10,3,7,0,0,23,201313,3,10,10,10,36,10,1516.05,1645.352,2013,13,0,0,0,1,1,1741
Falcons,7,10,7,7,3,0,34,Bills,14,3,7,7,0,0,31,201313,-7,0,0,3,65,-3,1430.498,1416.659,2013,13,0,0,1,0,0,698
Patriots,7,0,14,13,0,0,34,Texans,10,7,7,7,0,0,31,201313,-3,-10,-3,3,65,-3,1656.218,1384.991,2013,13,0,0,0,1,0,1597
Buccaneers,6,0,0,0,0,0,6,Panthers,7,10,7,3,0,0,27,201313,1,11,18,21,33,21,1428.963,1630.739,2013,13,0,0,0,1,1,511
Dolphins,0,6,14,3,0,0,23,Jets,0,0,3,0,0,0,3,201313,0,6,17,20,26,-20,1478.702,1405.362,2013,13,0,0,0,1,1,1091
Bears,3,3,14,0,0,0,20,Vikings,0,7,3,10,3,0,23,201313,-3,1,-10,3,43,3,1521.105,1427.301,2013,13,0,0,0,1,1,355
Titans,0,7,7,0,0,0,14,Colts,6,6,3,7,0,0,22,201313,6,5,1,8,36,8,1457.926,1512.539,2013,13,0,0,0,1,1,251
Jaguars,7,13,0,12,0,0,32,Browns,7,7,7,7,0,0,28,201313,0,6,-1,4,60,-4,1284.648,1400.673,2013,13,0,0,0,1,0,771
Steelers,0,0,7,13,0,0,20,Ravens,7,3,6,6,0,0,22,201313,7,10,9,2,42,2,1522.235,1575.995,2013,13,0,0,0,1,1,196
Raiders,7,14,0,3,0,0,24,Cowboys,7,7,7,10,0,0,31,201313,0,-7,0,7,55,7,1364.21,1533.419,2013,13,0,0,0,0,0,1472
Packers,0,10,0,0,0,0,10,Lions,0,17,9,14,0,0,40,201313,0,7,16,30,50,30,1525.131,1478.052,2013,13,0,0,0,1,1,291
Cardinals,0,7,7,7,0,0,21,Eagles,7,10,7,0,0,0,24,201313,7,10,10,3,45,3,1524.7,1503.527,2013,13,0,0,1,1,0,2078
Vikings,0,3,3,20,0,0,26,Ravens,7,0,0,22,0,0,29,201314,7,4,1,3,55,3,1442.51,1582.988,2013,14,0,0,0,0,0,937
Cowboys,7,7,0,14,0,0,28,Bears,7,17,11,10,0,0,45,201314,0,10,21,17,73,17,1541.168,1505.896,2013,14,0,0,0,1,0,802
Panthers,6,0,0,7,0,0,13,Saints,0,21,3,7,0,0,31,201314,-6,15,18,18,44,18,1640.507,1617.804,2013,14,0,0,0,1,1,648
Seahawks,0,14,0,3,0,0,17,49ers,6,10,0,3,0,0,19,201314,6,2,2,2,36,2,1724.383,1656.205,2013,14,0,0,0,1,1,679
Giants,0,0,7,7,0,0,14,Chargers,7,17,7,6,0,0,37,201314,7,24,24,23,51,23,1503.285,1470.946,2013,14,0,0,0,0,0,2427
Rams,3,0,0,7,0,0,10,Cardinals,7,7,9,7,0,0,30,201314,4,11,20,20,40,20,1505.197,1512.814,2013,14,0,0,0,1,1,1270
Titans,14,7,7,0,0,0,28,Broncos,10,10,14,17,0,0,51,201314,-4,-1,6,23,79,23,1443.991,1700.269,2013,14,0,0,0,1,0,1019
Chiefs,17,21,0,7,0,0,45,Washington,0,10,0,0,0,0,10,201314,17,28,28,35,55,-35,1503.095,1400.429,2013,14,0,0,0,0,0,940
Texans,0,7,10,3,0,0,20,Jaguars,7,10,7,3,0,0,27,201314,7,10,7,7,47,7,1379.065,1310.577,2013,14,0,0,0,1,1,820
Dolphins,3,7,14,10,0,0,34,Steelers,7,0,14,7,0,0,28,201314,-4,3,3,6,62,-6,1508.305,1515.242,2013,14,0,0,0,1,0,1013
Lions,0,8,6,6,0,0,20,Eagles,0,0,6,28,0,0,34,201314,0,-8,-8,14,54,14,1510.359,1515.413,2013,14,0,0,0,1,0,441
Raiders,0,3,14,10,0,0,27,Jets,10,10,10,7,0,0,37,201314,10,17,13,10,64,10,1356.461,1375.76,2013,14,0,0,0,1,0,2557
Browns,3,3,13,7,0,0,26,Patriots,0,0,11,16,0,0,27,201314,-3,-6,-8,1,53,1,1374.744,1662.144,2013,14,0,0,0,1,0,551
Falcons,0,21,0,0,0,0,21,Packers,7,3,6,6,0,0,22,201314,7,-11,-5,1,43,1,1446.766,1492.824,2013,14,0,0,0,1,0,768
Colts,0,0,14,14,0,0,28,Bengals,7,7,14,14,0,0,42,201314,7,14,14,14,70,14,1526.475,1611.443,2013,14,0,0,0,1,0,99
Bills,3,0,3,0,0,0,6,Buccaneers,14,10,3,0,0,0,27,201314,11,21,21,21,33,21,1400.391,1419.195,2013,14,0,0,0,0,0,1051
Chiefs,21,14,14,7,0,0,56,Raiders,3,14,14,0,0,0,31,201315,18,18,18,25,87,-25,1534.522,1338.863,2013,15,0,0,0,1,1,1495
Bengals,0,7,0,13,0,0,20,Steelers,21,6,3,0,0,0,30,201315,21,20,23,10,50,10,1626.485,1491.019,2013,15,0,0,0,1,1,252
Saints,0,3,0,13,0,0,16,Rams,14,10,3,0,0,0,27,201315,14,21,24,11,43,11,1643.194,1481.796,2013,15,0,0,0,1,0,599
Ravens,0,9,3,6,0,0,18,Lions,7,0,3,6,0,0,16,201315,-7,2,2,2,34,-2,1588.935,1489.335,2013,15,0,0,0,0,0,396
Cardinals,7,3,10,14,3,0,37,Titans,10,0,7,17,0,0,34,201315,-3,0,3,3,71,-3,1536.214,1436.451,2013,15,0,0,0,0,0,1442
Packers,3,0,14,20,0,0,37,Cowboys,13,13,3,7,0,0,36,201315,-10,-23,-12,1,73,-1,1497.382,1515.084,2013,15,0,0,0,1,0,937
Jets,3,3,7,7,0,0,20,Panthers,3,13,0,14,0,0,30,201315,0,10,3,10,50,10,1393.358,1615.118,2013,15,0,0,0,0,0,531
Bills,3,17,0,7,0,0,27,Jaguars,3,7,3,7,0,0,20,201315,0,10,7,7,47,-7,1377.661,1331.614,2013,15,0,0,0,1,0,880
Bears,0,10,7,21,0,0,38,Browns,3,7,14,7,0,0,31,201315,-3,0,-7,7,69,-7,1531.98,1373.355,2013,15,0,0,0,0,0,308
Seahawks,3,10,3,7,0,0,23,Giants,0,0,0,0,0,0,0,201315,3,13,16,23,23,-23,1713.28,1474.904,2013,15,0,0,0,1,0,2401
Chargers,3,14,7,3,0,0,27,Broncos,10,0,0,10,0,0,20,201315,-7,7,14,7,47,-7,1499.326,1707.809,2013,15,0,0,0,1,1,832
Washington,7,13,0,6,0,0,26,Falcons,14,3,7,3,0,0,27,201315,7,-3,4,1,53,1,1369.001,1442.207,2013,15,0,0,0,1,0,541
49ers,7,10,3,13,0,0,33,Buccaneers,0,7,0,7,0,0,14,201315,7,10,13,19,47,-19,1667.307,1441.925,2013,15,0,0,0,1,0,2396
Patriots,3,7,0,10,0,0,20,Dolphins,0,7,3,14,0,0,24,201315,-3,-3,0,4,44,4,1663.533,1532.528,2013,15,0,0,0,1,1,1241
Eagles,3,6,13,8,0,0,30,Vikings,7,10,10,21,0,0,48,201315,4,8,5,18,78,18,1536.437,1436.562,2013,15,0,0,0,1,0,983
Texans,3,0,0,0,0,0,3,Colts,7,13,5,0,0,0,25,201315,4,17,22,22,28,22,1358.029,1511.433,2013,15,0,0,0,1,1,865
Bears,0,3,8,0,0,0,11,Eagles,21,3,9,21,0,0,54,201316,21,21,22,43,65,43,1546.677,1503.525,2013,16,0,0,0,1,0,664
Patriots,14,3,3,21,0,0,41,Ravens,0,0,0,7,0,0,7,201316,14,17,20,34,48,-34,1643.826,1598.678,2013,16,0,0,0,1,0,350
Raiders,0,10,0,3,0,0,13,Chargers,3,7,10,6,0,0,26,201316,3,0,10,13,39,13,1319.158,1538.669,2013,16,0,0,0,1,1,454
Steelers,7,3,21,7,0,0,38,Packers,7,7,7,10,0,0,31,201316,0,-4,10,7,69,-7,1520.748,1506.267,2013,16,0,0,0,0,0,496
Cardinals,0,3,3,11,0,0,17,Seahawks,0,3,0,7,0,0,10,201316,0,0,3,7,27,-7,1548.501,1729.149,2013,16,0,0,0,1,1,1114
Giants,3,10,0,7,3,0,23,Lions,0,3,9,8,0,0,20,201316,3,10,1,3,43,-3,1459.036,1479.593,2013,16,0,0,0,1,0,480
Broncos,3,13,0,21,0,0,37,Texans,3,3,7,0,0,0,13,201316,0,10,3,24,50,-24,1668.466,1345.396,2013,16,0,0,0,1,0,878
Falcons,0,10,0,14,0,0,24,49ers,3,0,10,21,0,0,34,201316,3,-7,3,10,58,10,1446.264,1683.184,2013,16,0,0,0,1,0,2135
Saints,0,6,0,7,0,0,13,Panthers,0,7,3,7,0,0,17,201316,0,1,4,4,30,4,1610.175,1621.949,2013,16,0,0,0,1,1,648
Cowboys,7,7,0,10,0,0,24,Washington,3,3,14,3,0,0,23,201316,4,8,-6,1,47,-1,1506.199,1364.945,2013,16,0,0,0,1,1,1181
Browns,3,7,0,3,0,0,13,Jets,0,10,0,14,0,0,24,201316,-3,0,0,11,37,11,1358.658,1386.527,2013,16,0,0,0,1,0,403
Buccaneers,7,3,3,0,0,0,13,Rams,0,14,3,6,0,0,23,201316,-7,4,4,10,36,10,1426.049,1514.815,2013,16,0,0,0,1,0,861
Colts,0,13,10,0,0,0,23,Chiefs,7,0,0,0,0,0,7,201316,-7,6,16,16,30,-16,1524.066,1554.227,2013,16,0,0,0,1,0,451
Vikings,7,0,7,0,0,0,14,Bengals,14,14,14,0,0,0,42,201316,7,21,28,28,56,28,1469.474,1596.756,2013,16,0,0,0,0,0,604
Dolphins,0,0,0,0,0,0,0,Bills,3,7,0,9,0,0,19,201316,3,10,10,19,19,19,1552.235,1399.779,2013,16,0,0,0,1,1,1184
Titans,3,3,7,7,0,0,20,Jaguars,7,6,3,0,0,0,16,201316,-4,-7,-3,4,36,-4,1424.165,1309.495,2013,16,0,0,0,1,1,500
Eagles,3,14,0,7,0,0,24,Cowboys,0,10,6,6,0,0,22,201317,3,7,1,2,46,-2,1538.642,1511.451,2013,17,0,0,0,1,1,1297
Rams,0,0,3,6,0,0,9,Seahawks,7,6,7,7,0,0,27,201317,7,13,17,18,36,18,1527.909,1691.489,2013,17,0,0,0,1,1,1720
Chiefs,14,7,3,0,0,0,24,Chargers,7,7,0,10,3,0,27,201317,-7,-7,-10,3,51,3,1516.7,1546.276,2013,17,0,0,0,1,1,1334
49ers,17,0,0,6,0,0,23,Cardinals,0,7,0,13,0,0,20,201317,17,10,10,3,43,-3,1689.491,1586.16,2013,17,0,0,0,1,1,652
Buccaneers,7,7,3,0,0,0,17,Saints,14,14,7,7,0,0,42,201317,7,14,18,25,59,25,1412.955,1598.005,2013,17,0,0,0,1,1,480
Bills,3,0,7,10,0,0,20,Patriots,6,10,0,18,0,0,34,201317,3,13,6,14,54,14,1438.668,1681.751,2013,17,0,0,0,1,1,404
Broncos,14,17,0,3,0,0,34,Raiders,0,0,0,14,0,0,14,201317,14,31,31,20,48,-20,1679.102,1311.551,2013,17,0,0,0,1,1,939
Packers,0,13,7,13,0,0,33,Bears,7,0,14,7,0,0,28,201317,-7,6,-1,5,61,-5,1481.911,1511.561,2013,17,0,0,0,1,1,185
Washington,0,6,0,0,0,0,6,Giants,0,10,7,3,0,0,20,201317,0,4,11,14,26,14,1359.693,1476.942,2013,17,0,0,0,1,1,204
Lions,0,0,7,6,0,0,13,Vikings,7,0,0,7,0,0,14,201317,7,7,0,1,27,1,1461.687,1454.086,2013,17,0,0,0,1,1,542
Jets,0,14,0,6,0,0,20,Dolphins,0,7,0,0,0,0,7,201317,0,7,7,13,27,-13,1404.144,1513.347,2013,17,0,0,0,1,1,1091
Jaguars,0,3,0,7,0,0,10,Colts,17,3,7,3,0,0,30,201317,17,17,24,20,40,20,1295.991,1561.593,2013,17,0,0,0,1,1,699
Texans,7,0,0,3,0,0,10,Titans,0,6,7,3,0,0,16,201317,-7,-1,6,6,26,6,1334.76,1437.669,2013,17,0,0,0,1,1,665
Panthers,0,14,7,0,0,0,21,Falcons,7,3,7,3,0,0,20,201317,-7,4,4,1,41,-1,1634.119,1439.956,2013,17,0,0,0,1,1,226
Browns,0,0,0,7,0,0,7,Steelers,7,7,3,3,0,0,20,201317,7,14,17,13,27,13,1341.041,1545.104,2013,17,0,0,0,1,1,114
Ravens,6,0,11,0,0,0,17,Bengals,7,10,0,17,0,0,34,201317,1,11,0,17,51,17,1560.753,1612.144,2013,17,0,0,0,1,1,419
Chiefs,10,21,10,3,0,0,44,Colts,7,3,21,14,0,0,45,201318,-3,-21,-10,1,89,1,1506.94,1568.462,2013,18,1,0,0,1,0,451
Saints,0,6,14,6,0,0,26,Eagles,0,7,7,10,0,0,24,201318,0,-1,6,2,50,-2,1609.218,1551.032,2013,18,1,0,0,1,0,1088
Chargers,7,0,10,10,0,0,27,Bengals,0,10,0,0,0,0,10,201318,7,-3,7,17,37,-17,1556.036,1630.728,2013,18,1,0,0,1,0,1871
49ers,6,7,0,10,0,0,23,Packers,0,10,0,10,0,0,20,201318,6,3,3,3,43,-3,1701.619,1505.612,2013,18,1,0,0,1,0,1834
Chargers,0,0,0,17,0,0,17,Broncos,7,7,3,7,0,0,24,201319,7,14,17,7,41,7,1598.681,1687.083,2013,19,1,0,1,1,1,832
49ers,6,7,7,3,0,0,23,Panthers,0,10,0,0,0,0,10,201319,6,3,10,13,33,-13,1709.991,1638.339,2013,19,1,0,1,1,0,2296
Colts,7,5,10,0,0,0,22,Patriots,14,7,8,14,0,0,43,201319,7,9,7,21,65,21,1572.73,1688.645,2013,19,1,0,1,1,0,805
Saints,0,0,0,15,0,0,15,Seahawks,6,10,0,7,0,0,23,201319,6,16,16,8,38,8,1620.454,1702.773,2013,19,1,0,1,1,0,2098
Patriots,0,3,0,13,0,0,16,Broncos,3,10,7,6,0,0,26,201320,3,10,17,10,42,10,1703.547,1698.457,2013,20,1,0,0,1,0,1769
49ers,3,7,7,0,0,0,17,Seahawks,0,3,10,10,0,0,23,201320,-3,-7,-4,6,40,6,1735.798,1715.123,2013,20,1,0,0,1,1,679
Seahawks,8,14,14,7,0,0,43,Broncos,0,0,8,0,0,0,8,201322,8,22,28,35,51,-35,1731.777,1717.814,2013,22,1,1,1,0,0,1019
Chargers,0,3,14,0,0,0,17,Cardinals,0,6,0,12,0,0,18,201401,0,3,-11,1,35,1,1559.872,1551.021,2014,1,0,0,0,0,0,298
Giants,0,7,0,7,0,0,14,Lions,14,0,13,8,0,0,35,201401,14,7,20,21,49,21,1494.944,1472.359,2014,1,0,0,0,1,0,480
Colts,0,7,3,14,0,0,24,Broncos,3,21,0,7,0,0,31,201401,3,17,14,7,55,7,1540.218,1624.09,2014,1,0,0,0,1,0,998
Panthers,0,10,0,10,0,0,20,Buccaneers,0,0,0,14,0,0,14,201401,0,10,10,6,34,-6,1576.688,1436.161,2014,1,0,0,0,1,1,511
49ers,21,7,0,0,0,0,28,Cowboys,3,0,7,7,0,0,17,201401,18,25,18,11,45,-11,1647.763,1501.041,2014,1,0,0,0,1,0,1480
Washington,0,6,0,0,0,0,6,Texans,0,14,0,3,0,0,17,201401,0,8,8,11,23,11,1399.479,1384.864,2014,1,0,0,0,0,0,1217
Browns,3,0,14,10,0,0,27,Steelers,10,17,0,3,0,0,30,201401,7,24,10,3,57,3,1390.199,1537.231,2014,1,0,0,0,1,1,114
Bengals,6,9,0,8,0,0,23,Ravens,0,0,7,9,0,0,16,201401,6,15,8,7,39,-7,1560.389,1529.779,2014,1,0,0,0,1,1,419
Raiders,7,0,0,7,0,0,14,Jets,3,7,3,6,0,0,19,201401,-4,3,6,5,33,5,1370.713,1465.72,2014,1,0,0,0,1,0,2557
Patriots,10,10,0,0,0,0,20,Dolphins,7,3,13,10,0,0,33,201401,-3,-10,3,13,53,13,1624.459,1482.607,2014,1,0,0,0,1,1,1241
Vikings,3,10,7,14,0,0,34,Rams,0,0,3,3,0,0,6,201401,3,13,17,28,40,-28,1474.824,1512.75,2014,1,0,0,0,1,0,466
Titans,0,10,10,6,0,0,26,Chiefs,0,3,0,7,0,0,10,201401,0,7,17,16,36,-16,1466.756,1503.448,2014,1,0,0,0,1,0,471
Bills,7,10,0,3,3,0,23,Bears,7,0,10,3,0,0,20,201401,0,10,0,3,43,-3,1456.183,1493.573,2014,1,0,0,0,0,0,453
Saints,6,14,0,14,0,0,34,Falcons,0,10,14,10,3,0,37,201401,-6,-10,4,3,71,3,1573.737,1458.825,2014,1,0,0,0,1,1,424
Packers,7,3,0,6,0,0,16,Seahawks,3,14,5,14,0,0,36,201401,-4,7,12,20,52,20,1499.827,1678.971,2014,1,0,0,0,1,0,1645
Jaguars,14,3,0,0,0,0,17,Eagles,0,0,14,20,0,0,34,201401,-14,-17,-3,17,51,17,1361.082,1528.197,2014,1,0,0,0,0,0,758
Seahawks,7,7,7,0,0,0,21,Chargers,3,17,7,3,0,0,30,201402,-4,6,6,9,51,9,1689.766,1554.196,2014,2,0,0,0,0,0,1063
Eagles,3,3,14,10,0,0,30,Colts,7,10,3,7,0,0,27,201402,-4,-11,0,3,57,-3,1539.081,1528.612,2014,2,0,0,0,0,0,582
Bears,0,7,0,21,0,0,28,49ers,10,7,3,0,0,0,20,201402,-10,-10,-13,8,48,-8,1474.868,1666.188,2014,2,0,0,0,1,0,1853
Texans,14,3,10,3,0,0,30,Raiders,0,0,0,14,0,0,14,201402,14,17,27,16,44,-16,1405.658,1361.201,2014,2,0,0,0,1,0,1635
Jets,14,7,3,0,0,0,24,Packers,3,13,15,0,0,0,31,201402,-11,-5,7,7,55,7,1475.232,1489.032,2014,2,0,0,0,0,0,758
Chiefs,3,7,0,7,0,0,17,Broncos,7,14,0,3,0,0,24,201402,4,11,11,7,41,7,1465.288,1635.697,2014,2,0,0,0,1,1,556
Rams,7,3,3,6,0,0,19,Buccaneers,7,0,7,3,0,0,17,201402,0,3,-1,2,36,-2,1467.255,1421.375,2014,2,0,0,0,1,0,861
Lions,0,0,7,0,0,0,7,Panthers,0,6,7,11,0,0,24,201402,0,6,6,17,31,17,1499.001,1591.474,2014,2,0,0,0,1,0,504
Dolphins,0,0,10,0,0,0,10,Bills,6,3,14,6,0,0,29,201402,6,9,13,19,39,19,1515.905,1474.887,2014,2,0,0,0,1,1,1184
Cardinals,10,0,0,15,0,0,25,Giants,0,7,7,0,0,0,14,201402,10,3,-4,11,39,-11,1556.697,1468.302,2014,2,0,0,0,1,0,2139
Patriots,10,14,3,3,0,0,30,Vikings,7,0,0,0,0,0,7,201402,3,17,20,23,37,-23,1591.162,1520.319,2014,2,0,0,0,0,0,1128
Cowboys,3,13,7,3,0,0,26,Titans,0,0,10,0,0,0,10,201402,3,16,13,16,36,-16,1482.616,1504.915,2014,2,0,0,0,0,0,616
Saints,0,10,7,7,0,0,24,Browns,10,6,7,3,0,0,26,201402,10,6,6,2,50,2,1557.528,1384.438,2014,2,0,0,0,0,0,924
Falcons,3,0,0,7,0,0,10,Bengals,3,7,14,0,0,0,24,201402,0,7,21,14,34,14,1475.033,1583.598,2014,2,0,0,0,0,0,374
Steelers,0,3,3,0,0,0,6,Ravens,7,3,7,9,0,0,26,201402,7,7,11,20,32,20,1542.992,1506.57,2014,2,0,0,0,1,1,196
Jaguars,0,7,0,3,0,0,10,Washington,7,14,3,17,0,0,41,201402,7,14,17,31,51,31,1350.198,1378.685,2014,2,0,0,0,0,0,647
49ers,7,7,0,0,0,0,14,Cardinals,3,3,14,3,0,0,23,201403,-4,-8,6,9,37,9,1625.705,1579.632,2014,3,0,0,0,1,1,652
Colts,10,20,0,14,0,0,44,Jaguars,0,0,3,14,0,0,17,201403,10,30,27,27,61,-27,1512.183,1325.689,2014,3,0,0,0,1,1,699
Bears,14,3,7,3,0,0,27,Jets,3,10,3,3,0,0,19,201403,11,4,8,8,46,-8,1515.351,1459.633,2014,3,0,0,0,0,0,711
Washington,14,6,7,7,0,0,34,Eagles,7,14,6,10,0,0,37,201403,-7,1,0,3,71,3,1403.194,1555.509,2014,3,0,0,0,1,1,123
Broncos,3,0,0,17,0,0,20,Seahawks,3,14,0,3,6,0,26,201403,0,14,14,6,46,6,1643.4,1661.21,2014,3,0,0,0,0,0,1019
Steelers,3,6,14,14,0,0,37,Panthers,3,0,3,13,0,0,19,201403,0,6,17,18,56,-18,1515.404,1606.996,2014,3,0,0,0,0,0,363
Chiefs,0,14,7,13,0,0,34,Dolphins,0,3,12,0,0,0,15,201403,0,11,6,19,49,-19,1457.585,1488.313,2014,3,0,0,0,1,0,1242
Texans,0,0,10,7,0,0,17,Giants,0,14,3,13,0,0,30,201403,0,14,7,13,47,13,1435.946,1445.368,2014,3,0,0,0,0,0,1417
Ravens,3,7,7,6,0,0,23,Browns,7,0,14,0,0,0,21,201403,-4,3,-4,2,44,-2,1534.158,1399.474,2014,3,0,0,0,1,1,307
Raiders,3,0,6,0,0,0,9,Patriots,0,10,0,6,0,0,16,201403,-3,7,1,7,25,7,1330.913,1622.325,2014,3,0,0,0,1,0,2690
Cowboys,0,10,10,14,0,0,34,Rams,7,14,0,10,0,0,31,201403,-7,-11,-1,3,65,-3,1519.379,1478.947,2014,3,0,0,0,1,0,547
Packers,7,0,0,0,0,0,7,Lions,7,5,0,7,0,0,19,201403,0,5,5,12,26,12,1504.631,1483.479,2014,3,0,0,0,1,1,291
Titans,0,0,0,7,0,0,7,Bengals,10,9,7,7,0,0,33,201403,10,19,26,26,40,26,1468.151,1597.108,2014,3,0,0,0,1,0,243
Chargers,7,6,7,2,0,0,22,Bills,0,3,7,0,0,0,10,201403,7,10,10,12,32,-12,1582.751,1502.479,2014,3,0,0,0,1,0,2183
Buccaneers,0,0,0,14,0,0,14,Falcons,21,14,21,0,0,0,56,201403,21,35,56,42,70,42,1409.683,1461.523,2014,3,0,0,0,1,1,416
Vikings,0,6,3,0,0,0,9,Saints,13,0,0,7,0,0,20,201403,13,7,4,11,29,11,1489.155,1542.491,2014,3,0,0,0,1,0,1052
Patriots,0,0,7,7,0,0,14,Chiefs,7,10,10,14,0,0,41,201404,7,17,20,27,55,27,1626.401,1497.323,2014,4,0,0,0,1,0,1249
Saints,0,0,3,14,0,0,17,Cowboys,7,17,7,7,0,0,38,201404,7,24,28,21,55,21,1558.337,1534.389,2014,4,0,0,0,1,0,442
Eagles,7,14,0,0,0,0,21,49ers,3,10,10,3,0,0,26,201404,-4,-8,2,5,47,5,1561.124,1604.118,2014,4,0,0,0,1,0,2516
Falcons,7,7,14,0,0,0,28,Vikings,14,10,3,14,0,0,41,201404,7,10,-1,13,69,13,1485.661,1473.309,2014,4,0,0,0,1,0,908
Jaguars,0,14,0,0,0,0,14,Chargers,3,14,10,6,0,0,33,201404,3,3,13,19,47,19,1304.724,1607.105,2014,4,0,0,0,1,0,2087
Bills,0,10,0,7,0,0,17,Texans,0,7,10,6,0,0,23,201404,0,-3,7,6,40,6,1478.125,1415.805,2014,4,0,0,0,1,0,1285
Panthers,0,7,3,0,0,0,10,Ravens,0,21,7,10,0,0,38,201404,0,14,18,28,48,28,1561.902,1542.7,2014,4,0,0,0,0,0,364
Buccaneers,10,0,7,10,0,0,27,Steelers,10,7,7,0,0,0,24,201404,0,-7,-7,3,51,-3,1385.545,1560.498,2014,4,0,0,0,0,0,874
Lions,3,14,0,7,0,0,24,Jets,3,0,7,7,0,0,17,201404,0,14,7,7,41,-7,1505.47,1436.978,2014,4,0,0,0,0,0,480
Dolphins,3,21,14,0,0,0,38,Raiders,7,0,0,7,0,0,14,201404,-4,17,31,24,52,-24,1326.837,1448.575,2014,4,0,0,0,1,0,2582
Titans,0,10,7,0,0,0,17,Colts,14,6,14,7,0,0,41,201404,14,10,17,24,58,24,1453.21,1533.148,2014,4,0,0,0,1,1,251
Packers,7,14,10,7,0,0,38,Bears,7,10,0,0,0,0,17,201404,0,4,14,21,55,-21,1482.639,1538.006,2014,4,0,0,0,1,1,185
Giants,7,17,7,14,0,0,45,Washington,0,7,7,0,0,0,14,201404,7,17,17,31,59,-31,1465.509,1397.579,2014,4,0,0,0,1,1,204
Seahawks,7,10,0,10,0,0,27,Washington,0,7,3,7,0,0,17,201405,7,10,7,10,44,-10,1675.576,1363.259,2014,5,0,1,0,1,0,2322
Bengals,0,3,14,0,0,0,17,Patriots,14,6,14,9,0,0,43,201405,14,17,17,26,60,26,1612.049,1585.82,2014,5,0,1,0,1,0,732
Chiefs,7,3,7,0,0,0,17,49ers,3,10,3,6,0,0,22,201405,-4,3,-1,5,39,5,1537.904,1616.053,2014,5,0,0,0,0,0,1503
Jets,0,0,0,0,0,0,0,Chargers,7,14,7,3,0,0,31,201405,7,21,28,31,31,31,1416.425,1612.632,2014,5,0,0,0,1,0,2427
Cardinals,6,7,7,0,0,0,20,Broncos,7,14,3,17,0,0,41,201405,1,8,4,21,61,21,1601.219,1629.034,2014,5,0,1,1,0,0,585
Steelers,0,10,0,7,0,0,17,Jaguars,3,3,3,0,0,0,9,201405,-3,4,1,8,26,-8,1535.627,1299.196,2014,5,0,0,0,1,0,704
Bears,14,7,3,0,0,0,24,Panthers,7,7,7,10,0,0,31,201405,-7,-7,-3,7,55,7,1494.41,1533.239,2014,5,0,0,0,1,0,586
Vikings,0,0,0,10,0,0,10,Packers,14,14,14,0,0,0,42,201405,14,28,42,32,52,32,1495.207,1526.235,2014,5,0,0,0,1,1,259
Falcons,7,6,7,0,0,0,20,Giants,7,3,7,13,0,0,30,201405,0,-3,-3,10,50,10,1463.763,1499.828,2014,5,0,0,0,1,0,745
Buccaneers,0,10,14,7,0,0,31,Saints,6,7,7,11,6,0,37,201405,6,3,-4,6,68,6,1410.416,1531.562,2014,5,0,0,0,1,1,480
Ravens,0,3,0,10,0,0,13,Colts,3,3,7,7,0,0,20,201405,3,3,10,7,33,7,1571.363,1551.432,2014,5,0,0,0,1,0,509
Browns,0,10,3,16,0,0,29,Titans,7,21,0,0,0,0,28,201405,-7,-18,-15,1,57,-1,1390.933,1434.925,2014,5,0,1,0,1,0,458
Bills,0,3,3,11,0,0,17,Lions,7,7,0,0,0,0,14,201405,-7,-11,-8,3,31,-3,1458.84,1526.023,2014,5,0,0,0,0,0,215
Texans,0,0,7,10,0,0,17,Cowboys,0,3,7,7,3,0,20,201405,0,3,3,3,37,3,1435.091,1561.164,2014,5,0,0,0,0,0,225
Rams,0,7,7,14,0,0,28,Eagles,13,7,14,0,0,0,34,201405,13,13,20,6,62,6,1463.938,1549.189,2014,5,0,1,0,1,0,808
Chargers,7,7,7,10,0,0,31,Raiders,7,7,7,7,0,0,28,201406,0,0,0,3,59,-3,1623.902,1306.606,2014,6,0,0,1,1,1,454
49ers,0,10,14,7,0,0,31,Rams,14,0,0,3,0,0,17,201406,-14,-4,10,14,48,-14,1626.312,1453.143,2014,6,0,0,0,1,1,1741
Giants,0,0,0,0,0,0,0,Eagles,10,10,7,0,0,0,27,201406,10,20,27,27,27,27,1516.267,1559.984,2014,6,0,0,0,1,1,80
Cowboys,7,10,3,10,0,0,30,Seahawks,10,0,10,3,0,0,23,201406,-3,7,0,7,53,-7,1567.535,1683.944,2014,6,0,0,0,1,0,1679
Washington,0,13,0,7,0,0,20,Cardinals,7,7,3,13,0,0,30,201406,7,1,4,10,50,10,1354.892,1579.299,2014,6,0,0,0,1,0,1977
Bears,0,13,6,8,0,0,27,Falcons,3,0,10,0,0,0,13,201406,-3,10,6,14,40,-14,1480.317,1447.324,2014,6,0,0,0,1,0,587
Ravens,28,10,7,3,0,0,48,Buccaneers,0,0,10,7,0,0,17,201406,28,38,35,31,65,-31,1553.614,1401.262,2014,6,0,0,0,0,0,852
Broncos,3,14,7,7,0,0,31,Jets,7,0,3,7,0,0,17,201406,-4,10,14,14,48,-14,1650.953,1405.156,2014,6,0,0,0,1,0,1627
Lions,7,3,0,7,0,0,17,Vikings,0,0,0,3,0,0,3,201406,7,10,10,14,20,-14,1505.919,1470.735,2014,6,0,0,0,1,1,542
Packers,7,3,7,10,0,0,27,Dolphins,3,0,7,14,0,0,24,201406,4,7,7,3,51,-3,1550.707,1468.806,2014,6,0,0,1,0,0,1366
Jaguars,7,0,0,7,0,0,14,Titans,3,7,3,3,0,0,16,201406,-4,3,6,2,30,2,1288.126,1425.417,2014,6,0,0,0,1,1,500
Steelers,3,0,0,7,0,0,10,Browns,0,21,3,7,0,0,31,201406,-3,18,21,21,41,21,1546.697,1400.441,2014,6,0,0,0,1,1,114
Panthers,7,3,14,10,3,0,37,Bengals,0,17,0,17,3,0,37,201406,7,-7,7,0,74,0,1547.332,1583.261,2014,6,0,0,0,0,0,336
Patriots,0,13,10,14,0,0,37,Bills,0,7,7,8,0,0,22,201406,0,6,9,15,59,-15,1614.608,1478.944,2014,6,0,0,0,1,1,404
Colts,24,3,6,0,0,0,33,Texans,0,14,7,7,0,0,28,201406,24,13,12,5,61,-5,1569.181,1428.719,2014,6,0,0,0,1,1,865
49ers,0,10,0,7,0,0,17,Broncos,14,7,21,0,0,0,42,201407,14,11,32,25,59,25,1644.337,1664.016,2014,7,0,0,0,0,0,947
Cardinals,7,7,7,3,0,0,24,Raiders,0,10,3,0,0,0,13,201407,7,4,8,11,37,-11,1586.037,1301.889,2014,7,0,0,0,0,0,646
Giants,0,14,0,7,0,0,21,Cowboys,7,7,7,10,0,0,31,201407,7,0,7,10,52,10,1494.138,1601.062,2014,7,0,0,0,1,1,1370
Chiefs,0,10,3,10,0,0,23,Chargers,7,7,0,6,0,0,20,201407,-7,-4,-1,3,43,-3,1527.645,1628.619,2014,7,0,1,0,1,1,1334
Falcons,0,0,0,7,0,0,7,Ravens,7,10,3,9,0,0,29,201407,7,17,20,22,36,22,1417.32,1578.74,2014,7,0,0,0,0,0,576
Browns,3,3,0,0,0,0,6,Jaguars,0,7,3,14,0,0,24,201407,-3,1,4,18,30,18,1439.91,1283.34,2014,7,0,0,0,1,0,771
Titans,3,7,0,7,0,0,17,Washington,3,3,7,6,0,0,19,201407,0,-4,3,2,36,2,1430.203,1348.155,2014,7,0,0,0,0,0,566
Texans,7,6,0,10,0,0,23,Steelers,0,24,0,6,0,0,30,201407,-7,11,11,7,53,7,1415.1,1507.228,2014,7,0,0,0,1,0,1136
Bengals,0,0,0,0,0,0,0,Colts,3,7,7,10,0,0,27,201407,3,10,17,27,27,27,1578.952,1582.8,2014,7,0,0,0,1,0,99
Panthers,0,3,0,14,0,0,17,Packers,21,7,10,0,0,0,38,201407,21,25,35,21,55,21,1551.642,1563.795,2014,7,0,0,0,1,0,745
Saints,0,10,7,6,0,0,23,Lions,0,3,7,14,0,0,24,201407,0,-7,-7,1,47,1,1540.716,1535.721,2014,7,0,1,0,1,0,939
Dolphins,7,7,7,6,0,0,27,Bears,0,0,7,7,0,0,14,201407,7,14,14,13,41,-13,1455.717,1510.321,2014,7,0,0,0,0,0,1189
Vikings,3,10,0,3,0,0,16,Bills,0,10,0,7,0,0,17,201407,-3,-3,-3,1,33,1,1440.933,1457.471,2014,7,0,0,0,0,0,729
Jets,6,6,7,6,0,0,25,Patriots,7,10,3,7,0,0,27,201407,1,5,1,2,52,2,1392.093,1636.082,2014,7,0,0,0,1,1,181
Seahawks,3,3,7,13,0,0,26,Rams,7,14,0,7,0,0,28,201407,4,15,8,2,54,2,1650.417,1435.118,2014,7,0,0,0,1,1,1720
Washington,3,0,7,7,3,0,20,Cowboys,0,7,3,7,0,0,17,201408,3,-4,0,3,37,-3,1359.769,1613.116,2014,8,0,0,0,1,1,1181
Packers,10,6,0,7,0,0,23,Saints,10,6,14,14,0,0,44,201408,0,0,14,21,67,21,1587.134,1535.122,2014,8,0,0,0,1,0,1012
Colts,3,17,14,0,0,0,34,Steelers,7,28,7,9,0,0,51,201408,4,15,8,17,85,17,1608.79,1518.412,2014,8,0,0,0,1,0,328
Raiders,0,6,0,7,0,0,13,Browns,6,3,0,14,0,0,23,201408,6,3,3,10,36,10,1291.914,1401.271,2014,8,0,0,0,1,0,2153
Eagles,7,0,10,3,0,0,20,Cardinals,0,7,7,10,0,0,24,201408,-7,0,-3,4,44,4,1582.113,1596.012,2014,8,0,1,0,1,0,2078
Dolphins,0,10,14,3,0,0,27,Jaguars,0,3,3,7,0,0,13,201408,0,7,18,14,40,-14,1492.87,1321.978,2014,8,0,0,0,1,0,327
Seahawks,0,3,3,7,0,0,13,Panthers,3,3,0,3,0,0,9,201408,-3,-3,0,4,22,-4,1633.82,1528.303,2014,8,0,0,0,1,0,2280
Bills,14,10,6,13,0,0,43,Jets,0,17,0,6,0,0,23,201408,14,7,13,20,66,-20,1462.614,1389.31,2014,8,0,0,0,1,1,292
Bears,0,7,8,8,0,0,23,Patriots,7,31,7,6,0,0,51,201408,7,31,30,28,74,28,1473.169,1638.865,2014,8,0,0,0,0,0,853
Rams,7,0,0,0,0,0,7,Chiefs,0,10,10,14,0,0,34,201408,-7,3,13,27,41,27,1451.714,1549.303,2014,8,0,0,0,0,0,237
Texans,0,13,14,3,0,0,30,Titans,3,0,6,7,0,0,16,201408,-3,10,18,14,46,-14,1403.916,1418.588,2014,8,0,0,0,1,1,665
Ravens,0,6,8,10,0,0,24,Bengals,7,0,10,10,0,0,27,201408,7,1,3,3,51,3,1590.884,1552.961,2014,8,0,0,0,1,1,419
Lions,0,0,10,12,0,0,22,Falcons,14,7,0,0,0,0,21,201408,-14,-21,-11,1,43,-1,1405.175,1541.315,2014,8,0,0,0,1,0,597
Chargers,0,7,7,7,0,0,21,Broncos,0,14,14,7,0,0,35,201408,0,7,14,14,56,14,1606.961,1687.891,2014,8,0,0,0,1,1,832
Vikings,0,3,7,3,6,0,19,Buccaneers,0,0,0,13,0,0,13,201408,0,3,10,6,32,-6,1435.789,1376.137,2014,8,0,0,1,1,0,1318
Rams,3,7,0,3,0,0,13,49ers,3,7,0,0,0,0,10,201409,0,0,0,3,23,-3,1434.231,1620.463,2014,9,0,0,1,1,1,1741
Colts,3,13,21,3,0,0,40,Giants,0,3,7,14,0,0,24,201409,3,13,27,16,64,-16,1577.417,1482.085,2014,9,0,0,1,0,0,643
Ravens,7,3,0,13,0,0,23,Steelers,0,22,0,21,0,0,43,201409,-7,12,12,20,66,20,1578.255,1549.786,2014,9,0,0,0,1,1,196
Raiders,3,0,14,7,0,0,24,Seahawks,14,10,0,6,0,0,30,201409,11,21,7,6,54,6,1279.995,1647.789,2014,9,0,0,0,0,0,677
Broncos,7,0,14,0,0,0,21,Patriots,3,24,10,6,0,0,43,201409,-4,20,16,22,64,22,1703.206,1651.635,2014,9,0,0,0,1,0,1769
Eagles,7,10,7,7,0,0,31,Texans,7,7,0,7,0,0,21,201409,0,3,10,10,52,-10,1570.045,1438.347,2014,9,0,0,0,0,0,1339
Washington,3,7,10,6,0,0,26,Vikings,0,7,7,15,0,0,29,201409,-3,-3,-6,3,55,3,1387.715,1455.596,2014,9,0,0,0,1,0,931
Chargers,0,0,0,0,0,0,0,Dolphins,7,13,17,0,0,0,37,201409,7,20,37,37,37,37,1591.646,1511.067,2014,9,0,0,0,1,0,2267
Jets,0,10,0,0,0,0,10,Chiefs,14,7,3,0,0,0,24,201409,14,11,14,14,34,14,1359.704,1566.786,2014,9,0,0,0,1,0,1093
Cardinals,0,14,0,14,0,0,28,Cowboys,10,0,0,7,0,0,17,201409,-10,4,4,11,45,-11,1608.08,1585.17,2014,9,0,0,0,1,0,884
Buccaneers,0,10,7,0,0,0,17,Browns,3,6,7,6,0,0,22,201409,3,-1,-1,5,39,5,1356.33,1413.19,2014,9,0,0,0,0,0,937
Jaguars,3,0,7,13,0,0,23,Bengals,0,12,7,14,0,0,33,201409,-3,9,9,10,56,10,1303.781,1565.59,2014,9,0,0,0,1,0,630
Saints,0,14,7,7,0,0,28,Panthers,0,0,7,3,0,0,10,201409,0,14,14,18,38,-18,1564.703,1514.335,2014,9,0,0,0,1,1,648
Panthers,7,0,0,14,0,0,21,Eagles,17,14,7,7,0,0,45,201410,10,24,31,24,66,24,1483.445,1588.904,2014,10,0,0,0,1,0,450
Bears,0,0,7,7,0,0,14,Packers,14,28,6,7,0,0,55,201410,14,42,41,41,69,41,1460.399,1557.553,2014,10,0,1,1,1,1,185
Giants,7,10,0,0,0,0,17,Seahawks,7,7,3,21,0,0,38,201410,0,-3,0,21,55,21,1456.571,1650.276,2014,10,0,0,0,1,0,2401
Rams,7,7,0,0,0,0,14,Cardinals,0,10,0,21,0,0,31,201410,-7,-4,-4,17,45,17,1459.566,1636.468,2014,10,0,0,0,1,1,1270
Broncos,3,17,21,0,0,0,41,Raiders,3,7,0,7,0,0,17,201410,0,10,31,24,58,-24,1673.245,1277.508,2014,10,0,0,0,1,1,939
Titans,7,0,0,0,0,0,7,Ravens,0,7,7,7,0,0,21,201410,-7,0,7,14,28,14,1384.158,1551.444,2014,10,0,1,0,1,0,595
Cowboys,10,14,7,0,0,0,31,Jaguars,7,0,0,10,0,0,17,201410,3,17,24,14,48,-14,1298.259,1556.783,2014,10,0,0,0,0,0,906
Falcons,7,6,3,11,0,0,27,Buccaneers,3,7,0,7,0,0,17,201410,4,3,6,10,44,-10,1401.082,1345.075,2014,10,0,1,0,1,1,416
Steelers,0,3,0,10,0,0,13,Jets,17,0,3,0,0,0,20,201410,17,14,17,7,33,7,1576.596,1351.377,2014,10,0,0,0,1,0,314
49ers,14,7,0,3,3,0,27,Saints,3,7,7,7,0,0,24,201410,11,11,4,3,51,-3,1595.128,1595.592,2014,10,0,0,0,1,0,1921
Dolphins,0,3,10,3,0,0,16,Lions,10,0,0,10,0,0,20,201410,10,7,-3,4,36,4,1549.344,1545.408,2014,10,0,0,1,0,0,1155
Chiefs,3,0,0,14,0,0,17,Bills,7,3,3,0,0,0,13,201410,-4,-7,-10,4,30,-4,1575.113,1492.22,2014,10,0,0,1,1,0,858
Browns,7,10,7,0,0,0,24,Bengals,3,0,0,0,0,0,3,201410,4,14,21,21,27,-21,1424.445,1571.112,2014,10,0,0,0,1,1,217
Steelers,13,0,0,14,0,0,27,Titans,7,10,7,0,0,0,24,201411,6,-4,-11,3,51,-3,1544.502,1373.969,2014,11,0,0,0,1,0,471
Patriots,7,7,14,14,0,0,42,Colts,3,7,3,7,0,0,20,201411,4,4,15,22,62,-22,1681.595,1602.93,2014,11,0,1,1,1,0,805
Lions,3,3,0,0,0,0,6,Cardinals,14,0,0,0,0,0,14,201411,11,8,8,8,20,8,1558.344,1646.833,2014,11,0,0,0,1,0,1687
Eagles,0,6,7,7,0,0,20,Packers,17,13,9,14,0,0,53,201411,17,24,26,33,73,33,1605.194,1577.202,2014,11,0,0,0,1,0,728
Raiders,3,0,0,3,0,0,6,Chargers,7,3,3,0,0,0,13,201411,4,7,10,7,19,7,1270.252,1553.369,2014,11,0,0,1,1,1,454
Falcons,0,6,10,3,0,0,19,Panthers,0,3,0,14,0,0,17,201411,0,3,13,2,36,-2,1425.782,1467.155,2014,11,0,0,0,1,1,226
Buccaneers,10,3,7,7,0,0,27,Washington,0,7,0,0,0,0,7,201411,10,6,13,20,34,-20,1320.375,1379.411,2014,11,0,0,1,1,0,818
Bills,3,3,3,0,0,0,9,Dolphins,3,0,9,10,0,0,22,201411,0,-3,3,13,31,13,1477.077,1536.409,2014,11,0,0,0,1,1,1184
Bengals,7,6,7,7,0,0,27,Saints,3,0,0,7,0,0,10,201411,4,10,17,17,37,-17,1518.32,1578.643,2014,11,0,0,0,0,0,711
Broncos,0,7,0,0,0,0,7,Rams,10,3,3,6,0,0,22,201411,10,6,9,15,29,15,1680.502,1449.202,2014,11,0,0,0,0,0,794
Seahawks,0,13,7,0,0,0,20,Chiefs,7,7,3,7,0,0,24,201411,7,1,-3,4,44,4,1660.456,1590.256,2014,11,0,0,0,0,0,1502
Texans,7,7,3,6,0,0,23,Browns,0,7,0,0,0,0,7,201411,7,7,10,16,30,-16,1419.487,1477.237,2014,11,0,1,0,1,0,1113
Vikings,10,0,0,3,0,0,13,Bears,0,14,0,7,0,0,21,201411,-10,4,4,8,34,8,1463.9,1440.75,2014,11,0,1,0,1,1,355
49ers,3,6,7,0,0,0,16,Giants,7,0,3,0,0,0,10,201411,-4,2,6,6,26,-6,1612.077,1446.391,2014,11,0,0,0,1,0,2565
Rams,3,7,7,7,0,0,24,Chargers,3,3,14,7,0,0,27,201412,0,-4,3,3,51,3,1492.546,1557.635,2014,12,0,0,0,0,0,1561
Ravens,7,7,10,10,0,0,34,Saints,7,10,0,10,0,0,27,201412,0,-3,7,7,61,-7,1561.633,1537.394,2014,12,0,1,0,0,0,999
Jets,3,0,0,0,0,0,3,Bills,7,7,17,7,0,0,38,201412,4,11,28,35,41,35,1383.472,1460.674,2014,12,0,1,0,1,1,292
Cowboys,3,7,14,7,0,0,31,Giants,7,14,0,7,0,0,28,201412,-4,-11,3,3,59,-3,1565.71,1433.03,2014,12,0,1,0,1,1,1370
Washington,0,7,3,3,0,0,13,49ers,7,3,0,7,0,0,17,201412,7,3,0,4,30,4,1336.094,1625.438,2014,12,0,0,0,1,0,2435
Cardinals,0,3,0,0,0,0,3,Seahawks,3,6,10,0,0,0,19,201412,3,6,16,16,22,16,1658.846,1644.082,2014,12,0,0,0,1,1,1114
Bengals,7,2,7,6,0,0,22,Texans,0,3,10,0,0,0,13,201412,7,6,3,9,35,-9,1559.57,1459.675,2014,12,0,0,0,1,0,897
Dolphins,7,14,7,8,0,0,36,Broncos,3,14,0,22,0,0,39,201412,-4,-4,-11,3,75,3,1552.812,1637.157,2014,12,0,0,0,1,0,1724
Lions,3,3,0,3,0,0,9,Patriots,7,17,3,7,0,0,34,201412,4,18,21,25,43,25,1546.33,1711.532,2014,12,0,0,0,0,0,615
Packers,7,7,3,7,0,0,24,Vikings,0,10,3,8,0,0,21,201412,7,4,4,3,45,-3,1608.202,1444.922,2014,12,0,0,0,1,1,259
Titans,0,17,0,7,0,0,24,Eagles,17,10,7,9,0,0,43,201412,17,10,17,19,67,19,1364.639,1574.194,2014,12,0,0,0,0,0,683
Jaguars,3,0,0,0,0,0,3,Colts,3,3,14,3,0,0,23,201412,0,3,17,20,26,20,1289.332,1572.994,2014,12,0,1,0,1,1,699
Buccaneers,0,10,0,3,0,0,13,Bears,0,0,21,0,0,0,21,201412,0,-10,11,8,34,8,1363.692,1459.727,2014,12,0,0,0,1,0,1004
Browns,7,6,10,3,0,0,26,Falcons,7,7,0,10,0,0,24,201412,0,-1,9,2,50,-2,1437.05,1440.755,2014,12,0,0,0,0,0,555
Chiefs,0,3,7,10,0,0,20,Raiders,7,7,3,7,0,0,24,201412,7,11,7,4,44,4,1606.63,1265.986,2014,12,0,0,0,1,1,1495
Broncos,14,6,3,6,0,0,29,Chiefs,0,7,3,6,0,0,16,201413,14,13,13,13,45,-13,1644.879,1576.08,2014,13,0,0,0,1,1,556
Patriots,0,14,0,7,0,0,21,Packers,13,10,0,3,0,0,26,201413,13,9,9,5,47,5,1723.917,1617.816,2014,13,0,0,0,0,0,869
Cardinals,0,10,0,8,0,0,18,Falcons,17,3,3,6,0,0,29,201413,17,10,13,11,47,11,1635.124,1427.201,2014,13,0,0,0,1,0,1588
Titans,0,0,14,7,0,0,21,Texans,14,10,7,14,0,0,45,201413,14,24,17,24,66,24,1355.545,1439.278,2014,13,0,0,0,1,1,665
Chargers,7,3,3,21,0,0,34,Ravens,10,6,7,10,0,0,33,201413,-3,-6,-10,1,67,-1,1566.04,1585.294,2014,13,0,0,0,1,0,2291
Giants,0,21,0,3,0,0,24,Jaguars,0,3,13,9,0,0,25,201413,0,-18,-5,1,49,1,1422.168,1283.105,2014,13,0,0,0,0,0,835
Bengals,0,7,7,0,0,0,14,Buccaneers,3,7,0,3,0,0,13,201413,-3,-3,4,1,27,-1,1579.967,1352.082,2014,13,0,0,0,0,0,783
Dolphins,0,3,3,10,0,0,16,Jets,7,3,3,0,0,0,13,201413,-7,-7,-7,3,29,-3,1545.09,1362.868,2014,13,0,0,0,1,1,1091
Panthers,3,3,7,0,0,0,13,Vikings,14,14,0,3,0,0,31,201413,11,22,15,18,44,18,1452.183,1435.309,2014,13,0,1,0,1,0,938
Raiders,0,0,0,0,0,0,0,Rams,21,17,0,14,0,0,52,201413,21,38,38,52,52,52,1296.535,1484.141,2014,13,0,0,0,0,0,1733
Washington,3,7,14,3,0,0,27,Colts,7,14,21,7,0,0,49,201413,4,11,18,22,76,22,1332.903,1579.22,2014,13,0,0,0,0,0,490
Browns,3,0,0,7,0,0,10,Bills,0,0,14,12,0,0,26,201413,-3,-3,11,16,36,16,1450.604,1481.278,2014,13,0,0,0,1,0,173
Seahawks,7,6,3,3,0,0,19,49ers,0,0,3,0,0,0,3,201413,7,13,13,16,22,-16,1667.804,1628.629,2014,13,0,0,0,1,1,679
Eagles,14,9,7,3,0,0,33,Cowboys,0,7,3,0,0,0,10,201413,14,16,20,23,43,-23,1583.289,1576.572,2014,13,0,0,0,1,1,1297
Bears,14,0,3,0,0,0,17,Lions,3,21,0,10,0,0,34,201413,-11,10,7,17,51,17,1471.337,1533.945,2014,13,0,0,0,1,1,238
Saints,0,14,14,7,0,0,35,Steelers,3,3,7,19,0,0,32,201413,-3,8,15,3,67,-3,1513.732,1553.831,2014,13,0,0,1,0,0,919
Falcons,7,0,10,20,0,0,37,Packers,7,24,3,9,0,0,43,201414,0,24,17,6,80,6,1464.131,1638.224,2014,14,0,0,0,1,0,768
Patriots,3,10,0,10,0,0,23,Chargers,0,14,0,0,0,0,14,201414,3,-1,-1,9,37,-9,1703.509,1574.961,2014,14,0,0,0,1,0,2580
Seahawks,0,10,14,0,0,0,24,Eagles,7,0,7,0,0,0,14,201414,-7,3,10,10,38,-10,1698.6,1621.36,2014,14,0,0,0,1,0,2373
49ers,7,3,3,0,0,0,13,Raiders,3,7,7,7,0,0,24,201414,-4,0,4,11,37,11,1597.833,1283.047,2014,14,0,0,0,0,0,8
Chiefs,7,7,0,0,0,0,14,Cardinals,3,3,11,0,0,0,17,201414,-4,-8,3,3,31,3,1550.023,1598.193,2014,14,0,0,0,0,0,1047
Bills,0,3,0,14,0,0,17,Broncos,7,7,10,0,0,0,24,201414,7,11,21,7,41,7,1501.136,1670.936,2014,14,0,0,0,1,0,1366
Texans,3,7,7,10,0,0,27,Jaguars,7,6,0,0,0,0,13,201414,-4,-3,4,14,40,-14,1457.256,1291.785,2014,14,0,0,0,1,1,820
Rams,0,6,18,0,0,0,24,Washington,0,0,0,0,0,0,0,201414,0,6,24,24,24,-24,1497.63,1325.057,2014,14,0,0,0,1,0,708
Panthers,17,7,14,3,0,0,41,Saints,0,3,0,7,0,0,10,201414,17,21,35,31,51,-31,1427.335,1532.565,2014,14,0,0,0,1,1,648
Ravens,0,7,7,14,0,0,28,Dolphins,10,0,0,3,0,0,13,201414,-10,-3,4,15,41,-15,1576.372,1553.973,2014,14,0,0,0,1,0,956
Giants,17,6,10,3,0,0,36,Titans,0,0,7,0,0,0,7,201414,17,23,26,29,43,-29,1413.489,1337.567,2014,14,0,0,0,0,0,758
Buccaneers,0,10,0,7,0,0,17,Lions,7,10,10,7,0,0,34,201414,7,7,17,17,51,17,1348.45,1551.658,2014,14,0,0,0,1,0,994
Colts,0,7,9,9,0,0,25,Browns,7,7,7,3,0,0,24,201414,-7,-7,-5,1,49,-1,1587.066,1430.746,2014,14,0,0,0,1,0,262
Steelers,0,10,7,25,0,0,42,Bengals,0,14,7,0,0,0,21,201414,0,-4,-4,21,63,-21,1534.998,1583.599,2014,14,0,0,0,1,1,252
Cowboys,0,14,21,6,0,0,41,Bears,0,7,0,21,0,0,28,201414,0,7,28,13,69,-13,1538.501,1453.624,2014,14,0,0,0,1,0,802
Jets,12,3,3,6,0,0,24,Vikings,14,7,0,3,6,0,30,201414,2,6,3,6,54,6,1353.986,1460.157,2014,14,0,0,0,0,0,1016
Jaguars,6,6,0,0,0,0,12,Ravens,7,3,7,3,0,0,20,201415,1,-2,5,8,32,8,1273.174,1608.095,2014,15,0,0,0,1,0,681
Cowboys,14,7,7,10,0,0,38,Eagles,0,10,14,3,0,0,27,201415,14,11,4,11,65,-11,1563.16,1598.353,2014,15,0,0,0,1,1,1297
49ers,0,7,0,0,0,0,7,Seahawks,3,0,7,7,0,0,17,201415,3,-4,3,10,24,10,1552.526,1721.606,2014,15,0,0,0,1,1,679
Vikings,7,7,0,0,0,0,14,Lions,0,10,3,3,0,0,16,201415,-7,-4,-1,2,30,2,1469.973,1560.725,2014,15,0,0,0,1,1,542
Broncos,3,6,7,6,0,0,22,Chargers,0,3,0,7,0,0,10,201415,3,6,13,12,32,-12,1678.662,1556.63,2014,15,0,0,0,1,1,832
Jets,0,3,7,6,0,0,16,Titans,3,2,6,0,0,0,11,201415,-3,-2,-1,5,27,-5,1344.17,1304.787,2014,15,0,0,0,1,0,758
Buccaneers,7,3,0,7,0,0,17,Panthers,6,3,7,3,0,0,19,201415,-1,-1,6,2,36,2,1339.383,1481.96,2014,15,0,0,0,1,1,511
Saints,0,14,10,7,0,0,31,Bears,0,0,0,15,0,0,15,201415,0,14,24,16,46,-16,1477.94,1428.964,2014,15,0,0,0,1,0,832
Dolphins,3,10,0,0,0,0,13,Patriots,7,7,24,3,0,0,41,201415,4,1,25,28,54,28,1522.25,1721.84,2014,15,0,0,0,1,1,1241
Raiders,0,3,3,7,0,0,13,Chiefs,7,3,21,0,0,0,31,201415,7,7,25,18,44,18,1328.354,1540.987,2014,15,0,0,0,1,1,1495
Texans,7,0,0,3,0,0,10,Colts,0,14,0,3,0,0,17,201415,-7,7,7,7,27,7,1475.866,1592.011,2014,15,0,0,0,1,1,865
Bengals,10,10,3,7,0,0,30,Browns,0,0,0,0,0,0,0,201415,10,20,23,30,30,-30,1540.713,1425.801,2014,15,0,0,0,1,1,217
Packers,3,7,0,3,0,0,13,Bills,7,3,6,5,0,0,21,201415,4,0,6,8,34,8,1645.301,1493.41,2014,15,0,0,0,0,0,470
Steelers,6,14,0,7,0,0,27,Falcons,0,7,6,7,0,0,20,201415,6,13,7,7,47,-7,1577.885,1457.054,2014,15,0,0,0,0,0,521
Cardinals,0,6,3,3,0,0,12,Rams,3,0,0,3,0,0,6,201415,-3,3,6,6,18,-6,1607.229,1519.109,2014,15,0,0,0,1,1,1270
Washington,3,7,3,0,0,0,13,Giants,7,0,10,7,0,0,24,201415,4,-3,4,11,37,11,1303.578,1446.269,2014,15,0,0,0,1,1,204
Broncos,7,0,21,0,0,0,28,Bengals,7,13,7,10,0,0,37,201416,0,13,-1,9,65,9,1699.596,1569.5,2014,16,0,0,0,1,0,1093
Bills,7,3,0,14,0,0,24,Raiders,0,13,6,7,0,0,26,201416,-7,3,9,2,50,2,1521.89,1319.557,2014,16,0,0,0,1,0,2286
Colts,0,0,0,7,0,0,7,Cowboys,14,14,7,7,0,0,42,201416,14,28,35,35,49,35,1602.026,1596.502,2014,16,0,0,0,0,0,763
Giants,10,10,14,3,0,0,37,Rams,3,10,7,7,0,0,27,201416,7,7,14,10,64,-10,1456.817,1501.132,2014,16,0,0,0,1,0,871
Ravens,0,0,7,6,0,0,13,Texans,3,13,3,6,0,0,25,201416,3,16,12,12,38,12,1611.477,1465.852,2014,16,0,0,0,1,0,1250
Browns,0,3,3,7,0,0,13,Panthers,3,7,0,7,0,0,17,201416,3,7,4,4,30,4,1397.013,1486.626,2014,16,0,0,0,0,0,435
Packers,7,3,0,10,0,0,20,Buccaneers,0,3,0,0,0,0,3,201416,7,7,7,17,23,-17,1616.821,1334.718,2014,16,0,0,0,1,0,1185
Seahawks,0,14,0,21,0,0,35,Cardinals,0,3,3,0,0,0,6,201416,0,11,8,29,41,-29,1730.548,1625.206,2014,16,0,0,0,1,1,1114
Patriots,0,7,3,7,0,0,17,Jets,0,10,3,3,0,0,16,201416,0,-3,-3,1,33,-1,1732.601,1363.633,2014,16,0,0,0,1,1,181
Falcons,3,10,7,10,0,0,30,Saints,7,0,0,7,0,0,14,201416,-4,6,13,16,44,-16,1440.005,1507.796,2014,16,0,0,0,1,1,424
Vikings,7,10,0,18,0,0,35,Dolphins,0,7,7,23,0,0,37,201416,-7,-10,-3,2,72,2,1464.027,1511.489,2014,16,0,0,0,0,0,1513
Lions,7,0,3,10,0,0,20,Bears,0,7,7,0,0,0,14,201416,7,0,-4,6,34,-6,1566.67,1399.109,2014,16,0,0,0,1,1,238
Chargers,0,7,14,14,3,0,38,49ers,7,21,7,0,0,0,35,201416,-7,-21,-14,3,73,-3,1535.696,1543.585,2014,16,0,0,0,0,0,458
Eagles,7,7,0,10,0,0,24,Washington,10,0,14,3,0,0,27,201416,3,-4,10,3,51,3,1565.012,1293.031,2014,16,0,0,0,1,1,123
Titans,7,3,0,3,0,0,13,Jaguars,0,7,7,7,0,0,21,201416,-7,-3,4,8,34,8,1285.324,1269.792,2014,16,0,0,0,1,1,500
Chiefs,3,3,0,6,0,0,12,Steelers,3,7,7,3,0,0,20,201416,0,4,11,8,32,8,1549.784,1594.933,2014,16,0,0,0,1,0,779
Bengals,7,3,0,7,0,0,17,Steelers,7,13,0,7,0,0,27,201417,0,10,10,10,44,10,1597.622,1609.438,2014,17,0,0,0,1,1,252
Rams,3,3,0,0,0,0,6,Seahawks,0,0,6,14,0,0,20,201417,-3,-6,0,14,26,14,1468.212,1760.087,2014,17,0,0,0,1,1,1720
Cardinals,7,10,0,0,0,0,17,49ers,7,6,7,0,0,0,20,201417,0,-4,3,3,37,3,1595.668,1526.282,2014,17,0,0,0,1,1,652
Lions,0,7,7,6,0,0,20,Packers,7,7,7,9,0,0,30,201417,7,7,7,10,50,10,1579.929,1628.54,2014,17,0,0,0,1,1,291
Raiders,7,0,7,0,0,0,14,Broncos,10,10,10,17,0,0,47,201417,3,13,16,33,61,33,1335.679,1671.473,2014,17,0,0,0,1,1,939
Panthers,10,14,10,0,0,0,34,Falcons,0,3,0,0,0,0,3,201417,10,21,31,31,37,-31,1495.381,1481.151,2014,17,0,0,0,1,1,226
Jaguars,10,0,7,0,0,0,17,Texans,7,7,0,9,0,0,23,201417,-3,4,-3,6,40,6,1288.242,1498.547,2014,17,0,0,0,1,1,820
Browns,0,3,7,0,0,0,10,Ravens,0,3,0,17,0,0,20,201417,0,0,-7,10,30,10,1388.258,1578.782,2014,17,0,0,0,1,1,307
Saints,0,7,0,16,0,0,23,Buccaneers,3,17,0,0,0,0,20,201417,-3,-13,-13,3,43,-3,1466.649,1322.998,2014,17,0,0,0,1,1,480
Eagles,14,3,7,10,0,0,34,Giants,10,6,3,7,0,0,26,201417,4,1,5,8,60,-8,1541.537,1489.736,2014,17,0,0,0,1,1,80
Bills,7,10,0,0,0,0,17,Patriots,3,3,3,0,0,0,9,201417,4,11,8,8,26,-8,1505.768,1734.404,2014,17,0,0,0,1,1,404
Bears,0,3,3,3,0,0,9,Vikings,3,0,7,3,0,0,13,201417,3,0,4,4,22,4,1385.851,1456.845,2014,17,0,0,0,1,1,355
Jets,7,7,10,13,0,0,37,Dolphins,3,14,7,0,0,0,24,201417,4,-3,0,13,61,-13,1361.829,1518.671,2014,17,0,0,0,1,1,1091
Chargers,0,7,0,0,0,0,7,Chiefs,3,13,3,0,0,0,19,201417,3,9,12,12,26,12,1552.999,1535.28,2014,17,0,0,0,1,1,1334
Colts,7,10,0,10,0,0,27,Titans,0,7,3,0,0,0,10,201417,7,10,7,17,37,-17,1573.049,1266.874,2014,17,0,0,0,1,1,251
Cowboys,17,10,0,17,0,0,44,Washington,7,3,0,7,0,0,17,201417,10,17,17,27,61,-27,1625.478,1316.505,2014,17,0,0,0,1,1,1181
Cardinals,0,14,0,2,0,0,16,Panthers,10,3,14,0,0,0,27,201418,10,-1,13,11,43,11,1581.602,1536.004,2014,18,1,0,0,1,0,1778
Ravens,0,10,10,10,0,0,30,Steelers,3,6,0,8,0,0,17,201418,-3,1,11,13,47,-13,1586.808,1627.567,2014,18,1,0,0,1,1,196
Bengals,7,3,0,0,0,0,10,Colts,7,6,10,3,0,0,26,201418,0,3,13,16,36,16,1579.493,1583.452,2014,18,1,0,0,1,0,99
Lions,14,3,3,0,0,0,20,Cowboys,0,7,7,10,0,0,24,201418,-14,-10,-6,4,44,4,1564.328,1637.303,2014,18,1,0,0,1,0,999
Colts,0,14,7,3,0,0,24,Broncos,7,3,0,3,0,0,13,201419,-7,4,11,11,37,-11,1605.541,1676.874,2014,19,1,0,1,1,0,998
Cowboys,7,7,7,0,0,0,21,Packers,7,3,10,6,0,0,26,201419,0,-4,-1,5,47,5,1646.731,1644.141,2014,19,1,0,1,1,0,937
Ravens,14,7,7,3,0,0,31,Patriots,7,7,14,7,0,0,35,201419,-7,-7,0,4,66,4,1622.719,1691.589,2014,19,1,0,1,1,0,350
Panthers,0,10,0,7,0,0,17,Seahawks,7,7,0,17,0,0,31,201419,7,4,4,14,48,14,1559.262,1765.381,2014,19,1,0,1,1,0,2280
Packers,13,3,0,6,0,0,22,Seahawks,0,0,7,15,6,0,28,201420,-13,-16,-9,6,50,6,1658.467,1773.75,2014,20,1,0,0,1,0,1645
Colts,0,7,0,0,0,0,7,Patriots,14,3,21,7,0,0,45,201420,14,10,31,38,52,38,1641.924,1701.188,2014,20,1,0,0,1,0,805
Patriots,0,14,0,14,0,0,28,Seahawks,0,14,10,0,0,0,24,201422,0,0,-10,4,52,-4,1783.159,1723.965,2014,22,1,1,1,0,0,2495
Eagles,0,3,14,7,0,0,24,Falcons,3,17,0,6,0,0,26,201501,3,17,3,2,50,2,1544.655,1462.019,2015,1,0,0,0,1,0,665
Vikings,0,0,0,3,0,0,3,49ers,0,7,3,10,0,0,20,201501,0,7,10,17,23,17,1479.237,1528.565,2015,1,0,0,0,1,0,1581
Giants,3,10,3,10,0,0,26,Cowboys,3,3,7,14,0,0,27,201501,0,-7,-3,1,53,1,1479.528,1589.936,2015,1,0,0,0,1,1,1370
Titans,21,14,7,0,0,0,42,Buccaneers,0,7,0,7,0,0,14,201501,21,28,35,28,56,-28,1339.314,1376.729,2015,1,0,0,0,0,0,621
Bengals,7,17,9,0,0,0,33,Raiders,0,0,0,13,0,0,13,201501,7,24,33,20,46,-20,1539.936,1388.519,2015,1,0,0,0,1,0,2032
Ravens,0,3,10,0,0,0,13,Broncos,6,3,7,3,0,0,19,201501,6,6,3,6,32,6,1577.08,1595.327,2015,1,0,0,0,1,0,1506
Saints,3,7,3,6,0,0,19,Cardinals,7,7,3,14,0,0,31,201501,4,4,4,12,50,12,1486.37,1540.563,2015,1,0,0,0,1,0,1312
Lions,7,14,0,7,0,0,28,Chargers,3,7,10,13,0,0,33,201501,-4,-11,-1,5,61,5,1538.267,1522.523,2015,1,0,0,0,0,0,1968
Panthers,3,7,7,3,0,0,20,Jaguars,3,6,0,0,0,0,9,201501,0,1,8,11,29,-11,1535.596,1356.572,2015,1,0,0,0,0,0,341
Dolphins,0,7,0,10,0,0,17,Washington,3,7,0,0,0,0,10,201501,-3,-3,-3,7,27,-7,1483.514,1371.453,2015,1,0,0,0,0,0,924
Browns,0,10,0,0,0,0,10,Jets,0,14,10,7,0,0,31,201501,0,4,14,21,41,21,1421.821,1440.153,2015,1,0,0,0,1,0,403
Seahawks,7,3,3,18,0,0,31,Rams,0,10,14,7,3,0,34,201501,-7,0,11,3,65,3,1677.552,1476.945,2015,1,0,0,0,1,1,1720
Packers,7,3,7,14,0,0,31,Bears,3,10,3,7,0,0,23,201501,4,-3,1,8,54,-8,1601.039,1419.227,2015,1,0,0,0,1,1,185
Colts,0,0,8,6,0,0,14,Bills,7,10,7,3,0,0,27,201501,7,17,16,13,41,13,1581.097,1534.055,2015,1,0,0,0,1,0,434
Steelers,0,3,8,10,0,0,21,Patriots,0,14,7,7,0,0,28,201501,0,11,10,7,49,7,1562.771,1663.864,2015,1,0,0,0,1,0,479
Chiefs,14,13,0,0,0,0,27,Texans,6,3,0,11,0,0,20,201501,8,18,18,7,47,-7,1539.663,1504.621,2015,1,0,0,0,1,0,646
Rams,0,0,10,0,0,0,10,Washington,10,7,0,7,0,0,24,201502,10,17,7,14,34,14,1497.20882695224,1353.83501125187,2015,2,0,0,0,1,0,708
Jets,7,3,0,10,0,0,20,Colts,0,0,0,7,0,0,7,201502,7,10,10,13,27,-13,1462.92596764561,1556.27191062952,2015,2,0,0,0,1,0,643
Seahawks,3,0,14,0,0,0,17,Packers,10,3,3,11,0,0,27,201502,7,10,-1,10,44,10,1657.28817304776,1615.14144135638,2015,2,0,0,0,1,0,1645
Cowboys,3,3,7,7,0,0,20,Eagles,0,0,0,10,0,0,10,201502,3,6,13,10,30,-10,1593.36450258906,1533.01841149363,2015,2,0,0,0,1,1,1297
Dolphins,3,10,7,0,0,0,20,Jaguars,10,10,0,3,0,0,23,201502,7,7,0,3,43,3,1501.13198874813,1340.43381125684,2015,2,0,0,0,1,0,327
Ravens,10,10,0,13,0,0,33,Raiders,10,10,10,7,0,0,37,201502,0,0,10,4,70,4,1562.7388210858,1366.36421795295,2015,2,0,0,0,1,0,2442
Texans,3,0,7,7,0,0,17,Panthers,0,10,7,7,0,0,24,201502,-3,7,7,7,41,7,1481.72623033389,1551.73418874316,2015,2,0,0,0,0,0,925
49ers,0,3,0,15,0,0,18,Steelers,8,21,0,14,0,0,43,201502,8,26,26,25,61,25,1547.31238931705,1552.03412492866,2015,2,0,0,0,0,0,2260
Patriots,14,10,13,3,0,0,40,Bills,7,6,0,19,0,0,32,201502,7,11,24,8,72,-8,1674.60087507134,1558.88008937048,2015,2,0,0,0,1,1,404
Buccaneers,3,7,13,3,0,0,26,Saints,0,7,0,12,0,0,19,201502,3,3,16,7,45,-7,1331.29280948503,1470.07318967598,2015,2,0,0,0,1,1,480
Lions,0,10,0,6,0,0,16,Vikings,7,10,6,3,0,0,26,201502,7,7,13,10,42,10,1523.20981976495,1460.48961068295,2015,2,0,0,0,1,1,542
Titans,0,0,7,7,0,0,14,Browns,14,7,0,7,0,0,28,201502,14,21,14,14,42,14,1384.75019051497,1399.04803235439,2015,2,0,0,0,1,0,458
Chargers,3,3,7,6,0,0,19,Bengals,7,7,3,7,0,0,24,201502,4,8,4,5,43,5,1537.58018023505,1562.09078204705,2015,2,0,0,0,1,0,1871
Cardinals,14,14,14,6,0,0,48,Bears,7,13,3,0,0,0,23,201502,7,8,19,25,71,-25,1556.85981032402,1405.12455864362,2015,2,0,0,0,1,0,1450
Broncos,0,14,3,14,0,0,31,Chiefs,0,14,3,7,0,0,24,201502,0,0,0,7,55,-7,1609.6681789142,1562.55776966611,2015,2,0,0,0,1,1,556
Falcons,7,3,0,14,0,0,24,Giants,0,13,7,0,0,0,20,201502,7,-3,-10,4,44,-4,1473.65558850637,1476.09949741094,2015,2,0,0,0,1,0,745
Buccaneers,0,9,0,0,0,0,9,Texans,7,0,3,9,0,0,19,201503,7,-2,1,10,28,10,1366.29634761492,1469.38592915075,2015,3,0,0,0,0,0,790
Chiefs,0,7,7,14,0,0,28,Packers,14,10,7,7,0,0,38,201503,14,17,17,10,66,10,1540.51433803745,1637.31506520737,2015,3,0,0,0,0,0,503
Bengals,7,7,0,14,0,0,28,Ravens,0,0,7,17,0,0,24,201503,7,14,7,4,52,-4,1574.96779535205,1539.44190168976,2015,3,0,0,0,1,1,419
Bears,0,0,0,0,0,0,0,Seahawks,3,3,14,6,0,0,26,201503,3,6,20,26,26,26,1381.44591276541,1635.11454919677,2015,3,0,0,0,1,0,1732
Broncos,0,14,0,10,0,0,24,Lions,0,6,6,0,0,0,12,201503,0,8,2,12,36,-12,1631.71161054286,1499.41286908173,2015,3,0,0,0,0,0,1154
Bills,14,13,0,14,0,0,41,Dolphins,0,0,8,6,0,0,14,201503,14,27,19,27,55,-27,1540.51626893235,1482.74449692741,2015,3,0,0,0,1,1,1184
Saints,3,7,6,6,0,0,22,Panthers,0,10,10,7,0,0,27,201503,-3,0,4,5,49,5,1435.06965154609,1564.0744899263,2015,3,0,0,0,1,1,648
49ers,0,7,0,0,0,0,7,Cardinals,14,17,9,7,0,0,47,201503,14,24,33,40,54,40,1521.98588392048,1580.53845620223,2015,3,0,0,0,1,1,652
Jaguars,0,3,7,7,0,0,17,Patriots,10,10,17,14,0,0,51,201503,10,17,27,34,68,34,1358.82130307756,1692.96469550947,2015,3,0,0,0,1,0,1003
Chargers,0,7,0,7,0,0,14,Vikings,3,7,14,7,0,0,31,201503,3,3,17,17,45,17,1524.70316693005,1484.28656136617,2015,3,0,0,0,0,0,1530
Steelers,3,6,0,3,0,0,12,Rams,0,3,0,3,0,0,6,201503,3,6,6,6,18,-6,1577.36063032523,1462.8988343714,2015,3,0,0,0,0,0,557
Colts,7,7,0,21,0,0,35,Titans,0,10,17,6,0,0,33,201503,7,4,-13,2,68,-2,1515.70262161442,1364.47611026878,2015,3,0,0,0,1,1,251
Falcons,7,10,8,14,0,0,39,Cowboys,14,14,0,0,0,0,28,201503,-7,-11,-3,11,67,-11,1493.44211738764,1617.71614860908,2015,3,0,0,0,1,0,719
Raiders,3,14,3,7,0,0,27,Browns,0,3,7,10,0,0,20,201503,3,14,10,7,47,-7,1389.66113734899,1419.32211260058,2015,3,0,0,0,1,0,2153
Washington,0,6,0,15,0,0,21,Giants,12,3,3,14,0,0,32,201503,12,9,12,11,53,11,1388.14500383271,1456.31296852967,2015,3,0,0,0,1,1,204
Eagles,3,21,0,0,0,0,24,Jets,0,7,0,10,0,0,17,201503,3,17,17,7,41,-7,1508.66676547361,1503.49525666071,2015,3,0,0,0,0,0,80
Lions,0,3,0,7,0,0,10,Seahawks,0,10,3,0,0,0,13,201504,0,7,10,3,23,3,1479.28618007798,1643.04370344028,2015,4,0,0,0,1,0,1933
Packers,7,0,10,0,0,0,17,49ers,0,3,0,0,0,0,3,201504,7,4,14,14,20,-14,1649.94131829436,1498.82683365657,2015,4,0,0,0,1,0,1834
Rams,7,3,7,7,0,0,24,Cardinals,3,6,3,10,0,0,22,201504,4,1,5,2,46,-2,1446.55878204752,1603.69750646614,2015,4,0,0,0,1,1,1270
Vikings,0,10,0,10,0,0,20,Broncos,3,10,7,3,0,0,23,201504,3,3,10,3,43,3,1510.85170740943,1651.83829954661,2015,4,0,0,0,0,0,698
Browns,3,10,3,11,0,0,27,Chargers,7,6,7,10,0,0,30,201504,4,0,4,3,57,3,1391.81469704091,1498.13802088679,2015,4,0,0,0,1,0,2030
Eagles,0,0,13,7,0,0,20,Washington,6,7,3,7,0,0,23,201504,6,13,3,3,43,3,1533.68743665149,1373.27957204529,2015,4,0,0,0,1,1,123
Panthers,10,7,14,6,0,0,37,Buccaneers,3,7,7,6,0,0,23,201504,7,7,14,14,60,-14,1572.1956082558,1354.02806421417,2015,4,0,0,0,1,1,511
Cowboys,3,7,3,7,0,0,20,Saints,7,0,6,7,6,0,26,201504,4,-3,0,6,46,6,1577.02651891401,1426.94853321659,2015,4,0,0,0,1,0,442
Chiefs,3,9,3,6,0,0,21,Bengals,14,0,15,7,0,0,36,201504,11,2,14,15,57,15,1527.88808495046,1592.66129329314,2015,4,0,0,0,1,0,542
Raiders,0,14,3,3,0,0,20,Bears,6,10,0,6,0,0,22,201504,6,2,-1,2,42,2,1417.16855290866,1373.5167585219,2015,4,0,0,0,0,0,1845
Giants,9,7,0,8,0,0,24,Bills,3,0,0,7,0,0,10,201504,6,13,13,14,34,-14,1471.17840031709,1574.64359023706,2015,4,0,0,0,0,0,292
Texans,0,0,0,21,0,0,21,Falcons,7,21,14,6,0,0,48,201504,7,28,42,27,69,27,1481.6542125515,1534.13174708271,2015,4,0,0,0,0,0,700
Jets,10,10,7,0,0,0,27,Dolphins,0,7,0,7,0,0,14,201504,10,13,20,13,41,-13,1478.47458548283,1448.6171756227,2015,4,0,0,0,1,1,1091
Ravens,7,0,7,6,3,0,23,Steelers,3,10,7,0,0,0,20,201504,4,-6,-6,3,43,-3,1521.74840374867,1593.70068264911,2015,4,0,0,0,1,1,196
Jaguars,3,10,0,0,0,0,13,Colts,3,7,0,3,3,0,16,201504,0,-3,-3,3,29,3,1353.32515691508,1523.70326700498,2015,4,0,0,0,1,1,699
Steelers,0,3,7,14,0,0,24,Chargers,7,0,0,13,0,0,20,201505,-7,-4,3,4,44,-4,1573.37437748422,1505.12586438926,2015,5,0,0,0,1,0,2113
49ers,3,3,7,14,0,0,27,Giants,3,10,7,10,0,0,30,201505,0,7,7,3,57,3,1479.09658172907,1513.70556970865,2015,5,0,0,0,1,0,2565
Broncos,0,3,6,7,0,0,16,Raiders,0,7,0,3,0,0,10,201505,0,-4,2,6,26,-6,1657.77119033735,1406.95572740607,2015,5,0,0,0,1,1,939
Patriots,3,10,7,10,0,0,30,Cowboys,3,0,3,0,0,0,6,201505,0,10,14,24,36,-24,1698.46084167195,1551.92466484755,2015,5,0,1,0,0,0,1545
Cardinals,0,28,7,7,0,0,42,Lions,7,0,0,10,0,0,17,201505,-7,21,28,25,59,-25,1584.57970122473,1473.97835065553,2015,5,0,0,0,1,0,1687
Browns,3,6,7,14,3,0,33,Ravens,14,0,7,9,0,0,30,201505,-11,-5,-5,3,63,-3,1384.82685353844,1542.07470891356,2015,5,0,0,0,1,1,307
Jaguars,0,14,10,7,0,0,31,Buccaneers,3,17,11,7,0,0,38,201505,3,6,7,7,69,7,1348.18910807688,1339.20067766528,2015,5,0,0,0,0,0,171
Saints,7,0,3,7,0,0,17,Eagles,0,10,16,13,0,0,39,201505,-7,3,16,22,56,22,1452.05038728305,1515.31371847065,2015,5,0,0,0,1,0,1088
Bills,0,0,7,7,0,0,14,Titans,0,3,7,3,0,0,13,201505,0,-3,-3,1,27,-1,1532.1164208455,1356.47546487822,2015,5,0,0,1,1,0,626
Rams,0,10,0,0,0,0,10,Packers,14,0,7,3,0,0,24,201505,14,4,11,14,34,14,1465.67658728893,1669.67157022186,2015,5,0,0,0,1,0,422
Seahawks,7,3,14,0,0,0,24,Bengals,7,0,0,17,3,0,27,201505,0,-3,-17,3,51,3,1648.35153286273,1609.4943092547,2015,5,0,0,0,0,0,1967
Washington,0,7,0,12,0,0,19,Falcons,0,3,3,13,6,0,25,201505,0,-4,-1,6,44,6,1391.65329022613,1555.45848906348,2015,5,0,0,0,1,0,541
Colts,10,3,7,7,0,0,27,Texans,0,10,7,3,0,0,20,201505,10,3,3,7,47,-7,1528.83931584318,1460.32747057073,2015,5,0,0,0,1,1,865
Bears,3,0,3,12,0,0,18,Chiefs,7,10,0,0,0,0,17,201505,-4,-14,-11,1,35,-1,1383.72958402449,1511.0550689889,2015,5,0,0,0,0,0,410
Texans,7,3,0,21,0,0,31,Jaguars,0,7,7,6,0,0,20,201506,7,3,-4,11,51,-11,1439.7760420422,1331.15206483215,2015,6,0,0,0,1,1,820
Giants,7,0,0,0,0,0,7,Eagles,7,10,7,3,0,0,27,201506,0,10,17,20,34,20,1523.26657689664,1534.4748743575,2015,6,0,0,0,1,1,80
Ravens,0,6,7,7,0,0,20,49ers,6,10,3,6,0,0,25,201506,6,10,6,5,45,5,1517.94609365484,1469.53557454108,2015,6,0,0,0,0,0,2451
Chargers,3,7,7,3,0,0,20,Packers,14,3,7,3,0,0,27,201506,11,7,7,7,47,7,1489.20547088175,1678.13201218026,2015,6,0,0,0,0,0,1758
Panthers,0,7,7,13,0,0,27,Seahawks,3,7,10,3,0,0,23,201506,-3,-3,-6,4,50,-4,1587.02299480469,1635.68031478339,2015,6,0,1,0,1,0,2280
Cardinals,7,3,0,3,0,0,13,Steelers,0,3,12,10,0,0,25,201506,-7,-7,5,12,38,12,1612.3334849927,1589.29477099173,2015,6,0,0,0,0,0,1824
Patriots,7,13,7,7,0,0,34,Colts,7,14,0,6,0,0,27,201506,0,-1,6,7,61,-7,1722.34600392821,1549.39074437171,2015,6,0,0,0,1,0,805
Chiefs,0,0,0,10,0,0,10,Vikings,3,7,3,3,0,0,16,201506,3,10,13,6,26,6,1499.63769386828,1504.91881661869,2015,6,0,0,1,0,0,411
Falcons,0,7,0,14,0,0,21,Saints,14,0,10,7,0,0,31,201506,14,7,17,10,52,10,1562.90721092129,1432.8892313962,2015,6,0,0,0,1,1,424
Bengals,7,10,14,3,0,0,34,Bills,7,7,0,7,0,0,21,201506,0,3,17,13,55,-13,1622.16552733404,1536.68263086372,2015,6,0,0,0,1,0,388
Washington,7,6,0,7,0,0,20,Jets,7,3,17,7,0,0,34,201506,0,-3,14,14,54,14,1384.20456836832,1502.27973804676,2015,6,0,0,1,0,0,204
Bears,3,10,3,18,0,0,34,Lions,7,14,3,10,3,0,37,201506,4,8,8,3,71,3,1395.14695914511,1446.22456688756,2015,6,0,0,0,1,1,238
Dolphins,10,7,7,14,0,0,38,Titans,3,0,7,0,0,0,10,201506,7,14,14,28,48,-28,1424.81202305877,1351.90925486,2015,6,0,1,0,1,0,816
Broncos,3,7,3,10,3,0,26,Browns,0,0,7,16,0,0,23,201506,3,10,6,3,49,-3,1666.93933011952,1408.95546879716,2015,6,0,0,0,1,0,1223
Ravens,3,7,0,8,0,0,18,Cardinals,7,7,6,6,0,0,26,201507,4,4,10,8,44,8,1501.01108656497,1590.18918140929,2015,7,0,0,0,0,0,2000
Eagles,0,6,10,0,0,0,16,Panthers,7,7,7,6,0,0,27,201507,7,8,5,11,43,11,1557.54791086272,1609.35603438165,2015,7,0,0,0,1,0,450
Cowboys,3,10,0,7,0,0,20,Giants,0,10,10,7,0,0,27,201507,-3,-3,7,7,47,7,1528.03950259129,1500.19354039142,2015,7,0,1,0,1,1,1370
Raiders,10,20,7,0,0,0,37,Chargers,3,3,0,23,0,0,29,201507,7,24,31,8,66,-8,1397.7875876239,1482.18820281394,2015,7,0,1,0,1,1,454
Buccaneers,10,14,0,6,0,0,30,Washington,0,7,14,10,0,0,31,201507,-10,-17,-3,1,61,1,1356.23772091001,1371.2803429865,2015,7,0,1,0,1,0,818
Texans,0,0,13,13,0,0,26,Dolphins,21,20,0,3,0,0,44,201507,21,41,28,18,70,18,1461.09854992378,1457.60140352886,2015,7,0,0,0,1,0,966
Jets,3,7,7,6,0,0,23,Patriots,3,10,3,14,0,0,30,201507,0,3,-1,7,53,7,1515.20396342858,1736.19958091214,2015,7,0,0,0,1,1,181
Steelers,3,0,7,3,0,0,13,Chiefs,3,6,7,7,0,0,23,201507,0,6,6,10,36,10,1611.43907457514,1484.54423267186,2015,7,0,0,0,1,0,779
Saints,7,13,7,0,0,0,27,Colts,0,0,14,7,0,0,21,201507,7,20,13,6,48,-6,1462.16919854003,1535.53716738778,2015,7,0,0,0,0,0,713
Falcons,0,3,7,0,0,0,10,Titans,0,7,0,0,0,0,7,201507,0,-4,3,3,17,-3,1533.62724377746,1319.11987438991,2015,7,0,0,0,0,0,215
Vikings,3,12,10,3,0,0,28,Lions,14,3,0,2,0,0,19,201507,-11,-2,8,9,47,-9,1520.01227781511,1455.14996571604,2015,7,0,0,0,1,1,542
Bills,3,10,0,18,0,0,31,Jaguars,0,27,0,7,0,0,34,201507,-3,14,14,3,65,3,1512.07520615831,1309.82955695057,2015,7,0,0,0,1,0,880
Seahawks,7,10,0,3,0,0,20,49ers,0,0,3,0,0,0,3,201507,7,17,14,17,23,-17,1613.34727520643,1486.47058163095,2015,7,0,0,0,1,1,679
Browns,0,3,3,0,0,0,6,Rams,10,0,7,7,0,0,24,201507,10,7,11,18,30,18,1402.64155811512,1457.21614533053,2015,7,0,0,1,0,0,491
Colts,0,6,0,17,3,0,26,Panthers,10,0,7,6,6,0,29,201508,10,4,11,3,55,3,1506.91339467372,1625.30516721598,2015,8,0,0,0,0,0,428
Packers,0,7,3,0,0,0,10,Broncos,7,10,7,5,0,0,29,201508,7,10,14,19,39,19,1685.14928024807,1673.25324080156,2015,8,0,1,1,0,0,927
Seahawks,3,7,0,3,0,0,13,Cowboys,3,3,3,3,0,0,12,201508,0,4,1,1,25,-1,1636.50576445262,1509.76891793007,2015,8,0,0,0,1,0,1679
Jets,3,3,7,7,0,0,20,Raiders,7,14,10,3,0,0,34,201508,4,15,18,14,54,14,1509.25614246998,1430.91552532414,2015,8,0,0,0,1,0,2557
Titans,3,0,3,0,0,0,6,Texans,0,10,7,3,0,0,20,201508,-3,7,11,14,26,14,1311.40390787375,1437.47308982966,2015,8,0,0,0,1,1,665
Chargers,3,13,7,3,0,0,26,Ravens,6,7,6,10,0,0,29,201508,3,-3,-4,3,55,3,1449.0602651137,1489.03519731184,2015,8,0,0,0,1,0,2291
Bengals,3,3,0,10,0,0,16,Steelers,7,0,3,0,0,0,10,201508,-4,-1,-4,6,26,-6,1646.77295203945,1582.41642779747,2015,8,0,1,0,1,1,252
Giants,7,14,7,21,0,0,49,Saints,14,14,14,10,0,0,52,201508,7,7,14,3,101,3,1518.46412505264,1490.79297125409,2015,8,0,0,0,1,0,1168
Cardinals,7,3,14,10,0,0,34,Browns,7,13,0,0,0,0,20,201508,0,-10,4,14,54,-14,1602.16507066242,1383.96399549,2015,8,0,0,0,0,0,1745
Vikings,7,3,0,13,0,0,23,Bears,3,7,3,7,0,0,20,201508,4,0,-3,3,43,-3,1543.04869557848,1386.22156031663,2015,8,0,0,1,1,1,355
Buccaneers,3,10,7,0,3,0,23,Falcons,3,0,7,10,0,0,20,201508,0,10,10,3,43,-3,1351.06371127471,1541.34321029362,2015,8,0,0,0,1,1,416
Lions,3,0,0,7,0,0,10,Chiefs,7,17,7,14,0,0,45,201508,4,21,28,35,55,35,1432.11354795267,1513.56687944953,2015,8,0,0,0,0,0,643
Dolphins,0,0,7,0,0,0,7,Patriots,7,12,3,14,0,0,36,201508,7,19,15,29,43,29,1481.22686362298,1742.14740187074,2015,8,0,0,0,1,1,1241
49ers,3,3,0,0,0,0,6,Rams,2,18,0,7,0,0,27,201508,-1,14,14,21,33,21,1463.31209238476,1475.89370795565,2015,8,0,0,0,1,1,1741
Bears,0,7,0,15,0,0,22,Chargers,7,9,0,3,0,0,19,201509,-7,-9,-9,3,41,-3,1376.35156243382,1439.70912878906,2015,9,0,0,0,0,0,1729
Eagles,0,7,7,13,6,0,33,Cowboys,7,0,7,13,0,0,27,201509,-7,0,0,6,60,-6,1541.59877802839,1504.21225036557,2015,9,0,1,0,1,1,1297
Broncos,0,7,10,7,0,0,24,Colts,7,10,0,10,0,0,27,201509,7,10,0,3,51,3,1698.06806423445,1500.30709118957,2015,9,0,0,0,1,0,998
Giants,10,7,3,12,0,0,32,Buccaneers,6,3,3,6,0,0,18,201509,4,8,8,14,50,-14,1506.2914673747,1376.56323683126,2015,9,0,0,0,1,0,1004
Falcons,3,10,0,3,0,0,16,49ers,0,17,0,0,0,0,17,201509,-3,4,4,1,33,1,1515.84368473707,1440.01304827489,2015,9,0,0,0,1,0,2135
Packers,7,0,7,15,0,0,29,Panthers,3,24,3,7,0,0,37,201509,-4,20,16,8,66,8,1660.33445681518,1631.91147070013,2015,9,0,0,0,1,0,745
Raiders,7,7,7,14,0,0,35,Steelers,3,18,0,17,0,0,38,201509,-4,7,0,3,73,3,1459.20689351859,1562.91558290672,2015,9,0,0,0,1,0,2251
Titans,10,7,3,8,6,0,34,Saints,14,7,0,7,0,0,28,201509,-4,-4,-1,6,62,-6,1298.95751764162,1502.96562893203,2015,9,0,0,0,0,0,469
Washington,0,3,0,7,0,0,10,Patriots,14,3,3,7,0,0,27,201509,14,14,17,17,37,17,1376.4543526218,1750.01725874633,2015,9,0,1,0,0,0,385
Rams,6,9,0,3,0,0,18,Vikings,10,0,8,0,3,0,21,201509,4,-5,3,3,39,3,1499.19275206552,1552.91869346129,2015,9,0,0,0,1,0,466
Dolphins,0,7,7,3,0,0,17,Bills,9,10,7,7,0,0,33,201509,9,12,12,16,50,16,1473.35700674739,1488.80623391193,2015,9,0,0,1,1,1,1184
Browns,3,7,0,0,0,0,10,Bengals,7,7,3,14,0,0,31,201509,4,4,7,21,41,21,1369.13884403886,1666.2737969302,2015,9,0,0,0,1,1,217
Jaguars,3,7,3,10,0,0,23,Jets,14,0,7,7,0,0,28,201509,11,4,8,5,51,5,1333.09852919695,1480.96477427553,2015,9,0,1,0,1,0,835
Jaguars,7,3,3,9,0,0,22,Ravens,0,14,0,6,0,0,20,201510,7,-4,-1,2,42,-2,1325.68174339513,1498.38633363648,2015,10,0,0,1,1,0,681
Texans,0,3,0,7,0,0,10,Bengals,3,3,0,0,0,0,6,201510,-3,-3,-3,4,16,-4,1449.91948006179,1672.14483474316,2015,10,0,1,0,1,0,897
Cardinals,0,22,3,14,0,0,39,Seahawks,0,7,10,15,0,0,32,201510,0,15,8,7,71,-7,1616.99022211356,1642.06243201712,2015,10,0,1,1,1,1,1114
Patriots,7,3,7,10,0,0,27,Giants,7,10,6,3,0,0,26,201510,0,-7,-6,1,53,-1,1753.59139123745,1527.75292930836,2015,10,0,0,0,0,0,181
Chiefs,10,9,3,7,0,0,29,Broncos,0,0,0,13,0,0,13,201510,10,19,22,16,42,-16,1540.16658675769,1677.93661200386,2015,10,0,1,0,1,1,556
Vikings,10,10,0,10,0,0,30,Raiders,0,14,0,0,0,0,14,201510,10,6,6,16,44,-16,1561.74426829709,1452.1343864329,2015,10,0,0,0,0,0,1573
Saints,7,7,0,0,0,0,14,Washington,14,13,10,10,0,0,47,201510,7,13,23,33,61,33,1466.39839656213,1372.88022013068,2015,10,0,0,0,1,0,964
Panthers,7,7,3,10,0,0,27,Titans,7,3,0,0,0,0,10,201510,0,4,7,17,37,-17,1651.25740620924,1335.52475001152,2015,10,0,0,0,0,0,339
Browns,3,0,0,6,0,0,9,Steelers,6,15,3,6,0,0,30,201510,3,18,21,21,39,21,1363.2678062259,1569.98808999241,2015,10,0,0,0,1,1,114
Bills,0,12,10,0,0,0,22,Jets,3,0,7,7,0,0,17,201510,-3,9,12,5,39,-5,1509.92069524332,1488.38156007736,2015,10,0,0,0,1,1,292
Lions,0,3,6,9,0,0,18,Packers,3,0,0,13,0,0,16,201510,-3,0,6,2,34,-2,1405.51384064451,1640.98852130607,2015,10,0,1,0,1,1,291
Cowboys,3,3,0,0,0,0,6,Buccaneers,0,3,0,7,0,0,10,201510,-3,-3,-3,4,16,4,1482.94286298281,1355.1017748976,2015,10,0,0,0,1,0,916
Bears,10,14,0,13,0,0,37,Rams,10,0,3,0,0,0,13,201510,0,14,11,24,50,-24,1396.27769210954,1490.36717722972,2015,10,0,0,0,1,0,260
Dolphins,3,10,0,7,0,0,20,Eagles,16,0,0,3,0,0,19,201510,-13,-3,-3,1,39,-1,1452.242545416,1562.86816541115,2015,10,0,0,0,0,0,1021
Bills,0,3,7,3,0,0,13,Patriots,3,7,10,0,0,0,20,201511,3,7,10,7,33,7,1530.4740214314,1757.25721086713,2015,11,0,0,0,1,1,404
Bengals,7,7,0,17,0,0,31,Cardinals,0,7,21,6,0,0,34,201511,-7,-7,14,3,65,3,1641.07017682063,1644.1707720552,2015,11,0,0,0,0,0,1580
49ers,0,7,6,0,0,0,13,Seahawks,13,7,3,6,0,0,29,201511,13,13,10,16,42,16,1447.19588665727,1614.88188207548,2015,11,0,1,0,1,1,679
Packers,6,10,3,11,0,0,30,Vikings,6,0,7,0,0,0,13,201511,0,10,6,17,43,-17,1619.37382441748,1585.96730876595,2015,11,0,0,0,1,1,259
Jets,0,3,7,7,0,0,17,Texans,0,10,14,0,0,0,24,201511,0,7,14,7,41,7,1467.82823388928,1480.99413798432,2015,11,0,0,0,1,0,1417
Rams,7,0,6,0,0,0,13,Ravens,0,3,0,13,0,0,16,201511,-7,-4,-10,3,29,3,1440.80583141141,1478.75038977312,2015,11,0,0,0,0,0,730
Chiefs,6,6,7,14,0,0,33,Chargers,0,3,0,0,0,0,3,201511,6,9,16,30,36,-30,1587.76873464509,1419.78299911334,2015,11,0,0,1,1,1,1334
Buccaneers,7,21,7,10,0,0,45,Eagles,7,7,0,3,0,0,17,201511,0,14,21,28,62,-28,1374.63374324169,1551.8218592334,2015,11,0,0,0,1,0,928
Cowboys,0,14,0,10,0,0,24,Dolphins,0,7,7,0,0,0,14,201511,0,7,0,10,38,-10,1463.41089463872,1463.28885159375,2015,11,0,0,0,0,0,1110
Raiders,0,0,13,0,0,0,13,Lions,6,3,0,9,0,0,18,201511,6,9,-4,5,31,5,1427.91134596404,1427.1285375331,2015,11,0,0,0,0,0,2078
Broncos,7,3,0,7,0,0,17,Bears,0,6,3,6,0,0,15,201511,7,4,1,2,32,-2,1630.33446411646,1445.83903792785,2015,11,0,0,0,0,0,916
Colts,0,7,7,10,0,0,24,Falcons,7,7,7,0,0,0,21,201511,-7,-7,-7,3,45,-3,1520.43854342016,1508.66084635469,2015,11,0,1,1,0,0,427
Titans,3,3,7,0,0,0,13,Jaguars,0,6,3,10,0,0,19,201511,-3,0,-4,6,32,6,1325.61160697985,1345.31768725849,2015,11,0,0,0,1,1,500
Washington,14,0,0,2,0,0,16,Panthers,14,17,10,3,0,0,44,201511,0,17,27,28,60,28,1411.53289356507,1661.17054924091,2015,11,0,0,0,1,0,329
Giants,0,0,0,14,0,0,14,Washington,0,17,0,3,0,0,20,201512,0,17,17,6,34,6,1524.08710967868,1403.25511642347,2015,12,0,1,0,1,1,204
Ravens,10,7,7,9,0,0,33,Browns,0,13,7,7,0,0,27,201512,10,4,4,6,60,-6,1488.18062677998,1353.74564202573,2015,12,0,0,1,1,1,307
Patriots,7,7,0,10,0,0,24,Broncos,0,7,0,17,6,0,30,201512,-7,-7,-7,6,54,6,1763.02733194237,1637.30568156916,2015,12,0,0,0,1,0,1769
Steelers,3,15,3,9,0,0,30,Seahawks,0,14,6,19,0,0,39,201512,-3,-4,-1,9,69,9,1579.51025419258,1625.52024829107,2015,12,0,1,0,0,0,2132
Cardinals,3,3,7,6,0,0,19,49ers,0,3,10,0,0,0,13,201512,3,3,0,6,32,-6,1655.01504008487,1436.55752044168,2015,12,0,0,0,1,1,652
Saints,0,6,0,0,0,0,6,Texans,14,0,10,0,0,0,24,201512,14,8,18,18,30,18,1427.74572312774,1496.63198913577,2015,12,0,1,0,0,0,317
Chargers,0,21,3,7,0,0,31,Jaguars,6,3,3,13,0,0,25,201512,-6,12,12,6,56,-6,1396.42735954204,1359.57544132363,2015,12,0,0,0,1,0,2087
Dolphins,0,0,7,13,0,0,20,Jets,7,7,7,17,0,0,38,201512,7,14,14,18,58,18,1434.02042221342,1452.19038273783,2015,12,0,0,0,1,1,1091
Vikings,7,0,3,10,0,0,20,Falcons,0,3,0,7,0,0,10,201512,7,4,7,10,30,-10,1553.98318603143,1492.2948227504,2015,12,0,0,0,1,0,908
Buccaneers,3,9,0,0,0,0,12,Colts,3,3,13,6,0,0,25,201512,0,-6,7,13,37,13,1435.27007163984,1536.80456702445,2015,12,0,0,0,0,0,843
Raiders,7,3,7,7,0,0,24,Titans,6,0,8,7,0,0,21,201512,1,4,3,3,45,-3,1413.6835933029,1311.35385291471,2015,12,0,0,0,1,0,1950
Rams,0,7,0,0,0,0,7,Bengals,7,10,14,0,0,0,31,201512,7,10,24,24,38,24,1431.37559440455,1630.22590879096,2015,12,0,0,0,0,0,310
Bears,0,14,0,3,0,0,17,Packers,7,6,0,0,0,0,13,201512,-7,1,1,4,30,-4,1438.86782047515,1651.357947152,2015,12,0,0,0,1,1,185
Panthers,10,13,7,3,0,0,33,Cowboys,3,0,3,8,0,0,14,201512,7,20,24,19,47,-19,1669.44832638251,1492.67932401905,2015,12,0,0,0,1,0,928
Eagles,0,7,0,7,0,0,14,Lions,7,17,14,7,0,0,45,201512,7,17,31,31,59,31,1491.18553083525,1441.35629019424,2015,12,0,0,0,1,0,441
Bills,10,6,6,0,0,0,22,Chiefs,0,14,10,6,0,0,30,201512,-10,-2,2,8,52,8,1524.70390035616,1611.12437421639,2015,12,0,0,0,1,0,858
Falcons,0,9,3,7,0,0,19,Buccaneers,7,0,9,7,0,0,23,201513,7,-2,4,4,42,4,1468.05082356356,1421.67124546324,2015,13,0,0,0,1,1,416
Cowboys,0,3,3,13,0,0,19,Washington,0,3,3,10,0,0,16,201513,0,0,0,3,35,-3,1473.03781384912,1426.4020293899,2015,13,0,0,0,1,1,1181
Colts,3,7,0,0,0,0,10,Steelers,6,15,7,17,0,0,45,201513,3,11,18,35,55,35,1550.40339320105,1564.36512068612,2015,13,0,0,0,1,0,328
Panthers,0,13,14,14,0,0,41,Saints,14,2,8,14,0,0,38,201513,-14,-3,3,3,79,-3,1689.08983655244,1410.18633343872,2015,13,0,0,0,1,1,648
Eagles,0,14,14,7,0,0,35,Patriots,0,14,0,14,0,0,28,201513,0,0,14,7,63,-7,1458.26751882082,1739.55366239969,2015,13,0,0,0,0,0,261
Chiefs,7,0,7,20,0,0,34,Raiders,7,7,6,0,0,0,20,201513,0,-7,-6,14,54,-14,1623.24957833438,1425.8562114343,2015,13,0,0,0,1,1,1495
Jets,3,7,0,10,3,0,23,Giants,0,20,0,0,0,0,20,201513,3,-10,-10,3,43,-3,1473.89730316938,1500.94019671226,2015,13,0,0,0,0,0,0
Broncos,14,3,0,0,0,0,17,Chargers,0,3,0,0,0,0,3,201513,14,14,14,14,20,-14,1660.77935111184,1417.73211833816,2015,13,0,0,0,1,1,832
Ravens,0,3,7,3,0,0,13,Dolphins,0,15,0,0,0,0,15,201513,0,12,5,2,28,2,1503.32384744712,1412.31350178187,2015,13,0,0,0,1,0,956
Cardinals,7,3,14,3,0,0,27,Rams,0,0,3,0,0,0,3,201513,7,10,21,24,30,-24,1665.65559761357,1421.04974835962,2015,13,0,0,0,1,1,1270
Jaguars,0,12,7,20,0,0,39,Titans,7,14,0,21,0,0,42,201513,7,9,2,3,81,3,1338.27068252751,1299.18123478331,2015,13,0,0,0,1,1,500
Seahawks,7,14,14,3,0,0,38,Vikings,0,0,7,0,0,0,7,201513,7,21,28,31,45,-31,1640.66538179753,1578.22718521827,2015,13,0,0,0,1,0,1391
Bengals,7,13,14,3,0,0,37,Browns,0,3,0,0,0,0,3,201513,7,17,31,34,40,-34,1640.55175483589,1338.60242135859,2015,13,0,0,0,1,1,217
49ers,6,7,0,7,6,0,26,Bears,6,7,0,7,0,0,20,201513,0,0,0,6,46,-6,1425.91696291298,1469.50145694531,2015,13,0,0,0,1,0,1853
Texans,6,7,0,8,0,0,21,Bills,7,14,0,9,0,0,30,201513,1,8,8,9,51,9,1514.19137882479,1512.57869623817,2015,13,0,0,0,1,0,1285
Packers,0,0,14,13,0,0,27,Lions,17,0,3,3,0,0,23,201513,-17,-17,-6,4,50,-4,1620.72431068184,1474.27430220867,2015,13,0,0,0,1,1,291
Patriots,7,10,3,7,0,0,27,Texans,3,3,0,0,0,0,6,201514,4,11,14,21,33,-21,1696.11374215307,1495.84893416366,2015,14,0,0,0,1,0,1597
Cowboys,0,0,7,0,0,0,7,Packers,0,14,0,14,0,0,28,201514,0,14,7,21,35,21,1487.75567744288,1632.67098774032,2015,14,0,0,0,1,0,937
Raiders,0,0,9,6,0,0,15,Broncos,6,6,0,0,0,0,12,201514,-6,-12,-3,3,27,-3,1409.60111194437,1674.01080310442,2015,14,0,0,0,1,1,939
Seahawks,7,7,7,14,0,0,35,Ravens,0,6,0,0,0,0,6,201514,7,8,15,29,41,-29,1675.61898288156,1491.37553125741,2015,14,0,0,0,0,0,2328
Colts,3,10,3,0,0,0,16,Jaguars,3,6,21,21,0,0,51,201514,0,-4,14,35,67,35,1523.53928593291,1325.58903562929,2015,14,0,0,0,1,1,699
Falcons,0,0,0,0,0,0,0,Panthers,21,7,10,0,0,0,38,201514,21,28,38,38,38,38,1452.9460242289,1694.79934812141,2015,14,0,0,0,1,1,226
Saints,7,10,7,0,0,0,24,Buccaneers,0,10,0,7,0,0,17,201514,7,7,14,7,41,-7,1404.47682186975,1436.7760447979,2015,14,0,0,0,1,1,480
Giants,3,14,7,7,0,0,31,Dolphins,7,10,7,0,0,0,24,201514,-4,0,0,7,55,-7,1482.72621321707,1424.26181797158,2015,14,0,0,0,0,0,1091
Titans,0,0,8,0,0,0,8,Jets,10,17,0,3,0,0,30,201514,10,27,19,22,38,22,1311.86288168153,1492.11128666457,2015,14,0,0,0,1,0,758
Lions,0,0,7,7,0,0,14,Rams,0,7,7,7,0,0,21,201514,0,7,7,7,35,7,1462.32762515019,1405.43627627003,2015,14,0,0,0,1,0,454
Chargers,0,0,3,0,0,0,3,Chiefs,0,10,0,0,0,0,10,201514,0,10,7,7,13,7,1404.50066634558,1639.50467782431,2015,14,0,0,0,1,1,1334
49ers,0,3,0,7,0,0,10,Browns,7,3,7,7,0,0,24,201514,7,7,14,14,34,14,1452.58323305674,1325.53318354676,2015,14,0,0,0,0,0,2161
Steelers,7,9,7,10,0,0,33,Bengals,0,7,3,10,0,0,20,201514,7,9,13,13,53,-13,1591.22922795426,1653.62099264772,2015,14,0,0,0,1,1,252
Washington,7,7,7,3,0,0,24,Bears,0,7,14,0,0,0,21,201514,7,7,0,3,45,-3,1411.68416579614,1442.83518680155,2015,14,0,0,0,1,0,594
Vikings,7,3,0,10,0,0,20,Cardinals,10,0,7,6,0,0,23,201514,3,0,7,3,43,3,1543.27358413424,1681.26906970316,2015,14,0,0,0,1,0,1278
Bills,7,3,10,0,0,0,20,Eagles,7,10,3,3,0,0,23,201514,0,7,0,3,43,3,1530.9211408993,1501.70743906744,2015,14,0,0,0,0,0,279
Lions,7,14,7,7,0,0,35,Saints,3,0,7,17,0,0,27,201515,4,18,18,8,62,-8,1442.09301337135,1432.17196582795,2015,15,0,0,0,1,0,939
Cardinals,7,10,13,10,0,0,40,Eagles,3,7,0,7,0,0,17,201515,4,7,20,23,57,-23,1687.2880490459,1513.94839306384,2015,15,0,0,0,1,0,2078
Bengals,0,21,3,0,0,0,24,49ers,0,0,7,7,0,0,14,201515,0,21,17,10,38,-10,1615.77395027702,1419.79222189831,2015,15,0,0,0,0,0,2040
Dolphins,0,0,7,7,0,0,14,Chargers,6,17,0,7,0,0,30,201515,6,23,16,16,44,16,1403.01316128992,1398.9752078701,2015,15,0,0,0,1,0,2267
Broncos,14,13,0,0,0,0,27,Steelers,7,6,7,14,0,0,34,201515,-7,-14,-7,7,61,7,1645.65895068074,1629.07627032496,2015,15,0,0,0,1,0,1317
Browns,7,3,0,3,0,0,13,Seahawks,7,13,0,10,0,0,30,201515,0,10,10,17,43,17,1358.32419470519,1697.22438289355,2015,15,0,0,0,0,0,2020
Packers,14,0,10,6,0,0,30,Raiders,0,13,7,0,0,0,20,201515,14,1,4,10,50,-10,1645.65067276798,1437.95296436805,2015,15,0,0,0,0,0,1826
Chiefs,14,10,0,10,0,0,34,Ravens,7,7,0,0,0,0,14,201515,7,10,10,20,48,-20,1645.03013629979,1469.77013124542,2015,15,0,0,0,1,0,960
Falcons,7,10,0,6,0,0,23,Jaguars,0,3,14,0,0,0,17,201515,7,14,0,6,40,-6,1443.55839457842,1377.65086313881,2015,15,0,0,0,0,0,285
Panthers,7,14,14,3,0,0,38,Giants,7,0,7,21,0,0,35,201515,0,14,21,3,73,-3,1704.18697777189,1503.97486989873,2015,15,0,0,0,1,0,531
Titans,0,3,7,6,0,0,16,Patriots,7,17,3,6,0,0,33,201515,7,21,17,17,49,17,1300.80697275146,1714.43672782711,2015,15,0,0,0,1,0,936
Bears,0,7,3,7,0,0,17,Vikings,7,10,7,14,0,0,38,201515,7,10,14,21,55,21,1424.42621270822,1537.2546047915,2015,15,0,0,0,1,1,355
Texans,0,3,3,10,0,0,16,Colts,0,10,0,0,0,0,10,201515,0,-7,-4,6,26,-6,1477.52594848962,1471.47745842339,2015,15,0,0,0,1,1,865
Jets,6,3,0,10,0,0,19,Cowboys,3,7,3,3,0,0,16,201515,3,-1,-4,3,35,-3,1503.16719559464,1474.77599241522,2015,15,0,0,0,0,0,1370
Buccaneers,3,0,3,17,0,0,23,Rams,14,7,7,3,0,0,31,201515,11,18,22,8,54,8,1409.0809008397,1425.67088804887,2015,15,0,0,0,1,0,861
Bills,0,0,17,8,0,0,25,Washington,7,14,7,7,0,0,35,201515,7,21,11,10,60,10,1518.6801869029,1430.09313988947,2015,15,0,0,0,0,0,292
Steelers,0,3,7,7,0,0,17,Ravens,7,6,0,7,0,0,20,201516,7,10,3,3,37,3,1646.60568315077,1449.68179929903,2015,16,0,0,0,1,1,196
Bengals,7,7,0,3,0,0,17,Broncos,0,3,7,7,3,0,20,201516,-7,-11,-4,3,37,3,1630.25596991017,1628.12953785493,2015,16,0,0,0,1,0,1093
Giants,0,3,7,7,0,0,17,Vikings,3,16,13,17,0,0,49,201516,3,16,22,32,66,32,1495.75534291392,1552.37274239827,2015,16,0,0,0,1,0,1016
Rams,10,6,0,7,0,0,23,Seahawks,0,3,7,7,0,0,17,201516,10,13,6,6,40,-6,1441.97155628923,1701.57465385817,2015,16,0,0,0,1,1,1720
Packers,0,0,8,0,0,0,8,Cardinals,0,17,21,0,0,0,38,201516,0,17,30,30,46,30,1659.40755568622,1708.42677060149,2015,16,0,0,0,1,0,1492
Jaguars,0,6,13,8,0,0,27,Saints,14,10,7,7,0,0,38,201516,14,18,12,11,65,11,1358.2505932572,1406.09242594738,2015,16,0,0,0,0,0,503
Bears,0,13,0,13,0,0,26,Buccaneers,7,0,7,7,0,0,21,201516,-7,6,-1,5,47,-5,1409.30807510145,1392.78023259934,2015,16,0,0,0,1,0,1004
Patriots,0,3,10,7,0,0,20,Jets,3,7,7,3,6,0,26,201516,3,7,4,6,46,6,1717.27558053568,1518.74469116252,2015,16,0,0,0,1,1,181
Browns,0,3,7,3,0,0,13,Chiefs,10,7,0,0,0,0,17,201516,10,14,7,4,30,4,1353.97392374057,1665.11846824618,2015,16,0,0,0,1,0,698
Texans,10,7,17,0,0,0,34,Titans,0,0,0,6,0,0,6,201516,10,17,34,28,40,-28,1500.88130247386,1297.96812004289,2015,16,0,0,0,1,1,665
49ers,7,10,0,0,0,0,17,Lions,3,17,3,9,0,0,32,201516,-4,3,6,15,49,15,1405.31020226516,1468.17255325192,2015,16,0,0,0,1,0,2087
Cowboys,3,3,0,0,0,0,6,Bills,6,0,3,7,0,0,16,201516,3,0,3,10,22,10,1459.19849684734,1492.79833462262,2015,16,0,0,0,0,0,1197
Panthers,7,0,3,3,0,0,13,Falcons,0,7,7,6,0,0,20,201516,-7,0,4,7,33,7,1712.4065047567,1462.95866446003,2015,16,0,0,0,1,1,226
Washington,13,3,14,8,0,0,38,Eagles,7,3,7,7,0,0,24,201516,6,6,13,14,62,-14,1455.97499216975,1492.80967150825,2015,16,0,0,0,1,1,123
Chargers,7,10,0,3,0,0,20,Raiders,7,3,2,8,3,0,23,201516,0,-7,-5,3,43,3,1421.75526421742,1424.19608144981,2015,16,0,0,0,1,1,454
Colts,8,7,0,3,0,0,18,Dolphins,0,6,3,3,0,0,12,201516,8,9,6,6,30,-6,1448.12210443915,1380.2331049426,2015,16,0,0,0,1,0,1026
Rams,3,13,0,0,0,0,16,49ers,0,10,3,3,3,0,19,201517,-3,-6,-3,3,35,3,1481.52157383197,1388.33738276314,2015,17,0,0,0,1,1,1741
Vikings,3,3,14,0,0,0,20,Packers,3,0,0,10,0,0,13,201517,0,3,17,7,33,-7,1574.35963828831,1637.10512699003,2015,17,0,0,0,1,1,259
Buccaneers,3,0,7,0,0,0,10,Panthers,0,24,7,7,0,0,38,201517,-3,21,21,28,48,28,1371.91935076725,1678.6769515441,2015,17,0,0,0,1,1,511
Seahawks,10,20,6,0,0,0,36,Cardinals,0,6,0,0,0,0,6,201517,10,24,30,30,42,-30,1662.02463631543,1730.72919929768,2015,17,0,0,0,1,1,1114
Raiders,0,10,0,7,0,0,17,Chiefs,14,0,9,0,0,0,23,201517,14,4,13,6,40,6,1435.06809984077,1667.94744627023,2015,17,0,0,0,1,1,1495
Jaguars,0,3,3,0,0,0,6,Texans,3,17,0,10,0,0,30,201517,3,17,14,24,36,24,1342.03172917,1520.61150415796,2015,17,0,0,0,1,1,820
Eagles,14,7,7,7,0,0,35,Giants,3,17,7,3,0,0,30,201517,11,1,1,5,65,-5,1456.32259214716,1473.76844702388,2015,17,0,0,0,1,1,80
Chargers,3,3,7,7,0,0,20,Broncos,7,0,7,13,0,0,27,201517,4,1,1,7,47,7,1410.88324582646,1639.19458277242,2015,17,0,0,0,1,1,832
Titans,7,7,3,7,0,0,24,Colts,10,10,7,3,0,0,30,201517,3,6,10,6,54,6,1278.23791835879,1467.39409553972,2015,17,0,0,0,1,1,251
Washington,21,3,3,7,0,0,34,Cowboys,0,14,0,9,0,0,23,201517,21,10,13,11,57,-11,1492.46207153084,1442.59189280724,2015,17,0,0,0,1,1,1181
Steelers,7,7,3,11,0,0,28,Browns,3,6,0,3,0,0,12,201517,4,5,8,16,40,-16,1626.51321580242,1351.14494571652,2015,17,0,0,0,1,1,114
Ravens,0,9,0,7,0,0,16,Bengals,0,7,14,3,0,0,24,201517,0,-2,12,8,40,8,1469.77426664738,1619.19092499268,2015,17,0,0,0,1,1,419
Lions,7,3,7,7,0,0,24,Bears,0,0,10,10,0,0,20,201517,7,10,7,4,44,-4,1485.14537275394,1430.16895693354,2015,17,0,0,0,1,1,238
Jets,0,7,10,0,0,0,17,Bills,7,9,3,3,0,0,22,201517,7,9,2,5,39,5,1547.05305991949,1509.40493866272,2015,17,0,0,0,1,1,292
Saints,7,7,3,3,0,0,20,Falcons,3,14,0,0,0,0,17,201517,4,-3,0,3,37,-3,1422.31129003458,1496.68821767263,2015,17,0,0,0,1,1,424
Patriots,0,3,7,0,0,0,10,Dolphins,3,7,0,10,0,0,20,201517,3,7,0,10,30,10,1688.96721177871,1360.96111384203,2015,17,0,0,0,1,1,1241
Packers,0,17,7,11,0,0,35,Washington,5,6,7,0,0,0,18,201518,-5,6,6,17,53,-17,1607.25881367488,1518.57212379253,2015,18,1,0,0,1,0,686
Seahawks,0,0,0,10,0,0,10,Vikings,3,0,6,0,0,0,9,201518,-3,-3,-9,1,19,-1,1712.00100806875,1604.20595160346,2015,18,1,0,0,1,0,1391
Chiefs,7,6,7,10,0,0,30,Texans,0,0,0,0,0,0,0,201518,7,13,20,30,30,-30,1673.17645281849,1532.05714465938,2015,18,1,0,0,1,0,646
Steelers,0,6,9,3,0,0,18,Bengals,0,0,0,16,0,0,16,201518,0,6,15,2,34,-2,1638.3841424379,1628.21769304391,2015,18,1,0,0,1,1,252
Chiefs,3,3,7,7,0,0,20,Patriots,7,7,7,6,0,0,27,201519,4,8,8,7,47,7,1699.21018688796,1644.32110337201,2015,19,1,0,1,1,0,1249
Packers,0,6,7,7,0,0,20,Cardinals,7,0,3,10,6,0,26,201519,7,1,-3,6,46,6,1633.90812076086,1680.75282754436,2015,19,1,0,1,1,0,1492
Seahawks,0,0,14,10,0,0,24,Panthers,14,17,0,0,0,0,31,201519,14,31,17,7,55,7,1717.96694286292,1684.74155783108,2015,19,1,0,1,1,0,2280
Steelers,7,3,3,3,0,0,16,Broncos,6,3,3,11,0,0,23,201519,-1,-1,-1,7,39,7,1651.41465839155,1644.91854054651,2015,19,1,0,1,1,0,1317
Patriots,6,3,3,6,0,0,18,Broncos,7,10,0,3,0,0,20,201520,1,8,5,2,38,2,1664.41817614353,1661.79535582525,2015,20,1,0,0,1,0,1769
Cardinals,0,7,0,8,0,0,15,Panthers,17,7,10,15,0,0,49,201520,17,17,27,34,64,34,1693.50711983845,1703.37045346108,2015,20,1,0,0,1,0,1778
Panthers,0,7,0,3,0,0,10,Broncos,10,3,3,8,0,0,24,201522,10,6,9,14,34,14,1730.45773685885,1670.58089839598,2015,22,1,1,1,0,0,1355
Giants,0,13,0,7,0,0,20,Cowboys,3,6,7,3,0,0,19,201601,-3,4,-3,1,39,-1,1468.87798186004,1445.98789369703,2016,1,0,0,0,1,1,1370
Dolphins,0,3,0,7,0,0,10,Seahawks,3,3,0,6,0,0,12,201601,3,3,3,2,22,2,1438.73814816582,1634.55869815528,2016,1,0,0,0,0,0,2730
Lions,7,14,7,11,0,0,39,Colts,0,10,8,17,0,0,35,201601,7,11,10,4,74,-4,1502.85315875748,1484.30206131341,2016,1,0,0,0,0,0,240
Bears,7,7,0,0,0,0,14,Texans,0,10,3,10,0,0,23,201601,-7,-4,-1,9,37,9,1444.02306103417,1505.68227372661,2016,1,0,0,0,0,0,939
Steelers,0,14,10,14,0,0,38,Washington,6,0,3,7,0,0,16,201601,-6,8,15,22,54,-22,1591.35856207521,1496.28187780437,2016,1,0,0,0,0,0,190
Rams,0,0,0,0,0,0,0,49ers,7,7,0,14,0,0,28,201601,7,14,14,28,28,28,1479.22803675995,1437.34460097013,2016,1,0,0,0,1,1,347
Patriots,10,0,7,6,0,0,23,Cardinals,0,7,7,7,0,0,21,201601,10,3,3,2,44,-2,1605.4217557152,1612.61322429379,2016,1,0,0,0,0,0,2296
Bills,0,7,0,0,0,0,7,Ravens,3,7,0,3,0,0,13,201601,3,3,3,6,20,6,1518.80808993309,1475.49833239743,2016,1,0,0,0,1,0,275
Packers,7,14,3,3,0,0,27,Jaguars,7,10,3,3,0,0,23,201601,0,4,4,4,50,-4,1582.43588564451,1388.72405911239,2016,1,0,0,0,0,0,1039
Browns,0,7,3,0,0,0,10,Eagles,7,6,9,7,0,0,29,201601,7,6,12,19,39,19,1394.51601272069,1487.84937758732,2016,1,0,0,0,0,0,358
Bengals,3,10,7,3,0,0,23,Jets,7,9,0,6,0,0,22,201601,-4,-3,4,1,45,-1,1578.45811806017,1522.16390912172,2016,1,0,0,0,1,0,563
Raiders,10,0,3,22,0,0,35,Saints,3,14,7,10,0,0,34,201601,7,-7,-11,1,69,-1,1454.89272886167,1463.5000309425,2016,1,0,0,0,0,0,1914
Chargers,7,14,3,3,0,0,27,Chiefs,3,0,7,17,6,0,33,201601,-4,-18,-14,6,60,6,1438.43952536825,1621.07540941096,2016,1,0,0,0,1,1,1334
Vikings,0,0,12,13,0,0,25,Titans,3,7,0,6,0,0,16,201601,-3,-10,2,9,41,-9,1567.16001120619,1349.45261461893,2016,1,0,0,0,0,0,696
Buccaneers,3,14,14,0,0,0,31,Falcons,10,3,8,3,0,0,24,201601,-7,4,10,7,55,-7,1412.23649632018,1485.83297419564,2016,1,0,0,0,1,1,416
Panthers,7,10,0,3,0,0,20,Broncos,0,7,0,14,0,0,21,201601,-7,-10,-10,1,41,1,1633.57926535012,1637.1131581531,2016,1,0,0,0,0,0,1355
Eagles,3,6,13,7,0,0,29,Bears,0,7,0,7,0,0,14,201602,3,2,15,15,43,-15,1503.87393721284,1429.85402987043,2016,2,0,0,0,1,0,664
Packers,7,0,0,7,0,0,14,Vikings,0,10,7,0,0,0,17,201602,-7,3,10,3,31,3,1592.2521736801,1579.79345393256,2016,2,0,0,0,1,1,259
Falcons,0,13,8,14,0,0,35,Raiders,0,7,7,14,0,0,28,201602,0,6,7,7,63,-7,1455.22910041851,1463.56113743332,2016,2,0,0,0,0,0,2127
Colts,3,3,7,7,0,0,20,Broncos,3,10,3,18,0,0,34,201602,0,7,3,14,54,14,1465.67547598826,1642.52618918682,2016,2,0,0,0,1,0,998
Buccaneers,0,0,7,0,0,0,7,Cardinals,0,24,9,7,0,0,40,201602,0,24,26,33,47,33,1442.84037009731,1598.92757258315,2016,2,0,0,0,1,0,1793
Seahawks,0,3,0,0,0,0,3,Rams,3,3,0,3,0,0,9,201602,3,3,3,6,12,6,1638.13804913745,1448.11908076118,2016,2,0,0,0,1,1,960
Chiefs,0,3,0,9,0,0,12,Texans,7,6,0,6,0,0,19,201602,7,10,10,7,31,7,1627.85466277461,1519.85130489035,2016,2,0,0,0,1,0,646
Jaguars,0,0,0,14,0,0,14,Chargers,7,14,14,3,0,0,38,201602,7,21,35,24,52,24,1378.9077710768,1431.6602720046,2016,2,0,0,0,1,0,2087
Cowboys,10,3,7,7,0,0,27,Washington,0,10,13,0,0,0,23,201602,10,3,-3,4,50,-4,1438.0688249969,1468.02086198119,2016,2,0,0,0,1,1,1181
Bengals,3,3,3,7,0,0,16,Steelers,7,3,7,7,0,0,24,201602,4,4,8,8,40,8,1585.59146528381,1619.61957789839,2016,2,0,0,0,1,1,252
Saints,0,3,0,10,0,0,13,Giants,0,7,3,6,0,0,16,201602,0,4,7,3,29,3,1454.83162237086,1476.79705056017,2016,2,0,0,0,1,0,1168
Dolphins,0,3,7,14,0,0,24,Patriots,14,10,7,0,0,0,31,201602,14,21,21,7,55,7,1435.15879718365,1619.10740742584,2016,2,0,0,0,1,1,1241
Titans,0,3,0,13,0,0,16,Lions,9,3,3,0,0,0,15,201602,-9,-9,-12,1,31,-1,1336.81917189256,1521.47974408263,2016,2,0,0,0,0,0,470
Ravens,2,10,7,6,0,0,25,Browns,20,0,0,0,0,0,20,201602,-18,-8,-1,5,45,-5,1493.56605368813,1378.49145309517,2016,2,0,0,0,1,1,307
Jets,6,14,7,10,0,0,37,Bills,7,3,14,7,0,0,31,201602,-1,10,3,6,68,-6,1515.03056189808,1500.74036864239,2016,2,0,0,0,1,1,292
49ers,3,7,0,17,0,0,27,Panthers,7,10,14,15,0,0,46,201602,4,7,21,19,73,19,1468.4535569689,1628.1662343164,2016,2,0,0,0,1,0,2296
Falcons,7,21,10,7,0,0,45,Saints,7,10,8,7,0,0,32,201603,0,11,13,13,77,-13,1481.21465707928,1444.76586457626,2016,3,0,0,0,1,1,424
Bears,0,3,7,7,0,0,17,Cowboys,10,14,0,7,0,0,31,201603,10,21,14,14,48,14,1402.95805563971,1459.3749409376,2016,3,0,0,0,1,0,802
Steelers,0,3,0,0,0,0,3,Eagles,3,10,21,0,0,0,34,201603,3,10,31,31,37,31,1634.80967442354,1530.76991144356,2016,3,0,0,0,0,0,257
Jets,0,3,0,0,0,0,3,Chiefs,7,10,0,7,0,0,24,201603,7,14,14,21,27,21,1537.83546161683,1604.03388657703,2016,3,0,0,0,1,0,1093
Chargers,0,13,6,3,0,0,22,Colts,10,3,7,6,0,0,26,201603,10,0,1,4,48,4,1452.23763662971,1455.96220224265,2016,3,0,0,0,1,0,1784
Rams,10,7,7,13,0,0,37,Buccaneers,6,14,0,12,0,0,32,201603,4,-3,4,5,69,-5,1475.86987224623,1428.81824427008,2016,3,0,0,0,1,0,2149
49ers,0,3,0,15,0,0,18,Seahawks,14,10,6,7,0,0,37,201603,14,21,27,19,55,19,1456.75200058333,1610.3872576524,2016,3,0,0,0,1,1,679
Ravens,7,6,3,3,0,0,19,Jaguars,0,7,7,3,0,0,17,201603,7,6,2,2,36,-2,1508.57731154128,1358.33040645169,2016,3,0,0,0,1,0,681
Raiders,7,10,0,0,0,0,17,Titans,3,0,7,0,0,0,10,201603,4,14,7,7,27,-7,1437.57558077255,1349.45452044946,2016,3,0,0,0,1,0,1950
Washington,6,10,7,6,0,0,29,Giants,14,7,3,3,0,0,27,201603,-8,-5,-1,2,56,-2,1446.71474604049,1486.86280835477,2016,3,0,0,0,1,1,204
Browns,0,13,0,11,0,0,24,Dolphins,7,3,7,7,6,0,30,201603,7,-3,4,6,54,6,1363.48019524202,1427.96223300366,2016,3,0,0,0,1,0,1089
Lions,3,7,7,10,0,0,27,Packers,14,17,3,0,0,0,34,201603,11,21,17,7,61,7,1508.84439552573,1580.74465764829,2016,3,0,0,0,1,1,291
Broncos,3,13,0,13,0,0,29,Bengals,7,7,0,3,0,0,17,201603,-4,2,2,12,46,-12,1652.23946293243,1570.40136875866,2016,3,0,0,0,1,0,1093
Cardinals,0,7,6,5,0,0,18,Bills,10,7,13,3,0,0,33,201603,10,10,17,15,51,15,1612.94969841038,1477.93546892364,2016,3,0,0,0,0,0,1902
Texans,0,0,0,0,0,0,0,Patriots,10,0,10,7,0,0,27,201603,10,10,20,27,27,27,1543.67208108793,1626.30397160583,2016,3,0,0,0,1,0,1597
Vikings,2,6,8,6,0,0,22,Panthers,10,0,0,0,0,0,10,201603,-8,-2,6,12,32,-12,1591.30096996437,1639.86779070197,2016,3,0,0,0,1,0,938
Rams,7,3,0,7,0,0,17,Cardinals,0,10,3,0,0,0,13,201604,7,0,-3,4,30,-4,1494.8672468548,1578.61841057421,2016,4,0,0,0,1,1,356
Saints,7,7,7,14,0,0,35,Chargers,7,17,0,10,0,0,34,201604,0,-10,-3,1,69,-1,1415.83601585363,1439.67826347014,2016,4,0,0,0,0,0,1605
Broncos,7,10,3,7,0,0,27,Buccaneers,7,0,0,0,0,0,7,201604,0,10,13,20,34,-20,1676.46146609631,1409.82086966151,2016,4,0,0,0,0,0,1521
Chiefs,0,0,0,14,0,0,14,Steelers,22,7,7,7,0,0,43,201604,22,29,36,29,57,29,1622.68458221748,1595.57815545264,2016,4,0,0,0,1,0,779
Giants,0,3,0,7,0,0,10,Vikings,7,7,3,7,0,0,24,201604,7,11,14,14,34,14,1471.93635994955,1626.88508488482,2016,4,0,0,0,1,0,1016
Cowboys,0,14,7,3,0,0,24,49ers,7,7,3,0,0,0,17,201604,-7,0,4,7,41,-7,1476.41843243446,1444.6957728578,2016,4,0,0,0,1,0,1480
Titans,3,14,3,0,0,0,20,Texans,14,6,7,0,0,0,27,201604,11,3,7,7,47,7,1330.24378426516,1524.96942766884,2016,4,0,0,0,1,1,665
Seahawks,0,14,3,10,0,0,27,Jets,3,7,0,7,0,0,17,201604,-3,4,7,10,44,-10,1622.44348537793,1519.18476597638,2016,4,0,0,0,0,0,2401
Browns,0,17,3,0,0,0,20,Washington,14,3,0,14,0,0,31,201604,14,0,-3,11,51,11,1351.65121421601,1461.64119444571,2016,4,0,0,0,0,0,304
Raiders,7,7,0,14,0,0,28,Ravens,0,6,6,15,0,0,27,201604,7,8,2,1,55,-1,1456.78631695685,1516.60946210169,2016,4,0,0,0,1,0,2442
Bills,7,6,3,0,0,0,16,Patriots,0,0,0,0,0,0,0,201604,7,13,16,16,16,-16,1512.26675675981,1645.00662502492,2016,4,0,0,0,1,1,404
Lions,0,3,3,8,0,0,14,Bears,7,0,7,3,0,0,17,201604,7,4,8,3,31,3,1496.60591512002,1385.91456414285,2016,4,0,0,0,1,1,238
Panthers,0,10,0,23,0,0,33,Falcons,14,3,14,17,0,0,48,201604,14,7,21,15,81,15,1604.28367578152,1510.14450580191,2016,4,0,0,0,1,1,226
Colts,3,3,0,21,0,0,27,Jaguars,7,10,6,7,0,0,30,201604,4,11,17,3,57,3,1468.52157540222,1350.29825589128,2016,4,0,0,0,1,1,699
Dolphins,7,0,0,0,0,0,7,Bengals,10,6,3,3,0,0,22,201604,3,9,12,15,29,15,1439.79121402967,1546.17936559478,2016,4,0,0,0,1,0,957
Buccaneers,3,3,8,3,0,0,17,Panthers,0,0,14,0,0,0,14,201605,3,6,0,3,31,-3,1396.51592211294,1573.83457477479,2016,5,0,0,0,1,1,511
Giants,0,6,3,7,0,0,16,Packers,7,10,0,6,0,0,23,201605,7,11,8,7,39,7,1461.10781803946,1592.983138054,2016,5,0,0,1,1,0,758
Bills,7,9,7,7,0,0,30,Rams,3,10,3,3,0,0,19,201605,4,3,7,11,49,-11,1559.42049993752,1519.09835402768,2016,5,0,0,0,0,0,2193
Chargers,0,10,14,7,0,0,31,Raiders,3,6,18,7,0,0,34,201605,3,-1,3,3,65,3,1430.64730642239,1466.66676624765,2016,5,0,0,0,1,1,454
Bengals,0,0,0,14,0,0,14,Cowboys,7,14,7,0,0,0,28,201605,7,21,28,14,42,14,1560.15087236612,1499.54833071622,2016,5,0,0,0,0,0,817
Falcons,10,3,7,3,0,0,23,Broncos,0,3,0,13,0,0,16,201605,10,10,17,7,39,-7,1540.59360680864,1689.76641364488,2016,5,0,0,0,0,0,1209
Washington,6,0,10,0,0,0,16,Ravens,7,3,0,0,0,0,10,201605,-1,-4,6,6,26,-6,1473.95610531242,1506.72901281089,2016,5,0,0,0,0,0,35
Jets,3,10,0,0,0,0,13,Steelers,7,7,3,14,0,0,31,201605,4,1,4,18,44,18,1498.20061428431,1625.38185333183,2016,5,0,0,0,1,0,314
Texans,0,6,0,7,0,0,13,Vikings,14,10,0,7,0,0,31,201605,14,18,18,18,44,18,1531.78240635773,1637.71362679491,2016,5,0,0,0,0,0,1057
Titans,7,14,3,6,0,0,30,Dolphins,0,14,3,0,0,0,17,201605,7,7,7,13,47,-13,1323.43080557627,1425.81970725833,2016,5,0,0,0,1,0,816
Bears,3,10,0,10,0,0,23,Colts,3,13,3,10,0,0,29,201605,0,3,6,6,52,6,1401.92265812849,1449.07016194291,2016,5,0,0,0,0,0,163
Eagles,0,10,10,3,0,0,23,Lions,14,7,0,3,0,0,24,201605,14,11,1,1,47,1,1570.00143041446,1480.59782113438,2016,5,0,1,0,1,0,441
Patriots,16,7,7,3,0,0,33,Browns,7,0,0,6,0,0,13,201605,9,16,23,20,46,-20,1597.85288184721,1339.3363033493,2016,5,0,0,0,1,0,551
Cardinals,0,7,14,12,0,0,33,49ers,0,7,7,7,0,0,21,201605,0,0,7,12,54,-12,1554.38730340133,1421.56587457604,2016,5,0,0,0,1,1,652
Jets,0,3,0,0,0,0,3,Cardinals,7,7,7,7,0,0,28,201606,7,11,18,25,31,25,1484.73891490056,1574.47330063367,2016,6,0,0,0,0,0,2139
Colts,3,10,0,10,0,0,23,Texans,0,3,6,14,3,0,26,201606,-3,-10,-4,3,49,3,1461.808214593,1516.91360937424,2016,6,0,0,0,1,1,865
Falcons,0,3,21,0,0,0,24,Seahawks,7,10,0,9,0,0,26,201606,7,14,-7,2,50,2,1576.26987802051,1643.42763707,2016,6,0,0,1,1,0,2178
Cowboys,7,10,3,10,0,0,30,Packers,3,3,0,10,0,0,16,201606,4,11,14,14,46,-14,1526.23275772816,1602.28018345871,2016,6,0,0,0,1,0,937
Chiefs,7,6,10,3,0,0,26,Raiders,7,3,0,0,0,0,10,201606,0,3,13,16,36,-16,1592.88088433829,1476.17235230452,2016,6,0,1,0,1,1,1495
Eagles,0,14,0,6,0,0,20,Washington,7,14,3,3,0,0,27,201606,7,7,10,7,47,7,1562.50069412569,1499.90433043487,2016,6,0,0,0,1,1,123
Ravens,10,0,3,10,0,0,23,Giants,0,7,10,10,0,0,27,201606,-10,-3,4,4,50,4,1480.78078768844,1451.81077263475,2016,6,0,0,0,0,0,169
Broncos,0,3,0,10,0,0,13,Chargers,7,3,9,2,0,0,21,201606,7,7,16,8,34,8,1654.09014243301,1421.14172036552,2016,6,0,0,0,1,1,832
Bengals,0,7,7,3,0,0,17,Patriots,3,7,15,10,0,0,35,201606,3,3,11,18,52,18,1533.46644535418,1611.68418820996,2016,6,0,0,0,1,0,732
Steelers,8,0,0,7,0,0,15,Dolphins,3,13,7,7,0,0,30,201606,-5,8,15,15,45,15,1638.84355271558,1384.46859934382,2016,6,0,0,0,1,0,1013
Browns,6,7,0,13,0,0,26,Titans,7,7,7,7,0,0,28,201606,1,1,8,2,54,2,1325.50499698655,1364.78191349078,2016,6,0,0,0,1,0,458
Rams,7,7,7,7,0,0,28,Lions,7,7,7,10,0,0,31,201606,0,0,0,3,59,3,1492.18536744115,1488.09855742315,2016,6,0,0,0,1,0,1979
Jaguars,0,0,0,17,0,0,17,Bears,0,10,3,3,0,0,16,201606,0,-10,-13,1,33,-1,1369.74966935059,1389.1846054784,2016,6,0,1,0,0,0,862
49ers,3,10,0,3,0,0,16,Bills,7,10,7,21,0,0,45,201606,4,4,11,29,61,29,1401.4798773437,1586.33348652405,2016,6,0,0,0,0,0,2294
Panthers,0,10,7,21,0,0,38,Saints,14,10,7,10,0,0,41,201606,14,14,14,3,79,3,1548.8655903884,1424.86697290138,2016,6,0,0,1,1,1,648
Raiders,3,17,3,10,0,0,33,Jaguars,0,6,3,7,0,0,16,201607,3,14,14,17,49,-17,1452.58050554342,1378.67583469055,2016,7,0,0,0,1,0,2361
Texans,6,0,3,0,0,0,9,Broncos,0,14,7,6,0,0,27,201607,-6,8,12,18,36,18,1525.68745563074,1619.62197547474,2016,7,0,0,0,1,0,878
Seahawks,0,0,0,3,3,0,6,Cardinals,0,3,0,0,3,0,6,201607,0,-3,-3,0,12,0,1650.02883509445,1592.18699060564,2016,7,0,0,0,1,1,1114
Patriots,7,7,6,7,0,0,27,Steelers,0,10,3,3,0,0,16,201607,7,4,7,11,43,-11,1628.53778572328,1593.4342950303,2016,7,0,0,0,1,0,479
Buccaneers,0,17,10,7,0,0,34,49ers,14,0,0,3,0,0,17,201607,-14,3,13,17,51,-17,1421.48490649934,1389.76272019863,2016,7,0,1,0,1,0,2396
Chargers,7,10,3,10,3,0,33,Falcons,6,21,0,3,0,0,30,201607,1,-10,-7,3,63,-3,1455.60988732379,1569.66867999606,2016,7,0,0,0,0,0,1887
Vikings,0,3,0,7,0,0,10,Eagles,0,11,7,3,0,0,21,201607,0,8,15,11,31,11,1652.5824237784,1541.87267417379,2016,7,0,1,0,1,0,983
Saints,7,0,7,7,0,0,21,Chiefs,14,7,3,3,0,0,27,201607,7,14,10,6,48,6,1441.50790571363,1616.47273109939,2016,7,0,0,0,0,0,681
Bills,3,7,7,8,0,0,25,Dolphins,3,3,8,14,0,0,28,201607,0,-4,-3,3,53,3,1598.05064366912,1429.8778570291,2016,7,0,0,0,1,1,1184
Ravens,10,6,0,0,0,0,16,Jets,7,7,10,0,0,0,24,201607,-3,-2,8,8,40,8,1466.58201766445,1467.02522492859,2016,7,0,0,0,1,0,169
Colts,7,10,3,14,0,0,34,Titans,6,7,0,13,0,0,26,201607,1,4,7,8,60,-8,1453.0343683365,1372.21403027199,2016,7,0,0,0,1,1,251
Washington,0,3,0,14,0,0,17,Lions,0,3,7,10,0,0,20,201607,0,0,7,3,37,3,1520.53235038677,1499.24694427336,2016,7,0,0,0,1,0,394
Browns,0,10,7,0,0,0,17,Bengals,7,14,10,0,0,0,31,201607,7,11,14,14,48,14,1318.07288020534,1516.61284784086,2016,7,0,0,0,1,1,217
Giants,0,10,0,7,0,0,17,Rams,10,0,0,0,0,0,10,201607,-10,0,0,7,27,-7,1466.00954265874,1481.03698059094,2016,7,0,0,0,1,0,2445
Bears,0,3,7,0,0,0,10,Packers,3,3,7,13,0,0,26,201607,3,3,3,16,36,16,1380.25844013844,1562.20308027225,2016,7,0,0,0,1,1,185
Eagles,3,10,7,3,0,0,23,Cowboys,7,3,3,10,6,0,29,201608,4,-3,-7,6,52,6,1570.56844838934,1566.30986091462,2016,8,0,0,1,1,1,1297
Packers,7,17,0,8,0,0,32,Falcons,10,9,7,7,0,0,33,201608,3,-5,2,1,65,1,1572.10806233231,1547.42239450147,2016,8,0,0,0,1,0,768
Chargers,7,0,6,6,0,0,19,Broncos,3,7,7,10,0,0,27,201608,-4,3,4,8,46,8,1477.85617281838,1635.32930807252,2016,8,0,0,0,1,1,832
Lions,0,3,0,10,0,0,13,Texans,0,14,3,3,0,0,20,201608,0,11,14,7,33,7,1511.13850035784,1509.98012303296,2016,8,0,0,0,0,0,1105
Cardinals,0,7,7,6,0,0,20,Panthers,14,10,6,0,0,0,30,201608,14,17,16,10,50,10,1591.87285762898,1532.22465757615,2016,8,0,0,1,1,0,1778
Raiders,0,3,14,7,6,0,30,Buccaneers,3,7,0,14,0,0,24,201608,-3,-7,7,6,54,-6,1480.63005884322,1453.63493350992,2016,8,0,0,0,0,0,2388
Vikings,0,3,0,7,0,0,10,Bears,3,10,7,0,0,0,20,201608,3,10,17,10,30,10,1623.88664956285,1370.35345807838,2016,8,0,0,0,1,1,355
Chiefs,3,14,7,6,0,0,30,Colts,0,7,7,0,0,0,14,201608,3,10,10,16,44,-16,1623.51867824973,1473.85707038253,2016,8,0,0,0,1,0,451
Jets,0,7,14,10,0,0,31,Browns,10,10,0,8,0,0,28,201608,-10,-13,1,3,59,-3,1484.39046302529,1309.37187887743,2016,8,0,0,0,1,0,403
Patriots,14,10,14,3,0,0,41,Bills,3,7,7,8,0,0,25,201608,11,14,21,16,66,-16,1655.89154850036,1579.30899027587,2016,8,0,0,0,1,1,404
Washington,7,3,7,10,0,0,27,Bengals,7,0,13,7,0,0,27,201608,0,3,-3,0,54,0,1508.64079430229,1525.31384916877,2016,8,0,0,0,0,0,398
Jaguars,0,0,8,14,0,0,22,Titans,3,24,6,3,0,0,36,201608,3,27,25,14,58,14,1350.62628139075,1351.39132822596,2016,8,0,0,0,1,1,500
Seahawks,7,7,3,3,0,0,20,Saints,0,13,3,9,0,0,25,201608,-7,-1,-1,5,45,5,1650.34296807111,1434.46195856329,2016,8,0,0,0,1,0,2098
Bills,14,3,0,8,0,0,25,Seahawks,7,21,0,3,0,0,31,201609,-7,11,11,6,56,6,1552.06446039896,1623.24039971429,2016,9,0,0,0,0,0,2110
Broncos,0,10,0,10,0,0,20,Raiders,6,14,0,10,0,0,30,201609,6,10,10,10,50,10,1644.00699484187,1502.58861303981,2016,9,0,0,0,1,1,939
Titans,0,14,7,14,0,0,35,Chargers,9,10,14,10,0,0,43,201609,9,5,12,8,78,8,1372.76720505917,1469.17848604903,2016,9,0,0,0,1,0,1739
Colts,14,10,0,7,0,0,31,Packers,10,0,3,13,0,0,26,201609,4,14,11,5,57,-5,1453.09431695624,1566.08760945581,2016,9,0,0,0,0,0,341
Saints,14,17,0,10,0,0,41,49ers,3,17,3,0,0,0,23,201609,11,11,8,18,64,-18,1461.56452692011,1357.61269318805,2016,9,0,0,1,1,0,1921
Panthers,7,0,0,6,0,0,13,Rams,0,0,0,10,0,0,10,201609,7,7,7,3,23,-3,1555.77698024188,1459.19451805112,2016,9,0,0,1,1,0,2115
Steelers,0,0,0,14,0,0,14,Ravens,7,3,3,8,0,0,21,201609,7,10,13,7,35,7,1566.08053225322,1449.21677956775,2016,9,0,1,1,1,1,196
Lions,3,7,0,6,6,0,22,Vikings,0,3,6,7,0,0,16,201609,3,7,1,6,38,-6,1494.60250393924,1584.67844428615,2016,9,0,0,0,1,1,542
Jets,10,3,0,10,0,0,23,Dolphins,7,7,6,7,0,0,27,201609,-3,1,7,4,50,4,1493.54676063078,1448.61951042235,2016,9,0,0,1,1,1,1091
Jaguars,0,7,0,7,0,0,14,Chiefs,7,3,6,3,0,0,19,201609,7,3,9,5,33,5,1329.25040455754,1644.28143167602,2016,9,0,0,0,1,0,949
Cowboys,7,14,14,0,0,0,35,Browns,3,7,0,0,0,0,10,201609,4,11,25,25,45,-25,1581.96887047655,1300.21558127194,2016,9,0,0,0,0,0,1024
Falcons,10,10,13,10,0,0,43,Buccaneers,7,7,0,14,0,0,28,201609,3,6,19,15,71,-15,1553.44284737797,1431.67637931333,2016,9,0,0,0,1,1,416
Eagles,3,7,7,6,0,0,23,Giants,14,7,7,0,0,0,28,201609,11,11,11,5,51,5,1554.90943882741,1487.85200519856,2016,9,0,0,1,1,1,80
Texans,14,0,7,3,0,0,24,Jaguars,7,3,0,11,0,0,21,201610,7,4,11,3,45,-3,1526.51611945156,1326.16825221069,2016,10,0,1,0,1,1,820
Seahawks,6,13,3,9,0,0,31,Patriots,7,7,7,3,0,0,24,201610,-1,5,1,7,55,-7,1634.72939784899,1683.13607837727,2016,10,0,0,1,0,0,2495
Cowboys,10,3,10,12,0,0,35,Steelers,12,3,3,12,0,0,30,201610,-2,-2,5,5,65,-5,1595.20223109527,1541.62842038696,2016,10,0,0,0,0,0,1069
Bengals,7,3,10,0,0,0,20,Giants,7,7,0,7,0,0,21,201610,0,4,-6,1,41,1,1524.58261610931,1505.89257401311,2016,10,0,1,0,0,0,563
Dolphins,0,7,14,10,0,0,31,Chargers,0,10,7,7,0,0,24,201610,0,-3,4,7,55,-7,1463.64796647521,1480.7686226883,2016,10,0,0,0,1,0,2267
Chiefs,0,3,0,17,0,0,20,Panthers,3,14,0,0,0,0,17,201610,-3,-14,-14,3,37,-3,1647.36358402287,1568.20480941191,2016,10,0,0,0,0,0,801
49ers,0,10,3,7,0,0,20,Cardinals,7,13,0,3,0,0,23,201610,7,10,7,3,43,3,1331.91068661212,1568.32053496325,2016,10,0,0,1,1,1,652
Bears,3,7,0,0,0,0,10,Buccaneers,7,10,12,7,0,0,36,201610,4,7,19,26,46,26,1409.56166335508,1409.02512679435,2016,10,0,1,0,1,0,1004
Falcons,0,6,3,6,0,0,15,Eagles,7,0,3,14,0,0,24,201610,7,1,1,9,39,9,1576.09409989695,1536.86887001286,2016,10,0,0,0,1,0,665
Rams,3,0,3,3,0,0,9,Jets,0,6,0,0,0,0,6,201610,3,-3,0,3,15,-3,1446.76668888109,1478.51830457792,2016,10,0,0,0,0,0,2445
Broncos,7,3,0,15,0,0,25,Saints,0,3,14,6,0,0,23,201610,7,7,-7,2,48,-2,1613.78762465081,1487.26653349603,2016,10,0,0,0,0,0,1079
Packers,0,16,9,0,0,0,25,Titans,21,14,6,6,0,0,47,201610,21,19,16,22,72,22,1537.39626792989,1361.1770684199,2016,10,0,0,0,0,0,580
Browns,0,7,0,0,0,0,7,Ravens,0,6,15,7,0,0,28,201610,0,-1,14,21,35,21,1286.98222065322,1473.66889143401,2016,10,0,0,0,1,1,307
Vikings,0,20,0,0,0,0,20,Washington,7,7,6,6,0,0,26,201610,7,-6,0,6,46,6,1554.97431312962,1509.37202736175,2016,10,0,0,1,1,0,931
Texans,3,7,7,3,0,0,20,Raiders,0,10,3,14,0,0,27,201611,-3,0,-4,7,47,7,1534.73076733087,1532.80798323087,2016,11,0,0,1,1,0,1635
Packers,0,10,0,14,0,0,24,Washington,7,6,9,20,0,0,42,201611,7,3,12,18,66,18,1494.14707814323,1527.58524451727,2016,11,0,0,0,1,0,686
Eagles,0,7,0,8,0,0,15,Seahawks,6,10,7,3,0,0,26,201611,6,9,16,11,41,11,1557.94276010827,1663.56664083529,2016,11,0,0,0,1,0,2373
Patriots,6,7,0,17,0,0,30,49ers,3,7,0,7,0,0,17,201611,3,3,3,13,47,-13,1654.29883539097,1328.25434201139,2016,11,0,0,0,0,0,2698
Dolphins,0,0,0,14,0,0,14,Rams,7,0,3,0,0,0,10,201611,-7,-7,-10,4,24,-4,1490.2612778812,1465.20414960363,2016,11,0,0,0,0,0,2335
Bears,9,7,0,0,0,0,16,Giants,6,3,13,0,0,0,22,201611,-3,-7,6,6,38,6,1383.41532562444,1511.78161328668,2016,11,0,0,0,1,0,711
Cardinals,7,10,0,7,0,0,24,Vikings,7,13,10,0,0,0,30,201611,0,3,13,6,54,6,1571.97687956398,1536.7610959741,2016,11,0,0,0,1,0,1278
Titans,0,7,7,3,0,0,17,Colts,14,7,0,3,0,0,24,201611,14,14,7,7,41,7,1404.42625820656,1481.78565848216,2016,11,0,0,1,1,1,251
Jaguars,3,6,10,0,0,0,19,Lions,0,9,7,10,0,0,26,201611,-3,0,-3,7,45,7,1317.95360433138,1524.30663509577,2016,11,0,0,1,0,0,832
Ravens,7,3,0,7,0,0,17,Cowboys,0,10,7,10,0,0,27,201611,-7,0,7,10,44,10,1484.21915172819,1613.80549343241,2016,11,0,0,0,0,0,1210
Steelers,3,11,3,7,0,0,24,Browns,0,0,3,6,0,0,9,201611,3,14,14,15,33,-15,1523.02515804982,1276.43196035904,2016,11,0,0,0,1,1,114
Bills,7,3,3,3,0,0,16,Bengals,6,6,0,0,0,0,12,201611,1,-2,1,4,28,-4,1540.57546226426,1518.69357683574,2016,11,0,1,0,1,0,388
Saints,3,0,0,17,0,0,20,Panthers,3,17,3,0,0,0,23,201611,0,17,20,3,43,3,1478.45215134813,1554.99153718529,2016,11,0,0,0,1,1,648
Buccaneers,0,9,3,7,0,0,19,Chiefs,3,7,0,7,0,0,17,201611,-3,-1,2,2,36,-2,1435.17146452499,1660.57685624949,2016,11,0,0,0,0,0,1037
Bengals,0,3,6,5,0,0,14,Ravens,10,6,0,3,0,0,19,201612,10,13,7,5,33,5,1500.25054634037,1473.38075200663,2016,12,0,0,0,1,1,419
Packers,7,7,3,10,0,0,27,Eagles,7,3,3,0,0,0,13,201612,0,4,4,14,40,-14,1473.7418417535,1545.37670981504,2016,12,0,0,0,1,0,728
Chiefs,0,9,7,8,6,0,30,Broncos,0,3,7,14,3,0,27,201612,0,6,6,3,57,-3,1639.26768219545,1622.60200679871,2016,12,0,0,1,1,1,556
Patriots,0,10,3,9,0,0,22,Jets,3,7,0,7,0,0,17,201612,-3,0,3,5,39,-5,1662.88721517526,1460.08084385538,2016,12,0,0,1,1,1,181
Panthers,7,0,18,7,0,0,32,Raiders,7,17,0,11,0,0,35,201612,0,17,-1,3,67,3,1562.98563167176,1553.73576902418,2016,12,0,0,0,0,0,2288
Seahawks,0,5,0,0,0,0,5,Buccaneers,14,0,0,0,0,0,14,201612,14,9,9,9,19,9,1676.13269112852,1456.48063857903,2016,12,0,0,0,1,0,2526
Chargers,0,14,0,7,0,0,21,Texans,0,7,0,6,0,0,13,201612,0,7,7,8,34,-8,1454.15531128231,1513.80298153756,2016,12,0,1,0,1,0,1301
Rams,7,14,0,0,0,0,21,Saints,7,21,14,7,0,0,49,201612,0,7,21,28,70,28,1446.93591649373,1470.45805686166,2016,12,0,0,0,1,0,1669
Vikings,7,0,3,3,0,0,13,Lions,7,3,0,6,0,0,16,201612,0,3,0,3,29,3,1554.3184274556,1530.72465491425,2016,12,0,0,0,1,1,542
Giants,0,14,0,13,0,0,27,Browns,0,6,0,7,0,0,13,201612,0,8,8,14,40,-14,1520.62822403265,1263.1075604691,2016,12,0,0,0,0,0,403
Titans,7,14,3,3,0,0,27,Bears,7,0,0,14,0,0,21,201612,0,14,17,6,48,-6,1392.47849756981,1374.56871487847,2016,12,0,0,0,0,0,395
Jaguars,7,0,7,7,0,0,21,Bills,0,6,14,8,0,0,28,201612,-7,-1,6,7,49,7,1311.5355845129,1559.01849275963,2016,12,0,0,0,1,0,880
Cardinals,7,6,0,6,0,0,19,Falcons,7,10,7,14,0,0,38,201612,0,4,11,19,57,19,1554.41954808248,1555.02020980154,2016,12,0,0,1,1,0,1588
Steelers,14,7,0,7,0,0,28,Colts,0,7,0,0,0,0,7,201612,14,14,14,21,35,-21,1536.34955793976,1493.73341911891,2016,12,0,0,0,1,0,328
Washington,0,6,0,20,0,0,26,Cowboys,7,10,0,14,0,0,31,201612,7,11,11,5,57,5,1547.990480907,1624.64389315397,2016,12,0,0,0,1,1,1181
49ers,7,0,7,10,0,0,24,Dolphins,0,14,10,7,0,0,31,201612,-7,7,10,7,55,7,1319.6659622271,1508.5295109911,2016,12,0,0,0,0,0,2590
Colts,14,10,10,7,0,0,41,Jets,0,3,0,7,0,0,10,201613,14,21,31,31,51,-31,1460.49614030344,1449.57735260936,2016,13,0,0,0,1,0,643
Panthers,0,7,0,0,0,0,7,Seahawks,10,13,7,10,0,0,40,201613,10,16,23,33,47,33,1551.61637166065,1641.01616306694,2016,13,0,0,0,1,0,2280
Buccaneers,7,0,10,11,0,0,28,Chargers,7,7,7,0,0,0,21,201613,0,-7,-4,7,49,-7,1491.59716664061,1485.46257746712,2016,13,0,0,0,0,0,2085
Giants,0,0,7,7,0,0,14,Steelers,5,9,7,3,0,0,24,201613,5,14,14,10,38,10,1532.98925314294,1569.58683675523,2016,13,0,0,0,0,0,314
Washington,0,6,14,3,0,0,23,Cardinals,7,3,7,14,0,0,31,201613,7,4,-3,8,54,8,1537.66346670514,1530.75786642504,2016,13,0,0,0,1,0,1977
Bills,3,7,14,0,0,0,24,Raiders,3,6,14,15,0,0,38,201613,0,-1,-1,14,62,14,1564.18952774282,1565.10502903529,2016,13,0,0,0,1,0,2286
Broncos,0,10,7,3,0,0,20,Jaguars,0,3,0,7,0,0,10,201613,0,7,14,10,30,-10,1606.46837475778,1306.36454952971,2016,13,0,0,0,1,0,1465
Dolphins,0,0,0,6,0,0,6,Ravens,14,10,0,14,0,0,38,201613,14,24,24,32,44,32,1515.5490251469,1489.06790317315,2016,13,0,0,0,1,0,956
Rams,0,0,3,7,0,0,10,Patriots,7,10,6,3,0,0,26,201613,7,17,20,16,36,16,1422.63908493687,1673.39070642128,2016,13,0,0,0,0,0,2594
Texans,0,0,7,6,0,0,13,Packers,0,7,0,14,0,0,21,201613,0,7,0,8,34,8,1482.49571535275,1513.41938126867,2016,13,0,0,0,0,0,1095
Eagles,0,0,7,7,0,0,14,Bengals,10,9,10,3,0,0,32,201613,10,19,22,18,46,18,1505.69917029987,1484.56339517385,2016,13,0,0,0,0,0,497
49ers,0,6,0,0,0,0,6,Bears,0,7,14,5,0,0,26,201613,0,1,15,20,32,20,1312.6464480713,1352.00526358086,2016,13,0,0,0,1,0,1853
Chiefs,6,14,7,2,0,0,29,Falcons,10,6,0,12,0,0,28,201613,-4,4,11,1,57,-1,1655.40131423638,1578.68189145898,2016,13,0,0,0,0,0,675
Cowboys,0,7,0,10,0,0,17,Vikings,3,0,3,9,0,0,15,201613,-3,4,1,2,32,-2,1634.97090735583,1542.32556394159,2016,13,0,0,0,1,0,863
Lions,3,10,6,9,0,0,28,Saints,0,6,0,7,0,0,13,201613,3,7,13,15,41,-15,1542.71751842826,1494.75488841852,2016,13,0,0,0,1,0,939
Cowboys,7,0,0,0,0,0,7,Giants,0,0,10,0,0,0,10,201614,-7,-7,3,3,17,3,1644.95919454412,1516.58649225456,2016,14,0,0,0,1,1,1370
Saints,0,8,3,0,0,0,11,Buccaneers,3,10,0,3,0,0,16,201614,3,5,2,5,27,5,1465.44348687419,1516.54905241193,2016,14,0,0,0,1,1,480
Falcons,7,14,21,0,0,0,42,Rams,0,0,0,14,0,0,14,201614,7,21,42,28,56,-28,1572.01962789862,1415.71560146549,2016,14,0,0,0,1,0,1932
Seahawks,3,0,0,7,0,0,10,Packers,7,14,7,10,0,0,38,201614,4,18,25,28,48,28,1660.21727822806,1528.8040784026,2016,14,0,0,0,1,0,1645
Jets,0,3,3,11,6,0,23,49ers,14,3,0,0,0,0,17,201614,-14,-14,-11,6,40,-6,1408.56014192807,1292.05724220051,2016,14,0,0,0,0,0,2565
Vikings,6,3,3,13,0,0,25,Jaguars,0,9,7,0,0,0,16,201614,6,0,-4,9,41,-9,1532.3372767533,1297.46848704937,2016,14,0,0,0,0,0,1192
Chargers,0,7,9,0,0,0,16,Panthers,10,13,3,2,0,0,28,201614,10,16,10,12,44,12,1460.5106916958,1532.41525649953,2016,14,0,0,0,0,0,2076
Ravens,0,3,14,6,0,0,23,Patriots,9,7,7,7,0,0,30,201614,9,13,6,7,53,7,1519.63711325351,1680.31418989266,2016,14,0,0,0,1,0,350
Cardinals,6,3,0,14,0,0,23,Dolphins,7,7,7,5,0,0,26,201614,1,5,12,3,49,3,1548.61837911307,1484.97981506654,2016,14,0,0,0,0,0,1978
Texans,3,10,3,6,0,0,22,Colts,3,0,7,7,0,0,17,201614,0,10,6,5,39,-5,1467.11101821882,1501.51335098473,2016,14,0,0,0,1,1,865
Broncos,0,0,0,10,0,0,10,Titans,10,3,0,0,0,0,13,201614,10,13,13,3,23,3,1615.36443723812,1415.04194886742,2016,14,0,0,1,1,0,1019
Bears,3,0,7,7,0,0,17,Lions,0,10,3,7,0,0,20,201614,-3,7,3,3,37,3,1372.59446945165,1572.02891997259,2016,14,0,0,0,1,1,238
Bengals,13,7,0,3,0,0,23,Browns,0,0,7,3,0,0,10,201614,13,20,13,13,33,-13,1509.80670746932,1250.74653135881,2016,14,0,0,1,1,1,217
Steelers,7,7,7,6,0,0,27,Bills,0,7,0,13,0,0,20,201614,7,7,14,7,47,-7,1585.98959764361,1542.82605683012,2016,14,0,0,0,1,0,178
Raiders,3,7,3,0,0,0,13,Chiefs,0,21,0,0,0,0,21,201614,-3,11,8,8,34,8,1586.46849994799,1662.06357779674,2016,14,0,0,0,1,1,1495
Washington,0,7,14,6,0,0,27,Eagles,3,10,0,9,0,0,22,201614,-3,-6,8,5,49,-5,1519.80295401711,1480.4558580044,2016,14,0,0,0,1,1,123
Panthers,10,3,10,3,0,0,26,Washington,3,6,0,6,0,0,15,201615,7,4,14,11,41,-11,1547.51089134394,1539.26806656836,2016,15,0,0,0,1,0,329
Buccaneers,3,3,14,0,0,0,20,Cowboys,0,17,0,9,0,0,26,201615,-3,11,-3,6,46,6,1528.08359647139,1628.10995084804,2016,15,0,0,0,1,0,916
Raiders,3,7,3,6,0,0,19,Chargers,7,3,6,0,0,0,16,201615,-4,0,-3,3,35,-3,1573.74524031474,1445.41505685139,2016,15,0,0,0,1,1,454
Patriots,3,7,3,3,0,0,16,Broncos,3,0,0,0,0,0,3,201615,0,7,10,13,19,-13,1688.39810031219,1595.11383151134,2016,15,0,0,0,1,0,1769
Saints,10,14,3,21,0,0,48,Cardinals,7,13,7,14,0,0,41,201615,3,4,0,7,89,-7,1453.90894281473,1534.81829751881,2016,15,0,0,0,1,0,1312
49ers,0,13,0,0,0,0,13,Falcons,21,7,10,3,0,0,41,201615,21,15,25,28,54,28,1275.84137992726,1596.04468053633,2016,15,0,0,0,1,0,2135
Jaguars,0,13,7,0,0,0,20,Texans,0,5,6,10,0,0,21,201615,0,-8,-9,1,41,1,1285.78384679785,1491.10350089456,2016,15,0,0,0,1,1,820
Eagles,3,11,0,12,0,0,26,Ravens,10,10,0,7,0,0,27,201615,7,6,6,1,53,1,1460.99074545315,1511.55320283398,2016,15,0,0,0,0,0,89
Lions,0,3,3,0,0,0,6,Giants,7,3,0,7,0,0,17,201615,7,7,4,11,23,11,1576.46271435928,1533.43573595064,2016,15,0,0,0,1,0,480
Titans,0,7,0,12,0,0,19,Chiefs,14,3,0,0,0,0,17,201615,-14,-10,-10,2,36,-2,1435.2925545942,1674.78683742999,2016,15,0,0,0,1,0,471
Steelers,3,6,6,9,0,0,24,Bengals,10,10,0,0,0,0,20,201615,-7,-11,-5,4,44,-4,1608.31078443174,1521.7650416197,2016,15,0,0,0,1,1,252
Packers,7,3,17,3,0,0,30,Bears,0,10,0,17,0,0,27,201615,7,0,17,3,57,-3,1570.08254760139,1368.16067506496,2016,15,0,0,0,1,1,185
Browns,3,0,10,0,0,0,13,Bills,10,7,7,9,0,0,33,201615,7,14,11,20,46,20,1238.78819720843,1520.50487004199,2016,15,0,0,0,1,0,173
Dolphins,0,13,21,0,0,0,34,Jets,7,3,0,3,0,0,13,201615,-7,3,24,21,47,-21,1498.77989666079,1424.77600420132,2016,15,0,0,0,1,1,1091
Rams,0,3,0,0,0,0,3,Seahawks,0,10,7,7,0,0,24,201615,0,7,14,21,27,21,1391.69054882778,1618.93880902927,2016,15,0,0,0,1,1,960
Colts,10,17,0,7,0,0,34,Vikings,0,0,3,3,0,0,6,201615,10,27,24,28,40,-28,1477.52086830899,1544.02191700482,2016,15,0,0,0,0,0,510
49ers,7,0,0,15,0,0,22,Rams,14,0,0,7,0,0,21,201616,-7,-7,-7,1,43,-1,1270.21353450375,1383.13432860215,2016,16,0,0,0,1,1,347
Lions,7,14,0,0,0,0,21,Cowboys,14,7,14,7,0,0,42,201616,7,0,14,21,63,21,1553.41330781847,1638.20653239048,2016,16,0,0,0,1,0,999
Ravens,3,3,11,10,0,0,27,Steelers,7,0,3,21,0,0,31,201616,4,1,-7,4,58,4,1516.02565011171,1623.26194561039,2016,16,0,0,0,1,1,196
Bengals,0,3,0,7,0,0,10,Texans,0,0,3,9,0,0,12,201616,0,-3,0,2,22,2,1506.81388044105,1493.2542805531,2016,16,0,0,0,1,0,897
Cardinals,7,7,0,20,0,0,34,Seahawks,0,3,7,21,0,0,31,201616,7,11,4,3,65,-3,1503.70727218243,1627.4950292549,2016,16,0,0,0,1,1,1114
Buccaneers,0,7,14,3,0,0,24,Saints,7,6,15,3,0,0,31,201616,7,6,7,7,55,7,1517.98701492895,1485.01996815111,2016,16,0,0,0,1,1,480
Colts,0,7,7,11,0,0,25,Raiders,0,19,14,0,0,0,33,201616,0,12,19,8,58,8,1526.27742759557,1584.79091496914,2016,16,0,0,0,1,0,1936
Broncos,7,3,0,0,0,0,10,Chiefs,21,0,0,12,0,0,33,201616,14,11,11,23,43,23,1571.17471895818,1653.05141819629,2016,16,0,0,0,1,1,556
Falcons,13,7,3,10,0,0,33,Panthers,0,3,10,3,0,0,16,201616,13,17,10,17,49,-17,1601.67252595983,1577.14818372098,2016,16,0,0,0,1,1,226
Jets,0,0,0,3,0,0,3,Patriots,10,17,7,7,0,0,41,201616,10,27,34,38,44,38,1394.78917929943,1712.33721286535,2016,16,0,0,0,1,1,181
Vikings,3,10,0,12,0,0,25,Packers,14,14,0,10,0,0,38,201616,11,15,15,13,63,13,1495.26535771824,1578.24076140356,2016,16,0,0,0,1,1,259
Chargers,10,0,7,0,0,0,17,Browns,7,10,3,0,0,0,20,201616,-3,7,3,3,37,3,1434.36938219699,1232.49515311036,2016,16,0,0,0,1,0,2030
Washington,14,10,7,10,0,0,41,Bears,0,14,0,7,0,0,21,201616,14,10,17,20,62,-20,1509.63077419132,1360.00246126279,2016,16,0,0,0,1,0,594
Dolphins,7,7,14,3,3,0,34,Bills,0,7,14,10,0,0,31,201616,7,7,7,3,65,-3,1528.76672156268,1526.79791414006,2016,16,0,0,0,1,1,1184
Titans,0,7,3,7,0,0,17,Jaguars,10,9,6,13,0,0,38,201616,10,12,15,21,55,21,1457.0279738279,1283.63306713931,2016,16,0,0,0,1,1,500
Giants,3,10,3,3,0,0,19,Eagles,14,7,0,3,0,0,24,201616,11,8,5,5,43,5,1556.48514249145,1456.51829817542,2016,16,0,0,0,1,1,80
Packers,0,10,7,14,0,0,31,Lions,0,14,0,10,0,0,24,201617,0,-4,3,7,55,-7,1593.03031536168,1536.23087531996,2016,17,0,0,0,1,1,291
Giants,3,7,0,9,0,0,19,Washington,0,0,3,7,0,0,10,201617,3,10,7,9,29,-9,1536.45192881879,1531.94504699293,2016,17,0,0,0,1,1,204
Seahawks,3,16,3,3,0,0,25,49ers,7,7,2,7,0,0,23,201617,-4,5,6,2,48,-2,1604.81634856865,1281.31123900655,2016,17,0,0,0,1,1,679
Chiefs,3,17,14,3,0,0,37,Chargers,3,7,7,10,0,0,27,201617,0,10,17,10,64,-10,1670.9489970349,1414.04670019783,2016,17,0,0,0,1,1,1334
Cardinals,3,13,14,14,0,0,44,Rams,0,6,0,0,0,0,6,201617,3,10,24,38,50,-38,1526.38595286868,1372.03662409935,2016,17,0,0,0,1,1,356
Raiders,0,0,6,0,0,0,6,Broncos,7,10,7,0,0,0,24,201617,7,17,18,18,30,18,1598.49582450043,1553.27714011957,2016,17,0,0,0,1,1,939
Saints,10,3,0,19,0,0,32,Falcons,14,21,3,0,0,0,38,201617,4,22,25,6,70,6,1503.63159549757,1634.53289265308,2016,17,0,0,0,1,1,424
Panthers,7,0,3,6,0,0,16,Buccaneers,3,0,7,7,0,0,17,201617,-4,-4,0,1,33,1,1544.28781702773,1499.37538758249,2016,17,0,0,0,1,1,511
Ravens,3,0,0,7,0,0,10,Bengals,14,6,0,7,0,0,27,201617,11,17,17,17,37,17,1507.947141404,1497.65666595163,2016,17,0,0,0,1,1,419
Cowboys,0,10,3,0,0,0,13,Eagles,3,7,7,10,0,0,27,201617,3,0,4,14,40,14,1655.38896488899,1476.55151184808,2016,17,0,0,0,1,1,1297
Bills,0,3,0,7,0,0,10,Jets,0,10,10,10,0,0,30,201617,0,7,17,20,40,20,1509.96493738014,1388.57487541275,2016,17,0,0,0,1,1,292
Bears,0,10,0,0,0,0,10,Vikings,7,17,0,14,0,0,38,201617,7,14,14,28,48,28,1337.68818846118,1480.47580376012,2016,17,0,0,0,1,1,355
Patriots,14,6,7,8,0,0,35,Dolphins,0,7,7,0,0,0,14,201617,14,13,13,21,49,-21,1718.55151675203,1545.5996983226,2016,17,0,0,0,1,1,1241
Jaguars,10,7,0,3,0,0,20,Colts,0,3,14,7,0,0,24,201617,-10,-14,0,4,44,4,1325.9719890474,1512.57251806428,2016,17,0,0,0,1,1,699
Texans,0,0,10,7,0,0,17,Titans,7,7,7,3,0,0,24,201617,7,14,11,7,41,7,1502.41149504252,1414.68905191981,2016,17,0,0,0,1,1,665
Browns,7,7,0,7,3,0,24,Steelers,0,7,0,14,6,0,27,201617,-7,-7,-7,3,51,3,1252.81783510952,1631.3404543181,2016,17,0,0,0,1,1,114
Raiders,7,0,0,7,0,0,14,Texans,10,10,0,7,0,0,27,201618,3,13,13,13,41,13,1570.97351496853,1480.02786445898,2016,18,1,0,0,1,0,1635
Lions,0,3,3,0,0,0,6,Seahawks,0,10,0,16,0,0,26,201618,0,7,4,20,32,20,1514.86610039566,1608.43828792986,2016,18,1,0,0,1,0,1933
Dolphins,3,3,0,6,0,0,12,Steelers,14,6,10,0,0,0,30,201618,11,14,24,18,42,18,1525.00637583463,1633.00679936409,2016,18,1,0,0,1,0,1013
Giants,3,3,7,0,0,0,13,Packers,0,14,10,14,0,0,38,201618,-3,8,11,25,51,25,1564.21012031477,1614.39509028598,2016,18,1,0,0,1,0,758
Steelers,6,6,3,3,0,0,18,Chiefs,7,0,3,6,0,0,16,201619,-1,5,5,2,34,-2,1647.73417905969,1681.92646298258,2016,19,1,0,1,1,0,779
Packers,7,14,7,6,0,0,34,Cowboys,3,10,0,18,0,0,31,201619,4,8,15,3,65,-3,1635.45117196347,1617.79468316369,2016,19,1,0,1,1,0,937
Texans,3,10,0,3,0,0,16,Patriots,14,3,7,10,0,0,34,201619,11,4,11,18,50,18,1508.72399383035,1739.14483924,2016,19,1,0,1,1,0,1597
Seahawks,7,3,3,7,0,0,20,Falcons,0,19,7,10,0,0,36,201619,-7,9,13,16,56,16,1624.70621981451,1643.27343289149,2016,19,1,0,1,1,0,2178
Packers,0,0,15,6,0,0,21,Falcons,10,14,13,7,0,0,44,201620,10,24,22,23,65,23,1651.5377308735,1664.12726603019,2016,20,1,0,0,1,0,768
Steelers,0,9,0,8,0,0,17,Patriots,10,7,16,3,0,0,36,201620,10,8,24,19,53,19,1662.43721468854,1747.16032069491,2016,20,1,0,0,1,0,479
Patriots,0,3,6,19,6,0,34,Falcons,0,21,7,0,0,0,28,201622,0,-18,-19,6,62,-6,1763.81816829203,1688.08141789649,2016,22,1,1,1,0,0,926
Chargers,0,7,0,14,0,0,21,Broncos,7,7,10,0,0,0,24,201701,7,7,17,3,45,3,1437.04615616677,1555.53296643431,2017,1,0,0,0,1,1,830
Saints,3,3,3,10,0,0,19,Vikings,3,13,3,10,0,0,29,201701,0,10,10,10,48,10,1498.26070350611,1498.17461262799,2017,1,0,0,0,1,0,1052
Giants,0,0,3,0,0,0,3,Cowboys,3,13,0,3,0,0,19,201701,3,16,13,16,22,16,1530.43602575819,1569.47208283577,2017,1,0,0,0,1,1,1370
Panthers,7,6,10,0,0,0,23,49ers,0,0,3,0,0,0,3,201701,7,13,20,20,26,-20,1526.87716569192,1353.45953309689,2017,1,0,0,0,1,0,2296
Seahawks,0,3,3,3,0,0,9,Packers,0,0,14,3,0,0,17,201701,0,-3,8,8,26,8,1570.90159111721,1586.7223860048,2017,1,0,0,0,1,0,1645
Colts,3,0,0,6,0,0,9,Rams,10,17,10,9,0,0,46,201701,7,24,34,37,55,37,1513.71213747943,1398.79345782117,2017,1,0,0,0,0,0,1805
Jaguars,3,16,7,3,0,0,29,Texans,0,0,7,0,0,0,7,201701,3,19,19,22,36,-22,1381.98420059502,1502.13900825029,2017,1,0,0,0,1,1,820
Jets,0,6,6,0,0,0,12,Bills,0,7,7,7,0,0,21,201701,0,1,2,9,33,9,1451.56552552459,1484.12768300401,2017,1,0,0,0,1,1,292
Raiders,7,6,3,10,0,0,26,Titans,7,3,3,3,0,0,16,201701,0,3,3,10,42,-10,1529.85159039811,1459.7151216689,2017,1,0,0,0,1,0,1950
Cardinals,10,0,7,6,0,0,23,Lions,0,9,6,20,0,0,35,201701,-10,-1,-2,12,58,12,1536.82159349085,1500.73211234067,2017,1,0,0,0,1,0,1687
Steelers,7,7,7,0,0,0,21,Browns,7,0,3,8,0,0,18,201701,0,7,11,3,39,-3,1598.85291139428,1335.76766004235,2017,1,0,0,0,1,1,114
Ravens,3,14,3,0,0,0,20,Bengals,0,0,0,0,0,0,0,201701,3,17,20,20,20,-20,1491.09956653729,1515.96963836647,2017,1,0,0,0,1,1,419
Falcons,3,7,3,10,0,0,23,Bears,0,10,0,7,0,0,17,201701,3,0,3,6,40,-6,1617.20456993582,1383.93471551954,2017,1,0,0,0,1,0,587
Chiefs,7,7,7,21,0,0,42,Patriots,7,10,10,0,0,0,27,201701,0,-3,-6,15,69,-15,1613.14895156915,1687.39515418986,2017,1,0,0,0,1,0,1249
Eagles,7,9,3,11,0,0,30,Washington,0,14,3,0,0,0,17,201701,7,2,2,13,47,-13,1511.09719571559,1504.45790366463,2017,1,0,0,0,1,1,123
Jets,0,10,3,7,0,0,20,Raiders,7,14,7,17,0,0,45,201702,7,11,15,25,65,25,1435.55091966151,1553.42103645828,2017,2,0,0,0,1,0,2557
Lions,7,10,0,7,0,0,24,Giants,0,7,3,0,0,0,10,201702,7,10,7,14,34,-14,1523.9471224181,1511.25015691472,2017,2,0,0,0,1,0,480
Packers,7,0,3,13,0,0,23,Falcons,7,17,10,0,0,0,34,201702,0,17,24,11,57,11,1603.07299976626,1627.1521325644,2017,2,0,0,0,1,0,768
49ers,0,6,0,3,0,0,9,Seahawks,6,0,0,6,0,0,12,201702,6,0,0,3,21,3,1333.2155926349,1554.55097735575,2017,2,0,0,0,1,1,679
Washington,3,17,0,7,0,0,27,Rams,0,10,7,3,0,0,20,201702,3,10,3,7,47,-7,1472.83675242891,1441.32510001278,2017,2,0,0,0,1,0,2294
Cowboys,0,10,0,7,0,0,17,Broncos,7,14,14,7,0,0,42,201702,7,11,25,25,59,25,1588.65795167924,1562.13632572551,2017,2,0,0,0,0,0,661
Browns,0,7,3,0,0,0,10,Ravens,7,14,0,3,0,0,24,201702,7,14,11,14,34,14,1329.60533710977,1530.87367306072,2017,2,0,0,0,1,1,307
Dolphins,3,0,10,6,0,0,19,Chargers,0,10,7,0,0,0,17,201702,3,-7,-4,2,36,-2,1508.51933075935,1430.44279687557,2017,2,0,0,0,1,0,2335
Bills,0,0,0,3,0,0,3,Panthers,3,3,0,3,0,0,9,201702,3,6,6,6,12,6,1500.14228886709,1547.12110615391,2017,2,0,0,0,0,0,539
Bears,0,0,0,7,0,0,7,Buccaneers,10,16,0,3,0,0,29,201702,10,26,26,22,36,22,1373.98715289096,1505.56497071489,2017,2,0,0,0,1,0,1004
Titans,3,3,17,14,0,0,37,Jaguars,3,0,0,13,0,0,16,201702,0,3,20,21,53,-21,1436.14567560873,1432.91444092319,2017,2,0,0,0,1,1,500
Vikings,0,3,6,0,0,0,9,Steelers,7,7,6,6,0,0,26,201702,7,11,11,17,35,17,1517.16449578574,1605.01523432686,2017,2,0,0,0,0,0,741
Patriots,20,10,3,3,0,0,36,Saints,3,10,0,7,0,0,20,201702,17,17,20,16,56,-16,1646.52975669258,1479.27082034836,2017,2,0,0,0,0,0,1349
Eagles,3,0,7,10,0,0,20,Chiefs,3,3,7,14,0,0,27,201702,0,3,3,7,47,7,1542.71834695131,1654.01434906643,2017,2,0,0,0,0,0,1034
Cardinals,0,3,0,10,3,0,16,Colts,10,0,0,3,0,0,13,201702,-10,-7,-7,3,29,-3,1513.60658341342,1471.18049528782,2017,2,0,0,0,0,0,1496
Texans,3,7,0,3,0,0,13,Bengals,0,6,3,0,0,0,9,201702,3,4,1,4,22,-4,1451.20876792212,1476.19553184304,2017,2,0,0,0,1,0,897
Raiders,0,0,7,3,0,0,10,Washington,7,7,7,6,0,0,27,201703,7,14,14,17,37,17,1568.98532230738,1495.98161000408,2017,3,0,0,0,0,0,2426
Chiefs,14,3,0,7,0,0,24,Chargers,7,3,0,0,0,0,10,201703,7,7,7,14,34,-14,1664.25753634496,1419.93243904372,2017,3,0,0,0,1,1,1354
Bengals,7,14,0,3,0,0,24,Packers,7,0,7,10,3,0,27,201703,0,-14,-7,3,51,3,1455.16315135743,1585.18332912085,2017,3,0,0,0,0,0,412
Seahawks,0,7,7,13,0,0,27,Titans,0,9,21,3,0,0,33,201703,0,2,16,6,60,6,1558.50915258586,1473.54436001753,2017,3,0,0,0,0,0,1970
Saints,7,10,7,10,0,0,34,Panthers,3,3,7,0,0,0,13,201703,4,11,11,21,47,-21,1459.94318365896,1559.86820431743,2017,3,0,0,0,1,1,648
Giants,0,0,0,24,0,0,24,Eagles,0,7,7,13,0,0,27,201703,0,7,14,3,51,3,1479.36543838204,1532.47515967278,2017,3,0,0,0,1,1,80
Dolphins,0,0,0,6,0,0,6,Jets,0,10,10,0,0,0,20,201703,0,10,20,14,26,14,1519.0296885912,1419.98663381241,2017,3,0,0,0,1,1,1091
Cowboys,0,7,7,14,0,0,28,Cardinals,7,0,7,3,0,0,17,201703,-7,0,0,11,45,-11,1560.16891471402,1528.52202330404,2017,3,0,0,0,1,0,884
Buccaneers,3,0,14,0,0,0,17,Vikings,7,14,10,3,0,0,34,201703,4,18,14,17,51,17,1519.60346869271,1501.31629300764,2017,3,0,0,0,1,0,1318
Browns,0,14,0,14,0,0,28,Colts,7,21,0,3,0,0,31,201703,7,14,14,3,59,3,1321.02534725819,1456.2650553972,2017,3,0,0,0,1,0,262
Falcons,7,13,3,7,0,0,30,Lions,0,13,10,3,0,0,26,201703,7,7,0,4,56,-4,1645.04180320981,1555.83184095078,2017,3,0,0,0,1,0,597
Steelers,0,7,7,3,0,0,17,Bears,7,10,0,0,6,0,23,201703,7,10,3,6,40,6,1620.86343710496,1359.94865491314,2017,3,0,0,0,0,0,409
Broncos,3,10,3,0,0,0,16,Bills,0,13,7,6,0,0,26,201703,-3,0,4,10,42,10,1590.62536269073,1487.39519070357,2017,3,0,0,0,1,0,1366
Ravens,0,0,0,7,0,0,7,Jaguars,10,13,14,7,0,0,44,201703,10,23,37,37,51,37,1539.4536629123,1395.51575651439,2017,3,0,0,0,1,0,681
Rams,14,10,10,7,0,0,41,49ers,7,6,7,19,0,0,39,201703,7,11,14,2,80,-2,1418.18024243761,1329.25741740479,2017,3,0,0,0,1,1,347
Texans,10,10,7,6,0,0,33,Patriots,7,14,7,8,0,0,36,201703,-3,1,1,3,69,3,1472.24114840773,1665.85739338198,2017,3,0,0,0,1,0,1597
Washington,10,0,7,3,0,0,20,Chiefs,0,7,10,12,0,0,29,201704,-10,-3,0,9,49,9,1525.65901927925,1677.41041663111,2017,4,0,0,0,0,0,940
Colts,2,13,3,0,0,0,18,Seahawks,3,7,22,14,0,0,46,201704,1,-5,14,28,64,28,1462.36417429506,1537.74466038733,2017,4,0,0,0,0,0,1867
Raiders,0,7,0,3,0,0,10,Broncos,10,0,6,0,0,0,16,201704,10,3,9,6,26,6,1539.30791303221,1563.54794293643,2017,4,0,0,0,1,1,939
Giants,0,10,7,6,0,0,23,Buccaneers,13,3,0,9,0,0,25,201704,13,6,-1,2,48,2,1470.51669642621,1495.08325704011,2017,4,0,0,0,1,0,1004
Eagles,10,6,3,7,0,0,26,Chargers,0,10,0,14,0,0,24,201704,10,6,9,2,50,-2,1541.32390162861,1406.77955875757,2017,4,0,0,0,0,0,2388
49ers,3,3,6,0,3,0,15,Cardinals,0,6,3,3,6,0,18,201704,-3,0,-3,3,33,3,1319.13660926114,1500.87566522241,2017,4,0,0,0,1,1,652
Titans,0,14,0,0,0,0,14,Texans,14,16,7,20,0,0,57,201704,14,16,23,43,71,43,1494.30885221605,1467.67336106702,2017,4,0,0,0,1,1,665
Steelers,3,16,0,7,0,0,26,Ravens,0,0,9,0,0,0,9,201704,3,19,10,17,35,-17,1588.58945879859,1485.2695278548,2017,4,0,0,0,1,1,196
Jaguars,7,3,0,10,0,0,20,Jets,7,3,10,0,3,0,23,201704,0,0,10,3,43,3,1449.69989157189,1450.17933201856,2017,4,0,0,0,1,0,835
Lions,0,3,11,0,0,0,14,Vikings,0,7,0,0,0,0,7,201704,0,-4,7,7,21,-7,1541.02013253791,1525.83650466024,2017,4,0,0,0,1,1,542
Rams,3,13,10,9,0,0,35,Cowboys,3,21,0,6,0,0,30,201704,0,-8,2,5,65,-5,1428.30105058126,1587.81527279565,2017,4,0,0,0,1,0,1237
Bengals,0,21,10,0,0,0,31,Browns,0,0,0,7,0,0,7,201704,0,21,31,24,38,-24,1448.91007563863,1314.92622836033,2017,4,0,0,0,1,1,217
Bills,0,7,7,9,0,0,23,Falcons,0,10,0,7,0,0,17,201704,0,-3,4,6,40,-6,1514.47261045787,1659.85351162268,2017,4,0,0,0,0,0,698
Saints,0,3,7,10,0,0,20,Dolphins,0,0,0,0,0,0,0,201704,0,3,10,20,20,-20,1508.12768090446,1488.83699038505,2017,4,0,0,0,0,0,668
Bears,0,7,0,7,0,0,14,Packers,14,7,7,7,0,0,35,201704,14,14,21,21,49,21,1392.22263321951,1591.43640483965,2017,4,0,0,0,1,1,185
Panthers,3,14,6,10,0,0,33,Patriots,3,13,0,14,0,0,30,201704,0,1,7,3,63,-3,1511.68370707193,1670.42518072269,2017,4,0,0,0,0,0,710
Jaguars,0,7,13,10,0,0,30,Steelers,3,3,3,0,0,0,9,201705,-3,1,11,21,39,-21,1438.74517667102,1613.8776706396,2017,5,0,0,0,1,0,704
Vikings,0,3,14,3,0,0,20,Bears,2,0,7,8,0,0,17,201705,-2,1,8,3,37,-3,1501.53040580785,1382.32533241831,2017,5,0,0,0,1,1,355
Chiefs,3,20,0,19,0,0,42,Texans,0,7,6,21,0,0,34,201705,3,16,10,8,76,-8,1686.76287755364,1500.77631971046,2017,5,0,0,0,1,0,646
Packers,6,6,3,20,0,0,35,Cowboys,7,14,0,10,0,0,31,201705,-1,-9,-6,4,66,-4,1601.33370564085,1556.50538104245,2017,5,0,0,0,1,0,937
Seahawks,0,10,3,3,0,0,16,Rams,0,10,0,0,0,0,10,201705,0,0,3,6,26,-6,1557.26180087171,1459.61094233446,2017,5,0,0,0,1,1,960
Ravens,14,10,0,6,0,0,30,Raiders,3,7,7,0,0,0,17,201705,11,14,7,13,47,-13,1459.98131601379,1525.30775637439,2017,5,0,0,0,1,0,2442
Cardinals,0,7,0,0,0,0,7,Eagles,21,0,10,3,0,0,34,201705,21,14,24,27,41,27,1505.72721339922,1549.86975257963,2017,5,0,0,0,1,0,2078
Panthers,3,14,10,0,0,0,27,Lions,3,7,0,14,0,0,24,201705,0,7,17,3,51,-3,1535.87563752152,1565.3262313903,2017,5,0,0,0,1,0,504
Titans,0,3,7,0,0,0,10,Dolphins,10,0,0,6,0,0,16,201705,10,7,0,6,26,6,1461.20589357261,1460.33040329945,2017,5,0,0,0,1,0,816
Patriots,3,10,3,3,0,0,19,Buccaneers,0,7,0,7,0,0,14,201705,3,6,9,5,33,-5,1646.2332502731,1502.9769765001,2017,5,0,0,0,0,0,1169
Bills,3,7,3,3,0,0,16,Bengals,7,3,0,10,0,0,20,201705,4,0,-3,4,36,4,1547.62917373767,1474.00355165155,2017,5,0,0,0,1,0,388
Chargers,0,10,7,10,0,0,27,Giants,9,0,7,6,0,0,22,201705,-9,1,1,5,49,-5,1398.23370780655,1462.62297696622,2017,5,0,0,0,0,0,2445
Jets,0,3,7,7,0,0,17,Browns,0,0,7,7,0,0,14,201705,0,3,3,3,31,-3,1461.13404691943,1289.83275234741,2017,5,0,0,0,1,0,403
49ers,3,3,0,17,0,0,23,Colts,3,3,10,7,3,0,26,201705,0,0,10,3,49,3,1314.28506108432,1442.84703381068,2017,5,0,0,0,0,0,1944
Colts,3,10,6,3,0,0,22,Titans,6,3,6,21,0,0,36,201706,3,-4,-4,14,58,14,1449.14362938265,1445.74857459956,2017,6,0,0,0,1,1,251
Giants,3,14,3,3,0,0,23,Broncos,0,3,0,7,0,0,10,201706,3,14,17,13,33,-13,1436.80658140448,1577.54809959425,2017,6,0,0,1,0,0,1627
Chargers,0,7,0,10,0,0,17,Raiders,7,3,0,6,0,0,16,201706,-7,-3,-3,1,33,-1,1424.05010336829,1487.19992286942,2017,6,0,0,0,1,1,343
Steelers,2,10,0,7,0,0,19,Chiefs,3,0,0,10,0,0,13,201706,-1,9,9,6,32,-6,1558.40556918931,1700.61687546467,2017,6,0,0,0,1,0,779
Buccaneers,0,0,6,27,0,0,33,Cardinals,14,10,7,7,0,0,38,201706,14,24,25,5,71,5,1489.50737117824,1483.63749173879,2017,6,0,0,0,1,0,1793
Bears,0,10,7,7,3,0,27,Ravens,0,3,7,14,0,0,24,201706,0,7,7,3,51,-3,1370.88959479148,1498.08914951876,2017,6,0,0,0,0,0,605
Rams,17,7,0,3,0,0,27,Jaguars,14,0,3,0,0,0,17,201706,3,10,7,10,44,-10,1442.23308888008,1494.21727812131,2017,6,0,0,0,0,0,2143
Patriots,0,14,7,3,0,0,24,Jets,7,7,0,3,0,0,17,201706,-7,0,7,7,41,-7,1659.70285559496,1470.43371564058,2017,6,0,0,0,1,1,181
Lions,7,3,14,14,0,0,38,Saints,17,14,14,7,0,0,52,201706,10,21,21,14,90,14,1546.99793873879,1536.63426799006,2017,6,0,0,1,1,0,939
Packers,0,10,0,0,0,0,10,Vikings,0,14,3,6,0,0,23,201706,0,4,7,13,33,13,1618.51902701327,1512.96614343468,2017,6,0,0,0,1,1,259
Dolphins,0,0,14,6,0,0,20,Falcons,10,7,0,0,0,0,17,201706,-10,-17,-3,3,37,-3,1475.7877222725,1626.69694834288,2017,6,0,0,1,0,0,605
Eagles,3,7,11,7,0,0,28,Panthers,3,7,6,7,0,0,23,201706,0,0,5,5,51,-5,1571.95947424006,1554.20393017303,2017,6,0,0,0,1,0,450
49ers,0,7,10,7,0,0,24,Washington,7,10,0,9,0,0,26,201706,7,10,0,2,50,2,1307.98846551235,1516.30655835672,2017,6,0,0,1,1,0,2435
Browns,3,0,0,14,0,0,17,Texans,10,14,9,0,0,0,33,201706,7,21,30,16,50,16,1280.53308362626,1486.92232179943,2017,6,0,0,0,1,0,1113
Broncos,0,0,0,0,0,0,0,Chargers,7,7,0,7,0,0,21,201707,7,14,14,21,21,21,1532.96251144251,1434.00831736874,2017,7,0,0,0,1,1,830
Seahawks,0,3,7,14,0,0,24,Giants,0,7,0,0,0,0,7,201707,0,-4,3,17,31,-17,1574.63965432609,1481.39216955622,2017,7,0,1,0,1,0,2401
Bengals,7,7,0,0,0,0,14,Steelers,7,13,6,3,0,0,29,201707,0,6,12,15,43,15,1490.56233904299,1591.37008472262,2017,7,0,1,0,1,1,252
Panthers,0,3,0,0,0,0,3,Bears,7,10,0,0,0,0,17,201707,7,14,14,14,20,14,1533.4184360226,1393.71880036609,2017,7,0,0,0,1,0,586
Washington,3,7,7,7,0,0,24,Eagles,0,17,7,10,0,0,34,201707,-3,7,7,10,58,10,1519.66307350065,1592.74496839049,2017,7,0,0,0,1,1,123
Cowboys,14,6,13,7,0,0,40,49ers,3,0,0,7,0,0,10,201707,11,17,30,30,50,-30,1539.32005967003,1304.63195036842,2017,7,0,1,0,1,0,1480
Falcons,0,0,0,7,0,0,7,Patriots,0,17,3,3,0,0,23,201707,0,17,20,16,30,16,1602.83840037931,1672.63109606755,2017,7,0,0,0,0,0,926
Ravens,3,3,3,7,0,0,16,Vikings,3,6,9,6,0,0,24,201707,0,3,9,8,40,8,1475.25994394415,1542.97630838305,2017,7,0,0,0,0,0,937
Chiefs,10,10,10,0,0,0,30,Raiders,14,0,7,10,0,0,31,201707,4,-6,-9,1,61,1,1667.65235993136,1477.24170886897,2017,7,0,0,0,1,1,1495
Cardinals,0,0,0,0,0,0,0,Rams,3,20,3,7,0,0,33,201707,3,23,26,33,33,33,1498.14487282841,1475.77777448183,2017,7,0,0,0,1,1,356
Jaguars,14,6,7,0,0,0,27,Colts,0,0,0,0,0,0,0,201707,14,20,27,27,27,-27,1460.67259251956,1427.42337873903,2017,7,0,0,0,1,1,699
Saints,0,7,9,10,0,0,26,Packers,7,7,0,3,0,0,17,201707,-7,-7,2,9,43,-9,1558.93707548484,1588.5088620649,2017,7,0,0,0,1,0,1012
Titans,3,3,0,3,3,0,12,Browns,0,3,3,3,0,0,9,201707,3,3,0,3,21,-3,1467.46882524318,1271.7902457333,2017,7,0,0,0,1,0,458
Buccaneers,6,0,7,14,0,0,27,Bills,3,7,7,13,0,0,30,201707,-3,4,4,3,57,3,1474.99999008862,1531.07038634623,2017,7,0,0,1,0,0,1051
Jets,14,7,7,0,0,0,28,Dolphins,7,7,0,17,0,0,31,201707,-7,-7,-14,3,59,3,1457.50547516799,1499.64627023607,2017,7,0,0,0,1,1,1091
49ers,0,0,7,3,0,0,10,Eagles,3,14,10,6,0,0,33,201708,3,17,20,23,43,23,1287.19142202456,1606.78469380638,2017,8,0,0,0,1,0,2516
Steelers,3,7,10,0,0,0,20,Lions,3,9,0,3,0,0,15,201708,0,-2,8,5,35,-5,1605.70463289007,1524.69513124401,2017,8,0,0,1,0,0,205
Cowboys,7,7,9,10,0,0,33,Washington,10,3,0,6,0,0,19,201708,-3,1,10,14,52,-14,1556.76058801389,1505.62334808476,2017,8,0,0,0,1,1,1181
Texans,14,7,3,14,0,0,38,Seahawks,14,7,6,14,0,0,41,201708,0,0,3,3,79,3,1495.66515969239,1600.86189558409,2017,8,0,1,0,0,0,1889
Panthers,7,3,0,7,0,0,17,Buccaneers,0,0,3,0,0,0,3,201708,7,10,7,14,20,-14,1499.45026845025,1466.26222140942,2017,8,0,0,0,1,1,511
Broncos,0,3,10,6,0,0,19,Chiefs,14,3,3,9,0,0,29,201708,14,14,7,10,48,10,1498.50910822234,1657.75816520618,2017,8,0,0,0,1,1,556
Bears,0,3,3,6,0,0,12,Saints,7,7,0,6,0,0,20,201708,7,11,8,8,32,8,1427.68696793844,1589.38926400169,2017,8,0,0,0,1,0,832
Chargers,7,0,0,6,0,0,13,Patriots,0,15,3,3,0,0,21,201708,-7,8,11,8,34,8,1468.46172058891,1689.46043140868,2017,8,0,0,0,1,0,2594
Colts,0,13,7,3,0,0,23,Bengals,3,7,7,7,0,0,24,201708,3,-3,-3,1,47,1,1390.5321904402,1476.22779087554,2017,8,0,0,0,1,0,99
Raiders,7,0,0,7,0,0,14,Bills,0,14,6,14,0,0,34,201708,-7,7,13,20,48,20,1487.13590359415,1539.80815502543,2017,8,0,0,0,1,0,2286
Vikings,3,9,11,10,0,0,33,Browns,6,7,3,0,0,0,16,201708,-3,-1,7,17,49,-17,1556.1466338682,1263.40673148022,2017,8,0,0,0,0,0,629
Dolphins,0,0,0,0,0,0,0,Ravens,7,13,0,20,0,0,40,201708,7,20,20,40,40,40,1508.91344773938,1462.089618459,2017,8,0,0,0,1,0,956
Falcons,7,6,3,9,0,0,25,Jets,7,10,0,3,0,0,20,201708,0,-4,-1,5,45,-5,1586.00906503818,1448.23829766468,2017,8,0,0,0,0,0,745
Lions,7,7,3,13,0,0,30,Packers,0,3,0,14,0,0,17,201709,7,11,14,13,47,-13,1507.72606313374,1558.05667354805,2017,9,0,0,1,1,1,291
Raiders,3,10,7,7,0,0,27,Dolphins,0,9,7,8,0,0,24,201709,3,4,4,3,51,-3,1467.66649314466,1474.00711271107,2017,9,0,0,0,1,0,2582
Chiefs,0,10,7,0,0,0,17,Cowboys,7,7,7,7,0,0,28,201709,7,4,4,11,45,11,1667.14595143644,1585.09960663739,2017,9,0,0,0,0,0,453
Washington,0,7,3,7,0,0,17,Seahawks,2,0,0,12,0,0,14,201709,-2,5,8,3,31,-3,1477.28432946126,1607.88613144665,2017,9,0,0,0,1,0,2322
Cardinals,7,7,0,6,0,0,20,49ers,0,3,7,0,0,0,10,201709,7,11,4,10,30,-10,1460.22872109549,1281.8617595661,2017,9,0,1,0,1,1,652
Colts,7,3,7,3,0,0,20,Texans,0,7,0,7,0,0,14,201709,7,3,10,6,34,-6,1386.69466794357,1488.64092382983,2017,9,0,0,0,1,1,865
Bengals,0,7,0,0,0,0,7,Jaguars,3,10,3,7,0,0,23,201709,3,6,9,16,30,16,1480.06531337217,1497.56378081839,2017,9,0,0,1,1,0,630
Falcons,10,0,0,7,0,0,17,Panthers,0,14,6,0,0,0,20,201709,-10,4,10,3,37,3,1599.77247177923,1529.4370215005,2017,9,0,0,0,1,1,226
Broncos,3,6,0,14,0,0,23,Eagles,17,14,13,7,0,0,51,201709,14,22,35,28,74,28,1489.12132199208,1612.11435626484,2017,9,0,0,0,0,0,1574
Rams,7,20,21,3,0,0,51,Giants,7,3,0,7,0,0,17,201709,0,17,38,34,68,-34,1513.69392621475,1455.16992829822,2017,9,0,1,1,1,0,2445
Buccaneers,0,3,0,7,0,0,10,Saints,9,7,14,0,0,0,30,201709,9,13,27,20,40,20,1436.27546835917,1597.88792859971,2017,9,0,0,0,1,1,480
Ravens,3,3,0,14,0,0,20,Titans,10,6,0,7,0,0,23,201709,7,10,10,3,43,3,1496.99595348731,1475.85233949626,2017,9,0,0,1,1,0,595
Bills,0,7,0,14,0,0,21,Jets,7,3,14,10,0,0,34,201709,7,3,17,13,55,13,1559.27756547492,1434.47489092363,2017,9,0,0,0,1,1,292
Dolphins,0,7,7,7,0,0,21,Panthers,3,14,21,7,0,0,45,201710,3,10,24,24,66,24,1456.77827756654,1543.54705661784,2017,10,0,0,0,0,0,654
Patriots,14,13,7,7,0,0,41,Broncos,6,3,7,0,0,0,16,201710,8,18,18,25,57,-25,1695.74504521834,1473.41827707357,2017,10,0,1,0,1,0,1769
Giants,6,7,0,8,0,0,21,49ers,3,14,0,14,0,0,31,201710,-3,4,4,10,52,10,1418.84690591949,1266.24542463122,2017,10,0,0,0,1,0,2565
Cowboys,7,0,0,0,0,0,7,Falcons,3,7,7,10,0,0,27,201710,-4,3,10,20,34,20,1611.37042883597,1585.66243666189,2017,10,0,0,0,1,0,719
Texans,0,7,0,0,0,0,7,Rams,3,6,21,3,0,0,33,201710,3,2,23,26,40,26,1458.17876682846,1550.01694859348,2017,10,0,0,0,0,0,1371
Chargers,0,7,7,3,0,0,17,Jaguars,6,0,8,3,3,0,20,201710,6,-1,0,3,37,3,1462.17710677925,1518.50675990214,2017,10,0,1,0,1,0,2143
Vikings,7,21,7,3,0,0,38,Washington,10,7,3,10,0,0,30,201710,-3,11,15,8,68,-8,1564.12673509156,1500.26305097272,2017,10,0,1,0,1,0,931
Seahawks,7,8,0,7,0,0,22,Cardinals,0,7,3,6,0,0,16,201710,7,8,5,6,38,-6,1584.90740993519,1475.84505603037,2017,10,0,0,0,1,1,1114
Steelers,0,3,6,11,0,0,20,Colts,0,10,7,0,0,0,17,201710,0,-7,-8,3,37,-3,1622.67370100034,1417.15682494494,2017,10,0,1,0,1,0,328
Bengals,6,7,0,7,0,0,20,Titans,7,10,0,7,0,0,24,201710,1,4,4,4,44,4,1459.12233428842,1487.73768427848,2017,10,0,0,0,1,0,243
Browns,10,0,14,0,0,0,24,Lions,3,14,7,14,0,0,38,201710,-7,7,0,14,62,14,1255.42663025686,1544.49636051051,2017,10,0,1,0,0,0,90
Packers,3,7,3,10,0,0,23,Bears,3,3,0,10,0,0,16,201710,0,4,7,7,39,-7,1521.28637617128,1419.18830334042,2017,10,0,0,1,1,1,185
Saints,7,10,20,10,0,0,47,Bills,3,0,0,7,0,0,10,201710,4,14,34,37,57,-37,1609.66909168936,1527.52571385597,2017,10,0,0,0,0,0,1086
Jets,0,3,0,7,0,0,10,Buccaneers,3,0,6,6,0,0,15,201710,3,0,6,5,25,5,1466.22674254258,1424.49430526952,2017,10,0,0,0,0,0,1004
Cardinals,0,14,7,0,0,0,21,Texans,0,10,7,14,0,0,31,201711,0,-4,-4,10,52,10,1459.17452685404,1440.42922224437,2017,11,0,0,0,0,0,1014
Eagles,7,0,16,14,0,0,37,Cowboys,6,3,0,0,0,0,9,201711,1,-2,14,28,46,-28,1627.81740118335,1584.82774859545,2017,11,0,1,0,1,1,1297
Patriots,7,10,13,3,0,0,33,Raiders,0,0,0,8,0,0,8,201711,7,17,30,25,41,-25,1713.2526191641,1484.89532828919,2017,11,0,0,1,1,0,2690
Bengals,6,7,0,7,0,0,20,Broncos,7,0,3,7,0,0,17,201711,-1,6,3,3,37,-3,1447.74660966456,1455.91070312781,2017,11,0,0,0,1,0,1093
Bills,7,0,3,14,0,0,24,Chargers,10,27,10,7,0,0,54,201711,3,30,37,30,78,30,1493.21067492313,1453.44901531334,2017,11,0,0,0,1,0,2193
Chiefs,0,3,0,6,0,0,9,Giants,0,6,0,3,3,0,12,201711,0,3,3,3,21,3,1640.87512923786,1387.70695144017,2017,11,0,1,0,0,0,1093
Falcons,14,10,7,3,0,0,34,Seahawks,7,10,6,8,0,0,31,201711,7,7,8,3,65,-3,1612.20511690241,1601.57793911152,2017,11,0,0,0,1,0,2178
Rams,7,0,0,0,0,0,7,Vikings,0,7,0,17,0,0,24,201711,-7,0,0,17,31,17,1567.76649317757,1586.18223442114,2017,11,0,0,0,1,0,1521
Washington,10,7,7,7,0,0,31,Saints,10,3,0,18,3,0,34,201711,0,-4,-11,3,65,3,1478.20755164314,1643.9841306222,2017,11,0,0,0,1,0,964
Titans,7,0,10,0,0,0,17,Steelers,10,6,7,17,0,0,40,201711,3,9,6,23,57,23,1499.11340890234,1630.70395313949,2017,11,0,0,0,1,0,471
Lions,0,21,0,6,0,0,27,Bears,10,7,0,7,0,0,24,201711,-10,4,4,3,51,-3,1549.87314055917,1400.91400491562,2017,11,0,0,0,1,1,238
Buccaneers,3,17,0,10,0,0,30,Dolphins,7,0,6,7,0,0,20,201711,-4,13,7,10,50,-10,1441.03878240723,1439.04290313306,2017,11,0,0,0,0,0,205
Ravens,0,6,7,10,0,0,23,Packers,0,0,0,0,0,0,0,201711,0,6,13,23,23,-23,1485.11060870509,1539.56067459608,2017,11,0,1,0,0,0,687
Jaguars,7,3,0,9,0,0,19,Browns,0,7,0,0,0,0,7,201711,7,3,3,12,26,-12,1527.23485136805,1250.0498502082,2017,11,0,0,0,1,0,771
Vikings,13,7,7,3,0,0,30,Lions,0,10,6,7,0,0,23,201712,13,10,11,7,53,-7,1607.46965851927,1560.06097231814,2017,12,0,0,0,1,1,542
Texans,7,3,3,3,0,0,16,Ravens,0,17,0,6,0,0,23,201712,-7,7,4,7,39,7,1460.80612212368,1529.83469040821,2017,12,0,0,0,1,0,1250
Packers,14,0,7,7,0,0,28,Steelers,6,8,7,10,0,0,31,201712,-8,0,0,3,59,3,1494.83659289296,1644.93213885761,2017,12,0,0,0,0,0,496
Jaguars,0,3,7,14,0,0,24,Cardinals,3,10,3,11,0,0,27,201712,3,10,6,3,51,3,1537.88739652872,1438.79762697473,2017,12,0,0,0,0,0,1791
Saints,7,3,0,10,0,0,20,Rams,10,7,3,6,0,0,26,201712,3,7,10,6,46,6,1649.23910196008,1546.47906907944,2017,12,0,0,0,1,0,1669
Seahawks,0,7,7,10,0,0,24,49ers,0,3,3,7,0,0,13,201712,0,4,8,11,37,-11,1585.1571806549,1297.38537911054,2017,12,0,0,1,1,1,679
Bears,0,0,3,0,0,0,3,Eagles,7,17,0,7,0,0,31,201712,7,24,21,28,34,28,1390.72617315665,1663.98254309304,2017,12,0,0,0,1,0,664
Panthers,3,9,6,17,0,0,35,Jets,3,7,7,10,0,0,27,201712,0,2,1,8,62,-8,1561.28243105132,1449.68226540487,2017,12,0,1,1,0,0,531
Broncos,0,0,0,14,0,0,14,Raiders,0,14,7,0,0,0,21,201712,0,14,21,7,35,7,1438.59499904688,1472.39602106852,2017,12,0,0,0,1,1,939
Bills,7,6,3,0,0,0,16,Chiefs,0,3,7,0,0,0,10,201712,7,10,6,6,26,-6,1461.72216923546,1618.22384638994,2017,12,0,0,0,1,0,858
Titans,6,0,7,7,0,0,20,Colts,0,13,3,0,0,0,16,201712,6,-7,-3,4,36,-4,1484.88522318422,1409.12657280579,2017,12,0,0,1,1,1,251
Browns,3,3,3,7,0,0,16,Bengals,7,9,7,7,0,0,30,201712,4,10,14,14,46,14,1239.39730504753,1465.06231374549,2017,12,0,0,0,1,1,217
Buccaneers,3,3,7,7,0,0,20,Falcons,3,17,7,7,0,0,34,201712,0,14,14,14,54,14,1470.1528179915,1628.62587535903,2017,12,0,0,0,1,1,416
Giants,0,3,7,0,0,0,10,Washington,0,3,7,10,0,0,20,201712,0,0,0,10,30,10,1410.35823428809,1472.95258030526,2017,12,0,0,0,1,1,204
Chargers,0,3,13,12,0,0,28,Cowboys,0,0,0,6,0,0,6,201712,0,3,16,22,34,-22,1484.93752100101,1548.66260668576,2017,12,0,0,0,0,0,1237
Dolphins,0,10,0,7,0,0,17,Patriots,14,7,7,7,0,0,35,201712,14,11,18,18,52,18,1409.92886754879,1725.75192638477,2017,12,0,0,0,1,1,1241
Lions,0,0,13,7,0,0,20,Ravens,3,17,0,24,0,0,44,201713,3,20,7,24,64,24,1538.0385027109,1542.22790137525,2017,13,0,0,0,0,0,396
Steelers,0,3,7,13,0,0,23,Bengals,10,7,3,0,0,0,20,201713,-10,-14,-10,3,43,-3,1650.6085782451,1472.62097400501,2017,13,0,0,0,1,1,252
Eagles,0,3,0,7,0,0,10,Seahawks,10,0,7,7,0,0,24,201713,10,7,14,14,34,14,1671.27096350832,1594.95662921966,2017,13,0,0,0,1,0,2373
Rams,16,3,7,6,0,0,32,Cardinals,0,13,0,3,0,0,16,201713,16,6,13,16,48,-16,1568.42134883796,1454.25596233468,2017,13,0,0,0,1,1,356
Panthers,7,7,0,7,0,0,21,Saints,7,14,7,3,0,0,31,201713,0,7,14,10,52,10,1579.93017755889,1627.29682220156,2017,13,0,0,0,1,1,648
Giants,7,0,0,10,0,0,17,Raiders,7,3,0,14,0,0,24,201713,0,3,3,7,41,7,1395.66214926693,1486.78527462119,2017,13,0,0,0,0,0,2557
Browns,0,7,0,3,0,0,10,Chargers,0,9,10,0,0,0,19,201713,0,2,12,9,29,9,1231.83864478801,1530.04487367975,2017,13,0,0,0,1,0,2044
Colts,0,3,7,0,0,0,10,Jaguars,7,9,11,3,0,0,30,201713,7,13,17,20,40,20,1393.60630981402,1522.42906116877,2017,13,0,0,0,1,1,699
49ers,3,6,3,3,0,0,15,Bears,7,7,0,0,0,0,14,201713,-4,-5,-2,1,29,-1,1287.58593054578,1383.43775274137,2017,13,0,0,0,1,0,1853
Broncos,0,3,6,0,0,0,9,Dolphins,2,14,10,9,0,0,35,201713,2,13,17,26,44,26,1424.20574549421,1404.88617041157,2017,13,0,0,0,1,0,1724
Texans,3,7,0,3,0,0,13,Titans,0,10,7,7,0,0,24,201713,-3,0,7,11,37,11,1448.41291115664,1500.40548617599,2017,13,0,0,0,1,1,665
Buccaneers,7,3,0,10,0,0,20,Packers,3,14,0,3,6,0,26,201713,-4,7,7,6,46,6,1459.51017409122,1489.16015350547,2017,13,0,0,0,1,0,1185
Patriots,3,6,14,0,0,0,23,Bills,0,3,0,0,0,0,3,201713,3,6,20,20,26,-20,1730.79462352199,1495.54649815987,2017,13,0,0,0,1,1,404
Vikings,0,7,0,7,0,0,14,Falcons,3,3,3,0,0,0,9,201713,-3,1,-2,5,23,-5,1629.49212812651,1639.26851925931,2017,13,0,0,0,1,0,908
Washington,0,7,0,7,0,0,14,Cowboys,0,17,0,21,0,0,38,201713,0,10,10,24,52,24,1487.64866532642,1503.55525400702,2017,13,0,0,0,1,1,1181
Chiefs,14,3,7,7,0,0,31,Jets,14,7,6,11,0,0,38,201713,0,4,3,7,69,7,1584.39951746553,1431.0345188973,2017,13,0,0,0,1,0,1093
49ers,0,13,10,3,0,0,26,Texans,3,6,7,0,0,0,16,201714,-3,4,7,10,42,-10,1298.29851382857,1432.47625657648,2017,14,0,0,0,0,0,1642
Patriots,0,10,0,10,0,0,20,Dolphins,6,7,14,0,0,0,27,201714,6,3,17,7,47,7,1746.2173082644,1432.95322979036,2017,14,0,0,0,1,1,1241
Ravens,0,14,17,7,0,0,38,Steelers,7,13,0,19,0,0,39,201714,7,6,-11,1,77,1,1567.30135254101,1659.65129668883,2017,14,0,0,0,1,1,196
Seahawks,0,0,10,14,0,0,24,Jaguars,3,0,21,6,0,0,30,201714,3,3,14,6,54,6,1623.06325249615,1536.24025611236,2017,14,0,0,0,0,0,2451
Eagles,14,10,7,12,0,0,43,Rams,7,7,14,7,0,0,35,201714,7,10,3,8,78,-8,1643.16434023183,1592.23850581538,2017,14,0,0,0,1,0,2388
Jets,0,0,0,0,0,0,0,Broncos,10,3,7,3,0,0,23,201714,10,13,20,23,23,23,1458.09336209837,1396.13868611542,2017,14,0,0,0,1,0,1627
Vikings,7,6,0,11,0,0,24,Panthers,7,7,10,7,0,0,31,201714,0,1,11,7,55,7,1651.9716163449,1564.24787484434,2017,14,0,0,0,1,0,938
Washington,0,6,0,7,0,0,13,Chargers,13,10,7,0,0,0,30,201714,13,17,24,17,43,17,1463.70361591231,1534.3925905792,2017,14,0,0,0,0,0,2294
Cowboys,3,7,0,20,0,0,30,Giants,0,10,0,0,0,0,10,201714,3,0,0,20,40,-20,1527.50030342113,1384.42719747084,2017,14,0,0,0,1,1,1370
Lions,7,7,7,3,0,0,24,Buccaneers,7,0,0,14,0,0,21,201714,0,7,14,3,45,-3,1512.96505154514,1445.81409014553,2017,14,0,0,0,1,0,994
Saints,3,7,7,0,0,0,17,Falcons,3,7,0,10,0,0,20,201714,0,0,-7,3,37,3,1642.97912491611,1616.78903104092,2017,14,0,0,0,1,1,424
Colts,0,0,0,7,0,0,7,Bills,0,7,0,0,6,0,13,201714,0,7,7,6,20,6,1379.79511487043,1480.12381341746,2017,14,0,0,0,1,0,434
Bears,6,6,7,14,0,0,33,Bengals,7,0,0,0,0,0,7,201714,-1,5,12,26,40,-26,1372.72516945859,1463.57825556128,2017,14,0,0,0,0,0,250
Titans,0,7,0,0,0,0,7,Cardinals,0,0,6,6,0,0,12,201714,0,-7,-1,5,19,5,1516.34214075615,1430.43880535726,2017,14,0,0,0,0,0,1442
Packers,7,0,0,14,6,0,27,Browns,7,7,7,0,0,0,21,201714,0,-7,-14,6,48,-6,1502.85623745116,1227.49092788856,2017,14,0,0,0,0,0,381
Raiders,0,0,0,15,0,0,15,Chiefs,3,13,10,0,0,0,26,201714,3,16,26,11,41,11,1498.02022641728,1557.34067426446,2017,14,0,0,0,1,1,1495
Falcons,7,10,0,7,0,0,24,Buccaneers,7,0,7,7,0,0,21,201715,0,10,3,3,45,-3,1628.89625678792,1432.0504272976,2017,15,0,0,0,1,1,416
Cowboys,3,7,7,3,0,0,20,Raiders,0,0,10,7,0,0,17,201715,3,10,7,3,37,-3,1550.40417382073,1482.57454583353,2017,15,0,0,0,0,0,1472
Titans,0,10,3,10,0,0,23,49ers,6,10,0,9,0,0,25,201715,6,6,3,2,48,2,1497.16563345055,1338.31588603906,2017,15,0,0,0,0,0,1958
Patriots,7,3,6,11,0,0,27,Steelers,7,10,7,0,0,0,24,201715,0,-7,-8,3,51,-3,1708.39698986559,1663.37557349097,2017,15,0,0,0,1,0,479
Rams,13,21,6,2,0,0,42,Seahawks,0,0,7,0,0,0,7,201715,13,34,33,35,49,-35,1569.22948262922,1602.17630897814,2017,15,0,0,0,1,1,960
Packers,7,7,3,7,0,0,24,Panthers,7,3,14,7,0,0,31,201715,0,-4,7,7,55,7,1511.00955507979,1586.63159696146,2017,15,0,0,0,1,0,745
Cardinals,3,6,3,3,0,0,15,Washington,7,7,3,3,0,0,20,201715,4,5,5,5,35,5,1449.61531266286,1446.60192610812,2017,15,0,0,0,1,0,1977
Texans,0,0,7,0,0,0,7,Jaguars,7,24,7,7,0,0,45,201715,7,31,31,38,52,38,1392.45888436599,1557.12719963037,2017,15,0,0,0,1,1,820
Jets,0,10,3,6,0,0,19,Saints,10,7,0,14,0,0,31,201715,10,7,4,12,50,12,1426.63492372649,1630.87189916912,2017,15,0,0,0,0,0,1168
Bengals,0,0,0,7,0,0,7,Vikings,17,7,3,7,0,0,34,201715,17,24,27,27,41,27,1413.18313700297,1629.58789422778,2017,15,0,0,0,0,0,604
Ravens,3,14,10,0,0,0,27,Browns,0,10,0,0,0,0,10,201715,3,7,17,17,37,-17,1563.57707573887,1219.33761025993,2017,15,0,0,0,1,1,307
Dolphins,3,3,0,10,0,0,16,Bills,7,14,3,0,0,0,24,201715,4,15,18,8,40,8,1470.77354818917,1490.2064392499,2017,15,0,0,0,1,1,1184
Chargers,0,6,7,0,0,0,13,Chiefs,3,7,10,10,0,0,30,201715,3,4,7,17,43,17,1551.49428038339,1572.78635484821,2017,15,0,0,0,1,1,1354
Bears,0,3,0,7,0,0,10,Lions,3,10,7,0,0,0,20,201715,3,10,17,10,30,10,1423.1202880169,1526.72871439307,2017,15,0,0,0,1,1,238
Broncos,0,7,15,3,0,0,25,Colts,7,3,3,0,0,0,13,201715,-7,-3,9,12,38,-12,1427.5971244873,1369.71248903799,2017,15,0,0,0,1,0,998
Eagles,7,14,10,3,0,0,34,Giants,13,10,6,0,0,0,29,201715,-6,-2,2,5,63,-5,1666.17336341799,1361.52332707124,2017,15,0,0,0,1,1,80
Broncos,3,0,0,8,0,0,11,Washington,0,10,3,14,0,0,27,201716,-3,7,10,16,38,16,1453.85676810831,1460.95197852367,2017,16,0,0,0,0,0,1489
Steelers,10,10,7,7,0,0,34,Texans,0,0,0,6,0,0,6,201716,10,20,27,28,40,-28,1648.58200370811,1378.49502619893,2017,16,0,0,0,1,0,1136
Giants,0,0,0,0,0,0,0,Cardinals,3,7,6,7,0,0,23,201716,3,10,16,23,23,23,1355.02530503168,1435.26526024731,2017,16,0,0,0,1,0,2139
Raiders,0,7,3,0,0,0,10,Eagles,7,0,3,9,0,0,19,201716,7,0,0,9,29,9,1468.84216654209,1672.67138545755,2017,16,0,0,0,0,0,2508
Seahawks,0,7,7,7,0,0,21,Cowboys,0,9,3,0,0,0,12,201716,0,-2,2,9,33,-9,1554.3696664854,1564.13655311217,2017,16,0,0,0,1,0,1679
Jaguars,0,16,3,14,0,0,33,49ers,10,6,7,21,0,0,44,201716,10,0,4,11,77,11,1571.09105779743,1352.81811377763,2017,16,0,0,0,0,0,2370
Buccaneers,3,6,7,3,0,0,19,Panthers,3,9,3,7,0,0,22,201716,0,3,-1,3,41,3,1423.70933034246,1598.67138960561,2017,16,0,0,0,1,1,511
Chargers,0,7,7,0,0,0,14,Jets,0,0,7,0,0,0,7,201716,0,7,7,7,21,-7,1530.45068576283,1418.63154098456,2017,16,0,0,0,1,0,2445
Browns,0,3,0,0,0,0,3,Bears,6,0,14,0,0,0,20,201716,6,3,17,17,23,17,1210.77388648954,1410.88122052296,2017,16,0,0,0,0,0,308
Bills,3,10,3,0,0,0,16,Patriots,0,13,10,14,0,0,37,201716,-3,0,7,21,53,21,1506.32319861396,1723.19055964845,2017,16,0,0,0,1,1,404
Dolphins,3,10,0,0,0,0,13,Chiefs,3,17,3,6,0,0,29,201716,0,7,10,16,42,16,1454.65678882511,1593.82994946877,2017,16,0,0,0,1,0,1242
Rams,6,7,7,7,0,0,27,Titans,3,10,7,3,0,0,23,201716,3,0,0,4,50,-4,1617.03612512196,1482.66340571198,2017,16,0,0,0,0,0,1776
Lions,7,0,3,7,0,0,17,Bengals,0,6,7,13,0,0,26,201716,-7,-1,3,9,43,9,1538.96778188701,1403.42094679437,2017,16,0,0,0,0,0,231
Vikings,10,0,3,3,0,0,16,Packers,0,0,0,0,0,0,0,201716,10,10,13,16,16,-16,1639.35008443638,1498.96976243564,2017,16,0,0,0,1,1,259
Colts,0,7,6,3,0,0,16,Ravens,3,10,3,7,0,0,23,201716,3,6,3,7,39,7,1343.45284541698,1572.14079950926,2017,16,0,0,0,1,0,509
Falcons,0,0,3,10,0,0,13,Saints,3,10,7,3,0,0,23,201716,3,13,17,10,36,10,1637.23735374306,1638.87528191105,2017,16,0,0,0,1,1,424
Chiefs,7,7,10,3,0,0,27,Broncos,3,7,0,14,0,0,24,201717,4,4,14,3,51,-3,1606.06162689229,1432.0358704855,2017,17,0,0,0,1,1,556
Saints,14,0,3,7,0,0,24,Buccaneers,7,6,0,18,0,0,31,201717,-7,-1,-4,7,55,7,1657.73927534953,1418.68962674249,2017,17,0,0,0,1,1,480
Cardinals,10,10,3,3,0,0,26,Seahawks,7,0,7,10,0,0,24,201717,3,13,9,2,50,-2,1453.29360958716,1583.25724209086,2017,17,0,0,0,1,1,1114
Raiders,0,10,0,0,0,0,10,Chargers,0,20,10,0,0,0,30,201717,0,10,20,20,40,20,1461.64232532697,1548.08448904591,2017,17,0,0,0,1,1,343
Bills,7,3,9,3,0,0,22,Dolphins,0,0,3,13,0,0,16,201717,7,10,16,6,38,-6,1497.28932550963,1442.42511140159,2017,17,0,0,0,1,1,1184
49ers,10,10,7,7,0,0,34,Rams,3,3,0,7,0,0,13,201717,7,14,21,21,47,-21,1390.60202387117,1629.56392440853,2017,17,0,0,0,1,1,347
Jaguars,0,3,0,7,0,0,10,Titans,0,12,3,0,0,0,15,201717,0,9,12,5,25,5,1533.30714770389,1470.13560642541,2017,17,0,0,0,1,1,500
Bengals,7,10,7,7,0,0,31,Ravens,0,10,7,10,0,0,27,201717,7,7,7,4,58,-4,1431.97461004644,1577.8534283995,2017,17,0,0,0,1,1,419
Panthers,0,7,0,3,0,0,10,Falcons,7,0,6,9,0,0,22,201717,7,0,6,12,32,12,1603.69109320558,1618.37336030458,2017,17,0,0,0,1,1,226
Cowboys,0,0,0,6,0,0,6,Eagles,0,0,0,0,0,0,0,201717,0,0,0,6,6,-6,1535.24897750671,1679.87122667267,2017,17,0,0,0,1,1,1297
Browns,0,14,10,0,0,0,24,Steelers,7,14,7,0,0,0,28,201717,7,7,4,4,52,4,1201.56146302276,1663.0555935099,2017,17,0,0,0,1,1,114
Packers,3,0,0,8,0,0,11,Lions,3,17,7,8,0,0,35,201717,0,17,24,24,46,24,1477.42805647447,1510.41411863494,2017,17,0,0,0,1,1,291
Texans,3,10,0,0,0,0,13,Colts,0,7,7,8,0,0,22,201717,-3,-6,1,9,35,9,1364.02143639714,1337.74021652674,2017,17,0,0,0,1,1,865
Washington,7,3,0,0,0,0,10,Giants,15,0,0,3,0,0,18,201717,8,5,5,8,28,8,1482.77287614648,1336.99695569183,2017,17,0,0,0,1,1,204
Jets,3,0,0,3,0,0,6,Patriots,7,14,3,2,0,0,26,201717,4,18,21,20,32,20,1400.99773770148,1732.22443275278,2017,17,0,0,0,1,1,181
Bears,0,7,0,3,0,0,10,Vikings,7,9,7,0,0,0,23,201717,7,9,16,13,33,13,1420.09364398974,1660.89179039755,2017,17,0,0,0,1,1,355
Titans,0,3,7,12,0,0,22,Chiefs,14,7,0,0,0,0,21,201718,-14,-18,-11,1,43,-1,1487.94410561737,1615.25609010225,2017,18,1,0,0,1,0,471
Falcons,6,7,6,7,0,0,26,Rams,0,10,0,3,0,0,13,201718,6,3,9,13,39,-13,1637.54686082093,1568.4542812949,2017,18,1,0,0,1,0,1932
Bills,0,3,0,0,0,0,3,Jaguars,0,3,7,0,0,0,10,201718,0,0,7,7,13,7,1517.4086422612,1515.49864851193,2017,18,1,0,0,1,0,880
Panthers,0,9,3,14,0,0,26,Saints,7,14,3,7,0,0,31,201718,7,12,12,5,57,5,1584.51759268923,1624.70644853133,2017,18,1,0,0,1,1,648
Falcons,3,7,0,0,0,0,10,Eagles,0,9,3,3,0,0,15,201719,-3,-1,2,5,25,5,1663.57815854799,1646.76056167602,2017,19,1,0,1,1,0,665
Titans,7,0,0,7,0,0,14,Patriots,0,21,7,7,0,0,35,201719,-7,14,21,21,49,21,1499.36118354642,1737.00857115611,2017,19,1,0,1,1,0,936
Jaguars,14,14,0,17,0,0,45,Steelers,0,14,7,21,0,0,42,201719,14,14,7,3,87,-3,1532.08244049384,1664.25181012357,2017,19,1,0,1,1,0,704
Saints,0,0,7,17,0,0,24,Vikings,10,7,0,12,0,0,29,201719,10,17,10,5,53,5,1636.78187376287,1667.69221350682,2017,19,1,0,1,1,0,1052
Vikings,7,0,0,0,0,0,7,Eagles,7,17,7,7,0,0,38,201720,0,17,24,31,45,31,1680.2385772669,1661.87806059244,2017,20,1,0,0,1,0,983
Jaguars,0,14,3,3,0,0,20,Patriots,3,7,0,14,0,0,24,201720,3,-4,-7,4,44,4,1555.1298510349,1745.10792686622,2017,20,1,0,0,1,0,1003
Eagles,9,13,7,12,0,0,41,Patriots,3,9,14,7,0,0,33,201722,6,10,3,8,74,-8,1691.28731884238,1750.51017126293,2017,22,1,1,1,0,0,261
Rams,7,3,10,13,0,0,33,Raiders,7,6,0,0,0,0,13,201801,0,-3,7,20,46,-20,1529.94865571189,1464.89534084128,2018,1,0,0,0,0,0,343
Jets,7,10,31,0,0,0,48,Lions,7,3,7,0,0,0,17,201801,0,7,31,31,65,-31,1432.47573286543,1523.50845039037,2018,1,0,0,0,0,0,480
Bears,7,10,3,3,0,0,23,Packers,0,0,3,21,0,0,24,201801,-7,-17,-17,1,47,1,1443.86214725365,1471.71966634923,2018,1,0,0,0,1,1,185
Cowboys,0,0,0,8,0,0,8,Panthers,0,10,0,6,0,0,16,201801,0,10,10,8,24,8,1547.23976166891,1549.96144497179,2018,1,0,0,0,1,0,928
Washington,0,21,0,3,0,0,24,Cardinals,0,0,0,6,0,0,6,201801,0,21,21,18,30,-18,1471.50239394001,1482.65441734498,2018,1,0,0,0,1,0,1977
Seahawks,7,3,7,7,0,0,24,Broncos,7,10,3,7,0,0,27,201801,0,7,3,3,51,3,1545.04615044037,1450.22760485036,2018,1,0,0,0,0,0,1019
Chiefs,14,3,14,7,0,0,38,Chargers,6,6,0,16,0,0,28,201801,8,5,19,10,66,-10,1570.89267478213,1544.92253540731,2018,1,0,0,0,1,1,1354
Bills,0,0,3,0,0,0,3,Ravens,14,12,14,7,0,0,47,201801,14,26,37,44,50,44,1502.21656685286,1535.27010310843,2018,1,0,0,0,1,0,275
49ers,0,3,10,3,0,0,16,Vikings,3,7,14,0,0,0,24,201801,3,7,11,8,40,8,1469.47444465653,1602.21954601131,2018,1,0,0,0,1,0,1581
Buccaneers,14,17,10,7,0,0,48,Saints,10,14,0,16,0,0,40,201801,4,7,17,8,88,-8,1469.48163570713,1584.49034000186,2018,1,0,0,0,1,1,480
Texans,3,3,7,7,0,0,20,Patriots,7,14,3,3,0,0,27,201801,4,15,11,7,47,7,1397.60339308215,1651.07866316301,2018,1,0,0,0,1,0,1597
Titans,3,0,0,17,0,0,20,Dolphins,0,7,3,17,0,0,27,201801,-3,4,7,7,47,7,1495.84121855754,1449.87052976668,2018,1,0,0,0,1,0,816
Bengals,3,7,7,17,0,0,34,Colts,3,13,7,0,0,0,23,201801,0,-6,-6,11,57,-11,1474.61525585553,1406.90437553377,2018,1,0,0,0,1,0,99
Steelers,0,7,14,0,0,0,21,Browns,0,0,7,14,0,0,21,201801,0,7,14,0,42,0,1595.80293305501,1301.91016427273,2018,1,0,0,0,1,1,114
Falcons,3,3,0,6,0,0,12,Eagles,0,3,7,8,0,0,18,201801,-3,-3,4,6,30,6,1600.64043975438,1646.78633024053,2018,1,0,0,0,1,0,665
Jaguars,3,10,0,7,0,0,20,Giants,3,3,3,6,0,0,15,201801,0,7,4,5,35,-5,1534.81840442546,1411.67749395219,2018,1,0,0,0,0,0,835
Eagles,0,7,7,7,0,0,21,Buccaneers,7,13,7,0,0,0,27,201802,7,13,13,6,48,6,1659.57814793535,1504.80839876908,2018,2,0,0,0,1,0,928
Giants,0,0,3,10,0,0,13,Cowboys,10,0,3,7,0,0,20,201802,10,10,10,7,33,7,1397.11544582057,1530.02675041365,2018,2,0,0,0,1,1,1370
Patriots,0,3,7,10,0,0,20,Jaguars,14,7,3,7,0,0,31,201802,14,18,14,11,51,11,1656.08659061351,1549.38045255708,2018,2,0,0,0,1,0,1003
Seahawks,0,3,0,14,0,0,17,Bears,7,3,0,14,0,0,24,201802,7,7,7,7,41,7,1529.78955071726,1438.94775983992,2018,2,0,0,0,1,0,1732
Lions,7,3,3,14,0,0,27,49ers,3,10,14,3,0,0,30,201802,-4,3,14,3,57,3,1470.49495795665,1459.69150776681,2018,2,0,0,0,1,0,2087
Cardinals,0,0,0,0,0,0,0,Rams,0,19,8,7,0,0,34,201802,0,19,27,34,34,34,1445.57419840646,1560.38847051292,2018,2,0,0,0,1,1,356
Chiefs,21,0,14,7,0,0,42,Steelers,0,21,7,9,0,0,37,201802,21,0,7,5,79,-5,1598.03561476961,1586.99545365433,2018,2,0,0,0,1,0,779
Raiders,3,9,7,0,0,0,19,Broncos,0,0,10,10,0,0,20,201802,-3,-12,-9,1,39,1,1434.45552604025,1465.48420457347,2018,2,0,0,0,1,1,939
Browns,3,3,6,6,0,0,18,Saints,3,0,0,18,0,0,21,201802,0,-3,-9,3,39,3,1310.71764367341,1549.16357693991,2018,2,0,0,0,0,0,924
Dolphins,7,13,0,0,0,0,20,Jets,0,0,6,6,0,0,12,201802,7,20,14,8,32,-8,1469.35859110872,1485.48922529915,2018,2,0,0,0,1,1,1091
Ravens,0,14,3,6,0,0,23,Bengals,14,14,0,6,0,0,34,201802,14,14,11,11,57,11,1561.69232636884,1499.24009725248,2018,2,0,0,0,1,1,419
Panthers,3,7,0,14,0,0,24,Falcons,3,14,7,7,0,0,31,201802,0,7,14,7,55,7,1567.17445622705,1587.84862205956,2018,2,0,0,0,1,1,226
Colts,7,7,0,7,0,0,21,Washington,0,3,3,3,0,0,9,201802,7,11,8,12,30,-12,1382.27953413682,1508.58261287853,2018,2,0,0,0,0,0,490
Vikings,7,0,0,22,0,0,29,Packers,7,10,3,9,0,0,29,201802,0,-10,-13,0,58,0,1612.00248290103,1476.63405376296,2018,2,0,0,0,1,1,259
Texans,0,7,3,7,0,0,17,Titans,14,0,0,6,0,0,20,201802,14,7,4,3,37,3,1392.59546563165,1476.3531572155,2018,2,0,0,0,1,1,665
Chargers,14,14,0,3,0,0,31,Bills,0,6,7,7,0,0,20,201802,14,22,15,11,51,-11,1517.77959541983,1475.79434359245,2018,2,0,0,0,1,0,2193
Steelers,6,24,0,0,0,0,30,Buccaneers,7,3,3,14,0,0,27,201803,-1,20,17,3,57,-3,1565.79732675008,1530.22337466201,2018,3,0,0,0,0,0,874
Cowboys,0,3,3,7,0,0,13,Seahawks,0,17,0,7,0,0,24,201803,0,14,11,11,37,11,1539.27792095265,1507.18581093181,2018,3,0,0,0,1,0,1679
Bears,0,3,10,3,0,0,16,Cardinals,14,0,0,0,0,0,14,201803,-14,-11,-1,2,30,-2,1461.55149962537,1428.345402511,2018,3,0,0,0,1,0,1450
Chargers,6,7,7,3,0,0,23,Rams,14,7,14,0,0,0,35,201803,8,8,15,12,58,12,1544.55238146988,1577.61726640838,2018,3,0,0,0,0,0,0
Giants,7,13,0,7,0,0,27,Texans,3,3,3,13,0,0,22,201803,4,14,11,5,49,-5,1387.86427528157,1384.853606653,2018,3,0,0,0,0,0,1417
Broncos,14,0,0,0,0,0,14,Ravens,10,10,7,0,0,0,27,201803,-4,6,13,13,41,13,1470.33545248135,1537.05400973446,2018,3,0,0,0,1,0,1506
Titans,3,0,3,3,0,0,9,Jaguars,0,3,0,3,0,0,6,201803,3,0,3,3,15,-3,1484.09501619415,1577.73569344432,2018,3,0,0,0,1,1,500
Patriots,0,3,7,0,0,0,10,Lions,3,10,7,6,0,0,26,201803,3,10,10,16,36,16,1627.73134972627,1459.05885311706,2018,3,0,0,0,0,0,615
Packers,0,10,7,0,0,0,17,Washington,14,14,0,3,0,0,31,201803,14,18,11,14,48,14,1479.68103291294,1466.41663732728,2018,3,0,0,0,1,0,686
Colts,7,0,6,3,0,0,16,Eagles,7,3,3,7,0,0,20,201803,0,3,0,4,36,4,1424.44550968807,1634.16317204242,2018,3,0,0,0,0,0,582
Bills,17,10,0,0,0,0,27,Vikings,0,0,0,6,0,0,6,201803,17,27,27,21,33,-21,1449.0215575424,1608.95550375105,2018,3,0,0,0,0,0,729
Raiders,7,3,7,3,0,0,20,Dolphins,0,7,7,14,0,0,28,201803,-7,-3,-3,8,48,8,1429.60427813237,1497.40463832989,2018,3,0,0,0,1,0,2582
49ers,0,10,14,3,0,0,27,Chiefs,14,21,0,3,0,0,38,201803,14,25,11,11,65,11,1471.1276126064,1619.23374167386,2018,3,0,0,0,0,0,1503
Saints,7,9,7,14,6,0,43,Falcons,7,7,7,16,0,0,37,201803,0,2,2,6,80,-6,1552.78069756961,1603.025766074,2018,3,0,0,0,1,1,424
Jets,0,14,0,3,0,0,17,Browns,0,3,11,7,0,0,21,201803,0,-11,0,4,38,4,1457.44317807798,1307.10052304371,2018,3,0,0,0,1,0,403
Bengals,7,7,7,0,0,0,21,Panthers,7,14,7,3,0,0,31,201803,0,7,7,10,52,10,1523.87841388686,1551.99731221261,2018,3,0,0,0,0,0,336
Chiefs,3,7,3,14,0,0,27,Broncos,3,10,7,3,0,0,23,201804,0,-3,-7,4,50,-4,1629.50773502757,1454.4479021794,2018,4,0,0,0,1,1,556
Ravens,14,0,3,9,0,0,26,Steelers,0,14,0,0,0,0,14,201804,14,0,3,12,40,-12,1552.94156003641,1581.03540923641,2018,4,0,0,0,1,1,196
49ers,14,3,7,3,0,0,27,Chargers,6,11,9,3,0,0,29,201804,-8,0,2,2,56,2,1460.85361925269,1526.7497767646,2018,4,0,0,0,0,0,347
Saints,0,12,7,14,0,0,33,Giants,7,0,3,8,0,0,18,201804,-7,5,9,15,51,-15,1579.88764332642,1409.55644436869,2018,4,0,0,0,1,0,1168
Seahawks,7,0,10,3,0,0,20,Cardinals,0,10,0,7,0,0,17,201804,7,-3,7,3,37,-3,1529.35663923204,1416.18093602399,2018,4,0,0,0,1,1,1114
Browns,3,14,11,14,0,0,42,Raiders,7,7,7,21,3,0,45,201804,4,-3,-7,3,87,3,1327.8765683332,1416.43877074397,2018,4,0,0,0,1,0,2153
Jets,0,0,3,9,0,0,12,Jaguars,3,13,9,6,0,0,31,201804,3,16,22,19,43,19,1436.66713278849,1556.41124317739,2018,4,0,0,0,1,0,835
Texans,14,7,7,3,6,0,37,Colts,7,3,7,14,3,0,34,201804,7,11,11,3,71,-3,1363.16143756588,1419.56379175185,2018,4,0,0,0,1,1,865
Eagles,0,10,7,3,3,0,23,Titans,3,0,7,10,6,0,26,201804,3,-7,-7,3,49,3,1639.04488997864,1505.41946646108,2018,4,0,0,0,0,0,683
Bills,0,0,0,0,0,0,0,Packers,6,10,3,3,0,0,22,201804,6,16,19,22,22,22,1503.07520009027,1457.13369320829,2018,4,0,0,0,0,0,470
Lions,7,3,0,14,0,0,24,Cowboys,3,10,7,6,0,0,26,201804,-4,3,10,2,50,2,1497.41007797234,1517.10709265242,2018,4,0,0,0,1,0,999
Buccaneers,0,3,0,7,0,0,10,Bears,14,24,7,3,0,0,48,201804,14,35,42,38,58,38,1514.98529217568,1473.71596611238,2018,4,0,0,0,1,0,1004
Vikings,7,13,8,3,0,0,31,Rams,7,21,10,0,0,0,38,201804,0,8,10,7,69,7,1554.90186120318,1595.41987111366,2018,4,0,0,0,1,0,1521
Dolphins,0,0,0,7,0,0,7,Patriots,3,21,7,7,0,0,38,201804,3,24,31,31,45,31,1510.57014571829,1589.38012487099,2018,4,0,0,0,1,1,1241
Bengals,14,14,0,9,0,0,37,Falcons,7,17,3,9,0,0,36,201804,7,4,1,1,73,-1,1506.89548872387,1575.91882031719,2018,4,0,0,0,0,0,374
Washington,3,10,0,6,0,0,19,Saints,6,20,14,3,0,0,43,201805,3,13,27,24,62,24,1488.96397703193,1598.56223510329,2018,5,0,1,0,1,0,964
Giants,3,10,3,15,0,0,31,Panthers,7,13,0,13,0,0,33,201805,4,7,4,2,64,2,1390.88185259182,1568.9802373756,2018,5,0,0,1,1,0,531
Cowboys,6,0,7,3,0,0,16,Texans,0,10,3,3,3,0,19,201805,-6,4,0,3,35,3,1525.15695683561,1382.76207396279,2018,5,0,0,0,0,0,225
Rams,7,10,7,9,0,0,33,Seahawks,7,10,14,0,0,0,31,201805,0,0,-7,2,64,-2,1609.41493599709,1541.0534245144,2018,5,0,0,0,1,1,960
Cardinals,7,7,0,14,0,0,28,49ers,6,0,0,12,0,0,18,201805,1,8,8,10,46,-10,1404.48415074163,1454.21611540978,2018,5,0,0,0,1,1,652
Vikings,3,14,3,3,0,0,23,Eagles,0,3,3,15,0,0,21,201805,3,14,14,2,44,-2,1540.90679631975,1621.94541192776,2018,5,0,0,0,1,0,983
Raiders,0,3,0,7,0,0,10,Chargers,3,14,3,6,0,0,26,201805,3,14,17,16,36,16,1424.01568828897,1533.38728060751,2018,5,0,0,0,1,1,343
Falcons,0,10,0,7,0,0,17,Steelers,13,0,14,14,0,0,41,201805,13,3,17,24,58,24,1565.82372033571,1547.24319952978,2018,5,0,0,0,0,0,521
Jaguars,0,0,7,7,0,0,14,Chiefs,7,13,3,7,0,0,30,201805,7,20,16,16,44,16,1570.59688740913,1640.13602879246,2018,5,0,0,0,1,0,949
Colts,0,3,7,14,0,0,24,Patriots,7,17,0,14,0,0,38,201805,7,21,14,14,62,14,1399.96315535494,1609.16557652038,2018,5,0,0,0,1,0,805
Titans,3,3,0,6,0,0,12,Bills,7,0,3,3,0,0,13,201805,4,1,4,1,25,1,1522.51894451196,1473.69303868661,2018,5,0,0,0,1,0,626
Broncos,7,3,0,6,0,0,16,Jets,0,21,3,10,0,0,34,201805,-7,11,14,18,50,18,1443.81960841451,1422.48148855675,2018,5,0,0,0,1,0,1627
Ravens,3,0,3,3,0,0,9,Browns,0,6,3,0,3,0,12,201805,-3,3,3,3,21,3,1586.73376974304,1320.2996507882,2018,5,0,0,0,1,1,307
Packers,0,0,14,9,0,0,23,Lions,14,10,0,7,0,0,31,201805,14,24,10,8,54,8,1486.51585461195,1489.36021378915,2018,5,0,0,0,1,1,291
Dolphins,0,14,3,0,0,0,17,Bengals,0,0,3,24,0,0,27,201805,0,-14,-14,10,44,10,1490.7846940689,1516.99058870535,2018,5,0,0,0,1,0,957
49ers,14,10,3,3,0,0,30,Packers,17,3,3,10,0,0,33,201806,3,-4,-4,3,63,3,1420.85468932526,1469.31102120539,2018,6,0,0,0,1,0,1834
Chiefs,6,3,17,14,0,0,40,Patriots,10,14,3,16,0,0,43,201806,4,15,1,3,83,3,1656.98401959848,1617.40152615767,2018,6,0,0,0,1,0,1249
Ravens,7,7,7,0,0,0,21,Titans,0,0,0,0,0,0,0,201806,7,14,21,21,21,-21,1563.50012751551,1515.95815315277,2018,6,0,0,0,1,0,595
Jaguars,0,0,7,0,0,0,7,Cowboys,10,14,6,10,0,0,40,201806,10,24,23,33,47,33,1553.74889660311,1507.63973751898,2018,6,0,0,0,0,0,906
Rams,6,7,7,3,0,0,23,Broncos,3,0,7,10,0,0,20,201806,3,10,10,3,43,-3,1620.27817059324,1418.55746897588,2018,6,0,0,0,0,0,830
Panthers,0,6,3,8,0,0,17,Washington,14,3,0,6,0,0,23,201806,14,11,8,6,40,6,1572.89613610459,1472.98260081237,2018,6,0,0,0,1,0,329
Colts,7,6,7,14,0,0,34,Jets,10,13,10,9,0,0,42,201806,3,10,13,8,76,8,1391.72720571765,1447.74362799538,2018,6,0,0,0,1,0,643
Bills,0,0,6,7,0,0,13,Texans,7,3,0,10,0,0,20,201806,7,10,4,7,33,7,1480.2538300458,1400.27929327942,2018,6,0,0,0,1,0,1285
Bears,0,0,21,7,0,0,28,Dolphins,7,0,6,15,3,0,31,201806,7,7,-8,3,59,3,1507.48886997873,1473.66933364333,2018,6,0,1,0,0,0,1189
Seahawks,7,10,3,7,0,0,27,Raiders,0,0,0,3,0,0,3,201806,7,17,20,24,30,-24,1530.19018991825,1409.93430096243,2018,6,0,0,0,0,0,677
Chargers,7,14,14,3,0,0,38,Browns,0,6,0,8,0,0,14,201806,7,15,29,24,52,-24,1547.46866793405,1343.53329301573,2018,6,0,0,0,1,0,2044
Steelers,0,14,3,11,0,0,28,Bengals,7,7,0,7,0,0,21,201806,-7,0,3,7,49,-7,1574.57995547317,1534.10594913092,2018,6,0,0,0,1,1,252
Buccaneers,6,7,3,13,0,0,29,Falcons,7,17,0,10,0,0,34,201806,1,11,8,5,63,5,1481.21238830933,1538.48696439232,2018,6,0,1,0,1,1,416
Eagles,14,10,7,3,0,0,34,Giants,3,3,7,0,0,0,13,201806,11,18,18,21,47,-21,1605.50408696095,1386.96595386283,2018,6,0,0,0,1,1,80
Cardinals,3,7,0,7,0,0,17,Vikings,10,3,14,0,0,0,27,201806,7,3,17,10,44,10,1437.84557682615,1557.34812128656,2018,6,0,0,0,1,0,1278
Texans,6,7,7,0,0,0,20,Jaguars,0,0,7,0,0,0,7,201807,6,13,13,13,27,-13,1422.11804503796,1520.68467835375,2018,7,0,0,0,1,1,820
Giants,0,3,3,14,0,0,20,Falcons,0,10,0,13,0,0,23,201807,0,7,4,3,43,3,1370.0697517406,1549.72234335389,2018,7,0,0,0,1,0,745
Bengals,0,7,3,0,0,0,10,Chiefs,7,17,14,7,0,0,45,201807,7,17,28,35,55,35,1511.59510355467,1644.2802205859,2018,7,0,0,0,1,0,542
Cowboys,0,7,0,10,0,0,17,Washington,7,0,3,10,0,0,20,201807,7,0,3,3,37,3,1540.70395576834,1494.73579552398,2018,7,0,0,0,1,1,1181
Rams,3,19,10,7,0,0,39,49ers,0,7,3,0,0,0,10,201807,3,15,22,29,49,-29,1628.44358330477,1411.82982573608,2018,7,0,0,0,1,1,347
Saints,0,7,0,17,0,0,24,Ravens,0,10,7,6,0,0,23,201807,0,-3,-10,1,47,-1,1614.54361132285,1596.22210463601,2018,7,0,1,0,0,0,999
Browns,2,0,7,14,0,0,23,Buccaneers,3,13,7,0,3,0,26,201807,1,14,14,3,49,3,1324.75728993811,1469.97700934776,2018,7,0,0,0,0,0,937
Broncos,21,14,7,3,0,0,45,Cardinals,3,0,7,0,0,0,10,201807,18,32,32,35,55,-35,1410.39205626435,1426.47796817294,2018,7,0,0,0,0,0,585
Vikings,7,3,10,17,0,0,37,Jets,7,0,3,7,0,0,17,201807,0,3,10,20,54,-20,1568.71572993977,1461.59585817129,2018,7,0,0,0,0,0,1016
Lions,7,10,9,6,0,0,32,Dolphins,0,7,7,7,0,0,21,201807,7,10,12,11,53,-11,1506.56504719571,1486.11508952828,2018,7,0,1,0,0,0,1155
Bills,0,0,5,0,0,0,5,Colts,0,24,0,13,0,0,37,201807,0,24,19,32,42,32,1458.41507828726,1377.87497554174,2018,7,0,0,0,1,0,434
Patriots,7,14,10,7,0,0,38,Bears,10,7,7,7,0,0,31,201807,-3,4,7,7,69,-7,1630.10532517025,1495.04311409378,2018,7,0,0,0,0,0,853
Titans,3,3,7,6,0,0,19,Chargers,10,0,7,3,0,0,20,201807,7,4,4,1,39,1,1483.23617603227,1566.24467101167,2018,7,0,0,0,1,0,1776
Panthers,0,0,0,21,0,0,21,Eagles,0,10,7,0,0,0,17,201807,0,-10,-17,4,38,-4,1551.14294139298,1622.40028908318,2018,7,0,0,0,1,0,450
Colts,10,3,8,21,0,0,42,Raiders,0,14,14,0,0,0,28,201808,10,-1,-7,14,70,-14,1414.66278478534,1389.57513866199,2018,8,0,0,1,1,0,1936
Patriots,3,6,3,13,0,0,25,Bills,0,3,3,0,0,0,6,201808,3,6,6,19,31,-19,1646.24827218215,1421.62726904366,2018,8,0,0,0,1,1,404
Saints,7,10,10,3,0,0,30,Vikings,7,6,0,7,0,0,20,201808,0,4,14,10,50,-10,1622.57109695743,1594.98509583847,2018,8,0,0,0,1,0,1052
49ers,2,3,7,3,0,0,15,Cardinals,0,3,0,15,0,0,18,201808,-2,-2,-9,3,33,3,1393.07685878825,1380.74233816784,2018,8,0,0,0,1,1,652
Packers,7,3,10,7,0,0,27,Rams,0,8,15,6,0,0,29,201808,-7,-2,3,2,56,2,1478.33588479457,1647.1965502526,2018,8,0,1,0,1,0,1757
Ravens,7,0,7,7,0,0,21,Panthers,7,17,3,9,0,0,36,201808,0,17,13,15,57,15,1588.19461900143,1574.70359032593,2018,8,0,0,0,0,0,364
Browns,6,0,6,6,0,0,18,Steelers,0,14,9,10,0,0,33,201808,-6,8,11,15,51,15,1318.94464664027,1597.09080104942,2018,8,0,0,1,1,1,114
Broncos,7,7,0,9,0,0,23,Chiefs,3,13,14,0,0,0,30,201808,-4,2,16,7,53,7,1456.12768626945,1660.24007566616,2018,8,0,0,0,1,1,556
Seahawks,0,21,0,7,0,0,28,Lions,7,0,0,7,0,0,14,201808,-7,14,14,14,42,-14,1550.54935221869,1535.16213646538,2018,8,0,1,0,1,0,1933
Buccaneers,0,9,7,18,0,0,34,Bengals,7,20,7,3,0,0,37,201808,7,18,18,3,71,3,1475.7896526456,1495.63524847441,2018,8,0,0,0,0,0,783
Jets,0,3,0,7,0,0,10,Bears,7,0,7,10,0,0,24,201808,7,4,11,14,34,14,1435.32649227259,1478.90016708188,2018,8,0,0,0,0,0,711
Eagles,0,10,7,7,0,0,24,Jaguars,3,3,6,6,0,0,18,201808,-3,4,5,6,42,-6,1598.83964015023,1479.66320836766,2018,8,0,0,0,0,0,758
Dolphins,7,3,10,3,0,0,23,Texans,7,7,14,14,0,0,42,201808,0,4,8,19,65,19,1457.51800025861,1463.13951502405,2018,8,0,0,0,1,0,966
Washington,7,0,3,10,0,0,20,Giants,0,3,0,10,0,0,13,201808,7,4,7,7,33,-7,1507.72772188836,1365.16692002542,2018,8,0,0,0,1,1,204
Titans,0,14,7,7,0,0,28,Cowboys,7,7,0,0,0,0,14,201809,-7,0,7,14,42,-14,1478.12287888178,1527.71202940396,2018,9,0,1,1,0,0,616
Packers,3,7,7,0,0,0,17,Patriots,7,10,0,14,0,0,31,201809,4,7,0,14,48,14,1474.23477115735,1662.17954387443,2018,9,0,0,0,0,0,869
Chargers,6,13,0,6,0,0,25,Seahawks,7,3,0,7,0,0,17,201809,-1,9,9,8,42,-8,1571.35796816216,1582.18420510159,2018,9,0,1,0,0,0,960
Texans,7,9,0,3,0,0,19,Broncos,3,7,7,0,0,0,17,201809,4,6,-1,2,36,-2,1486.34514385782,1449.63506112262,2018,9,0,0,0,1,0,878
Steelers,7,7,6,3,0,0,23,Ravens,3,3,7,3,0,0,16,201809,4,8,7,7,39,-7,1602.93446211368,1565.09031774404,2018,9,0,0,0,1,1,196
Buccaneers,0,14,7,7,0,0,28,Panthers,14,21,0,7,0,0,42,201809,14,21,14,14,70,14,1465.63789711444,1597.80789158332,2018,9,0,0,0,1,1,511
Rams,7,10,10,8,0,0,35,Saints,14,21,0,10,0,0,45,201809,7,18,8,10,80,10,1651.29766388982,1649.58166698228,2018,9,0,0,0,1,0,1669
Lions,0,6,0,3,0,0,9,Vikings,7,10,0,7,0,0,24,201809,7,11,11,15,33,15,1503.52728358248,1567.97452581362,2018,9,0,0,0,1,1,542
Jets,0,3,0,3,0,0,6,Dolphins,0,6,0,7,0,0,13,201809,0,3,3,7,19,7,1417.33160336793,1434.31237142484,2018,9,0,0,0,1,1,1091
Chiefs,7,14,13,3,0,0,37,Browns,3,12,0,6,0,0,21,201809,4,6,19,16,58,-16,1666.73270081299,1313.10098557601,2018,9,0,0,0,1,0,698
Bears,0,28,3,10,0,0,41,Bills,0,0,3,6,0,0,9,201809,0,28,28,32,50,-32,1496.89505598654,1405.69599735138,2018,9,0,0,0,0,0,453
Raiders,3,0,0,0,0,0,3,49ers,7,10,14,3,0,0,34,201809,4,14,28,31,37,31,1358.83972165781,1381.57470772542,2018,9,0,0,0,0,0,8
Falcons,7,14,7,10,0,0,38,Washington,0,7,7,0,0,0,14,201809,7,14,14,24,52,-24,1554.62517506907,1523.40301063962,2018,9,0,1,0,1,0,541
Giants,7,3,10,7,0,0,27,49ers,3,10,7,3,0,0,23,201810,4,-3,0,4,50,-4,1349.49163127416,1406.6612927554,2018,10,0,1,0,1,0,2565
Cowboys,3,10,0,14,0,0,27,Eagles,0,3,10,7,0,0,20,201810,3,10,0,7,47,-7,1490.04861308751,1611.2041598391,2018,10,0,0,1,1,1,1297
Seahawks,14,0,7,10,0,0,31,Rams,7,10,3,16,0,0,36,201810,-7,3,-1,5,67,5,1554.53847858972,1632.18839849248,2018,10,0,0,0,1,1,960
Dolphins,3,6,3,0,0,0,12,Packers,7,7,14,3,0,0,31,201810,4,5,16,19,43,19,1449.71525079535,1465.05053003139,2018,10,0,0,0,0,0,1366
Chargers,0,10,7,3,0,0,20,Raiders,3,0,0,3,0,0,6,201810,-3,7,14,14,26,-14,1599.00369467403,1333.75313662783,2018,10,0,0,0,1,1,343
Washington,3,3,0,10,0,0,16,Buccaneers,0,3,0,0,0,0,3,201810,3,3,3,13,19,-13,1487.54410811804,1453.54739944575,2018,10,0,0,0,1,0,818
Bills,14,17,7,3,0,0,41,Jets,0,3,7,0,0,0,10,201810,14,28,28,31,51,-31,1373.74306216713,1401.92872399742,2018,10,0,0,0,1,1,292
Patriots,3,7,0,0,0,0,10,Titans,17,7,3,7,0,0,34,201810,14,14,17,24,44,24,1671.36378500039,1515.78629519823,2018,10,0,0,0,1,0,936
Jaguars,7,9,7,3,0,0,26,Colts,14,15,0,0,0,0,29,201810,7,13,6,3,55,3,1467.29868867879,1445.39820178952,2018,10,0,1,1,1,1,699
Falcons,0,10,0,6,0,0,16,Browns,7,7,14,0,0,0,28,201810,7,4,18,12,44,12,1590.48407759065,1305.10819916958,2018,10,0,0,0,0,0,555
Saints,7,28,10,6,0,0,51,Bengals,7,0,0,7,0,0,14,201810,0,28,38,37,65,-37,1668.69093237962,1505.78700400557,2018,10,0,0,1,0,0,711
Lions,0,7,3,12,0,0,22,Bears,13,13,8,0,0,0,34,201810,13,19,24,12,56,12,1486.67047005949,1528.84799117079,2018,10,0,0,0,1,1,238
Panthers,7,7,0,7,0,0,21,Steelers,21,10,14,7,0,0,52,201810,14,17,31,31,73,31,1609.89838925201,1625.6310415807,2018,10,0,0,0,0,0,363
Cardinals,7,0,7,0,0,0,14,Chiefs,10,10,0,6,0,0,26,201810,3,13,6,12,40,12,1392.24448923067,1674.72548721942,2018,10,0,1,0,0,0,1047
Raiders,7,7,6,3,0,0,23,Cardinals,14,0,0,7,0,0,21,201811,-7,0,6,2,44,-2,1321.83946088025,1386.96481142969,2018,11,0,0,0,0,0,646
Broncos,0,7,7,9,0,0,23,Chargers,6,7,6,3,0,0,22,201811,-6,-6,-5,1,45,-1,1437.6016271299,1610.91737042161,2018,11,0,1,0,1,1,830
Bengals,0,7,14,0,0,0,21,Ravens,7,6,8,3,0,0,24,201811,7,6,0,3,45,3,1480.52283946681,1542.39373827702,2018,11,0,0,1,1,1,419
Vikings,0,0,3,17,0,0,20,Bears,3,11,0,11,0,0,25,201811,3,14,11,5,45,5,1584.83133933661,1545.99167987561,2018,11,0,1,0,1,1,355
Eagles,0,7,0,0,0,0,7,Saints,10,14,14,10,0,0,48,201811,10,17,31,41,55,41,1577.36093119384,1693.95509691838,2018,11,0,0,0,1,0,1088
Steelers,0,0,6,14,0,0,20,Jaguars,0,9,7,0,0,0,16,201811,0,-9,-10,4,36,-4,1651.43029881217,1455.38017302494,2018,11,0,0,0,1,0,704
Chiefs,7,16,7,21,0,0,51,Rams,13,10,17,14,0,0,54,201811,6,0,10,3,105,3,1680.0051650204,1642.4700142935,2018,11,0,0,0,0,0,1354
Buccaneers,0,7,7,21,0,0,35,Giants,7,7,10,14,0,0,38,201811,7,7,10,3,73,3,1424.3973086523,1372.28903271028,2018,11,0,0,0,1,0,1004
Packers,14,7,0,3,0,0,24,Seahawks,3,14,0,10,0,0,27,201811,-11,-4,-4,3,51,3,1487.38626478869,1544.2568627887,2018,11,0,0,0,1,0,1645
Cowboys,3,0,3,16,0,0,22,Falcons,0,6,3,10,0,0,19,201811,3,-3,-3,3,41,-3,1523.89184173277,1545.98797939769,2018,11,0,0,0,1,0,719
Texans,10,7,3,3,0,0,23,Washington,0,7,7,7,0,0,21,201811,10,10,6,2,44,-2,1498.37857785054,1516.69419891149,2018,11,0,1,0,0,0,1217
Titans,0,3,0,7,0,0,10,Colts,7,17,7,7,0,0,38,201811,7,21,28,28,48,28,1557.91622778692,1457.31671744337,2018,11,0,0,0,1,1,251
Panthers,7,0,0,12,0,0,19,Lions,7,3,3,7,0,0,20,201811,0,3,6,1,39,1,1584.09913202054,1469.52678135467,2018,11,0,0,0,1,0,504
Titans,10,0,7,0,0,0,17,Texans,7,17,3,7,0,0,34,201812,-3,14,10,17,51,17,1520.19464464231,1512.48401060029,2018,12,0,0,0,1,1,665
Packers,7,7,0,3,0,0,17,Vikings,7,7,10,0,0,0,24,201812,0,0,10,7,41,7,1478.67834403494,1568.45504686839,2018,12,0,0,0,1,1,259
Dolphins,7,7,3,7,0,0,24,Colts,7,7,0,13,0,0,27,201812,0,0,-3,3,51,3,1427.37951603805,1495.03830058798,2018,12,0,1,0,1,0,1026
Steelers,0,10,7,0,0,0,17,Broncos,3,7,7,7,0,0,24,201812,3,0,0,7,41,7,1661.1475653119,1450.0032244902,2018,12,0,0,0,1,0,1317
Raiders,7,3,7,0,0,0,17,Ravens,3,10,7,14,0,0,34,201812,-4,3,3,17,51,17,1337.69592571526,1550.91655849393,2018,12,0,0,0,1,0,2442
Seahawks,0,10,7,13,0,0,30,Panthers,3,10,7,7,0,0,27,201812,-3,-3,-3,3,57,-3,1552.96478354245,1576.00289848199,2018,12,0,0,0,1,0,2280
49ers,0,6,3,0,0,0,9,Buccaneers,7,6,7,7,0,0,27,201812,7,7,11,18,36,18,1383.86389131928,1411.12628520836,2018,12,0,1,0,1,0,2396
Cardinals,10,0,0,0,0,0,10,Chargers,0,28,14,3,0,0,45,201812,-10,18,32,35,55,35,1371.10834659468,1598.51577306131,2018,12,0,0,0,0,0,356
Patriots,7,3,10,7,0,0,27,Jets,7,3,3,0,0,0,13,201812,0,0,7,14,40,-14,1629.2338524117,1356.25810435889,2018,12,0,1,1,1,1,181
Browns,14,14,7,0,0,0,35,Bengals,0,7,7,6,0,0,20,201812,14,21,21,15,55,-15,1349.60429736254,1472.0000192499,2018,12,0,1,0,1,1,217
Jaguars,0,14,0,7,0,0,21,Bills,14,0,0,10,0,0,24,201812,14,0,0,3,45,3,1445.66290652521,1419.41368180566,2018,12,0,0,1,1,0,880
Falcons,3,0,7,7,0,0,17,Saints,7,10,7,7,0,0,31,201812,4,14,14,14,48,14,1528.00907581465,1711.91736397854,2018,12,0,0,0,1,1,424
Washington,0,7,6,10,0,0,23,Cowboys,7,3,14,7,0,0,31,201812,7,3,11,8,54,8,1502.58876616174,1541.87074531581,2018,12,0,0,0,1,1,1181
Bears,0,9,0,14,0,0,23,Lions,0,7,6,3,0,0,16,201812,0,2,-4,7,39,-7,1562.36797234383,1477.62301489322,2018,12,0,0,0,1,1,238
Giants,9,10,0,3,0,0,22,Eagles,0,11,3,11,0,0,25,201812,-9,-8,-5,3,47,3,1385.56005615422,1559.39866413368,2018,12,0,0,0,1,1,80
Browns,0,0,7,6,0,0,13,Texans,10,13,3,3,0,0,29,201813,10,23,19,16,42,16,1394.8384933752,1536.05077198557,2018,13,0,0,0,1,0,1113
Chargers,7,0,8,18,0,0,33,Steelers,13,10,0,7,0,0,30,201813,-6,-16,-8,3,63,-3,1608.42690830224,1630.02029210763,2018,13,0,0,0,1,0,2132
49ers,0,3,7,6,0,0,16,Seahawks,6,14,7,16,0,0,43,201813,6,17,17,27,59,27,1362.93738367469,1570.98847300418,2018,13,0,0,0,1,1,679
Washington,0,13,0,0,0,0,13,Eagles,7,7,0,14,0,0,28,201813,7,1,1,15,41,15,1487.7248449719,1564.44668679633,2018,13,0,0,0,1,1,123
Vikings,0,7,3,0,0,0,10,Patriots,7,3,7,7,0,0,24,201813,7,3,7,14,34,14,1579.75844404805,1640.71259907601,2018,13,0,0,0,0,0,1128
Chiefs,10,9,14,7,0,0,40,Raiders,0,7,9,17,0,0,33,201813,10,12,17,7,73,-7,1667.39326007062,1329.08674198624,2018,13,0,1,0,1,1,1495
Jets,10,6,6,0,0,0,22,Titans,0,6,7,13,0,0,26,201813,-10,-10,-9,4,48,4,1344.77935769458,1496.62788325703,2018,13,0,0,0,1,0,758
Colts,0,0,0,0,0,0,0,Jaguars,0,3,0,3,0,0,6,201813,0,3,3,6,6,6,1503.34993507328,1433.55307111764,2018,13,0,0,0,1,1,699
Broncos,0,7,14,3,0,0,24,Bengals,0,3,7,0,0,0,10,201813,0,4,11,14,34,-14,1481.13049769447,1426.76582323724,2018,13,0,0,0,1,0,1093
Bears,7,7,0,13,0,0,27,Giants,7,3,14,3,3,0,30,201813,0,-4,10,3,57,3,1581.80743140936,1380.51203349157,2018,13,0,0,0,1,0,711
Bills,0,6,3,8,0,0,17,Dolphins,7,7,0,7,0,0,21,201813,7,8,5,4,38,4,1431.52351721323,1419.06788155275,2018,13,0,0,0,1,1,1184
Cardinals,0,7,10,3,0,0,20,Packers,0,10,0,7,0,0,17,201813,0,-3,7,3,37,-3,1361.19721135375,1467.37494685528,2018,13,0,0,0,1,0,1492
Rams,3,10,3,14,0,0,30,Lions,0,3,10,3,0,0,16,201813,3,10,3,14,46,-14,1655.08191924328,1458.18355582769,2018,13,0,1,0,1,0,1979
Ravens,7,3,6,10,0,0,26,Falcons,3,7,0,6,0,0,16,201813,4,0,6,10,42,-10,1559.52574222295,1518.63510202552,2018,13,0,0,0,0,0,576
Panthers,7,0,10,0,0,0,17,Buccaneers,10,7,7,0,0,0,24,201813,3,10,7,7,41,7,1557.97920902026,1432.05279285295,2018,13,0,0,0,1,1,511
Saints,0,0,10,0,0,0,10,Cowboys,10,3,0,0,0,0,13,201813,10,13,3,3,23,3,1721.29133776767,1556.73466650565,2018,13,0,0,0,1,0,442
Bengals,3,9,0,9,0,0,21,Chargers,7,10,3,6,0,0,26,201814,4,5,8,5,47,5,1398.72104560878,1626.381904958,2018,14,0,0,0,1,0,1895
Vikings,0,0,0,7,0,0,7,Seahawks,0,3,0,18,0,0,21,201814,0,3,3,14,28,14,1563.04364671462,1581.18319741708,2018,14,0,0,0,1,0,1391
Rams,3,3,0,0,0,0,6,Bears,3,3,9,0,0,0,15,201814,0,0,9,9,21,9,1671.37207284118,1561.51162587674,2018,14,0,0,0,1,0,1741
Lions,0,3,7,7,0,0,17,Cardinals,0,0,0,3,0,0,3,201814,0,3,10,14,20,-14,1441.89340222979,1383.08991226294,2018,14,0,0,0,1,0,1687
Steelers,0,14,0,7,0,0,21,Raiders,7,3,0,14,0,0,24,201814,7,-4,-4,3,45,3,1612.06529545187,1322.73318581625,2018,14,0,0,0,1,0,2251
Eagles,0,0,6,17,0,0,23,Cowboys,3,3,3,14,6,0,29,201814,3,6,3,6,52,6,1580.42199408499,1575.30509798705,2018,14,0,0,0,1,1,1297
Broncos,0,0,7,7,0,0,14,49ers,3,17,0,0,0,0,20,201814,3,20,13,6,34,6,1509.17527532293,1352.74265926179,2018,14,0,0,0,0,0,947
Colts,0,17,7,0,0,0,24,Texans,7,0,7,7,0,0,21,201814,-7,10,10,3,45,-3,1483.57908064614,1548.16280917923,2018,14,0,0,0,1,1,865
Saints,0,3,8,17,0,0,28,Buccaneers,7,7,0,0,0,0,14,201814,-7,-11,-3,14,42,-14,1702.72090628627,1457.1518894833,2018,14,0,0,0,1,1,480
Patriots,6,21,0,6,0,0,33,Dolphins,7,14,7,6,0,0,34,201814,1,-6,1,1,67,1,1657.42739640944,1432.42753925989,2018,14,0,0,0,1,1,1241
Ravens,0,10,7,7,0,0,24,Chiefs,7,10,0,7,3,0,27,201814,7,7,0,3,51,3,1585.45008400452,1673.74681624061,2018,14,0,0,0,1,0,960
Falcons,7,0,0,13,0,0,20,Packers,7,13,14,0,0,0,34,201814,0,13,27,14,54,14,1492.71076024395,1445.48224594609,2018,14,0,0,0,1,0,768
Panthers,7,10,3,0,0,0,20,Browns,7,10,0,9,0,0,26,201814,0,0,-3,6,46,6,1532.88011238991,1382.72645618154,2018,14,0,0,0,0,0,435
Jets,3,10,0,14,0,0,27,Bills,14,3,3,3,0,0,23,201814,-11,-4,-7,4,50,-4,1338.24536977782,1418.16385950609,2018,14,0,0,0,1,1,292
Jaguars,2,0,7,0,0,0,9,Titans,7,9,14,0,0,0,30,201814,5,14,21,21,39,21,1453.32392554478,1503.16187117379,2018,14,0,0,0,1,1,500
Giants,7,27,6,0,0,0,40,Washington,0,0,0,16,0,0,16,201814,7,34,40,24,56,-24,1400.80783902419,1471.74953768324,2018,14,0,0,0,1,1,204
Eagles,3,10,17,0,0,0,30,Rams,7,6,0,10,0,0,23,201815,-4,0,17,7,53,-7,1564.711621449,1644.84872490659,2018,15,0,0,0,1,0,2388
Patriots,7,0,3,0,0,0,10,Steelers,7,7,0,3,0,0,17,201815,0,7,4,7,27,7,1646.73420416097,1587.84836181333,2018,15,0,0,0,1,0,479
Seahawks,6,7,0,10,0,0,23,49ers,7,10,3,3,3,0,26,201815,1,4,7,3,49,3,1601.14984219481,1378.26853044498,2018,15,0,0,0,1,1,679
Buccaneers,0,9,3,0,0,0,12,Ravens,0,10,7,3,0,0,20,201815,0,1,5,8,32,8,1444.07517356152,1577.86411450895,2018,15,0,0,0,0,0,852
Washington,3,0,3,10,0,0,16,Jaguars,0,10,0,3,0,0,13,201815,3,-7,-4,3,29,-3,1424.66228270452,1433.31812064278,2018,15,0,0,0,0,0,647
Titans,7,0,7,3,0,0,17,Giants,0,0,0,0,0,0,0,201815,7,7,14,17,17,-17,1523.16767607579,1447.89509400291,2018,15,0,0,0,0,0,758
Dolphins,0,10,7,0,0,0,17,Vikings,21,0,3,17,0,0,41,201815,21,11,7,24,58,24,1443.12073150836,1543.07700193689,2018,15,0,0,0,0,0,1513
Saints,3,3,0,6,0,0,12,Panthers,7,0,0,2,0,0,9,201815,-4,-1,-1,3,21,-3,1715.79762220805,1507.77320574051,2018,15,0,0,0,1,1,648
Raiders,0,7,6,3,0,0,16,Bengals,7,13,0,10,0,0,30,201815,7,13,7,14,46,14,1346.95011945479,1393.77207507873,2018,15,0,0,0,1,0,2032
Packers,0,3,11,3,0,0,17,Bears,7,7,0,10,0,0,24,201815,7,11,0,7,41,7,1470.97286306192,1588.03497381133,2018,15,0,0,0,1,1,185
Lions,0,13,0,0,0,0,13,Bills,0,7,0,7,0,0,14,201815,0,-6,-6,1,27,1,1469.53468782727,1394.13772475087,2018,15,0,0,0,0,0,215
Cardinals,7,0,0,7,0,0,14,Falcons,10,16,7,7,0,0,40,201815,3,19,26,26,54,26,1355.44862666546,1467.22014312812,2018,15,0,0,0,1,0,1588
Browns,7,3,0,7,0,0,17,Broncos,7,3,3,3,0,0,16,201815,0,0,-3,1,33,-1,1407.83336283094,1483.64940413974,2018,15,0,0,0,1,0,1223
Texans,3,13,0,13,0,0,29,Jets,3,6,6,7,0,0,22,201815,0,7,1,7,51,-7,1528.17944516459,1362.27150453304,2018,15,0,0,0,1,0,1417
Chargers,0,7,7,15,0,0,29,Chiefs,14,0,7,7,0,0,28,201815,-14,-7,-7,1,57,-1,1631.33087548805,1681.33278573618,2018,15,0,0,0,1,1,1354
Cowboys,0,0,0,0,0,0,0,Colts,7,3,10,3,0,0,23,201815,7,10,20,23,23,23,1591.01547062304,1503.56244466078,2018,15,0,0,0,0,0,763
Broncos,0,0,7,7,0,0,14,Raiders,7,10,0,10,0,0,27,201816,7,17,10,13,41,13,1473.39670240395,1329.19875025485,2018,16,0,0,0,1,1,939
Chiefs,3,7,7,14,0,0,31,Seahawks,7,7,10,14,0,0,38,201816,4,4,7,7,69,7,1671.68281829645,1579.86002786982,2018,16,0,0,0,0,0,1502
Steelers,3,11,14,0,0,0,28,Saints,7,10,7,7,0,0,31,201816,4,3,-4,3,59,3,1608.22025888967,1723.73939177398,2018,16,0,0,0,0,0,919
Bears,0,7,7,0,0,0,14,49ers,0,9,0,0,0,0,9,201816,0,-2,5,5,23,-5,1598.00636538158,1399.55834476997,2018,16,0,0,0,1,0,1853
Rams,7,14,3,7,0,0,31,Cardinals,3,6,0,0,0,0,9,201816,4,12,15,22,40,-22,1613.79111783297,1339.24939705654,2018,16,0,0,0,1,1,356
Falcons,7,3,14,0,0,0,24,Panthers,7,3,0,0,0,0,10,201816,0,0,14,14,34,-14,1483.41937273704,1499.83143617458,2018,16,0,0,0,1,1,226
Texans,0,16,0,14,0,0,30,Eagles,7,6,10,9,0,0,32,201816,7,-3,7,2,62,2,1542.44438717683,1595.76922852262,2018,16,0,0,0,0,0,1339
Packers,0,17,3,18,6,0,44,Jets,7,14,14,3,0,0,38,201816,-7,-4,-15,6,82,-6,1461.00147149167,1348.0065625208,2018,16,0,0,0,0,0,758
Bills,0,0,6,6,0,0,12,Patriots,7,7,7,3,0,0,24,201816,7,14,15,12,36,12,1401.31045557606,1626.36230708463,2018,16,0,0,0,1,1,404
Giants,14,3,7,3,0,0,27,Colts,0,7,14,7,0,0,28,201816,-14,-10,-3,1,55,1,1419.97608366746,1537.74278783152,2018,16,0,0,0,0,0,643
Vikings,0,14,3,10,0,0,27,Lions,3,6,0,0,0,0,9,201816,-3,5,8,18,36,-18,1559.78386854806,1462.36195700208,2018,16,0,0,0,1,1,542
Buccaneers,3,10,0,7,0,0,20,Cowboys,14,3,10,0,0,0,27,201816,11,4,14,7,47,7,1434.34092669536,1556.8351274523,2018,16,0,0,0,1,0,916
Bengals,0,0,0,18,0,0,18,Browns,0,16,7,3,0,0,26,201816,0,16,23,8,44,8,1411.52344427867,1418.08606456673,2018,16,0,0,0,1,1,217
Ravens,3,3,10,6,0,0,22,Chargers,0,3,7,0,0,0,10,201816,3,3,6,12,32,-12,1587.59836137511,1640.98084292778,2018,16,0,0,0,1,0,2314
Washington,3,7,3,3,0,0,16,Titans,6,3,0,16,0,0,25,201816,3,-1,-4,9,41,9,1442.00141191256,1551.08668641124,2018,16,0,0,0,0,0,566
Jaguars,7,0,0,10,0,0,17,Dolphins,7,0,0,0,0,0,7,201816,0,0,0,10,24,-10,1415.97899143474,1426.41386489719,2018,16,0,0,0,1,0,327
Raiders,0,3,0,0,0,0,3,Chiefs,14,7,7,7,0,0,35,201817,14,18,25,32,38,32,1362.70933136605,1649.00977643397,2018,17,0,0,0,1,1,1495
Colts,7,10,7,9,0,0,33,Titans,0,10,7,0,0,0,17,201817,7,7,7,16,50,-16,1541.0556333994,1562.54598218458,2018,17,0,0,0,1,1,251
Eagles,3,7,7,7,0,0,24,Washington,0,0,0,0,0,0,0,201817,3,10,17,24,24,-24,1602.77527808767,1430.54211613922,2018,17,0,0,0,1,1,123
Bengals,0,10,0,3,0,0,13,Steelers,0,3,7,6,0,0,16,201817,0,-7,0,3,29,3,1394.56558455387,1601.52451767017,2018,17,0,0,0,1,1,252
Bears,7,6,0,11,0,0,24,Vikings,0,3,7,0,0,0,10,201817,7,10,3,14,34,-14,1608.71210973834,1586.10068483326,2018,17,0,0,0,1,1,355
49ers,3,7,7,15,0,0,32,Rams,14,17,14,3,0,0,48,201817,11,21,28,16,80,16,1388.85260041321,1626.98132175403,2018,17,0,0,0,1,1,347
Chargers,0,7,7,9,0,0,23,Broncos,0,3,0,6,0,0,9,201817,0,4,11,14,32,-14,1604.97761670231,1439.88612129275,2018,17,0,0,0,1,1,830
Browns,7,0,7,10,0,0,24,Ravens,10,10,3,3,0,0,26,201817,3,13,9,2,50,2,1435.04392429153,1623.60158760058,2018,17,0,0,0,1,1,307
Falcons,0,7,17,10,0,0,34,Buccaneers,7,10,3,12,0,0,32,201817,-7,-10,4,2,66,-2,1518.01192269681,1424.6208171056,2018,17,0,0,0,1,1,416
Jaguars,3,0,0,0,0,0,3,Texans,3,14,0,3,0,0,20,201817,0,14,14,17,23,17,1446.11733632551,1535.43833761178,2018,17,0,0,0,1,1,820
Dolphins,0,14,3,0,0,0,17,Bills,14,0,14,14,0,0,42,201817,14,0,11,25,59,25,1396.27552000642,1394.12814505964,2018,17,0,0,0,1,1,1184
Lions,7,14,3,7,0,0,31,Packers,0,0,0,0,0,0,0,201817,7,21,24,31,31,-31,1436.04514071688,1477.43102809065,2018,17,0,0,0,1,1,291
Cardinals,3,10,8,3,0,0,24,Seahawks,7,7,7,6,0,0,27,201817,4,1,0,3,51,3,1326.05919313548,1602.5330697323,2018,17,0,0,0,1,1,1114
Jets,3,0,0,0,0,0,3,Patriots,7,14,7,10,0,0,38,201817,4,18,25,35,41,35,1331.57700592182,1633.54461760105,2018,17,0,0,0,1,1,181
Panthers,13,10,7,3,0,0,33,Saints,0,0,0,14,0,0,14,201817,13,23,30,19,47,-19,1465.23888621481,1730.43513299348,2018,17,0,0,0,1,1,648
Cowboys,0,14,7,15,0,0,36,Giants,0,7,11,17,0,0,35,201817,0,7,3,1,71,-1,1566.55523704206,1416.66323809957,2018,17,0,0,0,1,1,1370
Colts,14,7,0,0,0,0,21,Texans,0,0,0,7,0,0,7,201818,14,21,21,14,28,-14,1577.74081029028,1551.18206480949,2018,18,1,0,0,1,1,865
Seahawks,0,6,8,8,0,0,22,Cowboys,3,7,0,14,0,0,24,201818,3,4,-4,2,46,2,1605.48162951474,1571.63017149923,2018,18,1,0,0,1,0,1679
Chargers,6,6,0,11,0,0,23,Ravens,0,0,3,14,0,0,17,201818,6,12,9,6,40,-6,1623.61744611503,1627.31590982503,2018,18,1,0,0,1,0,2314
Eagles,3,0,7,6,0,0,16,Bears,0,6,0,9,0,0,15,201818,3,-3,4,1,31,-1,1624.28470658181,1639.67686318167,2018,18,1,0,0,1,0,664
Chargers,7,0,7,14,0,0,28,Patriots,14,21,3,3,0,0,41,201819,7,28,24,13,69,13,1647.62448257118,1640.17195998375,2018,19,1,0,1,1,0,2594
Eagles,14,0,0,0,0,0,14,Saints,0,10,7,3,0,0,20,201819,-14,-4,3,6,34,6,1633.11467259084,1669.10586059685,2018,19,1,0,1,1,0,1088
Colts,0,7,0,6,0,0,13,Chiefs,14,10,0,7,0,0,31,201819,14,17,17,18,44,18,1608.34007864136,1656.0581811171,2018,19,1,0,1,1,0,451
Cowboys,7,0,8,7,0,0,22,Rams,3,17,3,7,0,0,30,201819,-4,13,8,8,52,8,1581.49432812361,1634.38618524913,2018,19,1,0,1,1,0,1237
Rams,0,10,7,6,3,0,26,Saints,13,0,7,3,0,0,23,201820,-13,-3,-3,3,49,-3,1648.42410526513,1682.45019430919,2018,20,1,0,0,1,0,1669
Patriots,7,7,3,14,6,0,37,Chiefs,0,0,7,24,0,0,31,201820,7,14,10,6,68,-6,1661.66856554621,1675.28641180895,2018,20,1,0,0,1,0,1249
Patriots,0,3,0,10,0,0,13,Rams,0,0,3,0,0,0,3,201822,0,3,0,10,16,-10,1686.3388366702,1666.96939481924,2018,22,1,1,1,0,0,2594
Bengals,3,14,0,3,0,0,20,Seahawks,0,14,0,7,0,0,21,201901,-3,-3,-3,1,41,1,1428.5335151433,1565.41164859357,2019,1,0,0,0,0,0,1967
Broncos,0,0,6,10,0,0,16,Raiders,7,7,0,10,0,0,24,201901,7,14,8,8,40,8,1449.16419458668,1405.44061778861,2019,1,0,0,0,1,1,939
Texans,0,14,7,7,0,0,28,Saints,0,3,14,13,0,0,30,201901,0,-11,-4,2,58,2,1515.38853097227,1610.93660317005,2019,1,0,0,0,0,0,317
Steelers,0,0,3,0,0,0,3,Patriots,7,13,10,3,0,0,33,201901,7,20,27,30,36,30,1572.19321967273,1640.85648810958,2019,1,0,0,0,1,0,479
49ers,3,3,14,11,0,0,31,Buccaneers,0,7,7,3,0,0,17,201901,3,-1,6,14,48,-14,1422.63182461207,1444.77266859125,2019,1,0,0,0,1,0,2396
Lions,0,17,0,7,3,0,27,Cardinals,0,3,3,18,3,0,27,201901,0,14,11,0,54,0,1490.51940926969,1383.74042223536,2019,1,0,0,0,1,0,1687
Giants,7,0,3,7,0,0,17,Cowboys,7,14,14,0,0,0,35,201901,0,14,25,18,52,18,1442.7255357616,1546.63760540507,2019,1,0,0,0,1,1,1370
Colts,0,6,10,8,0,0,24,Chargers,7,10,7,0,6,0,30,201901,7,11,8,6,54,6,1561.07456529967,1585.75191800581,2019,1,0,0,0,1,0,1805
Bills,0,0,3,14,0,0,17,Jets,6,0,10,0,0,0,16,201901,-6,-6,-13,1,33,-1,1448.42368150679,1384.96644235941,2019,1,0,0,0,1,1,292
Rams,0,13,10,7,0,0,30,Panthers,0,3,10,14,0,0,27,201901,0,10,10,3,57,-3,1598.01566621671,1519.37877240763,2019,1,0,0,0,1,0,2115
Washington,10,10,0,7,0,0,27,Eagles,0,7,14,11,0,0,32,201901,-10,-13,1,5,59,5,1441.02179176339,1581.51355925233,2019,1,0,0,0,1,1,123
Falcons,0,0,0,12,0,0,12,Vikings,14,7,7,0,0,0,28,201901,14,21,28,16,40,16,1520.31582461035,1538.42395425995,2019,1,0,0,0,1,0,908
Ravens,21,21,10,7,0,0,59,Dolphins,0,10,0,0,0,0,10,201901,21,32,42,49,69,-49,1570.53924891259,1415.17876187059,2019,1,0,0,0,1,0,956
Titans,3,9,10,21,0,0,43,Browns,6,0,7,0,0,0,13,201901,-3,6,9,30,56,-30,1518.90720352913,1455.88640137805,2019,1,0,0,0,1,0,458
Packers,0,7,0,3,0,0,10,Bears,3,0,0,0,0,0,3,201901,-3,4,4,7,13,-7,1455.13136993533,1588.89793144843,2019,1,0,0,0,1,1,185
Chiefs,17,6,7,10,0,0,40,Jaguars,7,6,0,13,0,0,26,201901,10,10,17,14,66,-14,1602.07742712331,1455.24907275187,2019,1,0,0,0,1,0,949
Cardinals,3,3,3,8,0,0,17,Ravens,7,10,0,6,0,0,23,201902,4,11,8,6,40,6,1385.56534920517,1598.55771020712,2019,2,0,0,0,0,0,2000
Browns,6,10,7,0,0,0,23,Jets,0,3,0,0,0,0,3,201902,6,13,20,20,26,-20,1421.31981397536,1377.99930635302,2019,2,0,0,0,1,0,403
Eagles,0,6,6,8,0,0,20,Falcons,3,7,7,7,0,0,24,201902,3,4,5,4,44,4,1589.200033619,1499.42372277767,2019,2,0,0,0,1,0,665
Saints,0,3,3,3,0,0,9,Rams,3,3,14,7,0,0,27,201902,3,3,14,18,36,18,1616.75446431035,1611.2527156438,2019,2,0,0,0,1,0,1669
Bears,0,6,7,3,0,0,16,Broncos,3,0,0,11,0,0,14,201902,-3,3,10,2,30,-2,1554.22203086172,1428.73340426133,2019,2,0,0,0,0,0,916
Jaguars,0,3,0,9,0,0,12,Texans,3,3,0,7,0,0,13,201902,3,3,3,1,25,1,1435.17777134696,1509.57066983197,2019,2,0,0,0,1,1,820
Cowboys,0,14,7,10,0,0,31,Washington,0,7,7,7,0,0,21,201902,0,7,7,10,52,-10,1561.64531234901,1433.33531739672,2019,2,0,0,0,1,1,1181
Chiefs,0,28,0,0,0,0,28,Raiders,10,0,0,0,0,0,10,201902,-10,18,18,18,38,-18,1622.14872852822,1425.87140811396,2019,2,0,0,0,1,1,1495
Bills,7,14,0,7,0,0,28,Giants,7,0,0,7,0,0,14,201902,0,14,14,14,42,-14,1455.39081751318,1427.71782881766,2019,2,0,0,0,0,0,292
Patriots,7,6,10,20,0,0,43,Dolphins,0,0,0,0,0,0,0,201902,7,13,23,43,43,-43,1661.35527196907,1387.16030057606,2019,2,0,0,0,1,1,1241
Colts,7,6,0,6,0,0,19,Titans,0,7,10,0,0,0,17,201902,7,6,-4,2,36,-2,1547.09912301326,1553.47379093182,2019,2,0,0,0,1,1,251
Vikings,0,10,6,0,0,0,16,Packers,14,7,0,0,0,0,21,201902,14,11,5,5,37,5,1559.31605609263,1489.80727052204,2019,2,0,0,0,1,1,259
Chargers,7,3,0,0,0,0,10,Lions,6,0,0,7,0,0,13,201902,-1,-4,-4,3,23,3,1599.72736029222,1488.69448229988,2019,2,0,0,0,0,0,1979
49ers,14,10,10,7,0,0,41,Bengals,7,3,0,7,0,0,17,201902,7,14,24,24,58,-24,1457.75678181037,1425.50782652535,2019,2,0,0,0,0,0,2040
Buccaneers,3,7,7,3,0,0,20,Panthers,3,6,3,2,0,0,14,201902,0,1,5,6,34,-6,1409.64771139295,1506.14172298054,2019,2,0,0,0,1,1,511
Seahawks,0,7,14,7,0,0,28,Steelers,0,10,3,13,0,0,26,201902,0,-3,8,2,54,-2,1568.43733721152,1551.69443581324,2019,2,0,0,0,0,0,2132
Bears,7,21,0,3,0,0,31,Washington,0,3,6,6,0,0,15,201903,7,25,19,16,46,-16,1563.07125264348,1414.22795853294,2019,3,0,0,0,1,0,594
Saints,7,13,7,6,0,0,33,Seahawks,7,0,0,20,0,0,27,201903,0,13,20,6,60,-6,1592.94754840432,1581.22003015962,2019,3,0,0,0,1,0,2098
Steelers,6,0,7,7,0,0,20,49ers,0,3,14,7,0,0,24,201903,-6,-3,4,4,44,4,1538.91174286514,1493.50300877245,2019,3,0,0,0,0,0,2260
Texans,0,7,14,6,0,0,27,Chargers,7,10,0,3,0,0,20,201903,-7,-10,4,7,47,-7,1513.60572962331,1583.70304942369,2019,3,0,0,0,1,0,1371
Giants,3,7,15,7,0,0,32,Buccaneers,12,16,0,3,0,0,31,201903,-9,-18,-3,1,63,-1,1397.22163097049,1439.76273979713,2019,3,0,0,0,1,0,1004
Panthers,0,14,14,10,0,0,38,Cardinals,7,3,10,0,0,0,20,201903,-7,4,8,18,58,-18,1476.02669457636,1379.76243769626,2019,3,0,0,0,1,0,1778
Lions,7,13,0,7,0,0,27,Eagles,10,0,7,7,0,0,24,201903,-3,10,3,3,51,-3,1504.71879316841,1571.76350496555,2019,3,0,0,0,1,0,441
Rams,3,0,7,10,0,0,20,Browns,0,6,7,0,0,0,13,201903,3,-3,-3,7,33,-7,1635.05963154983,1453.98420096202,2019,3,0,0,0,0,0,2044
Raiders,0,7,0,7,0,0,14,Vikings,7,14,7,6,0,0,34,201903,7,14,21,20,48,20,1408.11137665204,1541.12867786265,2019,3,0,0,0,0,0,1573
Ravens,6,0,7,15,0,0,28,Chiefs,0,23,7,3,0,0,33,201903,-6,17,17,5,61,5,1604.36062171603,1639.90875999014,2019,3,0,0,0,1,0,960
Falcons,0,3,7,14,0,0,24,Colts,10,10,0,7,0,0,27,201903,10,17,10,3,51,3,1516.86025143112,1560.75393730653,2019,3,0,0,0,0,0,427
Broncos,0,10,6,0,0,0,16,Packers,7,10,7,3,0,0,27,201903,7,7,8,11,43,11,1419.88418247957,1507.99464875202,2019,3,0,0,0,0,0,927
Dolphins,3,3,0,0,0,0,6,Cowboys,10,0,14,7,0,0,31,201903,7,4,18,25,37,25,1371.21444164375,1580.75267121279,2019,3,0,0,0,0,0,1110
Bengals,0,0,7,10,0,0,17,Bills,8,6,0,7,0,0,21,201903,8,14,7,4,38,4,1389.76159956327,1485.88701536035,2019,3,0,0,0,1,0,388
Titans,0,0,0,7,0,0,7,Jaguars,14,0,3,3,0,0,20,201903,14,14,17,13,27,13,1539.81897663855,1431.14271155562,2019,3,0,0,0,1,1,500
Jets,0,0,7,7,0,0,14,Patriots,13,7,10,0,0,0,30,201903,13,20,23,16,44,16,1345.33491936636,1677.30113090138,2019,3,0,0,0,1,1,181
Bengals,3,0,0,0,0,0,3,Steelers,0,10,14,3,0,0,27,201904,-3,7,21,24,30,24,1381.26092992517,1523.85799156991,2019,4,0,0,0,1,1,252
Cowboys,3,0,7,0,0,0,10,Saints,0,9,0,3,0,0,12,201904,-3,6,-1,2,22,2,1590.64425686682,1615.92351738268,2019,4,0,0,0,1,0,442
Jaguars,3,3,14,6,0,0,26,Broncos,7,10,0,7,0,0,24,201904,-4,-11,3,2,50,-2,1461.43487376262,1406.27508213068,2019,4,0,0,0,1,0,1465
Vikings,0,0,0,6,0,0,6,Bears,7,3,6,0,0,0,16,201904,7,10,16,10,22,10,1554.66651219904,1583.9020895963,2019,4,0,0,0,1,1,355
Seahawks,10,10,0,7,0,0,27,Cardinals,0,3,0,7,0,0,10,201904,10,17,17,17,37,-17,1558.24406118126,1353.336041534,2019,4,0,0,0,1,1,1114
Buccaneers,7,21,3,24,0,0,55,Rams,0,17,3,20,0,0,40,201904,7,11,11,15,95,-15,1430.28865711543,1648.44785330322,2019,4,0,0,0,1,0,2149
Panthers,3,7,0,6,0,0,16,Texans,0,3,7,0,0,0,10,201904,3,7,0,6,26,-6,1502.45309073862,1543.96594000943,2019,4,0,0,0,0,0,925
Washington,0,3,0,0,0,0,3,Giants,7,10,7,0,0,0,24,201904,7,14,21,21,27,21,1393.39712158012,1406.69571365219,2019,4,0,0,0,1,1,204
Chargers,10,7,3,10,0,0,30,Dolphins,7,3,0,0,0,0,10,201904,3,7,10,20,40,-20,1553.34283903757,1361.32285598972,2019,4,0,0,0,1,0,2335
Raiders,14,7,3,7,0,0,31,Colts,7,3,0,14,0,0,24,201904,7,11,14,7,55,-7,1394.57354231565,1569.95348444793,2019,4,0,0,0,1,0,1936
Chiefs,0,13,7,14,0,0,34,Lions,10,3,10,7,0,0,30,201904,-10,0,-3,4,64,-4,1652.21846175305,1524.81688909574,2019,4,0,0,0,0,0,643
Patriots,13,0,3,0,0,0,16,Bills,0,3,7,0,0,0,10,201904,13,10,6,6,26,-6,1681.73479150744,1494.38768499845,2019,4,0,0,0,1,1,404
Titans,14,10,0,0,0,0,24,Falcons,7,0,3,0,0,0,10,201904,7,17,14,14,34,-14,1509.52681443155,1507.66070428972,2019,4,0,0,0,0,0,215
Eagles,0,21,6,7,0,0,34,Packers,7,13,7,0,0,0,27,201904,-7,1,0,7,61,-7,1551.66540903822,1521.60374910091,2019,4,0,0,0,1,0,728
Browns,7,3,14,16,0,0,40,Ravens,0,7,3,15,0,0,25,201904,7,3,14,15,65,-15,1440.59597920863,1592.05091995311,2019,4,0,0,0,1,1,307
Patriots,6,6,14,7,0,0,33,Washington,7,0,0,0,0,0,7,201905,-1,5,19,26,40,-26,1693.93299608578,1370.16400632185,2019,5,0,0,0,0,0,385
Packers,14,3,14,3,0,0,34,Cowboys,0,0,10,14,0,0,24,201905,14,17,21,10,58,-10,1498.35605647044,1582.77325373953,2019,5,0,0,0,1,0,937
Browns,0,3,0,0,0,0,3,49ers,14,7,7,3,0,0,31,201905,14,18,25,28,34,28,1488.35975077262,1508.55676006768,2019,5,0,0,1,0,0,2161
Falcons,7,10,0,15,0,0,32,Texans,7,9,17,20,0,0,53,201905,0,-1,16,21,85,21,1474.76884936333,1517.43701337764,2019,5,0,0,0,0,0,700
Jaguars,7,10,7,3,0,0,27,Panthers,14,7,7,6,0,0,34,201905,7,4,4,7,61,7,1472.78282416701,1528.98201737041,2019,5,0,0,0,0,0,341
Ravens,10,7,0,6,3,0,26,Steelers,7,6,7,3,0,0,23,201905,3,4,-3,3,49,-3,1544.28714838912,1537.52700615854,2019,5,0,0,0,1,1,196
Colts,7,6,0,6,0,0,19,Chiefs,3,7,0,3,0,0,13,201905,4,3,3,6,32,-6,1532.62028170166,1665.08784610098,2019,5,0,0,0,1,0,451
Vikings,3,15,7,3,0,0,28,Giants,0,7,3,0,0,0,10,201905,3,11,15,18,38,-18,1537.76063470542,1429.92882891046,2019,5,0,0,0,1,0,1016
Jets,0,0,0,6,0,0,6,Eagles,14,7,3,7,0,0,31,201905,14,21,24,25,37,25,1340.9012587603,1574.91310166869,2019,5,0,1,0,0,0,80
Rams,6,7,13,3,0,0,29,Seahawks,7,7,7,9,0,0,30,201905,1,1,-5,1,59,1,1595.23137298171,1575.03182989028,2019,5,0,0,0,1,1,960
Cardinals,7,6,0,13,0,0,26,Bengals,3,3,3,14,0,0,23,201905,4,7,4,3,49,-3,1336.54827282498,1367.59191533654,2019,5,0,0,0,0,0,1580
Broncos,14,3,0,3,0,0,20,Chargers,0,0,7,6,0,0,13,201905,14,17,10,7,33,-7,1394.92713172629,1572.04826731323,2019,5,0,0,0,1,1,830
Bears,0,0,21,0,0,0,21,Raiders,0,17,0,7,0,0,24,201905,0,17,-4,3,45,3,1600.80796708992,1431.90674506192,2019,5,0,0,0,0,0,1845
Bills,0,7,0,7,0,0,14,Titans,0,0,7,0,0,0,7,201905,0,7,0,7,21,-7,1482.18948042011,1542.41866935794,2019,5,0,0,0,1,0,626
Buccaneers,7,3,7,7,0,0,24,Saints,3,14,7,7,0,0,31,201905,-4,7,7,7,55,7,1483.50513743694,1623.79452050997,2019,5,0,0,0,1,1,480
Lions,10,3,6,3,0,0,22,Packers,0,10,3,10,0,0,23,201906,-10,-3,-6,1,45,1,1511.94750474781,1534.51085965058,2019,6,0,1,0,1,1,291
Steelers,14,7,3,0,0,0,24,Chargers,0,0,0,17,0,0,17,201906,14,21,24,7,41,-7,1520.92219832717,1534.60702965115,2019,6,0,0,0,1,0,2132
Cowboys,0,6,3,13,0,0,22,Jets,7,14,0,3,0,0,24,201906,7,15,12,2,46,2,1546.61845055939,1332.19837926584,2019,6,0,0,0,0,0,1370
Titans,0,0,0,0,0,0,0,Broncos,3,3,7,3,0,0,16,201906,3,6,13,16,16,16,1512.74882017963,1432.36836938837,2019,6,0,0,0,1,0,1019
Falcons,7,3,10,13,0,0,33,Cardinals,3,17,7,7,0,0,34,201906,-4,10,7,1,67,1,1454.15111258556,1354.95215330701,2019,6,0,0,0,1,0,1588
Bengals,7,3,0,7,0,0,17,Ravens,14,3,3,3,0,0,23,201906,7,7,10,6,40,6,1349.18803485451,1560.89195622049,2019,6,0,0,0,1,1,419
49ers,7,0,10,3,0,0,20,Rams,7,0,0,0,0,0,7,201906,0,0,10,13,27,-13,1533.18058482426,1589.30936125736,2019,6,0,0,0,1,1,347
Eagles,0,10,10,0,0,0,20,Vikings,10,14,7,7,0,0,38,201906,10,14,11,18,58,18,1583.61598116315,1563.10006898885,2019,6,0,0,0,1,0,983
Washington,0,7,10,0,0,0,17,Dolphins,0,3,0,13,0,0,16,201906,0,4,14,1,33,-1,1359.31281136943,1342.61742771406,2019,6,0,0,1,0,0,924
Texans,3,20,0,8,0,0,31,Chiefs,17,0,7,0,0,0,24,201906,-14,6,-1,7,55,-7,1538.05475015541,1632.71839430792,2019,6,0,0,0,1,0,646
Seahawks,6,12,7,7,0,0,32,Browns,14,6,0,8,0,0,28,201906,-8,-2,5,4,60,-4,1580.95384161463,1463.73592601604,2019,6,0,0,0,0,0,2020
Panthers,10,7,10,10,0,0,37,Buccaneers,0,7,3,16,0,0,26,201906,10,10,17,11,63,-11,1542.08145781245,1474.57582588342,2019,6,0,0,0,1,1,511
Giants,0,14,0,0,0,0,14,Patriots,7,14,0,14,0,0,35,201906,7,7,7,21,49,21,1404.58939462703,1704.7841910382,2019,6,0,0,0,0,0,181
Saints,3,0,3,7,0,0,13,Jaguars,0,3,3,0,0,0,6,201906,3,0,0,7,19,-7,1632.72383206349,1459.68338372497,2019,6,0,0,0,0,0,503
49ers,0,0,3,6,0,0,9,Washington,0,0,0,0,0,0,0,201907,0,0,3,9,9,-9,1570.46944845233,1367.37892158696,2019,7,0,0,0,1,0,2435
Patriots,17,7,2,7,0,0,33,Jets,0,0,0,0,0,0,0,201907,17,24,26,33,33,-33,1710.55698925726,1348.76305686704,2019,7,0,0,0,1,1,181
Eagles,7,0,3,0,0,0,10,Cowboys,14,13,0,10,0,0,37,201907,7,20,17,27,47,27,1558.4303077123,1530.05377295819,2019,7,0,0,0,1,1,1297
Ravens,3,10,7,10,0,0,30,Seahawks,0,13,0,3,0,0,16,201907,3,0,7,14,46,-14,1566.73380451584,1594.32987659432,2019,7,0,0,0,0,0,2328
Saints,9,3,14,10,0,0,36,Bears,7,3,0,15,0,0,25,201907,2,2,16,11,61,-11,1646.57247865687,1579.01793515007,2019,7,0,0,1,1,0,832
Chargers,3,7,0,10,0,0,20,Titans,3,7,0,13,0,0,23,201907,0,0,0,3,43,3,1508.23906169051,1482.95499241699,2019,7,0,0,0,1,0,1776
Cardinals,14,3,7,3,0,0,27,Giants,0,14,0,7,0,0,21,201907,14,3,10,6,48,-6,1362.68390219579,1398.81659640797,2019,7,0,0,0,1,0,2139
Rams,3,10,14,10,0,0,37,Falcons,3,0,0,7,0,0,10,201907,0,10,24,27,47,-27,1552.02049762929,1446.41936369678,2019,7,0,0,0,1,0,1932
Raiders,3,7,7,7,0,0,24,Packers,7,14,14,7,0,0,42,201907,4,11,18,18,66,18,1453.69677700177,1539.5316451389,2019,7,0,1,0,0,0,1826
Vikings,7,14,7,14,0,0,42,Lions,14,7,3,6,0,0,30,201907,-7,0,4,12,72,-12,1588.2857424397,1506.92671925949,2019,7,0,0,0,1,1,542
Jaguars,0,6,3,18,0,0,27,Bengals,0,7,3,7,0,0,17,201907,0,-1,-1,10,44,-10,1445.83473713159,1343.34618655916,2019,7,0,0,0,1,0,630
Dolphins,0,14,0,7,0,0,21,Bills,6,3,0,22,0,0,31,201907,6,-5,-5,10,52,10,1334.55131749653,1511.85932959842,2019,7,0,0,1,1,1,1184
Chiefs,10,10,7,3,0,0,30,Broncos,6,0,0,0,0,0,6,201907,4,14,21,24,36,-24,1600.66178722108,1462.16219715101,2019,7,0,0,0,1,1,556
Texans,0,9,7,7,0,0,23,Colts,7,7,14,2,0,0,30,201907,7,5,12,7,53,7,1570.11135724225,1564.98973349472,2019,7,0,0,1,1,1,865
Cardinals,3,3,3,0,0,0,9,Saints,0,10,7,14,0,0,31,201908,-3,4,8,22,40,22,1388.85558643502,1671.21023573167,2019,8,0,0,0,1,0,1312
Packers,14,0,3,14,0,0,31,Chiefs,0,17,0,7,0,0,24,201908,14,-3,0,7,55,-7,1555.82299558307,1625.31713865551,2019,8,0,0,0,0,0,503
Dolphins,14,0,0,0,0,0,14,Steelers,0,10,7,10,0,0,27,201908,-14,-4,3,13,41,13,1325.97023875445,1547.29016628781,2019,8,0,0,1,1,0,1013
Browns,0,7,3,3,0,0,13,Patriots,17,0,7,3,0,0,27,201908,17,10,14,14,40,14,1450.35989103635,1720.08737228854,2019,8,0,1,0,1,0,551
Panthers,3,0,10,0,0,0,13,49ers,14,13,14,10,0,0,51,201908,11,24,28,38,64,38,1561.56445771134,1583.95061959001,2019,8,0,1,0,1,0,2296
Jets,7,0,0,8,0,0,15,Jaguars,13,6,3,7,0,0,29,201908,6,12,15,14,44,14,1339.23267383576,1466.87775974684,2019,8,0,0,0,1,0,835
Bengals,0,10,0,0,0,0,10,Rams,3,14,7,0,0,0,24,201908,3,7,14,14,34,14,1322.30316394391,1580.93260134316,2019,8,0,0,0,0,0,1895
Raiders,7,7,7,3,0,0,24,Texans,7,3,3,14,0,0,27,201908,0,-4,-8,3,51,3,1437.4054265576,1553.32261175079,2019,8,0,0,0,1,0,1635
Buccaneers,3,12,8,0,0,0,23,Titans,14,3,3,7,0,0,27,201908,11,2,-3,4,50,4,1455.09282598453,1495.0222601273,2019,8,0,1,0,0,0,621
Giants,0,13,6,7,0,0,26,Lions,14,3,7,7,0,0,31,201908,14,4,5,5,57,5,1372.64491216874,1482.66445401377,2019,8,0,0,0,1,0,480
Chargers,0,7,3,7,0,0,17,Bears,0,9,7,0,0,0,16,201908,0,-2,-6,1,33,-1,1496.1717939802,1554.38017807527,2019,8,0,0,0,0,0,1741
Eagles,3,8,13,7,0,0,31,Bills,0,7,6,0,0,0,13,201908,3,4,11,18,44,-18,1529.09614090863,1520.4404083405,2019,8,0,0,0,0,0,279
Seahawks,3,21,0,3,0,0,27,Falcons,0,0,11,9,0,0,20,201908,3,24,13,7,47,-7,1558.69853950601,1417.50725998291,2019,8,0,0,0,1,0,2178
Washington,0,6,3,0,0,0,9,Vikings,3,10,3,3,0,0,19,201908,3,7,7,10,28,10,1353.89775044928,1612.54800768542,2019,8,0,0,0,1,0,931
Broncos,0,6,7,0,0,0,13,Colts,0,3,9,3,0,0,15,201908,0,-3,-1,2,28,2,1437.50684571658,1581.77847898618,2019,8,0,0,0,1,0,998
Cowboys,3,10,3,21,0,0,37,Giants,3,9,3,3,0,0,18,201909,0,1,1,19,55,-19,1559.38793976186,1363.76637613557,2019,9,0,1,0,1,1,1370
Patriots,0,13,7,0,0,0,20,Ravens,10,7,7,13,0,0,37,201909,10,4,4,17,57,17,1726.0621791884,1602.36514160415,2019,9,0,0,1,1,0,350
Packers,0,0,3,8,0,0,11,Chargers,6,3,10,7,0,0,26,201909,6,9,16,15,37,15,1586.14114154323,1506.01443841784,2019,9,0,0,0,0,0,1757
Browns,0,12,0,7,0,0,19,Broncos,7,10,7,0,0,0,24,201909,7,5,12,5,43,5,1444.38508413649,1432.87922009863,2019,9,0,0,0,1,0,1223
Buccaneers,14,7,3,10,0,0,34,Seahawks,7,6,8,13,6,0,40,201909,-7,-8,-3,6,74,6,1444.23443988596,1574.45872778087,2019,9,0,0,0,1,0,2526
Lions,7,7,3,7,0,0,24,Raiders,7,10,0,14,0,0,31,201909,0,3,0,7,55,7,1491.54299004694,1430.72212992009,2019,9,0,0,0,0,0,2078
Titans,0,0,7,13,0,0,20,Panthers,0,17,7,6,0,0,30,201909,0,17,17,10,50,10,1505.88064622587,1535.00865348355,2019,9,0,0,0,0,0,339
49ers,7,14,7,0,0,0,28,Cardinals,7,0,7,11,0,0,25,201909,0,14,14,3,53,-3,1610.5064238178,1382.39704596737,2019,9,0,0,0,1,1,652
Bears,0,0,7,7,0,0,14,Eagles,3,9,7,3,0,0,22,201909,3,12,12,8,36,8,1544.53753363763,1564.1724980887,2019,9,0,0,0,1,0,664
Jets,7,5,3,3,0,0,18,Dolphins,0,21,3,2,0,0,26,201909,-7,9,9,8,44,8,1326.87894194667,1318.43454062777,2019,9,0,0,0,1,1,1091
Vikings,7,3,6,7,0,0,23,Chiefs,7,3,10,6,0,0,26,201909,0,0,4,3,49,3,1618.16460424209,1594.99899269535,2019,9,0,0,0,0,0,411
Washington,0,6,3,0,0,0,9,Bills,10,7,0,7,0,0,24,201909,10,11,8,15,33,15,1348.28115389261,1485.36405116043,2019,9,0,0,0,0,0,292
Texans,3,6,10,7,0,0,26,Jaguars,0,3,0,0,0,0,3,201909,3,6,16,23,29,-23,1560.0059083883,1479.23149163593,2019,9,0,0,0,1,1,820
Colts,3,13,2,6,0,0,24,Steelers,3,10,7,6,0,0,26,201909,0,-3,2,2,50,2,1586.40610460413,1554.82586441449,2019,9,0,0,0,1,0,328
Seahawks,0,7,14,3,3,0,27,49ers,10,0,0,14,0,0,24,201910,-10,-3,11,3,51,-3,1583.22750341784,1617.76263203764,2019,10,0,0,0,1,1,679
Vikings,14,3,11,0,0,0,28,Cowboys,0,14,7,3,0,0,24,201910,14,3,7,4,52,-4,1606.19055805231,1577.50889749769,2019,10,0,0,0,1,0,863
Rams,7,0,3,2,0,0,12,Steelers,7,7,0,3,0,0,17,201910,0,7,4,5,29,5,1589.8549233214,1564.60985486358,2019,10,0,1,0,0,0,2132
Panthers,7,3,0,6,0,0,16,Packers,7,7,10,0,0,0,24,201910,0,4,14,8,40,8,1551.9219446718,1557.0085736459,2019,10,0,0,0,1,0,745
Dolphins,3,7,0,6,0,0,16,Colts,0,0,6,6,0,0,12,201910,3,10,4,4,28,-4,1336.39957264986,1576.62211415504,2019,10,0,0,0,1,0,1026
Cardinals,3,10,7,7,0,0,27,Buccaneers,7,10,3,10,0,0,30,201910,4,4,0,3,57,3,1375.14083774753,1435.46566424899,2019,10,0,0,0,1,0,1793
Falcons,3,10,0,13,0,0,26,Saints,3,3,3,0,0,0,9,201910,0,7,4,17,35,-17,1401.74707170805,1677.66877619932,2019,10,0,1,1,1,1,424
Chiefs,10,3,9,10,0,0,32,Titans,0,13,7,15,0,0,35,201910,-10,0,-2,3,67,3,1606.97303888513,1488.96735503762,2019,10,0,0,0,1,0,471
Bills,0,7,2,7,0,0,16,Browns,6,3,3,7,0,0,19,201910,6,2,3,3,35,3,1497.45491182391,1429.56499755453,2019,10,0,0,0,1,0,173
Ravens,14,14,21,0,0,0,49,Bengals,0,10,0,3,0,0,13,201910,14,18,39,36,62,-36,1637.03092491053,1313.38084196567,2019,10,0,0,1,1,1,419
Lions,3,3,0,7,0,0,13,Bears,0,7,13,0,0,0,20,201910,-3,1,14,7,33,7,1471.03764099408,1528.43380504916,2019,10,0,0,0,1,1,238
Chargers,0,14,3,7,0,0,24,Raiders,10,7,3,6,0,0,26,201910,10,3,3,2,50,2,1535.14700631517,1451.22747897295,2019,10,0,0,0,1,1,343
Giants,0,13,14,0,0,0,27,Jets,14,0,10,10,0,0,34,201910,14,1,-3,7,61,7,1345.64541839974,1308.91390992458,2019,10,0,0,0,0,0,0
Jets,6,14,0,14,0,0,34,Washington,0,3,0,14,0,0,17,201911,6,17,17,17,51,-17,1327.77775998688,1336.19029322913,2019,11,0,0,1,0,0,204
Chiefs,0,10,14,0,0,0,24,Chargers,3,6,8,0,0,0,17,201911,-3,1,7,7,41,-7,1590.61731936741,1523.46274505082,2019,11,0,0,0,1,1,1354
Bears,0,0,7,0,0,0,7,Rams,0,10,0,7,0,0,17,201911,0,10,3,10,24,10,1541.46633110479,1574.26042764114,2019,11,0,0,0,1,0,1741
Patriots,0,9,8,0,0,0,17,Eagles,3,7,0,0,0,0,10,201911,-3,-1,7,7,27,-7,1691.39639588202,1580.27622667717,2019,11,0,1,1,0,0,261
Bengals,7,0,3,0,0,0,10,Raiders,0,14,0,3,0,0,17,201911,-7,7,4,7,27,7,1301.48505885368,1462.9117402373,2019,11,0,0,0,1,0,2032
Cardinals,9,7,3,7,0,0,26,49ers,0,10,7,19,0,0,36,201911,-9,-6,-2,10,62,10,1366.56104629946,1599.19322127463,2019,11,0,0,0,1,1,652
Texans,0,0,0,7,0,0,7,Ravens,0,14,13,14,0,0,41,201911,0,14,27,34,48,34,1583.65970771662,1648.92670802252,2019,11,0,1,0,1,0,1250
Steelers,0,0,7,0,0,0,7,Browns,7,7,0,7,0,0,21,201911,7,14,7,14,28,14,1580.20435054384,1443.56163422515,2019,11,0,0,0,1,1,114
Saints,13,7,7,7,0,0,34,Buccaneers,0,7,10,0,0,0,17,201911,13,13,10,17,51,-17,1617.68814667083,1444.04545569706,2019,11,0,0,0,1,1,480
Broncos,10,10,3,0,0,0,23,Vikings,0,0,7,20,0,0,27,201911,-10,-20,-16,4,50,4,1447.69930668059,1624.25951138251,2019,11,0,1,0,0,0,698
Bills,6,17,7,7,0,0,37,Dolphins,0,14,0,6,0,0,20,201911,6,9,16,17,57,-17,1483.45827515329,1368.2733182892,2019,11,0,0,0,1,1,1184
Jaguars,7,0,0,6,0,0,13,Colts,7,3,14,9,0,0,33,201911,0,3,17,20,46,20,1455.57769230761,1544.7483685157,2019,11,0,1,0,1,1,699
Cowboys,3,21,3,8,0,0,35,Lions,7,7,7,6,0,0,27,201911,-4,10,6,8,62,-8,1559.43994416749,1458.00511493845,2019,11,0,0,0,1,0,999
Falcons,10,10,6,3,0,0,29,Panthers,0,0,0,3,0,0,3,201911,10,20,26,26,32,-26,1461.72770123654,1534.86625498031,2019,11,0,0,0,1,1,226
Seahawks,7,3,0,7,0,0,17,Eagles,3,0,0,6,0,0,9,201912,4,7,7,8,26,-8,1601.79691418085,1562.59668477878,2019,12,0,1,0,1,0,2373
Packers,0,0,8,0,0,0,8,49ers,10,13,7,7,0,0,37,201912,10,23,22,29,45,29,1574.06426333739,1605.64520401337,2019,12,0,1,0,1,0,1834
Cowboys,0,6,0,3,0,0,9,Patriots,7,3,0,3,0,0,13,201912,7,4,4,4,22,4,1578.79585811905,1709.07593778041,2019,12,0,0,0,0,0,1545
Jaguars,0,3,8,9,0,0,20,Titans,0,7,28,7,0,0,42,201912,0,4,24,22,62,22,1438.98308389968,1505.32307455534,2019,12,0,0,1,1,1,500
Lions,0,6,7,3,0,0,16,Washington,3,10,0,6,0,0,19,201912,3,7,0,3,35,3,1438.64920098689,1300.0630241212,2019,12,0,0,0,1,0,394
Ravens,14,14,7,10,0,0,45,Rams,0,6,0,0,0,0,6,201912,14,22,29,39,51,-39,1670.46585755465,1590.92206148874,2019,12,0,0,0,0,0,2314
Raiders,3,0,0,0,0,0,3,Jets,3,10,21,0,0,0,34,201912,0,10,31,31,37,31,1470.96578877356,1363.90502909481,2019,12,0,0,0,1,0,2557
Dolphins,0,3,14,7,0,0,24,Browns,14,14,0,13,0,0,41,201912,14,25,11,17,65,17,1344.06792908211,1477.24533533659,2019,12,0,0,0,1,0,1089
Steelers,0,3,7,6,0,0,16,Bengals,0,7,3,0,0,0,10,201912,0,-4,0,6,26,-6,1546.5206494324,1293.43101031742,2019,12,0,0,0,1,1,252
Giants,0,7,0,7,0,0,14,Bears,0,3,16,0,0,0,19,201912,0,-4,12,5,33,5,1326.78156833744,1524.80469725719,2019,12,0,1,0,1,0,711
Broncos,0,0,3,0,0,0,3,Bills,3,3,7,7,0,0,20,201912,3,6,10,17,23,17,1441.91812760513,1507.66366436038,2019,12,0,0,0,1,0,1366
Buccaneers,7,12,6,10,0,0,35,Falcons,10,0,3,9,0,0,22,201912,-3,9,12,13,57,-13,1424.84459097771,1510.1832094623,2019,12,0,0,0,1,1,416
Colts,0,10,7,0,0,0,17,Texans,0,10,3,7,0,0,20,201912,0,0,-4,3,37,3,1561.34297692363,1562.12055818449,2019,12,0,0,0,1,1,865
Panthers,6,9,9,7,0,0,31,Saints,14,3,14,3,0,0,34,201912,8,2,7,3,65,3,1486.41074675456,1636.88901139018,2019,12,0,0,0,1,1,648
Vikings,7,10,0,13,0,0,30,Seahawks,7,3,17,10,0,0,37,201913,0,-7,10,7,67,7,1630.04069045797,1625.67783171992,2019,13,0,1,0,1,0,1391
Patriots,3,0,6,13,0,0,22,Texans,7,7,7,7,0,0,28,201913,4,11,12,6,50,6,1716.32655567016,1573.06268345604,2019,13,0,0,0,1,0,1597
Raiders,0,0,0,9,0,0,9,Chiefs,7,14,10,9,0,0,40,201913,7,21,31,31,49,31,1431.37627310522,1606.943421992,2019,13,0,0,1,1,1,1495
Chargers,0,10,0,10,0,0,20,Broncos,14,3,0,6,0,0,23,201913,14,7,7,3,43,3,1507.13664242623,1424.44389549714,2019,13,0,1,0,1,1,830
Rams,3,17,14,0,0,0,34,Cardinals,0,0,0,7,0,0,7,201913,3,20,34,27,41,-27,1555.80867385021,1360.10906356072,2019,13,0,0,1,1,1,356
49ers,7,7,3,0,0,0,17,Ravens,7,10,0,3,0,0,20,201913,0,3,0,3,37,3,1629.3960165728,1705.57924519318,2019,13,0,0,0,0,0,2451
Buccaneers,15,10,0,3,0,0,28,Jaguars,0,0,3,8,0,0,11,201913,15,25,22,17,39,-17,1464.71616801768,1420.07581108859,2019,13,0,0,0,0,0,171
Washington,3,9,3,14,0,0,29,Panthers,14,0,0,7,0,0,21,201913,-11,-2,1,8,50,-8,1317.39883493716,1480.74489445415,2019,13,0,0,0,1,0,329
Packers,14,3,0,14,0,0,31,Giants,7,3,3,0,0,0,13,201913,7,7,4,18,44,-18,1550.31345077796,1321.00935032289,2019,13,0,0,0,1,0,758
Eagles,10,11,7,3,0,0,31,Dolphins,7,7,12,11,0,0,37,201913,-3,-7,-2,6,68,6,1538.71576723971,1331.22537419603,2019,13,0,0,0,0,0,1021
Titans,7,0,10,14,0,0,31,Colts,7,3,7,0,0,0,17,201913,0,-3,0,14,48,-14,1524.23034736643,1550.40085165208,2019,13,0,0,0,1,1,251
Jets,3,3,0,0,0,0,6,Bengals,7,10,5,0,0,0,22,201913,4,11,16,16,28,16,1403.49454476315,1284.36058993638,2019,13,0,0,0,1,0,563
Saints,7,10,3,6,0,0,26,Falcons,0,9,0,9,0,0,18,201913,7,8,11,8,44,-8,1642.55486369059,1470.31163242233,2019,13,0,0,0,1,1,424
Bills,0,13,10,3,0,0,26,Cowboys,7,0,0,8,0,0,15,201913,-7,6,16,11,41,-11,1525.13789646837,1571.5452402293,2019,13,0,0,0,0,0,1197
Bears,7,3,7,7,0,0,24,Lions,14,3,0,3,0,0,20,201913,-7,-7,0,4,44,-4,1530.57691527174,1421.31339017093,2019,13,0,0,0,1,1,238
Browns,3,7,0,3,0,0,13,Steelers,0,10,7,3,0,0,20,201913,-3,0,7,7,33,7,1490.08789022267,1555.59106981344,2019,13,0,0,0,1,1,114
Broncos,14,17,7,0,0,0,38,Texans,0,3,7,14,0,0,24,201914,14,28,28,14,62,-14,1439.13029387094,1597.70929540402,2019,14,0,0,0,1,0,878
Giants,0,17,0,0,0,0,17,Eagles,0,3,7,7,6,0,23,201914,0,-14,-7,6,40,6,1305.68125878868,1509.82408144534,2019,14,0,0,0,1,1,80
Seahawks,3,0,6,3,0,0,12,Rams,7,14,0,7,0,0,28,201914,4,18,12,16,40,16,1642.41805054835,1575.95809822522,2019,14,0,0,0,1,1,960
Steelers,10,3,7,3,0,0,23,Cardinals,0,10,0,7,0,0,17,201914,10,3,10,6,40,-6,1568.17591962715,1339.95963918571,2019,14,0,0,0,0,0,1824
Chiefs,3,17,3,0,0,0,23,Patriots,7,0,6,3,0,0,16,201914,-4,13,10,7,39,-7,1619.45468044459,1691.67994372218,2019,14,0,0,0,1,0,1249
Titans,7,14,7,14,0,0,42,Raiders,7,14,0,0,0,0,21,201914,0,0,7,21,63,-21,1559.72942337597,1418.86501465263,2019,14,0,0,0,1,0,1950
Chargers,7,17,14,7,0,0,45,Jaguars,3,0,7,0,0,0,10,201914,4,21,28,35,55,-35,1492.45024405243,1389.19449101388,2019,14,0,0,0,1,0,2143
Colts,10,17,8,0,0,0,35,Buccaneers,14,7,7,10,0,0,38,201914,4,-6,-7,3,73,3,1514.90177564254,1495.59748809239,2019,14,0,0,0,0,0,843
Cowboys,7,0,0,17,0,0,24,Bears,0,17,7,7,0,0,31,201914,-7,10,17,7,55,7,1537.25397739718,1544.354676131,2019,14,0,0,0,1,0,802
49ers,7,21,7,13,0,0,48,Saints,13,14,6,13,0,0,46,201914,-6,1,2,2,94,-2,1621.38933975795,1657.23671590787,2019,14,0,0,0,1,0,1921
Lions,0,0,0,7,0,0,7,Vikings,7,10,0,3,0,0,20,201914,7,17,17,13,27,13,1407.53562931167,1613.30047162954,2019,14,0,0,0,1,1,542
Washington,0,6,3,6,0,0,15,Packers,14,0,3,3,0,0,20,201914,14,8,8,5,35,5,1356.05026967651,1565.64154231217,2019,14,0,0,0,1,0,686
Bengals,6,7,3,3,0,0,19,Browns,7,7,10,3,0,0,27,201914,1,1,8,8,46,8,1317.89698322011,1477.50304040896,2019,14,0,0,0,1,1,217
Ravens,3,7,7,7,0,0,24,Bills,0,6,3,8,0,0,17,201914,3,4,8,7,41,-7,1713.58592200803,1559.42915930049,2019,14,0,0,0,1,0,275
Panthers,0,10,0,10,0,0,20,Falcons,3,10,17,10,0,0,40,201914,3,3,20,20,60,20,1442.0934597148,1455.62978020505,2019,14,0,0,0,1,1,226
Dolphins,3,6,3,9,0,0,21,Jets,0,16,0,6,0,0,22,201914,-3,7,4,1,43,1,1360.1170599904,1369.95815147942,2019,14,0,0,0,1,1,1091
Jaguars,3,0,3,14,0,0,20,Raiders,10,6,0,0,0,0,16,201915,-7,-13,-10,4,36,-4,1357.83452381812,1395.40768212791,2019,15,0,0,0,1,0,2361
Colts,0,0,0,7,0,0,7,Saints,3,17,14,0,0,0,34,201915,3,20,34,27,41,27,1503.09688146038,1642.47154413998,2019,15,0,0,0,0,0,713
Bills,0,7,0,10,0,0,17,Steelers,0,3,7,0,0,0,10,201915,0,4,-3,7,27,-7,1544.46325861921,1578.35632973989,2019,15,0,0,0,1,0,178
Falcons,0,10,0,19,0,0,29,49ers,0,10,3,9,0,0,22,201915,0,0,-3,7,51,-7,1478.49172794525,1636.15451152584,2019,15,0,0,0,1,0,2135
Rams,0,7,0,14,0,0,21,Cowboys,7,21,3,13,0,0,44,201915,7,21,24,23,65,23,1604.42817803574,1521.23883753007,2019,15,0,0,0,1,0,1237
Vikings,6,13,6,14,0,0,39,Chargers,3,7,0,0,0,0,10,201915,3,9,15,29,49,-29,1621.47046565354,1523.81021124819,2019,15,0,0,0,0,0,1521
Browns,0,10,7,7,0,0,24,Cardinals,7,14,7,10,0,0,38,201915,7,11,11,14,62,14,1486.09007748416,1329.77922907297,2019,15,0,0,0,0,0,1745
Seahawks,13,7,3,7,0,0,30,Panthers,0,7,3,14,0,0,24,201915,13,13,13,6,54,-6,1613.94797073783,1419.2315119746,2019,15,0,0,0,1,0,2280
Texans,0,14,0,10,0,0,24,Titans,0,0,7,14,0,0,21,201915,0,14,7,3,45,-3,1550.46512481345,1583.18675590069,2019,15,0,0,0,1,1,665
Dolphins,0,10,3,7,0,0,20,Giants,0,7,16,13,0,0,36,201915,0,-3,10,16,56,16,1354.8356882575,1299.60651045577,2019,15,0,0,0,0,0,1091
Broncos,0,3,0,0,0,0,3,Chiefs,6,9,8,0,0,0,23,201915,6,12,20,20,26,20,1486.37446446151,1649.96314414374,2019,15,0,0,0,1,1,556
Bears,0,3,0,10,0,0,13,Packers,7,0,14,0,0,0,21,201915,7,4,18,8,34,8,1560.36981599811,1571.07983275278,2019,15,0,0,0,1,1,185
Buccaneers,14,7,3,14,0,0,38,Lions,0,3,7,7,0,0,17,201915,14,18,14,21,55,-21,1507.40238227455,1399.36563528767,2019,15,0,0,0,1,0,994
Patriots,7,6,14,7,0,0,34,Bengals,10,0,0,3,0,0,13,201915,-3,3,17,21,47,-21,1661.17148002303,1309.30994614491,2019,15,0,0,0,1,0,732
Jets,0,7,0,14,0,0,21,Ravens,13,8,14,7,0,0,42,201915,13,14,28,21,63,21,1375.23952321232,1728.55182268931,2019,15,0,0,0,1,0,169
Eagles,3,7,7,20,0,0,37,Washington,7,7,0,13,0,0,27,201915,-4,-4,3,10,64,-10,1515.89882977825,1350.6119792359,2019,15,0,0,0,1,1,123
Packers,3,6,8,6,0,0,23,Vikings,3,7,0,0,0,0,10,201916,0,-1,7,13,33,-13,1587.76428671758,1651.84366288367,2019,16,0,0,0,1,1,259
Chiefs,7,10,0,9,0,0,26,Bears,0,0,3,0,0,0,3,201916,7,17,14,23,29,-23,1661.62972879534,1543.68536203331,2019,16,0,0,0,0,0,410
Cardinals,7,10,3,7,0,0,27,Seahawks,7,0,0,6,0,0,13,201916,0,10,13,14,40,-14,1365.29132813451,1625.76494000045,2019,16,0,0,0,1,1,1114
Raiders,7,7,7,3,0,0,24,Chargers,0,7,7,3,0,0,17,201916,7,7,7,7,41,-7,1373.68223989079,1493.43701401806,2019,16,0,0,0,1,1,343
Lions,3,7,7,0,0,0,17,Broncos,0,10,3,14,0,0,27,201916,-3,0,-4,10,44,10,1372.78459518554,1474.70787980991,2019,16,0,0,0,0,0,1154
Giants,14,14,7,0,6,0,41,Washington,7,7,7,14,0,0,35,201916,7,14,14,6,76,-6,1327.02032565761,1334.12026400815,2019,16,0,0,0,1,1,204
Steelers,0,10,0,0,0,0,10,Jets,7,3,3,3,0,0,16,201916,7,0,3,6,26,6,1550.5478511956,1370.95077179863,2019,16,0,0,0,1,0,314
Cowboys,0,6,0,3,0,0,9,Eagles,10,0,7,0,0,0,17,201916,10,4,11,8,26,8,1554.96047459584,1532.390545006,2019,16,0,0,0,1,1,1297
Panthers,0,3,3,0,0,0,6,Colts,14,7,3,14,0,0,38,201916,14,18,18,32,44,32,1407.41454271198,1488.72488782569,2019,16,0,0,0,0,0,428
Saints,0,10,21,7,0,0,38,Titans,14,0,7,7,0,0,28,201916,-14,-4,10,10,66,-10,1656.84353777467,1564.70329838464,2019,16,0,0,0,0,0,469
Ravens,0,14,7,10,0,0,31,Browns,0,6,3,6,0,0,15,201916,0,8,12,16,46,-16,1732.840574103,1450.57797842262,2019,16,0,0,0,1,1,307
Jaguars,0,3,3,6,0,0,12,Falcons,14,3,0,7,0,0,24,201916,14,14,11,12,36,12,1379.55996605524,1514.71105294635,2019,16,0,0,0,0,0,285
Rams,7,14,7,3,0,0,31,49ers,3,21,0,10,0,0,34,201916,-4,3,-4,3,65,3,1570.70654096997,1599.93518652474,2019,16,0,0,0,1,1,347
Bills,3,7,7,0,0,0,17,Patriots,7,3,3,11,0,0,24,201916,4,0,-4,7,41,7,1572.2717371635,1669.97282852798,2019,16,0,0,0,1,1,404
Texans,10,7,3,3,0,0,23,Buccaneers,3,14,3,0,0,0,20,201916,7,0,0,3,43,-3,1568.9485823295,1533.98342237668,2019,16,0,0,0,0,0,790
Bengals,0,6,6,23,0,0,35,Dolphins,14,7,7,7,3,0,38,201916,14,15,16,3,73,3,1300.50859763996,1327.42187305566,2019,16,0,0,0,1,0,957
Titans,7,7,7,14,0,0,35,Texans,7,0,7,0,0,0,14,201917,0,7,7,21,49,-21,1542.8631129536,1584.2153879446,2019,17,0,0,0,1,1,665
Steelers,0,7,3,0,0,0,10,Ravens,6,10,0,12,0,0,28,201917,6,9,6,18,38,18,1523.48371377048,1744.31958402685,2019,17,0,0,0,1,1,196
Colts,10,10,0,0,0,0,20,Jaguars,3,13,8,14,0,0,38,201917,-7,-4,4,18,58,18,1508.46558204188,1368.27046254882,2019,17,0,0,0,1,1,699
Eagles,3,7,7,17,0,0,34,Giants,0,3,14,0,0,0,17,201917,3,7,0,17,51,-17,1551.32749712891,1351.25483002815,2019,17,0,0,0,1,1,80
Cardinals,7,3,7,7,0,0,24,Rams,3,14,0,14,0,0,31,201917,-4,7,0,7,55,7,1420.39399261721,1560.93247572242,2019,17,0,0,0,1,1,356
Raiders,0,3,0,12,0,0,15,Broncos,0,10,3,3,0,0,16,201917,0,7,10,1,31,1,1407.43224035281,1487.04201364847,2019,17,0,0,0,1,1,939
Washington,0,10,6,0,0,0,16,Cowboys,6,14,17,10,0,0,47,201917,6,10,21,31,63,31,1309.88575963761,1536.02352247293,2019,17,0,0,0,1,1,1181
Bears,6,5,7,3,0,0,21,Vikings,0,6,0,13,0,0,19,201917,6,5,12,2,40,-2,1517.34450462293,1613.84658891339,2019,17,0,0,0,1,1,355
Falcons,10,6,0,6,6,0,28,Buccaneers,0,22,0,0,0,0,22,201917,10,-6,-6,6,50,-6,1526.00055645277,1518.71661676158,2019,17,0,0,0,1,1,416
Dolphins,3,7,7,10,0,0,27,Patriots,0,10,7,7,0,0,24,201917,3,0,0,3,51,-3,1337.28842109985,1680.87742430832,2019,17,0,0,0,1,1,1241
Chargers,0,7,7,7,0,0,21,Chiefs,3,7,14,7,0,0,31,201917,3,3,10,10,52,10,1459.68701355604,1687.97058620572,2019,17,0,0,0,1,1,1354
Packers,0,3,7,13,0,0,23,Lions,7,10,0,3,0,0,20,201917,-7,-14,-7,3,43,-3,1625.76136068786,1360.45046134698,2019,17,0,0,0,1,1,291
Browns,7,9,0,7,0,0,23,Bengals,13,7,3,10,0,0,33,201917,6,4,7,10,56,10,1439.09896849877,1290.64204959577,2019,17,0,0,0,1,1,217
Jets,0,3,0,10,0,0,13,Bills,0,0,3,3,0,0,6,201917,0,3,0,7,19,-7,1398.01490922375,1561.36714138316,2019,17,0,0,0,1,1,292
49ers,10,3,6,7,0,0,26,Seahawks,0,0,7,14,0,0,21,201917,10,13,12,5,47,-5,1609.70925177229,1570.66227551775,2019,17,0,0,0,1,1,679
Saints,14,21,7,0,0,0,42,Panthers,0,3,7,0,0,0,10,201917,14,32,32,32,52,-32,1678.68372320571,1387.67384849579,2019,17,0,0,0,1,1,648
Vikings,3,10,7,0,6,0,26,Saints,3,7,0,10,0,0,20,201918,0,3,10,6,46,-6,1596.84410480098,1692.25422318856,2019,18,1,0,0,1,0,1052
Seahawks,3,7,7,0,0,0,17,Eagles,0,3,6,0,0,0,9,201918,3,7,8,8,26,-8,1601.79691418085,1562.59668477878,2019,18,1,0,0,1,0,2373
Bills,7,6,3,3,0,0,19,Texans,0,0,8,11,3,0,22,201918,-7,-13,-8,3,41,3,1524.78724135976,1542.09159482626,2019,18,1,0,0,1,0,1285
Titans,7,7,0,6,0,0,20,Patriots,3,10,0,0,0,0,13,201918,4,1,1,7,33,-7,1584.98690607194,1649.7868334529,2019,18,1,0,0,1,0,936
Vikings,7,3,0,0,0,0,10,49ers,7,7,10,3,0,0,27,201919,0,4,14,17,37,17,1626.88991030393,1629.19262758102,2019,19,1,0,1,1,0,1581
Titans,7,7,14,0,0,0,28,Ravens,0,6,0,6,0,0,12,201919,7,8,22,16,40,-16,1614.97708237574,1752.7485915294,2019,19,1,0,1,1,0,595
Texans,21,3,7,0,0,0,31,Chiefs,0,28,13,10,0,0,51,201919,-21,4,10,20,82,20,1552.3469500457,1694.57209697917,2019,19,1,0,1,1,0,646
Seahawks,3,0,14,6,0,0,23,Packers,7,14,7,0,0,0,28,201919,4,18,11,5,51,5,1579.31289442705,1631.85839935054,2019,19,1,0,1,1,0,1645
Titans,10,7,0,7,0,0,24,Chiefs,7,14,0,14,0,0,35,201920,-3,4,4,11,59,11,1662.57936214379,1707.52397717462,2019,20,1,0,0,1,0,471
Packers,0,0,7,13,0,0,20,49ers,7,20,7,3,0,0,37,201920,7,27,27,17,57,17,1643.32268994627,1651.8724977481,2019,20,1,0,0,1,0,1834
49ers,3,7,10,0,0,0,20,Chiefs,7,3,0,21,0,0,31,201922,4,0,-10,11,51,11,1674.00727853106,1723.94156010318,2019,22,1,1,1,0,0,1503
Steelers,3,13,0,10,0,0,26,Giants,3,7,0,6,0,0,16,202001,0,6,6,10,42,-10,1511.70313751195,1391.07131458934,2020,1,0,0,0,0,0,314
Cowboys,0,14,3,0,0,0,17,Rams,7,6,7,0,0,0,20,202001,7,-1,3,3,37,3,1532.11536282697,1548.23404595027,2020,1,0,0,0,1,0,1237
Cardinals,7,3,0,14,0,0,24,49ers,10,3,0,7,0,0,20,202001,-3,-3,-3,4,44,-4,1442.65026627615,1603.78530833319,2020,1,0,0,0,1,1,652
Buccaneers,7,0,10,6,0,0,23,Saints,0,17,7,10,0,0,34,202001,-7,10,7,11,57,11,1498.62921640758,1609.80561179041,2020,1,0,0,0,1,1,480
Chargers,0,6,0,10,0,0,16,Bengals,7,0,6,0,0,0,13,202001,-7,-1,-7,3,29,-3,1470.39033518839,1382.62734642343,2020,1,0,0,0,1,0,1895
Browns,6,0,0,0,0,0,6,Ravens,10,14,7,7,0,0,38,202001,4,18,25,32,44,32,1440.53333230626,1638.43087450757,2020,1,0,0,0,1,1,307
Colts,7,10,0,3,0,0,20,Jaguars,0,14,3,10,0,0,27,202001,-7,-3,0,7,47,7,1482.65477791485,1438.50258514562,2020,1,0,0,0,1,1,699
Titans,0,7,0,9,0,0,16,Broncos,7,0,0,7,0,0,14,202001,-7,0,0,2,30,-2,1599.10785281015,1495.65672785063,2020,1,0,0,0,1,0,1019
Eagles,10,7,0,0,0,0,17,Washington,0,7,7,13,0,0,27,202001,-10,-10,-3,10,44,10,1528.56090703668,1368.49082524672,2020,1,0,0,0,1,1,123
Dolphins,0,3,0,8,0,0,11,Patriots,0,7,7,7,0,0,21,202001,0,4,11,10,32,10,1413.91934130351,1581.53110476607,2020,1,0,0,0,1,1,1241
Packers,3,19,7,14,0,0,43,Vikings,7,3,0,24,0,0,34,202001,-4,12,19,9,77,-9,1582.45860610887,1571.1400267579,2020,1,0,0,0,1,1,259
Bears,3,3,0,21,0,0,27,Lions,3,10,10,0,0,0,23,202001,0,-7,-17,4,50,-4,1524.56465915689,1404.5689484562,2020,1,0,0,0,1,1,238
Jets,0,3,7,7,0,0,17,Bills,14,7,0,6,0,0,27,202001,14,18,11,10,44,10,1458.06320616477,1511.35459076021,2020,1,0,0,0,1,1,292
Seahawks,14,0,14,10,0,0,38,Falcons,3,9,0,13,0,0,25,202001,11,2,16,13,63,-13,1546.89906922088,1534.51556573532,2020,1,0,0,0,1,0,2178
Texans,7,0,0,13,0,0,20,Chiefs,0,17,7,10,0,0,34,202001,-7,10,17,14,54,14,1527.93004656683,1664.8472507563,2020,1,0,0,0,1,0,646
Raiders,7,10,10,7,0,0,34,Panthers,9,6,0,15,0,0,30,202001,-2,2,12,4,64,-4,1437.32610815023,1417.73556567529,2020,1,0,0,0,0,0,1915
Saints,10,7,0,7,0,0,24,Raiders,0,17,7,10,0,0,34,202002,-10,0,7,10,58,10,1622.05289565324,1455.89539133258,2020,2,0,0,0,0,0,1508
Patriots,7,7,3,13,0,0,30,Seahawks,7,7,14,7,0,0,35,202002,0,0,11,5,65,5,1590.53822932484,1577.99984361592,2020,2,0,0,0,0,0,2495
Ravens,3,17,3,10,0,0,33,Texans,0,10,0,6,0,0,16,202002,3,10,13,17,49,-17,1649.7022512196,1516.11122943531,2020,2,0,0,0,1,0,1250
Chiefs,0,6,3,11,3,0,23,Chargers,7,7,3,3,0,0,20,202002,-7,-8,-8,3,43,-3,1676.66606788782,1483.2136353193,2020,2,0,0,0,1,1,1354
Washington,0,0,3,12,0,0,15,Cardinals,14,6,0,10,0,0,30,202002,14,20,17,15,45,15,1400.24441328388,1470.85372441385,2020,2,0,0,0,1,0,1977
Panthers,0,0,7,10,0,0,17,Buccaneers,14,7,0,10,0,0,31,202002,14,21,14,14,48,14,1399.16628249294,1486.38193254475,2020,2,0,0,0,1,1,511
Broncos,0,3,11,7,0,0,21,Steelers,7,10,0,9,0,0,26,202002,7,14,3,5,47,5,1486.04942731321,1531.37752094418,2020,2,0,0,0,1,0,1317
Rams,14,7,3,13,0,0,37,Eagles,3,13,0,3,0,0,19,202002,11,5,8,18,56,-18,1558.53792493455,1496.80731899952,2020,2,0,0,0,1,0,2388
49ers,7,14,3,7,0,0,31,Jets,3,0,3,7,0,0,13,202002,4,18,18,18,44,-18,1575.58185019549,1442.76921737092,2020,2,0,0,0,0,0,2565
Vikings,3,0,0,8,0,0,11,Colts,0,15,3,10,0,0,28,202002,-3,12,15,17,39,17,1543.9203734166,1463.29013677989,2020,2,0,0,0,0,0,510
Jaguars,7,3,7,13,0,0,30,Titans,14,10,6,3,0,0,33,202002,7,14,13,3,63,3,1457.86722628058,1608.71515334757,2020,2,0,0,0,1,1,500
Lions,14,0,0,7,0,0,21,Packers,3,14,17,8,0,0,42,202002,-11,3,20,21,63,21,1391.33198675325,1609.67825945017,2020,2,0,0,0,1,1,291
Falcons,20,9,0,10,0,0,39,Cowboys,0,10,14,16,0,0,40,202002,-20,-19,-5,1,79,1,1503.41479134028,1521.81148384269,2020,2,0,0,0,1,0,719
Giants,0,0,3,10,0,0,13,Bears,10,7,0,0,0,0,17,202002,10,17,14,4,30,4,1371.39693115711,1537.80162085984,2020,2,0,0,0,1,0,711
Bengals,3,10,3,14,0,0,30,Browns,7,14,7,7,0,0,35,202002,4,8,12,5,65,5,1369.80404629252,1429.26195559423,2020,2,0,0,0,1,1,217
Bills,7,10,0,14,0,0,31,Dolphins,7,3,3,15,0,0,28,202002,0,7,4,3,59,-3,1526.64857955406,1404.91221674474,2020,2,0,0,0,1,1,1184
Jets,7,0,0,0,0,0,7,Colts,7,10,14,5,0,0,36,202003,0,10,24,29,43,29,1419.71066912447,1493.70940034952,2020,3,0,0,0,1,0,643
Packers,3,10,14,10,0,0,37,Saints,7,10,10,3,0,0,30,202003,-4,-4,0,7,67,-7,1618.64274426123,1589.80016684372,2020,3,0,0,0,1,0,1012
Cowboys,9,6,7,9,0,0,31,Seahawks,9,14,7,8,0,0,38,202003,0,8,8,7,69,7,1526.91686194339,1592.87754087819,2020,3,0,0,0,1,0,1679
Lions,3,14,3,6,0,0,26,Cardinals,7,6,10,0,0,0,23,202003,-4,4,-3,3,49,-3,1382.36750194219,1487.26423830273,2020,3,0,0,0,1,0,1687
Buccaneers,10,13,5,0,0,0,28,Broncos,0,10,0,0,0,0,10,202003,10,13,18,18,38,-18,1501.27286392735,1474.23043774932,2020,3,0,0,0,0,0,1521
Chiefs,6,21,0,7,0,0,34,Ravens,3,7,3,7,0,0,20,202003,3,17,14,14,54,-14,1685.13085320088,1672.26918221266,2020,3,0,0,0,1,0,960
Panthers,6,12,0,3,0,0,21,Chargers,0,7,3,6,0,0,16,202003,6,11,8,5,37,-5,1384.27535111034,1474.74885000624,2020,3,0,0,0,0,0,2115
Texans,7,14,0,0,0,0,21,Steelers,3,14,3,8,0,0,28,202003,-4,-4,-1,7,49,7,1493.54429844225,1543.19651050807,2020,3,0,0,0,1,0,1136
Titans,6,3,16,6,0,0,31,Vikings,7,10,7,6,0,0,30,202003,-1,-8,1,1,61,-1,1614.37079408025,1513.50110984697,2020,3,0,0,0,0,0,696
49ers,6,10,7,13,0,0,36,Giants,0,6,3,0,0,0,9,202003,6,10,14,27,45,-27,1598.64039844194,1365.3150909111,2020,3,0,0,0,1,0,2565
Raiders,3,7,0,10,0,0,20,Patriots,0,13,10,13,0,0,36,202003,-3,3,13,16,56,16,1488.1481201421,1575.66053206257,2020,3,0,0,0,1,0,2372
Washington,7,0,13,0,0,0,20,Browns,0,17,0,17,0,0,34,202003,-7,10,-3,14,54,14,1383.833899395,1440.39259598389,2020,3,0,0,0,0,0,304
Rams,0,3,14,15,0,0,32,Bills,7,14,7,7,0,0,35,202003,7,18,11,3,67,3,1588.30361483314,1537.97549722532,2020,3,0,0,0,0,0,2193
Bears,3,7,0,20,0,0,30,Falcons,6,10,10,0,0,0,26,202003,-3,-6,-16,4,56,-4,1543.88346110585,1498.30941323958,2020,3,0,0,0,1,0,587
Dolphins,14,7,7,3,0,0,31,Jaguars,0,7,0,6,0,0,13,202003,14,14,21,18,44,-18,1393.58529907348,1452.2115855479,2020,3,0,0,0,1,0,327
Bengals,0,10,7,6,0,0,23,Eagles,0,13,3,7,0,0,23,202003,0,-3,1,0,46,0,1358.67340590286,1467.04162910093,2020,3,0,0,0,0,0,497
Falcons,0,3,6,7,0,0,16,Packers,7,13,7,3,0,0,30,202004,7,17,18,14,46,14,1481.16470818185,1641.97694578513,2020,4,0,0,0,1,0,768
Eagles,8,0,3,14,0,0,25,49ers,7,0,7,6,0,0,20,202004,1,1,-3,5,45,-5,1460.0067665966,1615.67040776645,2020,4,0,0,0,1,0,2516
Bills,7,10,0,13,0,0,30,Raiders,3,10,3,7,0,0,23,202004,4,4,1,7,53,-7,1551.16540534358,1472.5896927803,2020,4,0,0,0,1,0,1970
Colts,7,6,3,3,0,0,19,Bears,0,3,0,8,0,0,11,202004,7,10,13,8,30,-8,1513.54337311887,1561.02816616358,2020,4,0,0,0,0,0,163
Giants,0,6,0,3,0,0,9,Rams,7,3,0,7,0,0,17,202004,7,4,4,8,26,8,1348.28508158659,1575.11370671488,2020,4,0,0,0,1,0,2445
Vikings,7,10,7,7,0,0,31,Texans,0,6,10,7,0,0,23,202004,7,11,8,8,54,-8,1507.38248072104,1480.07519170863,2020,4,0,0,0,0,0,1057
Cardinals,0,7,7,7,0,0,21,Panthers,14,7,7,3,0,0,31,202004,14,14,14,10,52,10,1465.42928059732,1411.6498871279,2020,4,0,0,0,1,0,1778
Patriots,0,3,0,7,0,0,10,Chiefs,6,0,7,13,0,0,26,202004,6,3,10,16,36,16,1591.21895942437,1717.00026991748,2020,4,0,0,0,1,0,1249
Chargers,14,10,7,0,0,0,31,Buccaneers,7,7,14,10,0,0,38,202004,-7,-10,-3,7,69,7,1447.37431398868,1534.4945237821,2020,4,0,0,0,0,0,2149
Seahawks,10,7,0,14,0,0,31,Dolphins,3,6,3,11,0,0,23,202004,7,8,5,8,54,-8,1605.43741664957,1435.4377157846,2020,4,0,0,0,0,0,2730
Saints,7,21,7,0,0,0,35,Lions,14,0,7,8,0,0,29,202004,-7,14,14,6,64,-6,1566.46596531982,1404.2024596476,2020,4,0,0,0,1,0,939
Browns,7,24,10,8,0,0,49,Cowboys,14,0,0,24,0,0,38,202004,-7,17,27,11,87,-11,1457.42575493683,1514.35698617201,2020,4,0,0,0,0,0,1024
Jaguars,7,6,0,12,0,0,25,Bengals,3,7,17,6,0,0,33,202004,-4,-3,14,8,58,8,1410.35916883678,1365.70826840719,2020,4,0,0,0,1,0,630
Broncos,3,14,7,13,0,0,37,Jets,7,6,3,12,0,0,28,202004,-4,4,8,9,65,-9,1441.00877789457,1399.87669635512,2020,4,0,0,0,1,0,1627
Ravens,7,14,7,3,0,0,31,Washington,0,10,0,7,0,0,17,202004,7,11,18,14,48,-14,1640.39976549606,1366.80074044206,2020,4,0,0,0,0,0,35
Bills,7,3,0,6,0,0,16,Titans,7,14,7,14,0,0,42,202005,0,11,18,26,58,26,1571.02516200851,1620.48942320618,2020,5,0,0,1,1,0,626
Chargers,6,14,0,7,0,0,27,Saints,3,7,3,14,3,0,30,202005,-3,-10,-7,3,57,3,1435.93505384011,1580.01645936101,2020,5,0,0,0,0,0,1669
Vikings,7,6,6,7,0,0,26,Seahawks,0,0,21,6,0,0,27,202005,-7,-13,2,1,53,1,1532.15355495981,1620.25709136902,2020,5,0,0,0,1,0,1391
Giants,14,6,3,11,0,0,34,Cowboys,3,21,7,6,0,0,37,202005,-11,4,8,3,71,3,1342.1895863219,1479.17876130096,2020,5,0,0,0,1,1,1370
Colts,7,3,10,3,0,0,23,Browns,3,17,7,5,0,0,32,202005,-4,10,7,9,55,9,1543.94516814976,1492.60397980788,2020,5,0,0,0,1,0,262
Dolphins,14,16,7,6,0,0,43,49ers,0,7,10,0,0,0,17,202005,14,23,20,26,60,-26,1420.61804106515,1584.57159672968,2020,5,0,0,0,0,0,2590
Jaguars,0,7,0,7,0,0,14,Texans,0,10,3,17,0,0,30,202005,0,3,6,16,44,16,1389.86194609942,1455.30411746986,2020,5,0,0,0,1,1,820
Bengals,0,0,0,3,0,0,3,Ravens,10,7,3,7,0,0,27,202005,10,17,20,24,30,24,1386.20549114455,1651.84394975688,2020,5,0,0,0,1,1,419
Eagles,7,7,8,7,0,0,29,Steelers,7,10,14,7,0,0,38,202005,0,3,9,9,67,9,1491.10557763337,1556.66561724169,2020,5,0,0,1,0,0,257
Cardinals,7,10,7,6,0,0,30,Jets,0,3,7,0,0,0,10,202005,7,14,14,20,40,-20,1442.34222141897,1375.00164241102,2020,5,0,0,0,0,0,2139
Raiders,3,21,0,16,0,0,40,Chiefs,7,17,0,8,0,0,32,202005,-4,0,0,8,72,-8,1452.72993611537,1730.03968436867,2020,5,0,0,0,1,1,1140
Panthers,3,17,0,3,0,0,23,Falcons,7,0,3,6,0,0,16,202005,-4,13,10,7,39,-7,1434.73694630625,1470.64407733118,2020,5,0,0,0,1,1,226
Buccaneers,10,3,3,3,0,0,19,Bears,0,14,0,6,0,0,20,202005,-10,1,-2,1,39,1,1545.93378393067,1530.62637113269,2020,5,0,0,0,1,0,1004
Rams,6,14,3,7,0,0,30,Washington,7,3,0,0,0,0,10,202005,-1,10,13,20,40,-20,1581.20920197957,1355.35655618124,2020,5,0,0,0,1,0,2294
Cardinals,0,21,7,10,0,0,38,Cowboys,0,3,0,7,0,0,10,202006,0,18,25,28,48,-28,1472.55020944108,1485.22691304373,2020,6,0,0,0,1,0,884
Chiefs,7,6,7,6,0,0,26,Bills,3,7,0,7,0,0,17,202006,4,3,10,9,43,-9,1684.36430620528,1549.66016847695,2020,6,0,0,0,1,0,858
Rams,0,6,3,7,0,0,16,49ers,7,14,0,3,0,0,24,202006,7,15,12,8,40,8,1597.3096070845,1526.53367561631,2020,6,0,0,0,1,1,347
Packers,10,0,0,0,0,0,10,Buccaneers,0,28,10,0,0,0,38,202006,-10,18,28,28,48,28,1652.4975766358,1540.11834917907,2020,6,0,1,0,1,0,1185
Jets,0,0,0,0,0,0,0,Dolphins,7,14,3,0,0,0,24,202006,7,21,24,24,24,24,1344.79365438891,1478.65596217852,2020,6,0,0,0,1,1,1091
Bears,7,6,7,3,0,0,23,Panthers,3,3,0,10,0,0,16,202006,4,7,14,7,39,-7,1536.44180588429,1462.68854971517,2020,6,0,0,0,1,0,586
Lions,7,10,7,10,0,0,34,Jaguars,3,0,7,6,0,0,16,202006,4,14,14,18,50,-18,1390.65196560641,1372.71070337717,2020,6,0,1,0,0,0,832
Ravens,14,3,7,6,0,0,30,Eagles,0,0,6,22,0,0,28,202006,14,17,18,2,58,-2,1659.1047150535,1477.1736944113,2020,6,0,0,0,0,0,89
Washington,0,10,0,9,0,0,19,Giants,10,3,0,7,0,0,20,202006,10,3,3,1,39,1,1339.25615107631,1336.14143457913,2020,6,0,0,0,1,1,204
Broncos,6,6,6,0,0,0,18,Patriots,0,3,0,9,0,0,12,202006,6,9,15,6,30,-6,1465.88383183867,1578.17954497318,2020,6,0,1,1,1,0,1769
Falcons,10,10,10,10,0,0,40,Vikings,0,0,7,16,0,0,23,202006,10,20,23,17,63,-17,1442.69247392226,1528.35727415949,2020,6,0,0,0,1,0,908
Bengals,14,10,3,0,0,0,27,Colts,0,21,0,10,0,0,31,202006,-14,-3,-6,4,58,4,1378.94472584793,1521.96056403671,2020,6,0,0,0,1,0,99
Texans,0,10,13,13,0,0,36,Titans,14,7,0,15,6,0,42,202006,14,11,-2,6,78,6,1472.45536019211,1641.85441673774,2020,6,0,0,0,1,1,665
Browns,0,7,0,0,0,0,7,Steelers,10,14,7,7,0,0,38,202006,10,17,24,31,45,31,1514.58858392093,1570.59750046376,2020,6,0,0,0,1,1,114
Seahawks,10,17,0,7,0,0,34,Cardinals,7,10,7,10,3,0,37,202007,-3,-10,-3,3,71,3,1624.05337216934,1515.13196753093,2020,7,0,1,0,1,1,1114
Jaguars,0,14,15,0,0,0,29,Chargers,9,7,20,3,0,0,39,202007,9,2,7,10,68,10,1338.57216644705,1430.0902579802,2020,7,0,0,1,1,0,2143
49ers,7,16,7,3,0,0,33,Patriots,0,3,3,0,0,0,6,202007,7,20,24,27,39,-27,1548.92996436037,1547.06361275549,2020,7,0,0,0,0,0,2698
Chiefs,10,14,6,13,0,0,43,Broncos,6,3,0,7,0,0,16,202007,4,15,21,27,59,-27,1702.26445864308,1496.99976405636,2020,7,0,0,0,1,1,556
Buccaneers,7,14,3,21,0,0,45,Raiders,7,3,7,3,0,0,20,202007,0,11,7,25,65,-25,1579.19656905067,1498.40531427875,2020,7,0,0,1,0,0,1985
Packers,7,14,7,7,0,0,35,Texans,0,0,7,13,0,0,20,202007,7,21,21,15,55,-15,1613.4193567642,1465.21073891014,2020,7,0,0,0,0,0,1095
Bears,0,3,0,7,0,0,10,Rams,7,3,14,0,0,0,24,202007,7,7,21,14,34,14,1556.6321075484,1574.91331834044,2020,7,0,0,0,1,0,1741
Bills,0,6,6,6,0,0,18,Jets,3,7,0,0,0,0,10,202007,-3,-4,2,8,28,-8,1531.76001603915,1330.53824400065,2020,7,0,0,0,1,1,292
Panthers,3,14,7,0,0,0,24,Saints,7,14,3,3,0,0,27,202007,4,4,0,3,51,3,1442.49824805106,1585.86125522092,2020,7,0,0,1,1,1,648
Steelers,7,17,3,0,0,0,27,Titans,0,7,10,7,0,0,24,202007,7,17,10,3,51,-3,1592.44766164432,1649.09903801971,2020,7,0,0,0,1,0,471
Browns,3,7,7,20,0,0,37,Bengals,7,10,3,14,0,0,34,202007,-4,-7,-3,3,71,-3,1492.73842274037,1372.12404420204,2020,7,0,0,0,1,1,217
Lions,7,3,3,10,0,0,23,Falcons,0,14,0,8,0,0,22,202007,7,-4,-1,1,45,-1,1424.79050253653,1486.39220835644,2020,7,0,0,0,1,0,597
Giants,7,0,7,7,0,0,21,Eagles,7,3,0,12,0,0,22,202007,0,3,-4,1,43,1,1341.69494641027,1470.12603381604,2020,7,0,0,0,1,1,80
Cowboys,3,0,0,0,0,0,3,Washington,9,13,0,3,0,0,25,202007,6,19,19,22,28,22,1442.64515495388,1333.70263924517,2020,7,0,0,0,1,1,1181
Buccaneers,3,3,9,10,0,0,25,Giants,7,7,3,6,0,0,23,202008,-4,-8,-2,2,48,-2,1610.07607135671,1338.54469006919,2020,8,0,0,0,1,0,1004
Cowboys,3,6,0,0,0,0,9,Eagles,7,0,8,8,0,0,23,202008,4,-2,6,14,32,14,1406.62611366241,1473.27629015712,2020,8,0,0,0,1,1,1297
49ers,0,7,0,20,0,0,27,Seahawks,6,7,14,10,0,0,37,202008,6,6,20,10,64,10,1589.40274157226,1608.12929477159,2020,8,0,0,0,1,1,679
Saints,3,7,6,7,3,0,26,Bears,3,10,0,10,0,0,23,202008,0,-3,3,3,49,-3,1591.72641194941,1536.67675272182,2020,8,0,0,0,1,0,832
Chargers,0,14,10,6,0,0,30,Broncos,3,0,7,21,0,0,31,202008,3,-11,-14,1,61,1,1443.02268213143,1477.67615404928,2020,8,0,0,0,1,1,830
Steelers,7,0,14,7,0,0,28,Ravens,7,10,0,7,0,0,24,202008,0,-10,4,4,52,-4,1612.05997559806,1666.15237564876,2020,8,0,0,1,1,1,196
Rams,7,3,0,7,0,0,17,Dolphins,7,21,0,0,0,0,28,202008,0,18,18,11,45,11,1594.86867316702,1492.91137256678,2020,8,0,0,1,0,0,2335
Jets,3,6,0,0,0,0,9,Chiefs,14,7,7,7,0,0,35,202008,11,12,19,26,44,26,1317.56804504341,1721.58806865016,2020,8,0,0,0,1,0,1093
Colts,0,20,0,21,0,0,41,Lions,7,0,7,7,0,0,21,202008,-7,13,6,20,62,-20,1528.7812456826,1434.71254802019,2020,8,0,1,0,0,0,240
Raiders,0,6,0,10,0,0,16,Browns,0,3,3,0,0,0,6,202008,0,3,0,10,22,-10,1467.52581197271,1504.11351694164,2020,8,0,0,0,1,0,1825
Titans,0,7,0,13,0,0,20,Bengals,3,14,0,14,0,0,31,202008,3,10,10,11,51,11,1629.48672406597,1360.74895000077,2020,8,0,0,0,1,0,243
Patriots,0,6,8,7,0,0,21,Bills,7,0,7,10,0,0,24,202008,7,1,0,3,45,3,1506.5908355436,1544.73021499639,2020,8,0,0,0,1,1,404
Falcons,6,10,3,6,0,0,25,Panthers,7,7,3,0,0,0,17,202008,-1,2,2,8,42,-8,1476.47016287278,1436.63309132257,2020,8,0,0,0,1,1,226
Vikings,7,7,14,0,0,0,28,Packers,7,7,0,8,0,0,22,202008,0,0,14,6,50,-6,1484.65753972531,1633.85621251549,2020,8,0,1,0,1,1,259
Texans,10,10,7,0,0,0,27,Jaguars,7,9,3,6,0,0,25,202009,3,4,8,2,52,-2,1444.77388315885,1325.63974229582,2020,9,0,1,1,1,1,820
Patriots,7,3,7,13,0,0,30,Jets,3,17,7,0,0,0,27,202009,4,-10,-10,3,57,-3,1497.16820497424,1314.1461585763,2020,9,0,0,0,1,1,181
Saints,14,17,0,7,0,0,38,Buccaneers,0,0,0,3,0,0,3,202009,14,31,31,35,41,-35,1606.05106190165,1614.76542942648,2020,9,0,0,0,1,1,480
Dolphins,14,10,0,10,0,0,34,Cardinals,7,10,14,0,0,0,31,202009,7,7,-7,3,65,-3,1520.8633093731,1531.05604492868,2020,9,0,0,1,0,0,1978
Steelers,0,9,0,15,0,0,24,Cowboys,3,10,6,0,0,0,19,202009,-3,-4,-10,5,43,-5,1634.68975897068,1390.31836659134,2020,9,0,0,0,0,0,1069
Raiders,7,7,14,3,0,0,31,Chargers,0,17,3,6,0,0,26,202009,7,-3,8,5,57,-5,1499.81377495712,1438.24305386408,2020,9,0,0,0,1,1,228
Giants,10,10,3,0,0,0,23,Washington,0,3,7,10,0,0,20,202009,10,17,13,3,43,-3,1333.85533199942,1369.72168053664,2020,9,0,0,1,1,1,204
Lions,0,10,0,10,0,0,20,Vikings,13,7,7,7,0,0,34,202009,13,10,17,14,54,14,1407.17252758018,1518.04441491758,2020,9,0,0,0,1,1,542
Panthers,7,10,0,14,0,0,31,Chiefs,3,10,7,13,0,0,33,202009,-4,-4,3,2,64,2,1412.79968893975,1725.00995511727,2020,9,0,0,0,0,0,801
Ravens,7,0,7,10,0,0,24,Colts,7,3,0,0,0,0,10,202009,0,-3,4,14,34,-14,1643.52259227614,1556.32126612261,2020,9,0,0,0,1,0,509
Bears,0,0,0,17,0,0,17,Titans,3,7,7,7,0,0,24,202009,3,10,17,7,41,7,1522.35210276958,1587.66125061666,2020,9,0,0,0,0,0,395
Seahawks,0,10,10,14,0,0,34,Bills,14,10,3,17,0,0,44,202009,14,14,7,10,78,10,1625.76774006447,1554.15284556575,2020,9,0,0,0,0,0,2110
Broncos,0,3,3,21,0,0,27,Falcons,10,10,7,7,0,0,34,202009,10,17,21,7,61,7,1482.45578231663,1500.3035652556,2020,9,0,0,0,0,0,1209
Packers,7,14,10,3,0,0,34,49ers,3,0,0,14,0,0,17,202009,4,18,28,17,51,-17,1600.46933732322,1571.76429627938,2020,9,0,0,0,1,0,1834
Vikings,7,0,6,6,0,0,19,Bears,3,3,7,0,0,0,13,202010,4,1,0,6,32,-6,1531.41038821575,1509.75665172967,2020,10,0,0,0,1,1,355
Ravens,0,10,7,0,0,0,17,Patriots,0,13,10,0,0,0,23,202010,0,3,6,6,40,6,1668.62169876935,1506.02024608328,2020,10,0,0,0,1,0,350
Bengals,0,7,0,3,0,0,10,Steelers,12,10,7,7,0,0,36,202010,12,15,22,26,46,26,1402.57442345008,1643.39037637379,2020,10,0,1,0,1,1,252
49ers,7,3,0,3,0,0,13,Saints,0,17,0,10,0,0,27,202010,-7,7,7,14,40,14,1539.31676960145,1650.87926788489,2020,10,0,0,0,1,0,1921
Seahawks,7,6,0,3,0,0,16,Rams,10,7,6,0,0,0,23,202010,3,4,10,7,39,7,1601.25860916653,1566.9167363607,2020,10,0,0,1,1,1,960
Bills,7,9,7,7,0,0,30,Cardinals,3,6,17,6,0,0,32,202010,-4,-7,3,2,62,2,1578.66197646369,1513.64370732358,2020,10,0,0,0,0,0,1902
Chargers,0,7,7,7,0,0,21,Dolphins,14,3,3,9,0,0,29,202010,14,10,6,8,50,8,1420.12036465032,1538.2756469782,2020,10,0,0,0,1,0,2335
Buccaneers,7,10,12,17,0,0,46,Panthers,14,3,0,6,0,0,23,202010,-7,0,12,23,69,-23,1569.93722344324,1410.88000686733,2020,10,0,0,0,1,1,511
Eagles,3,0,14,0,0,0,17,Giants,7,7,7,6,0,0,27,202010,4,11,4,10,44,10,1489.58403722819,1352.48780288035,2020,10,0,1,0,1,1,80
Jaguars,3,7,7,3,0,0,20,Packers,0,17,0,7,0,0,24,202010,-3,7,0,4,44,4,1316.57471276122,1632.91686400115,2020,10,0,0,0,0,0,1039
Washington,3,0,7,17,0,0,27,Lions,7,10,7,6,0,0,30,202010,4,14,14,3,57,3,1351.08920965571,1393.80655428201,2020,10,0,0,0,1,0,394
Texans,0,0,0,7,0,0,7,Browns,3,0,0,7,0,0,10,202010,3,3,3,3,17,3,1453.83891269345,1471.82555395723,2020,10,0,0,1,1,0,1113
Colts,3,10,14,7,0,0,34,Titans,7,10,0,0,0,0,17,202010,-4,-4,10,17,51,-17,1531.2221596294,1600.25670165657,2020,10,0,0,0,1,1,251
Broncos,3,3,0,6,0,0,12,Raiders,7,3,10,17,0,0,37,202010,4,4,14,25,49,25,1467.10604989893,1517.93646417088,2020,10,0,0,0,1,1,604
Dolphins,7,3,0,3,0,0,13,Broncos,7,6,7,0,0,0,20,202011,0,3,10,7,33,7,1548.7580086419,1446.10742152511,2020,11,0,0,0,1,0,1724
Rams,7,10,7,3,0,0,27,Buccaneers,0,14,3,7,0,0,24,202011,7,3,7,3,51,-3,1585.62033153479,1592.35974491252,2020,11,0,0,0,1,0,2149
Chiefs,7,7,7,14,0,0,35,Raiders,14,3,0,14,0,0,31,202011,-7,-3,4,4,66,-4,1726.92963718969,1538.9350925447,2020,11,0,1,0,1,1,1140
Cowboys,6,10,0,15,0,0,31,Vikings,7,0,7,14,0,0,28,202011,-1,9,2,3,59,-3,1381.61774918823,1553.72434886032,2020,11,0,1,0,1,0,863
Packers,7,21,0,3,0,0,31,Colts,7,7,11,6,3,0,34,202011,0,-14,-3,3,65,3,1635.66526227718,1573.31905669935,2020,11,0,0,0,0,0,341
Jets,6,0,13,9,0,0,28,Chargers,7,17,7,3,0,0,34,202011,1,18,12,6,62,6,1305.29411746726,1409.63800298662,2020,11,0,1,0,1,0,2445
Patriots,7,3,7,3,0,0,20,Texans,7,14,3,3,0,0,27,202011,0,11,7,7,47,7,1531.95706079262,1443.61142640094,2020,11,0,0,0,1,0,1597
Cardinals,0,7,7,7,0,0,21,Seahawks,7,9,7,5,0,0,28,202011,7,9,9,7,49,7,1524.63049912751,1582.55501399244,2020,11,0,0,0,1,1,1114
Steelers,0,17,0,10,0,0,27,Jaguars,3,0,0,0,0,0,3,202011,-3,14,14,24,30,-24,1651.88241082075,1313.82631448519,2020,11,0,0,0,1,0,704
Lions,0,0,0,0,0,0,0,Panthers,7,0,10,3,0,0,20,202011,7,7,17,20,20,20,1403.05145557826,1388.45748539805,2020,11,0,0,0,1,0,504
Bengals,0,9,0,0,0,0,9,Washington,7,0,10,3,0,0,20,202011,7,-2,8,11,29,11,1394.08238900312,1341.84430835946,2020,11,0,0,0,0,0,398
Falcons,3,6,0,0,0,0,9,Saints,3,7,7,7,0,0,24,202011,0,1,8,15,33,15,1515.6532976733,1664.20242986275,2020,11,0,1,0,1,1,424
Eagles,0,0,7,10,0,0,17,Browns,0,7,5,10,0,0,22,202011,0,7,5,5,39,5,1459.72078297441,1482.05304024974,2020,11,0,0,0,0,0,358
Titans,7,3,3,11,6,0,30,Ravens,3,11,7,3,0,0,24,202011,4,-4,-8,6,54,-6,1558.15980458662,1642.68488406001,2020,11,0,0,0,1,0,595
Browns,7,10,3,7,0,0,27,Jaguars,3,10,6,6,0,0,25,202012,4,4,1,2,52,-2,1495.04366005076,1303.9785688752,2020,12,0,0,0,1,0,771
Seahawks,0,14,3,6,0,0,23,Eagles,0,6,3,8,0,0,17,202012,0,8,8,6,40,-6,1595.55807004435,1446.73016317339,2020,12,0,0,0,1,0,2373
Bears,3,7,0,15,0,0,25,Packers,6,21,14,0,0,0,41,202012,3,17,31,16,66,16,1487.4426910851,1621.92477975327,2020,12,0,1,0,1,1,185
Chiefs,17,3,7,0,0,0,27,Buccaneers,0,7,3,14,0,0,24,202012,17,13,17,3,51,-3,1736.99067007097,1575.11191102722,2020,12,0,0,0,0,0,1037
49ers,7,0,10,6,0,0,23,Rams,3,0,10,7,0,0,20,202012,4,4,4,3,43,-3,1525.99360762359,1602.86816542009,2020,12,0,1,0,1,1,347
Saints,0,17,7,7,0,0,31,Broncos,0,0,3,0,0,0,3,202012,0,17,21,28,34,-28,1675.64117301904,1469.54764134666,2020,12,0,0,0,0,0,1079
Dolphins,3,10,0,7,0,0,20,Jets,3,0,0,0,0,0,3,202012,0,10,10,17,23,-17,1525.31778882035,1295.39556150436,2020,12,0,0,0,1,1,1091
Ravens,7,0,0,7,0,0,14,Steelers,6,6,0,7,0,0,19,202012,-1,5,5,5,33,5,1613.33802728813,1661.73015643074,2020,12,0,0,0,1,1,196
Panthers,0,7,14,6,0,0,27,Vikings,7,3,0,18,0,0,28,202012,7,3,-11,1,55,1,1413.93275627979,1528.97141228391,2020,12,0,0,0,1,0,938
Titans,14,21,3,7,0,0,45,Colts,7,7,0,12,0,0,26,202012,7,21,24,19,71,-19,1587.5066613585,1587.05953922326,2020,12,0,0,0,1,1,251
Giants,7,3,3,6,0,0,19,Bengals,7,3,0,7,0,0,17,202012,0,0,3,2,36,-2,1382.35105713413,1370.28371515899,2020,12,0,1,0,0,0,563
Chargers,6,0,8,3,0,0,17,Bills,7,10,7,3,0,0,27,202012,1,11,10,10,44,10,1419.53655894952,1567.67518465976,2020,12,0,0,1,1,0,2193
Raiders,0,3,3,0,0,0,6,Falcons,6,10,14,13,0,0,43,202012,6,13,24,37,49,37,1528.87405966342,1504.21455451701,2020,12,0,0,0,0,0,1741
Washington,7,10,3,21,0,0,41,Cowboys,3,10,3,0,0,0,16,202012,4,4,4,25,57,-25,1365.64298220359,1406.37068576464,2020,12,0,0,0,1,1,1181
Texans,13,10,3,15,0,0,41,Lions,7,7,3,8,0,0,25,202012,6,9,9,16,66,-16,1466.03899910247,1377.57618469652,2020,12,0,0,0,0,0,1105
Cardinals,10,0,0,7,0,0,17,Patriots,0,7,10,3,0,0,20,202012,-10,-3,7,3,37,3,1511.6274430756,1509.52948809109,2020,12,0,0,0,0,0,2296
Bills,0,17,10,7,0,0,34,49ers,7,0,10,7,0,0,24,202013,-7,10,10,10,58,-10,1577.58785684161,1546.54798548211,2020,13,0,0,0,0,0,2294
Washington,0,3,7,13,0,0,23,Steelers,0,14,0,3,0,0,17,202013,0,-11,-4,6,40,-6,1409.9739634173,1673.3977827343,2020,13,0,0,0,0,0,190
Broncos,3,7,6,0,0,0,16,Chiefs,3,6,10,3,0,0,22,202013,0,-1,3,6,38,6,1450.09179751675,1746.65946740744,2020,13,0,0,0,1,1,556
Patriots,7,21,7,10,0,0,45,Chargers,0,0,0,0,0,0,0,202013,7,28,35,45,45,-45,1520.59332450679,1409.62388676767,2020,13,0,0,0,1,0,2594
Eagles,3,0,0,13,0,0,16,Packers,0,14,6,10,0,0,30,202013,-3,11,17,14,46,14,1432.42222886895,1634.43505157155,2020,13,0,0,0,1,0,728
Giants,0,0,14,3,0,0,17,Seahawks,3,2,0,7,0,0,12,202013,-3,-5,9,5,29,-5,1395.30990544478,1609.86600434879,2020,13,0,0,0,1,0,2401
Rams,0,14,3,21,0,0,38,Cardinals,7,0,7,14,0,0,28,202013,-7,7,3,10,66,-10,1582.31378756157,1500.5636066599,2020,13,0,0,0,1,1,356
Cowboys,3,7,0,7,0,0,17,Ravens,7,10,7,10,0,0,34,202013,4,7,14,17,51,17,1362.03970455093,1601.67040098457,2020,13,0,0,0,0,0,1210
Raiders,7,10,7,7,0,0,31,Jets,7,6,0,15,0,0,28,202013,0,4,11,3,59,-3,1497.28218227971,1280.39138715294,2020,13,0,0,0,1,0,2227
Jaguars,9,0,7,8,0,0,24,Vikings,0,6,13,5,3,0,27,202013,-9,-3,3,3,51,3,1297.20088552531,1532.3268046627,2020,13,0,0,0,0,0,1192
Bengals,7,0,0,0,0,0,7,Dolphins,0,6,10,3,0,0,19,202013,-7,-1,9,12,26,12,1357.32486684834,1540.32196317177,2020,13,0,0,0,1,0,957
Browns,10,28,3,0,0,0,41,Titans,0,7,14,14,0,0,35,202013,10,31,20,6,76,-6,1501.82134340065,1624.03875510107,2020,13,0,0,0,1,0,458
Lions,6,7,7,14,0,0,34,Bears,9,14,0,7,0,0,30,202013,-3,-10,-3,4,64,-4,1351.43326887422,1474.93241926682,2020,13,0,0,0,1,1,238
Saints,7,7,7,0,0,0,21,Falcons,3,6,0,7,0,0,16,202013,4,5,12,5,37,-5,1695.09701684895,1535.80643190072,2020,13,0,0,0,1,1,424
Colts,14,10,0,2,0,0,26,Texans,10,10,0,0,0,0,20,202013,4,4,4,6,46,-6,1550.52744548069,1492.18191492477,2020,13,0,0,0,1,1,865
Ravens,7,14,13,13,0,0,47,Browns,7,7,6,22,0,0,42,202014,0,7,14,5,89,-5,1609.16472186214,1533.55737167105,2020,14,0,0,0,1,1,307
Steelers,0,7,0,8,0,0,15,Bills,0,9,14,3,0,0,26,202014,0,2,16,11,41,11,1633.65141792392,1604.31578245364,2020,14,0,0,0,1,0,178
Washington,0,13,10,0,0,0,23,49ers,7,0,0,8,0,0,15,202014,-7,6,16,8,38,-8,1449.72032822768,1519.82005987008,2020,14,0,0,0,1,0,2435
Falcons,7,10,0,0,0,0,17,Chargers,7,3,7,3,0,0,20,202014,0,-7,0,3,37,3,1523.17682504454,1377.05436607889,2020,14,0,0,0,0,0,1932
Saints,0,0,14,7,0,0,21,Eagles,0,17,0,7,0,0,24,202014,0,17,3,3,45,3,1707.72662370513,1423.87501780442,2020,14,0,0,0,1,0,1088
Packers,7,7,7,10,0,0,31,Lions,7,7,0,10,0,0,24,202014,0,0,7,7,55,-7,1642.98226263608,1377.74758809772,2020,14,0,0,0,1,1,291
Jets,3,0,0,0,0,0,3,Seahawks,7,16,14,3,0,0,40,202014,4,20,34,37,43,37,1272.75735765017,1575.65733198366,2020,14,0,0,0,0,0,2401
Colts,10,10,7,17,0,0,44,Raiders,7,7,6,7,0,0,27,202014,3,6,7,17,71,-17,1570.41937185275,1504.91621178248,2020,14,0,0,0,1,0,1590
Titans,7,10,14,0,0,0,31,Jaguars,0,3,7,0,0,0,10,202014,7,14,21,21,41,-21,1592.30272683067,1293.5196202553,2020,14,0,0,0,1,1,500
Vikings,0,6,8,0,0,0,14,Buccaneers,0,17,6,3,0,0,26,202014,0,11,9,12,40,12,1536.00806993271,1565.44311369075,2020,14,0,0,1,1,0,1318
Cardinals,3,10,7,6,0,0,26,Giants,0,0,7,0,0,0,7,202014,3,13,13,19,33,-19,1477.91226682583,1429.51857780991,2020,14,0,0,0,1,0,2139
Chiefs,0,14,16,3,0,0,33,Dolphins,7,3,0,17,0,0,27,202014,-7,4,20,6,60,-6,1750.36704273151,1549.24156812413,2020,14,0,0,0,1,0,1242
Cowboys,10,7,3,10,0,0,30,Bengals,0,7,0,0,0,0,7,202014,10,10,13,23,37,-23,1354.54538367336,1348.40526189598,2020,14,0,0,0,0,0,817
Texans,0,7,0,0,0,0,7,Bears,7,23,3,3,0,0,36,202014,7,23,26,29,43,29,1472.28998855271,1448.61810004332,2020,14,0,0,0,0,0,939
Patriots,0,3,0,0,0,0,3,Rams,10,7,7,0,0,0,24,202014,10,14,21,21,27,21,1553.16284519557,1604.96512739564,2020,14,0,0,0,0,0,2594
Broncos,6,7,12,7,0,0,32,Panthers,0,7,3,17,0,0,27,202014,6,6,15,5,59,-5,1446.38422219268,1410.577363901,2020,14,0,0,1,0,0,1355
Seahawks,3,10,7,0,0,0,20,Washington,0,3,0,12,0,0,15,202015,3,10,17,5,35,-5,1582.35009213886,1481.80036923107,2020,15,0,0,0,1,0,2322
Browns,0,13,0,7,0,0,20,Giants,3,0,0,3,0,0,6,202015,-3,10,10,14,26,-14,1516.26999006013,1397.89175062986,2020,15,0,0,0,0,0,403
Chiefs,7,7,7,11,0,0,32,Saints,0,9,6,14,0,0,29,202015,7,5,6,3,61,-3,1761.85858050146,1683.74243620582,2020,15,0,0,0,0,0,681
Eagles,0,20,6,0,0,0,26,Cardinals,16,10,0,7,0,0,33,202015,16,6,0,7,59,7,1447.85920530373,1509.53909400588,2020,15,0,0,0,1,0,2078
Jets,7,6,10,0,0,0,23,Rams,0,3,7,10,0,0,20,202015,7,10,13,3,43,-3,1266.06459749497,1624.80517590121,2020,15,0,0,0,0,0,2445
Steelers,0,0,10,7,0,0,17,Bengals,3,14,0,10,0,0,27,202015,3,17,7,10,44,10,1611.70004905417,1310.27137891702,2020,15,0,0,0,1,1,252
Bears,10,10,7,6,0,0,33,Vikings,7,3,10,7,0,0,27,202015,3,10,7,6,60,-6,1478.05036082739,1517.93911110311,2020,15,0,0,0,1,1,355
Jaguars,0,0,7,7,0,0,14,Ravens,9,17,7,7,0,0,40,202015,9,26,26,26,54,26,1281.97631946658,1626.45210347306,2020,15,0,0,0,1,0,681
Texans,0,10,3,7,0,0,20,Colts,14,0,3,10,0,0,27,202015,14,4,4,7,47,7,1442.85772776864,1599.27463131537,2020,15,0,0,0,1,1,865
Lions,7,8,3,7,0,0,25,Titans,14,10,0,22,0,0,46,202015,7,9,6,21,71,21,1368.59868909522,1603.84602761939,2020,15,0,0,0,0,0,470
49ers,7,7,10,9,0,0,33,Cowboys,14,3,7,17,0,0,41,202015,7,3,0,8,74,8,1487.74001886669,1392.67926665232,2020,15,0,0,0,1,0,1480
Buccaneers,0,0,21,10,0,0,31,Falcons,7,10,7,3,0,0,27,202015,-7,-17,-3,4,58,-4,1583.51207252035,1505.48212852654,2020,15,0,0,0,1,1,416
Panthers,3,0,7,6,0,0,16,Packers,7,14,0,3,0,0,24,202015,4,18,11,8,40,8,1390.8966275787,1652.13116163858,2020,15,0,0,0,1,0,745
Bills,7,14,17,10,0,0,48,Broncos,0,13,0,6,0,0,19,202015,7,8,25,29,67,-29,1626.26715132339,1466.06495851498,2020,15,0,0,0,1,0,1366
Chargers,7,10,7,0,6,0,30,Raiders,3,7,7,7,3,0,27,202015,4,7,7,3,57,-3,1394.74906259689,1476.06095231986,2020,15,0,0,0,1,1,228
Patriots,0,6,3,3,0,0,12,Dolphins,0,0,7,15,0,0,22,202015,0,-6,-2,10,34,10,1533.32279669,1537.75003035418,2020,15,0,0,0,1,1,1241
Bills,3,21,7,7,0,0,38,Patriots,3,6,0,0,0,0,9,202016,0,15,22,29,47,-29,1650.15222891808,1514.66163128522,2020,16,0,0,0,1,1,404
Titans,0,7,7,0,0,0,14,Packers,6,13,14,7,0,0,40,202016,6,12,19,26,54,26,1612.04893437714,1657.20661291685,2020,16,0,0,0,0,0,580
Rams,3,3,0,3,0,0,9,Seahawks,0,6,7,7,0,0,20,202016,-3,0,7,11,29,11,1593.22011630069,1598.18485068453,2020,16,0,0,0,1,1,960
Eagles,14,3,0,0,0,0,17,Cowboys,3,17,10,7,0,0,37,202016,-11,3,13,20,54,20,1435.0644362303,1416.87851906178,2020,16,0,0,0,1,1,1297
Panthers,6,14,0,0,0,0,20,Washington,0,3,3,7,0,0,13,202016,6,17,14,7,33,-7,1385.82117630043,1465.9656106854,2020,16,0,0,0,1,0,329
Broncos,0,0,3,13,0,0,16,Chargers,3,10,0,6,0,0,19,202016,3,13,10,3,35,3,1442.17988092029,1415.50830013188,2020,16,0,0,0,1,1,830
Bengals,7,3,14,13,0,0,37,Texans,3,7,14,7,0,0,31,202016,4,0,0,6,68,-6,1353.03812175564,1434.60246909964,2020,16,0,0,0,1,0,897
Giants,0,3,3,7,0,0,13,Ravens,14,6,0,7,0,0,27,202016,14,17,14,14,40,14,1375.48303023851,1631.25921221411,2020,16,0,0,0,0,0,169
Bears,7,6,21,7,0,0,41,Jaguars,3,7,0,7,0,0,17,202016,4,3,24,24,58,-24,1504.47152909036,1277.16921072553,2020,16,0,0,0,0,0,862
Colts,7,14,3,0,0,0,24,Steelers,0,7,7,14,0,0,28,202016,-7,-14,-10,4,52,4,1607.52988998437,1568.93330621555,2020,16,0,0,0,1,0,328
Browns,3,0,7,6,0,0,16,Jets,7,6,7,3,0,0,23,202016,4,10,10,7,39,7,1538.67871045148,1297.64965709549,2020,16,0,0,0,1,0,403
Falcons,0,7,0,7,0,0,14,Chiefs,0,7,0,10,0,0,17,202016,0,0,0,3,31,3,1490.08226598845,1775.11936919232,2020,16,0,0,0,0,0,675
Dolphins,3,3,7,13,0,0,26,Raiders,7,6,3,9,0,0,25,202016,-4,-7,-3,1,51,-1,1556.41119575896,1455.30171478487,2020,16,0,0,0,1,0,2177
49ers,7,0,7,6,0,0,20,Cardinals,3,3,0,6,0,0,12,202016,4,1,8,8,32,-8,1463.54076645723,1522.33386307931,2020,16,0,0,0,1,1,652
Buccaneers,13,21,13,0,0,0,47,Lions,0,0,7,0,0,0,7,202016,13,34,40,40,54,-40,1598.91193505844,1360.39578233747,2020,16,0,0,0,1,0,994
Vikings,7,7,13,6,0,0,33,Saints,14,10,7,21,0,0,52,202016,7,10,4,19,85,19,1491.51794284014,1670.48164751496,2020,16,0,0,0,1,0,1052
Titans,3,14,14,10,0,0,41,Texans,3,6,19,10,0,0,38,202017,0,8,3,3,79,-3,1590.29304640072,1405.44686574304,2020,17,0,0,0,1,1,665
Saints,7,9,10,7,0,0,33,Panthers,7,0,0,0,0,0,7,202017,0,9,19,26,40,-26,1681.11328583838,1416.87929062627,2020,17,0,0,0,1,1,648
Washington,10,7,0,3,0,0,20,Eagles,0,14,0,0,0,0,14,202017,10,3,3,6,34,-6,1434.90749635956,1409.2461977312,2020,17,0,0,0,1,1,123
Seahawks,3,3,0,20,0,0,26,49ers,0,3,6,14,0,0,23,202017,3,3,-3,3,49,-3,1617.48278862223,1494.78461881759,2020,17,0,0,0,1,1,679
Cardinals,7,0,0,0,0,0,7,Rams,0,12,3,3,0,0,18,202017,-7,5,8,11,25,11,1491.09001071895,1573.92217836299,2020,17,0,0,0,1,1,356
Chargers,7,17,7,7,0,0,38,Chiefs,7,7,0,7,0,0,21,202017,0,10,17,17,59,-17,1427.6367821788,1777.93330974638,2020,17,0,0,0,1,1,1354
Jaguars,0,7,7,0,0,0,14,Colts,10,10,0,8,0,0,28,202017,10,13,6,14,42,14,1260.25871425225,1592.83264607935,2020,17,0,0,0,1,1,699
Raiders,3,14,0,15,0,0,32,Broncos,10,0,6,15,0,0,31,202017,-7,7,1,1,63,-1,1449.188398447,1430.05139887337,2020,17,0,0,0,1,1,604
Steelers,0,6,3,13,0,0,22,Browns,7,3,7,7,0,0,24,202017,7,4,8,2,46,2,1583.63055012057,1505.51266143431,2020,17,0,0,0,1,1,114
Falcons,3,7,10,7,0,0,27,Buccaneers,10,13,0,21,0,0,44,202017,7,13,3,17,71,17,1487.26832543439,1617.44206676853,2020,17,0,0,0,1,1,416
Cowboys,3,6,7,3,0,0,19,Giants,6,14,0,3,0,0,23,202017,3,11,4,4,42,4,1442.69675756088,1369.04122533144,2020,17,0,0,0,1,1,1370
Jets,0,7,7,0,0,0,14,Patriots,7,0,7,14,0,0,28,202017,7,0,0,14,42,14,1330.81570611266,1488.3017378602,2020,17,0,0,0,1,1,181
Vikings,7,14,10,6,0,0,37,Lions,6,10,13,6,0,0,35,202017,1,5,2,2,72,-2,1480.88630451672,1341.86565062738,2020,17,0,0,0,1,1,542
Ravens,10,7,21,0,0,0,38,Bengals,0,3,0,0,0,0,3,202017,10,14,35,35,41,-35,1637.70101712118,1382.19372511224,2020,17,0,0,0,1,1,419
Dolphins,3,3,7,13,0,0,26,Bills,0,28,7,21,0,0,56,202017,-3,22,22,30,82,30,1562.52451209683,1676.5121223431,2020,17,0,0,0,1,1,1184
Packers,0,21,0,14,0,0,35,Bears,7,6,3,0,0,0,16,202017,-7,8,5,19,51,-19,1678.96250089327,1521.38202556364,2020,17,0,0,0,1,1,185
Browns,28,7,0,13,0,0,48,Steelers,0,10,13,14,0,0,37,202018,28,25,12,11,85,-11,1516.98176947052,1572.16144208436,2020,18,1,0,0,1,1,114
Bears,0,3,0,6,0,0,9,Saints,7,0,7,7,0,0,21,202018,7,4,11,12,30,12,1500.11846470766,1695.68359887576,2020,18,1,0,0,1,0,832
Ravens,0,10,7,3,0,0,20,Titans,10,0,0,3,0,0,13,202018,-10,0,7,7,33,-7,1654.21500371709,1599.07659899522,2020,18,1,0,0,1,0,595
Buccaneers,9,9,0,13,0,0,31,Washington,0,7,9,7,0,0,23,202018,9,11,2,8,54,-8,1630.46996656274,1456.9547361768,2020,18,1,0,0,1,0,818
Colts,3,7,0,14,0,0,24,Bills,7,7,3,10,0,0,27,202018,4,4,7,3,51,3,1597.05601541947,1693.21711914965,2020,18,1,0,0,1,0,434
Rams,3,17,0,10,0,0,30,Seahawks,0,10,3,7,0,0,20,202018,3,10,7,10,50,-10,1587.85675555671,1628.7684810046,2020,18,1,0,0,1,1,960
Rams,3,7,8,0,0,0,18,Packers,3,16,6,7,0,0,32,202019,0,9,7,14,50,14,1620.49853499295,1700.22606174924,2020,19,1,0,1,1,0,1757
Ravens,0,3,0,0,0,0,3,Bills,3,0,14,0,0,0,17,202019,3,0,14,14,20,14,1675.6957768823,1700.53800894625,2020,19,1,0,0,1,0,275
Browns,3,0,7,7,0,0,17,Chiefs,6,13,3,0,0,0,22,202019,3,16,12,5,39,5,1552.012725206,1712.65208960953,2020,19,1,0,1,1,0,698
Buccaneers,0,13,7,10,0,0,30,Saints,6,7,7,0,0,0,20,202019,-6,0,0,10,50,-10,1645.07400833565,1704.05129354753,2020,19,1,0,0,1,1,480
Bills,9,3,3,9,0,0,24,Chiefs,0,21,10,7,0,0,38,202020,-9,9,16,14,62,14,1719.97414925088,1719.6189211602,2020,20,1,0,0,1,0,858
Buccaneers,7,14,7,3,0,0,31,Packers,0,10,13,3,0,0,26,202020,7,11,5,5,57,-5,1679.18625484534,1715.62318735277,2020,20,1,0,0,1,0,1185
Chiefs,3,3,3,0,0,0,9,Buccaneers,7,14,10,0,0,0,31,202022,4,15,22,22,40,22,1741.08727932497,1703.30329600465,2020,22,1,1,1,0,0,1037
