Vikings,0,9,0,0,9,Saints,7,0,7,0,14,201001
Dolphins,3,7,0,5,15,Bills,0,3,0,7,10,201001
Lions,7,7,0,0,14,Bears,3,10,0,6,19,201001
Raiders,3,3,0,7,13,Titans,10,14,7,7,38,201001
Bengals,0,3,14,7,24,Patriots,10,14,7,7,38,201001
Panthers,3,13,0,2,18,Giants,7,7,10,7,31,201001
Falcons,0,3,3,3,0,9,Steelers,3,0,3,3,6,15,201001
Browns,7,7,0,0,14,Buccaneers,3,7,0,7,17,201001
Broncos,0,7,7,3,17,Jaguars,0,7,10,7,24,201001
Colts,0,10,0,14,24,Texans,6,7,7,14,34,201001
Cardinals,0,10,0,7,17,Rams,0,10,3,0,13,201001
Packers,0,13,14,0,27,Eagles,3,0,7,10,20,201001
49ers,3,3,0,0,6,Seahawks,0,14,14,3,31,201001
Cowboys,0,0,7,0,7,Redskins,3,7,0,3,13,201001
Ravens,0,7,3,0,10,Jets,3,3,0,3,9,201001
Chargers,7,0,7,0,14,Chiefs,7,14,0,0,21,201001
Cardinals,0,7,0,0,7,Falcons,7,17,10,7,41,201002
Ravens,0,0,7,3,10,Bengals,0,6,3,6,15,201002
Chiefs,3,7,3,3,16,Browns,0,14,0,0,14,201002
Bears,10,10,0,7,27,Cowboys,7,7,3,3,20,201002
Eagles,7,14,7,7,35,Lions,7,10,0,15,32,201002
Bills,0,7,0,0,7,Packers,13,0,14,7,34,201002
Steelers,7,6,0,6,19,Titans,3,0,0,8,11,201002
Dolphins,7,0,7,0,14,Vikings,0,0,7,3,10,201002
Buccaneers,7,7,3,3,20,Panthers,0,7,0,0,7,201002
Seahawks,0,0,7,7,14,Broncos,7,10,7,7,31,201002
Rams,0,7,0,7,14,Raiders,0,3,10,3,16,201002
Patriots,0,14,0,0,14,Jets,0,10,11,7,28,201002
Jaguars,3,3,0,7,13,Chargers,7,14,3,14,38,201002
Texans,0,7,10,10,3,30,Redskins,6,14,7,0,0,27,201002
Giants,0,0,7,7,14,Colts,7,17,7,7,38,201002
Saints,9,0,7,9,25,49ers,0,7,7,8,22,201002
49ers,0,3,0,7,10,Chiefs,0,10,14,7,31,201003
Lions,7,3,0,0,10,Vikings,7,7,10,0,24,201003
Bills,3,13,7,7,30,Patriots,7,10,14,7,38,201003
Falcons,7,7,3,7,3,27,Saints,14,0,7,3,0,24,201003
Titans,3,7,9,10,29,Giants,0,10,0,0,10,201003
Steelers,7,21,3,7,38,Buccaneers,3,3,0,7,13,201003
Bengals,7,3,0,10,20,Panthers,0,0,7,0,7,201003
Browns,3,7,0,7,17,Ravens,7,7,0,10,24,201003
Cowboys,0,10,7,10,27,Texans,0,3,0,10,13,201003
Redskins,0,13,3,0,16,Rams,14,0,7,9,30,201003
Eagles,7,7,14,0,28,Jaguars,0,3,0,0,3,201003
Colts,6,7,7,7,27,Broncos,0,3,10,0,13,201003
Raiders,13,7,0,3,23,Cardinals,10,7,7,0,24,201003
Chargers,0,0,12,8,20,Seahawks,0,10,7,10,27,201003
Jets,7,7,7,10,31,Dolphins,0,10,10,3,23,201003
Packers,7,3,0,7,17,Bears,0,7,0,13,20,201003
49ers,14,0,0,0,14,Falcons,0,10,3,3,16,201004
Jets,7,10,21,0,38,Bills,0,7,0,7,14,201004
Bengals,0,10,3,7,20,Browns,3,10,10,0,23,201004
Lions,0,14,6,6,26,Packers,7,14,7,0,28,201004
Broncos,0,10,6,10,26,Titans,0,10,10,0,20,201004
Seahawks,0,3,0,0,3,Rams,7,3,7,3,20,201004
Panthers,0,7,7,0,14,Saints,0,10,3,3,16,201004
Ravens,0,10,0,7,17,Steelers,7,0,0,7,14,201004
Texans,14,0,10,7,31,Raiders,7,7,0,10,24,201004
Colts,7,7,0,14,28,Jaguars,7,7,7,10,31,201004
Redskins,14,3,0,0,17,Eagles,0,6,0,6,12,201004
Cardinals,0,7,0,3,10,Chargers,7,21,10,3,41,201004
Bears,0,0,0,3,3,Giants,3,0,7,7,17,201004
Patriots,0,6,21,14,41,Dolphins,7,0,7,0,14,201004
Jaguars,3,10,14,9,36,Bills,10,3,7,6,26,201005
Buccaneers,0,7,7,10,24,Bengals,7,3,3,8,21,201005
Falcons,0,6,7,7,20,Browns,0,7,3,0,10,201005
Rams,3,3,0,0,6,Lions,3,21,7,13,44,201005
Chiefs,0,3,6,0,9,Colts,3,3,3,10,19,201005
Packers,7,3,3,0,0,13,Redskins,0,3,0,10,3,16,201005
Bears,17,0,0,6,23,Panthers,3,0,3,0,6,201005
Broncos,0,7,0,10,17,Ravens,7,10,0,14,31,201005
Giants,14,10,3,7,34,Texans,0,3,7,0,10,201005
Saints,10,3,0,7,20,Cardinals,0,10,3,17,30,201005
Titans,10,7,3,14,34,Cowboys,3,7,7,10,27,201005
Chargers,0,17,7,3,27,Raiders,12,3,7,13,35,201005
Eagles,7,10,0,10,27,49ers,7,3,0,14,24,201005
Vikings,0,0,7,13,20,Jets,3,6,6,14,29,201005
Seahawks,7,7,2,7,23,Bears,7,6,0,7,20,201006
Dolphins,7,3,3,7,3,23,Packers,10,0,0,10,0,20,201006
Chargers,0,3,7,7,17,Rams,10,7,0,3,20,201006
Ravens,3,7,7,3,0,20,Patriots,7,0,3,10,3,23,201006
Lions,7,3,0,10,20,Giants,7,7,7,7,28,201006
Falcons,0,7,3,7,17,Eagles,14,7,7,3,31,201006
Browns,3,0,0,7,10,Steelers,0,7,7,14,28,201006
Saints,7,10,7,7,31,Buccaneers,0,0,0,6,6,201006
Chiefs,7,7,10,7,31,Texans,0,7,7,21,35,201006
Jets,0,7,3,14,24,Broncos,0,10,7,3,20,201006
Raiders,3,3,0,3,9,49ers,0,3,7,7,17,201006
Cowboys,7,7,0,7,21,Vikings,7,0,14,3,24,201006
Colts,7,10,7,3,27,Redskins,7,0,10,7,24,201006
Titans,7,10,3,10,30,Jaguars,0,0,3,0,3,201006
Bengals,3,0,22,7,32,Falcons,7,17,0,15,39,201007
Redskins,7,3,7,0,17,Bears,7,7,0,0,14,201007
Eagles,0,13,3,3,19,Titans,0,7,3,27,37,201007
Jaguars,3,10,7,0,20,Chiefs,7,7,14,14,42,201007
Steelers,0,17,3,3,23,Dolphins,6,10,3,3,22,201007
Browns,10,10,0,10,30,Saints,0,3,0,14,17,201007
Rams,0,17,0,0,17,Buccaneers,3,3,6,6,18,201007
49ers,7,3,0,10,20,Panthers,3,7,3,10,23,201007
Bills,10,14,0,10,0,34,Ravens,3,17,14,0,3,37,201007
Cardinals,0,0,7,3,10,Seahawks,3,7,9,3,22,201007
Raiders,24,14,21,0,59,Broncos,0,7,7,0,14,201007
Patriots,7,6,7,3,23,Chargers,3,0,0,17,20,201007
Vikings,7,10,7,0,24,Packers,7,7,14,0,28,201007
Giants,7,17,14,3,41,Cowboys,10,10,0,15,35,201007
Dolphins,3,9,3,7,22,Bengals,7,7,0,0,14,201008
Jaguars,7,7,14,7,35,Cowboys,3,0,0,14,17,201008
Redskins,0,13,0,12,25,Lions,0,7,7,23,37,201008
Bills,0,0,3,7,0,10,Chiefs,0,7,0,3,3,13,201008
Panthers,0,3,0,7,10,Rams,0,10,0,10,20,201008
Packers,3,0,0,6,9,Jets,0,0,0,0,0,201008
Broncos,0,0,7,9,16,49ers,3,0,0,21,24,201008
Titans,5,14,0,6,25,Chargers,7,7,10,9,33,201008
Seahawks,0,0,0,3,3,Raiders,3,7,3,20,33,201008
Vikings,0,7,3,8,18,Patriots,0,7,14,7,28,201008
Buccaneers,7,17,7,7,38,Cardinals,7,7,14,7,35,201008
Steelers,0,3,0,7,10,Saints,0,3,3,14,20,201008
Texans,0,3,7,7,17,Colts,7,10,10,3,30,201008
Buccaneers,0,14,7,0,21,Falcons,7,10,10,0,27,201009
Bears,0,7,7,8,22,Bills,0,7,6,6,19,201009
Patriots,0,7,0,7,14,Browns,10,7,7,10,34,201009
Jets,0,10,0,10,3,23,Lions,7,0,6,7,0,20,201009
Cardinals,0,14,7,3,0,24,Vikings,0,10,0,14,3,27,201009
Saints,7,10,10,7,34,Panthers,3,0,0,0,3,201009
Dolphins,7,3,0,0,10,Ravens,7,6,7,6,26,201009
Chargers,14,0,7,8,29,Texans,10,10,3,0,23,201009
Giants,21,14,6,0,41,Seahawks,0,0,0,7,7,201009
Chiefs,0,10,3,7,0,20,Raiders,0,0,14,6,3,23,201009
Colts,0,17,0,7,24,Eagles,13,3,3,7,26,201009
Cowboys,0,7,0,0,7,Packers,0,28,7,10,45,201009
Steelers,10,10,0,7,27,Bengals,0,7,0,14,21,201009
Ravens,0,0,7,14,21,Falcons,0,10,3,13,26,201010
Lions,0,3,0,9,12,Bills,0,7,7,0,14,201010
Vikings,3,7,3,0,13,Bears,0,14,6,7,27,201010
Jets,3,14,0,3,6,26,Browns,10,3,0,7,0,20,201010
Bengals,0,10,0,7,17,Colts,10,10,0,3,23,201010
Titans,10,0,7,0,17,Dolphins,7,3,10,9,29,201010
Panthers,3,7,6,0,16,Buccaneers,7,14,0,10,31,201010
Texans,3,0,14,7,24,Jaguars,3,14,0,14,31,201010
Chiefs,0,10,7,12,29,Broncos,21,14,7,7,49,201010
Cowboys,6,13,14,0,33,Giants,3,3,14,0,20,201010
Seahawks,7,10,9,10,36,Cardinals,7,3,0,8,18,201010
Rams,3,7,7,3,0,20,49ers,7,3,0,10,3,23,201010
Patriots,10,0,13,16,39,Steelers,0,3,0,23,26,201010
Eagles,28,17,14,0,59,Redskins,0,14,7,7,28,201010
Bears,3,3,10,0,16,Dolphins,0,0,0,0,0,201011
Bills,7,7,14,21,49,Bengals,7,24,0,0,31,201011
Lions,0,10,9,0,19,Cowboys,7,0,14,14,35,201011
Redskins,7,3,3,3,3,19,Titans,7,3,3,3,0,16,201011
Cardinals,3,0,3,7,13,Chiefs,0,14,7,10,31,201011
Packers,0,17,7,7,31,Vikings,3,0,0,0,3,201011
Texans,0,7,0,20,27,Jets,3,10,7,10,30,201011
Raiders,3,0,0,0,3,Steelers,0,21,0,14,35,201011
Ravens,10,7,3,17,37,Panthers,0,3,3,7,13,201011
Browns,0,7,10,3,20,Jaguars,3,7,0,14,24,201011
Falcons,3,13,7,11,34,Rams,7,3,7,0,17,201011
Seahawks,3,13,0,3,19,Saints,7,20,7,0,34,201011
Buccaneers,0,7,7,7,21,49ers,0,0,0,0,0,201011
Colts,0,14,0,14,28,Patriots,7,14,7,3,31,201011
Giants,0,3,7,7,17,Eagles,7,6,3,11,27,201011
Broncos,7,0,0,7,14,Chargers,7,14,7,7,35,201011
Patriots,3,7,14,21,45,Lions,7,10,7,0,24,201012
Saints,17,3,3,7,30,Cowboys,0,6,14,7,27,201012
Bengals,0,7,0,3,10,Jets,0,3,14,9,26,201012
Packers,3,0,7,7,17,Falcons,3,7,0,10,20,201012
Steelers,7,6,0,3,3,19,Bills,0,0,7,9,0,16,201012
Panthers,7,6,7,3,23,Browns,14,7,0,3,24,201012
Jaguars,7,10,0,3,20,Giants,3,3,3,15,24,201012
Vikings,7,0,10,0,17,Redskins,7,0,0,6,13,201012
Titans,0,0,0,0,0,Texans,0,14,3,3,20,201012
Dolphins,10,3,10,10,33,Raiders,7,7,0,3,17,201012
Chiefs,7,14,0,21,42,Seahawks,7,3,7,7,24,201012
Eagles,3,10,0,13,26,Bears,14,7,10,0,31,201012
Rams,7,19,7,3,36,Broncos,10,3,0,20,33,201012
Buccaneers,0,3,0,7,10,Ravens,0,17,0,0,17,201012
Chargers,10,6,10,10,36,Colts,7,7,0,0,14,201012
49ers,14,7,3,3,27,Cardinals,3,3,0,0,6,201012
Texans,3,7,14,0,24,Eagles,7,13,0,14,34,201013
Saints,3,10,7,14,34,Bengals,0,6,6,18,30,201013
Bears,7,7,3,7,24,Lions,7,10,3,0,20,201013
49ers,3,10,3,0,16,Packers,0,14,14,6,34,201013
Jaguars,7,10,0,0,17,Titans,0,0,3,3,6,201013
Broncos,0,3,0,3,6,Chiefs,7,3,0,0,10,201013
Browns,0,3,7,3,13,Dolphins,0,3,0,7,10,201013
Bills,7,0,0,7,14,Vikings,7,24,0,7,38,201013
Redskins,0,0,7,0,7,Giants,14,7,7,3,31,201013
Raiders,14,7,0,7,28,Chargers,0,3,3,7,13,201013
Cowboys,10,7,10,8,3,38,Colts,0,7,7,21,0,35,201013
Rams,3,6,7,3,19,Cardinals,6,0,0,0,6,201013
Panthers,7,7,0,0,14,Seahawks,0,3,21,7,31,201013
Falcons,7,7,0,14,28,Buccaneers,7,7,3,7,24,201013
Steelers,0,0,3,10,13,Ravens,7,0,3,0,10,201013
Jets,0,3,0,0,3,Patriots,17,7,7,14,45,201013
Colts,7,14,3,6,30,Titans,0,7,7,14,28,201014
Browns,3,3,0,0,6,Bills,0,10,0,3,13,201014
Packers,0,0,3,0,3,Lions,0,0,0,7,7,201014
Bengals,7,0,0,0,7,Steelers,0,10,3,10,23,201014
Buccaneers,0,3,6,8,17,Redskins,0,10,0,6,16,201014
Falcons,14,3,7,7,31,Panthers,0,0,7,3,10,201014
Raiders,7,10,7,7,31,Jaguars,0,7,21,10,38,201014
Rams,0,6,0,7,13,Saints,14,7,7,3,31,201014
Seahawks,7,0,7,7,21,49ers,10,20,10,0,40,201014
Patriots,7,26,3,0,36,Bears,0,0,7,0,7,201014
Dolphins,10,0,0,0,10,Jets,0,3,0,3,6,201014
Broncos,3,0,0,10,13,Cardinals,3,13,3,24,43,201014
Chiefs,0,0,0,0,0,Chargers,7,14,0,10,31,201014
Eagles,7,7,3,13,30,Cowboys,7,3,10,7,27,201014
Giants,0,14,7,0,21,Vikings,3,0,0,0,3,201014
Ravens,7,14,7,0,6,34,Texans,0,7,6,15,0,28,201014
49ers,0,0,0,7,7,Chargers,7,10,7,10,34,201015
Browns,7,0,0,10,17,Bengals,0,10,6,3,19,201015
Redskins,0,7,7,16,30,Cowboys,10,10,10,3,33,201015
Texans,0,3,7,7,17,Titans,21,3,7,0,31,201015
Jaguars,0,10,7,7,24,Colts,7,7,10,10,34,201015
Chiefs,0,14,3,10,27,Rams,6,0,0,7,13,201015
Bills,0,10,7,0,17,Dolphins,0,7,0,7,14,201015
Eagles,0,3,7,28,38,Giants,7,17,0,7,31,201015
Lions,7,3,7,3,3,23,Buccaneers,0,14,0,6,0,20,201015
Cardinals,0,3,0,9,12,Panthers,6,7,6,0,19,201015
Saints,7,7,3,7,24,Ravens,7,14,3,6,30,201015
Falcons,0,17,17,0,34,Seahawks,7,3,0,8,18,201015
Broncos,14,3,3,3,23,Raiders,14,3,6,16,39,201015
Jets,7,3,7,5,22,Steelers,0,10,7,0,17,201015
Packers,3,14,7,3,27,Patriots,7,7,7,10,31,201015
Bears,10,7,20,3,40,Vikings,7,0,7,0,14,201015
Panthers,0,0,0,3,3,Steelers,3,17,7,0,27,201016
Cowboys,0,10,10,6,26,Cardinals,14,7,0,6,27,201016
Patriots,7,17,7,3,34,Bills,3,0,0,0,3,201016
Jets,0,24,7,3,34,Bears,10,7,21,0,38,201016
Ravens,0,13,7,0,20,Browns,7,3,0,0,10,201016
Titans,0,7,7,0,14,Chiefs,14,17,3,0,34,201016
49ers,0,14,0,3,17,Rams,9,3,3,10,25,201016
Lions,3,7,7,17,34,Dolphins,3,14,7,3,27,201016
Redskins,10,0,0,7,3,20,Jaguars,0,7,3,7,0,17,201016
Chargers,0,3,7,10,20,Bengals,7,6,0,21,34,201016
Texans,7,10,6,0,23,Broncos,0,0,10,14,24,201016
Colts,7,10,7,7,31,Raiders,7,6,3,10,26,201016
Giants,0,14,3,0,17,Packers,14,7,10,14,45,201016
Seahawks,7,0,0,8,15,Buccaneers,3,14,14,7,38,201016
Saints,3,7,0,7,17,Falcons,0,7,0,7,14,201016
Vikings,0,7,10,7,24,Eagles,7,0,0,7,14,201016
Panthers,0,0,3,7,10,Falcons,14,7,10,0,31,201017
Steelers,14,17,7,3,41,Browns,0,3,0,6,9,201017
Vikings,0,0,7,6,13,Lions,0,10,3,7,20,201017
Raiders,0,10,7,14,31,Chiefs,3,0,7,0,10,201017
Dolphins,0,0,0,7,7,Patriots,14,10,14,0,38,201017
Buccaneers,3,7,10,3,23,Saints,7,0,3,3,13,201017
Bills,0,0,7,0,7,Jets,3,14,7,14,38,201017
Bengals,0,0,0,7,7,Ravens,3,3,7,0,13,201017
Chargers,0,16,10,7,33,Broncos,7,0,7,14,28,201017
Bears,0,3,0,0,3,Packers,0,0,3,7,10,201017
Titans,3,3,14,0,20,Colts,3,10,7,3,23,201017
Cowboys,0,7,0,7,14,Eagles,0,7,0,6,13,201017
Cardinals,0,7,0,0,7,49ers,7,3,21,7,38,201017
Giants,3,7,7,0,17,Redskins,0,7,0,7,14,201017
Jaguars,0,17,0,0,17,Texans,10,10,7,7,34,201017
Rams,0,3,3,0,6,Seahawks,7,0,3,6,16,201017
Saints,10,10,0,16,36,Seahawks,7,17,10,7,41,201018
Jets,0,0,7,10,17,Colts,0,7,3,6,16,201018
Ravens,3,7,13,7,30,Chiefs,7,0,0,0,7,201018
Packers,7,7,7,0,21,Eagles,0,3,7,6,16,201018
Ravens,14,7,0,3,24,Steelers,7,0,14,10,31,201019
Packers,0,28,14,6,48,Falcons,7,7,0,7,21,201019
Seahawks,0,0,3,21,24,Bears,14,7,7,7,35,201019
Jets,0,14,0,14,28,Patriots,3,0,8,10,21,201019
Packers,7,7,0,7,21,Bears,0,0,0,14,14,201020
Jets,0,3,7,9,19,Steelers,7,17,0,0,24,201020
Steelers,0,10,7,8,25,Packers,14,7,0,10,31,201022
Saints,7,10,10,7,34,Packers,21,7,7,7,42,201101
Falcons,3,0,3,6,12,Bears,10,6,14,0,30,201101
Bengals,10,3,0,14,27,Browns,0,14,3,0,17,201101
Bills,14,6,14,7,41,Chiefs,0,7,0,0,7,201101
Eagles,14,3,7,7,31,Rams,7,3,3,0,13,201101
Lions,6,14,7,0,27,Buccaneers,10,3,0,7,20,201101
Titans,0,0,7,7,14,Jaguars,7,3,3,3,16,201101
Steelers,0,7,0,0,7,Ravens,14,7,11,3,35,201101
Colts,0,0,0,7,7,Texans,17,17,0,0,34,201101
Panthers,7,7,7,0,21,Cardinals,7,0,7,14,28,201101
Vikings,7,10,0,0,17,Chargers,7,0,7,10,24,201101
Seahawks,0,0,7,10,17,49ers,0,16,0,17,33,201101
Giants,7,7,0,0,14,Redskins,0,14,7,7,28,201101
Cowboys,7,3,7,7,24,Jets,0,7,3,17,27,201101
Patriots,7,7,14,10,38,Dolphins,7,0,10,7,24,201101
Raiders,0,16,0,7,23,Broncos,3,0,10,7,20,201101
Raiders,0,21,0,14,35,Bills,0,3,14,21,38,201102
Chiefs,3,0,0,0,3,Lions,7,13,7,21,48,201102
Ravens,0,10,0,3,13,Titans,0,10,10,6,26,201102
Browns,0,14,0,13,27,Colts,3,6,3,7,19,201102
Buccaneers,0,0,10,14,24,Vikings,7,10,0,3,20,201102
Bears,7,3,3,0,13,Saints,3,13,7,7,30,201102
Jaguars,3,0,0,0,3,Jets,9,6,14,3,32,201102
Seahawks,0,0,0,0,0,Steelers,7,10,7,0,24,201102
Cardinals,7,0,7,7,21,Redskins,0,10,0,12,22,201102
Packers,0,7,16,7,30,Panthers,10,3,0,10,23,201102
Cowboys,0,7,7,10,3,27,49ers,0,14,7,3,0,24,201102
Bengals,0,3,12,7,22,Broncos,7,3,7,7,24,201102
Texans,6,10,0,7,23,Dolphins,3,0,7,3,13,201102
Chargers,7,0,0,14,21,Patriots,7,13,0,15,35,201102
Eagles,0,10,21,0,31,Falcons,7,7,7,14,35,201102
Rams,6,0,10,0,16,Giants,7,14,7,0,28,201102
Patriots,14,7,3,7,31,Bills,0,10,7,17,34,201103
49ers,0,0,3,10,13,Bengals,3,0,0,5,8,201103
Dolphins,7,3,3,3,16,Browns,0,7,3,7,17,201103
Broncos,7,0,7,0,14,Titans,0,10,0,7,17,201103
Lions,0,0,10,13,3,26,Vikings,6,14,0,3,0,23,201103
Texans,10,6,3,14,33,Saints,0,10,7,23,40,201103
Giants,14,0,0,15,29,Eagles,0,13,3,0,16,201103
Jaguars,0,10,0,0,10,Panthers,2,3,3,8,16,201103
Jets,7,10,0,7,24,Raiders,7,10,7,10,34,201103
Ravens,21,6,3,7,37,Rams,0,0,7,0,7,201103
Chiefs,0,0,7,10,17,Chargers,0,10,7,3,20,201103
Packers,7,10,3,7,27,Bears,0,10,0,7,17,201103
Cardinals,0,10,0,0,10,Seahawks,3,3,7,0,13,201103
Falcons,0,3,0,10,13,Buccaneers,3,10,3,0,16,201103
Steelers,10,0,0,13,23,Colts,0,13,0,7,20,201103
Redskins,6,3,7,0,16,Cowboys,3,6,3,6,18,201103
Panthers,3,17,0,9,29,Bears,10,14,0,10,34,201104
Bills,0,17,0,3,20,Bengals,3,0,10,10,23,201104
Titans,7,14,10,0,31,Browns,3,3,0,7,13,201104
Lions,0,3,14,17,34,Cowboys,7,13,10,0,30,201104
Vikings,7,0,3,7,17,Chiefs,3,6,6,7,22,201104
Redskins,7,7,3,0,17,Rams,0,0,0,10,10,201104
49ers,0,3,14,7,24,Eagles,7,13,3,0,23,201104
Saints,7,7,6,3,23,Jaguars,0,10,0,0,10,201104
Steelers,0,0,7,3,10,Texans,7,3,0,7,17,201104
Giants,0,10,0,21,31,Cardinals,3,3,14,7,27,201104
Falcons,7,17,3,3,30,Seahawks,0,7,14,7,28,201104
Broncos,3,14,0,6,23,Packers,14,14,14,7,49,201104
Patriots,7,10,7,7,31,Raiders,3,7,3,6,19,201104
Dolphins,7,3,3,3,16,Chargers,7,6,10,3,26,201104
Jets,7,10,0,0,17,Ravens,17,10,7,0,34,201104
Colts,3,7,7,0,17,Buccaneers,0,7,10,7,24,201104
Eagles,0,7,7,10,24,Bills,7,14,10,0,31,201105
Chiefs,0,14,7,7,28,Colts,7,17,0,0,24,201105
Cardinals,0,3,7,0,10,Vikings,28,0,3,3,34,201105
Seahawks,14,0,2,20,36,Giants,7,7,0,11,25,201105
Titans,3,0,7,7,17,Steelers,7,14,7,10,38,201105
Saints,10,10,3,7,30,Panthers,6,7,7,7,27,201105
Bengals,7,6,0,17,30,Jaguars,7,6,0,7,20,201105
Raiders,3,9,3,10,25,Texans,7,7,3,3,20,201105
Buccaneers,3,0,0,0,3,49ers,7,17,10,14,48,201105
Chargers,6,17,0,6,29,Broncos,7,3,0,14,24,201105
Jets,0,7,7,7,21,Patriots,7,3,14,6,30,201105
Packers,0,6,9,10,25,Falcons,7,7,0,0,14,201105
Bears,0,10,0,3,13,Lions,0,7,14,3,24,201105
Panthers,3,7,7,0,17,Falcons,7,7,0,17,31,201106
Colts,0,7,0,10,17,Bengals,7,3,10,7,27,201106
49ers,0,12,3,10,25,Lions,10,0,3,6,19,201106
Rams,0,3,0,0,3,Packers,3,21,0,0,24,201106
Bills,14,3,0,7,24,Giants,7,10,7,3,27,201106
Jaguars,0,3,7,3,13,Steelers,7,10,0,0,17,201106
Eagles,7,13,0,0,20,Redskins,0,3,3,7,13,201106
Browns,0,7,0,10,17,Raiders,7,7,10,0,24,201106
Texans,0,7,7,0,14,Ravens,7,3,6,13,29,201106
Cowboys,3,7,3,3,16,Patriots,3,10,0,7,20,201106
Saints,7,3,3,7,20,Buccaneers,3,17,3,3,26,201106
Vikings,0,3,7,0,10,Bears,16,10,10,3,39,201106
Dolphins,3,3,0,0,6,Jets,7,7,3,7,24,201106
Seahawks,0,0,3,0,3,Browns,0,3,0,3,6,201107
Falcons,10,7,3,3,23,Lions,3,3,10,0,16,201107
Texans,3,17,7,14,41,Titans,0,0,7,0,7,201107
Broncos,0,0,0,15,3,18,Dolphins,0,6,0,9,0,15,201107
Chargers,7,14,0,0,21,Jets,3,7,7,10,27,201107
Bears,7,7,7,3,24,Buccaneers,2,3,0,13,18,201107
Redskins,0,6,7,7,20,Panthers,3,6,14,10,33,201107
Chiefs,14,0,7,7,28,Raiders,0,0,0,0,0,201107
Steelers,7,10,9,6,32,Cardinals,0,7,7,6,20,201107
Rams,0,7,0,0,7,Cowboys,7,10,3,14,34,201107
Packers,7,6,20,0,33,Vikings,7,10,0,10,27,201107
Colts,0,7,0,0,7,Saints,21,13,14,14,62,201107
Ravens,0,0,0,7,7,Jaguars,3,3,3,3,12,201107
Colts,0,0,3,7,10,Titans,3,17,0,7,27,201108
Saints,0,0,7,14,21,Rams,0,17,7,7,31,201108
Dolphins,7,7,3,0,17,Giants,3,7,0,10,20,201108
Vikings,7,7,7,3,24,Panthers,0,14,7,0,21,201108
Cardinals,3,21,0,3,27,Ravens,0,6,14,10,30,201108
Jaguars,0,7,0,7,14,Texans,7,0,7,10,24,201108
Redskins,0,0,0,0,0,Bills,7,6,7,3,23,201108
Lions,7,17,14,7,45,Broncos,3,0,0,7,10,201108
Patriots,0,10,0,7,17,Steelers,7,10,3,5,25,201108
Browns,0,3,0,7,10,49ers,10,7,0,3,20,201108
Bengals,10,7,0,17,34,Seahawks,0,3,3,6,12,201108
Cowboys,0,0,0,7,7,Eagles,14,10,3,7,34,201108
Chargers,0,3,9,8,0,20,Chiefs,10,3,0,7,3,23,201108
Jets,0,3,17,7,27,Bills,0,0,3,8,11,201109
Seahawks,3,3,0,7,13,Cowboys,3,3,7,10,23,201109
Falcons,14,7,7,3,31,Colts,0,7,0,0,7,201109
Dolphins,7,7,14,3,31,Chiefs,3,0,0,0,3,201109
Buccaneers,0,3,3,10,16,Saints,7,10,7,3,27,201109
49ers,0,13,3,3,19,Redskins,0,3,0,8,11,201109
Browns,3,0,3,6,12,Texans,14,10,3,3,30,201109
Bengals,0,7,7,10,24,Titans,3,14,0,0,17,201109
Broncos,7,0,17,14,38,Raiders,3,14,7,0,24,201109
Giants,0,0,10,14,24,Patriots,0,0,3,17,20,201109
Rams,3,6,4,0,0,13,Cardinals,3,0,3,7,6,19,201109
Packers,21,7,3,14,45,Chargers,7,10,7,14,38,201109
Ravens,3,6,7,7,23,Steelers,0,6,0,14,20,201109
Bears,7,10,3,10,30,Eagles,0,10,14,0,24,201109
Raiders,7,10,7,0,24,Chargers,3,0,14,0,17,201110
Saints,3,7,7,6,3,26,Falcons,3,3,7,10,0,23,201110
Steelers,14,3,7,0,24,Bengals,7,3,7,0,17,201110
Rams,0,10,0,3,13,Browns,3,6,3,0,12,201110
Bills,0,7,0,0,7,Cowboys,14,14,6,10,44,201110
Jaguars,3,0,7,7,17,Colts,0,3,0,0,3,201110
Broncos,7,3,0,7,17,Chiefs,0,0,7,3,10,201110
Redskins,3,3,3,0,9,Dolphins,7,3,3,7,20,201110
Cardinals,0,7,0,14,21,Eagles,0,14,0,3,17,201110
Texans,9,7,14,7,37,Buccaneers,0,3,0,6,9,201110
Titans,14,3,3,10,30,Panthers,0,0,3,0,3,201110
Ravens,0,7,3,7,17,Seahawks,10,9,3,0,22,201110
Lions,0,6,0,7,13,Bears,10,10,17,0,37,201110
Giants,3,3,7,7,20,49ers,3,6,3,15,27,201110
Patriots,6,7,10,14,37,Jets,0,9,0,7,16,201110
Vikings,0,0,7,0,7,Packers,14,3,14,14,45,201110
Jets,0,3,7,3,13,Broncos,3,0,7,7,17,201111
Jaguars,0,7,0,3,10,Browns,0,7,0,7,14,201111
Panthers,10,17,0,8,35,Lions,0,14,14,21,49,201111
Buccaneers,0,10,3,13,26,Packers,7,14,0,14,35,201111
Bills,3,3,0,2,8,Dolphins,14,14,7,0,35,201111
Raiders,3,21,3,0,27,Vikings,7,0,0,14,21,201111
Cowboys,7,3,0,14,3,27,Redskins,0,14,3,7,0,24,201111
Bengals,7,0,7,10,24,Ravens,0,14,10,7,31,201111
Seahawks,0,10,7,7,24,Rams,7,0,0,0,7,201111
Cardinals,0,0,0,7,7,49ers,6,3,14,0,23,201111
Titans,0,3,7,7,17,Falcons,7,6,10,0,23,201111
Chargers,3,7,7,3,20,Bears,3,14,14,0,31,201111
Eagles,0,10,0,7,17,Giants,0,3,0,7,10,201111
Chiefs,3,0,0,0,3,Patriots,0,10,17,7,34,201111
Packers,0,7,17,3,27,Lions,0,0,0,15,15,201112
Dolphins,3,3,10,3,19,Cowboys,0,10,0,10,20,201112
49ers,3,0,3,0,6,Ravens,3,3,0,10,16,201112
Vikings,0,0,7,7,14,Falcons,7,10,0,7,24,201112
Browns,7,10,3,0,20,Bengals,7,0,10,6,23,201112
Buccaneers,3,7,7,0,17,Titans,7,3,0,13,23,201112
Panthers,3,7,7,10,27,Colts,0,10,3,6,19,201112
Cardinals,3,0,17,3,23,Rams,7,3,0,10,20,201112
Bills,7,7,7,3,24,Jets,0,14,7,7,28,201112
Texans,7,13,0,0,20,Jaguars,7,3,0,3,13,201112
Bears,0,7,0,13,20,Raiders,6,6,6,7,25,201112
Redskins,7,0,0,16,23,Seahawks,0,7,3,7,17,201112
Patriots,7,17,7,7,38,Eagles,10,3,0,7,20,201112
Broncos,0,7,3,3,3,16,Chargers,3,7,3,0,0,13,201112
Steelers,0,13,0,0,13,Chiefs,3,3,0,3,9,201112
Giants,0,3,7,14,24,Saints,0,21,14,14,49,201112
Eagles,0,7,0,7,14,Seahawks,7,10,7,7,31,201113
Titans,10,7,3,3,23,Bills,7,3,0,7,17,201113
Chiefs,0,7,3,0,10,Bears,0,3,0,0,3,201113
Raiders,0,0,0,14,14,Dolphins,6,7,21,0,34,201113
Broncos,7,0,14,14,35,Vikings,5,10,7,10,32,201113
Colts,0,3,0,21,24,Patriots,3,14,14,0,31,201113
Bengals,0,7,0,0,7,Steelers,0,28,7,0,35,201113
Panthers,14,10,7,7,38,Buccaneers,3,9,0,7,19,201113
Jets,7,3,3,21,34,Redskins,7,6,0,6,19,201113
Falcons,0,3,7,0,10,Texans,3,7,0,7,17,201113
Ravens,0,10,7,7,24,Browns,0,0,3,7,10,201113
Packers,7,14,7,10,38,Giants,10,7,7,11,35,201113
Cowboys,0,10,3,0,0,13,Cardinals,3,0,3,7,6,19,201113
Rams,0,0,0,0,0,49ers,3,6,10,7,26,201113
Lions,0,7,10,0,17,Saints,3,21,0,7,31,201113
Chargers,10,14,7,7,38,Jaguars,0,14,0,0,14,201113
Browns,3,0,0,0,3,Steelers,7,0,0,7,14,201114
Texans,3,0,7,10,20,Bengals,6,10,3,0,19,201114
Vikings,7,7,7,7,28,Lions,21,10,0,3,34,201114
Saints,3,3,3,13,22,Titans,0,3,7,7,17,201114
Eagles,0,24,0,2,26,Dolphins,7,0,3,0,10,201114
Chiefs,3,0,0,7,10,Jets,7,21,7,2,37,201114
Patriots,14,6,14,0,34,Redskins,10,10,7,0,27,201114
Falcons,7,0,10,14,31,Panthers,7,16,0,0,23,201114
Buccaneers,7,7,0,0,14,Jaguars,0,28,0,13,41,201114
Colts,0,3,0,7,10,Ravens,10,7,7,0,24,201114
Bears,0,0,7,3,0,10,Broncos,0,0,0,10,3,13,201114
49ers,3,9,7,0,19,Cardinals,0,7,7,7,21,201114
Raiders,0,0,7,9,16,Packers,14,17,12,3,46,201114
Bills,0,0,10,0,10,Chargers,7,9,14,7,37,201114
Giants,5,10,7,15,37,Cowboys,7,10,3,14,34,201114
Rams,0,3,3,7,13,Seahawks,10,0,10,10,30,201114
Jaguars,0,0,7,7,14,Falcons,10,17,14,0,41,201115
Cowboys,14,14,3,0,31,Buccaneers,0,0,15,0,15,201115
Dolphins,0,13,7,10,30,Bills,7,0,0,16,23,201115
Seahawks,7,0,17,14,38,Bears,7,7,0,0,14,201115
Titans,0,6,0,7,13,Colts,3,0,14,10,27,201115
Packers,0,0,7,7,14,Chiefs,6,0,3,10,19,201115
Bengals,3,0,10,7,20,Rams,0,6,0,7,13,201115
Saints,7,14,14,7,42,Vikings,3,10,0,7,20,201115
Redskins,3,14,3,3,23,Giants,0,3,0,7,10,201115
Panthers,7,14,0,7,28,Texans,0,0,6,7,13,201115
Lions,7,7,0,14,28,Raiders,7,10,0,10,27,201115
Patriots,7,20,7,7,41,Broncos,13,3,0,7,23,201115
Jets,0,13,0,6,19,Eagles,14,14,10,7,45,201115
Browns,7,3,7,0,0,17,Cardinals,0,7,0,10,3,20,201115
Ravens,0,7,0,7,14,Chargers,7,10,14,3,34,201115
Steelers,0,0,3,0,3,49ers,3,3,7,7,20,201115
Texans,10,0,3,3,16,Colts,3,3,3,10,19,201116
Broncos,7,0,7,0,14,Bills,0,17,6,17,40,201116
Cardinals,0,0,0,16,16,Bengals,10,10,3,0,23,201116
Jaguars,7,3,0,7,17,Titans,10,7,3,3,23,201116
Raiders,3,0,7,3,3,16,Chiefs,3,0,3,7,0,13,201116
Dolphins,3,14,0,7,24,Patriots,0,0,17,10,27,201116
Giants,0,10,7,12,29,Jets,7,0,0,7,14,201116
Rams,0,0,0,0,0,Steelers,3,7,3,14,27,201116
Vikings,3,7,13,10,33,Redskins,0,10,10,6,26,201116
Buccaneers,0,10,0,6,16,Panthers,10,10,21,7,48,201116
Browns,0,0,7,7,14,Ravens,10,7,3,0,20,201116
Chargers,0,0,10,0,10,Lions,10,14,7,7,38,201116
Eagles,7,7,3,3,20,Cowboys,0,0,0,7,7,201116
49ers,0,3,10,6,19,Seahawks,7,3,0,7,17,201116
Bears,0,3,7,11,21,Packers,7,7,14,7,35,201116
Falcons,10,0,3,3,16,Saints,7,14,10,14,45,201116
Lions,9,10,15,7,41,Packers,10,14,7,14,45,201117
49ers,7,13,7,7,34,Rams,7,0,3,17,27,201117
Jets,7,3,0,7,17,Dolphins,3,3,0,13,19,201117
Bears,0,14,0,3,17,Vikings,10,3,0,0,13,201117
Bills,21,0,0,0,21,Patriots,0,14,14,21,49,201117
Panthers,7,10,0,0,17,Saints,14,10,14,7,45,201117
Redskins,0,0,7,3,10,Eagles,3,7,3,21,34,201117
Colts,0,3,3,7,13,Jaguars,7,3,6,3,19,201117
Titans,0,13,3,7,23,Texans,7,3,3,9,22,201117
Buccaneers,0,7,11,6,24,Falcons,21,21,0,3,45,201117
Ravens,10,7,0,7,24,Bengals,3,0,7,6,16,201117
Steelers,0,3,10,0,13,Browns,0,6,3,0,9,201117
Chiefs,7,0,0,0,7,Broncos,0,0,3,0,3,201117
Chargers,7,17,7,7,38,Raiders,7,6,6,7,26,201117
Seahawks,0,3,7,10,0,20,Cardinals,7,3,7,3,3,23,201117
Cowboys,0,0,7,7,14,Giants,7,14,0,10,31,201117
Bengals,7,3,0,0,10,Texans,7,10,7,7,31,201118
Lions,7,7,7,7,28,Saints,0,10,14,21,45,201118
Falcons,0,2,0,0,2,Giants,0,7,10,7,24,201118
Steelers,6,0,7,10,0,23,Broncos,0,20,0,3,6,29,201118
Saints,0,14,0,18,32,49ers,14,3,3,16,36,201119
Broncos,0,7,3,0,10,Patriots,14,21,7,3,45,201119
Texans,3,10,0,0,13,Ravens,17,0,0,3,20,201119
Giants,10,10,0,17,37,Packers,3,7,3,7,20,201119
Ravens,0,10,10,0,20,Patriots,3,10,3,7,23,201120
Giants,0,10,0,7,3,20,49ers,7,0,7,3,0,17,201120
Giants,9,0,6,6,21,Patriots,0,10,7,0,17,201122
Cowboys,0,7,10,7,24,Giants,0,3,7,7,17,201201
Colts,7,7,0,7,21,Bears,7,17,10,7,41,201201
Eagles,0,10,0,7,17,Browns,3,0,3,10,16,201201
Rams,3,10,0,10,23,Lions,0,10,3,14,27,201201
Patriots,7,14,7,6,34,Titans,3,0,7,3,13,201201
Falcons,10,10,14,6,40,Chiefs,3,14,0,7,24,201201
Jaguars,3,6,3,11,0,23,Vikings,0,7,7,9,3,26,201201
Redskins,10,10,10,10,40,Saints,7,7,3,15,32,201201
Bills,0,7,7,14,28,Jets,7,20,14,7,48,201201
Dolphins,3,0,7,0,10,Texans,0,24,3,3,30,201201
49ers,3,13,7,7,30,Packers,0,7,0,15,22,201201
Seahawks,3,0,10,3,16,Cardinals,3,7,3,7,20,201201
Panthers,0,0,7,3,10,Buccaneers,10,3,0,3,16,201201
Steelers,0,10,3,6,19,Broncos,0,7,7,17,31,201201
Bengals,0,10,3,0,13,Ravens,10,7,17,10,44,201201
Chargers,3,7,6,6,22,Raiders,3,3,0,8,14,201201
Bears,0,0,3,7,10,Packers,0,13,0,10,23,201202
Chiefs,0,0,3,14,17,Bills,7,14,14,0,35,201202
Browns,3,7,7,10,27,Bengals,7,10,7,10,34,201202
Vikings,3,3,0,14,20,Colts,7,10,3,3,23,201202
Raiders,7,3,0,3,13,Dolphins,7,0,14,14,35,201202
Cardinals,6,0,7,7,20,Patriots,3,3,3,9,18,201202
Buccaneers,3,21,3,7,34,Giants,6,7,3,25,41,201202
Ravens,7,10,0,6,23,Eagles,7,0,10,7,24,201202
Saints,10,3,0,14,27,Panthers,7,14,7,7,35,201202
Texans,10,7,7,3,27,Jaguars,0,0,7,0,7,201202
Redskins,14,7,7,0,28,Rams,3,13,7,8,31,201202
Cowboys,0,7,0,0,7,Seahawks,10,3,7,7,27,201202
Jets,7,3,0,0,10,Steelers,3,10,7,7,27,201202
Titans,0,3,7,0,10,Chargers,14,3,7,14,38,201202
Lions,6,0,3,10,19,49ers,7,7,3,10,27,201202
Broncos,0,7,0,14,21,Falcons,10,10,7,0,27,201202
Giants,10,10,6,10,36,Panthers,0,0,7,0,7,201203
Rams,0,3,3,0,6,Bears,3,7,0,13,23,201203
Bills,14,0,3,7,24,Browns,0,7,7,0,14,201203
Buccaneers,7,0,0,3,10,Cowboys,7,3,0,6,16,201203
Lions,6,3,7,25,0,41,Titans,10,10,0,21,3,44,201203
Jaguars,3,0,10,9,22,Colts,7,7,0,3,17,201203
Jets,0,3,7,10,3,23,Dolphins,7,3,7,3,0,20,201203
49ers,0,3,10,0,13,Vikings,7,10,0,7,24,201203
Chiefs,3,3,7,11,3,27,Saints,7,3,14,0,0,24,201203
Bengals,14,10,0,14,38,Redskins,7,3,14,7,31,201203
Eagles,0,0,6,0,6,Cardinals,10,14,0,3,27,201203
Falcons,6,14,0,7,27,Chargers,0,0,3,0,3,201203
Texans,7,14,10,0,31,Broncos,5,6,0,14,25,201203
Steelers,14,3,14,0,31,Raiders,7,7,7,13,34,201203
Patriots,13,7,7,3,30,Ravens,0,14,7,10,31,201203
Packers,0,0,6,6,12,Seahawks,0,7,0,7,14,201203
Browns,0,7,3,6,16,Ravens,0,9,14,0,23,201204
Panthers,7,7,7,7,28,Falcons,7,10,7,6,30,201204
Patriots,7,0,14,31,52,Bills,0,14,7,7,28,201204
Vikings,10,3,7,0,20,Lions,3,3,0,7,13,201204
Chargers,17,10,0,10,37,Chiefs,0,6,7,7,20,201204
Seahawks,7,0,3,3,13,Rams,3,10,3,3,19,201204
49ers,0,10,7,17,34,Jets,0,0,0,0,0,201204
Titans,0,7,0,7,14,Texans,14,0,14,10,38,201204
Raiders,3,3,0,0,6,Broncos,10,0,21,6,37,201204
Dolphins,0,13,0,8,0,21,Cardinals,0,0,7,14,3,24,201204
Bengals,3,14,0,10,27,Jaguars,0,7,3,0,10,201204
Saints,7,7,10,3,27,Packers,7,14,0,7,28,201204
Redskins,7,14,0,3,24,Buccaneers,3,3,7,9,22,201204
Giants,0,3,7,7,17,Eagles,0,7,6,6,19,201204
Bears,0,10,14,10,34,Cowboys,0,7,3,8,18,201204
Cardinals,3,0,0,0,3,Rams,7,3,0,7,17,201205
Dolphins,0,7,10,0,17,Bengals,6,0,0,7,13,201205
Packers,7,14,0,6,27,Colts,0,3,16,11,30,201205
Ravens,3,0,6,0,9,Chiefs,0,3,0,3,6,201205
Browns,14,3,3,7,27,Giants,7,20,7,7,41,201205
Eagles,0,0,7,7,14,Steelers,0,10,0,6,16,201205
Falcons,0,7,0,17,24,Redskins,0,7,3,7,17,201205
Seahawks,3,3,7,3,16,Panthers,0,3,7,2,12,201205
Bears,3,0,10,28,41,Jaguars,0,3,0,0,3,201205
Titans,0,0,0,7,7,Vikings,7,6,10,7,30,201205
Broncos,0,7,7,7,21,Patriots,7,10,14,0,31,201205
Bills,0,3,0,0,3,49ers,3,14,7,21,45,201205
Chargers,7,10,7,0,24,Saints,7,7,7,10,31,201205
Texans,7,10,6,0,23,Jets,7,0,7,3,17,201205
Steelers,10,0,3,10,23,Titans,6,10,0,10,26,201206
Raiders,3,10,0,7,20,Falcons,0,7,6,10,23,201206
Bengals,7,7,0,10,24,Browns,0,7,6,21,34,201206
Rams,6,0,0,8,14,Dolphins,0,10,7,0,17,201206
Colts,3,3,0,3,9,Jets,0,21,7,7,35,201206
Lions,6,0,0,17,3,26,Eagles,0,7,6,10,0,23,201206
Chiefs,0,3,0,7,10,Buccaneers,7,0,14,17,38,201206
Cowboys,7,3,10,9,29,Ravens,3,14,7,7,31,201206
Bills,9,0,7,0,3,19,Cardinals,3,7,3,3,0,16,201206
Patriots,7,10,3,3,23,Seahawks,10,0,0,14,24,201206
Giants,0,10,13,3,26,49ers,3,0,0,0,3,201206
Vikings,9,0,3,14,26,Redskins,0,17,7,14,38,201206
Packers,14,7,7,14,42,Texans,0,10,7,7,24,201206
Broncos,0,0,14,21,35,Chargers,10,14,0,0,24,201206
Seahawks,3,3,0,0,6,49ers,3,0,7,3,13,201207
Titans,14,7,7,7,35,Bills,14,6,14,0,34,201207
Browns,0,6,7,0,13,Colts,7,7,3,0,17,201207
Packers,10,0,7,13,30,Rams,3,3,0,14,20,201207
Cardinals,0,7,0,7,14,Vikings,7,7,7,0,21,201207
Redskins,3,10,0,10,23,Giants,0,13,0,14,27,201207
Saints,7,21,0,7,35,Buccaneers,14,7,0,7,28,201207
Cowboys,0,3,10,6,19,Panthers,0,7,0,7,14,201207
Ravens,3,0,7,3,13,Texans,9,20,7,7,43,201207
Jaguars,7,10,3,3,0,23,Raiders,3,3,7,10,3,26,201207
Jets,7,3,3,13,0,26,Patriots,14,2,7,3,3,29,201207
Steelers,3,11,3,7,24,Bengals,7,7,3,0,17,201207
Lions,0,0,0,7,7,Bears,10,0,3,0,13,201207
Buccaneers,10,10,10,6,36,Vikings,0,10,7,0,17,201208
Panthers,3,10,6,3,22,Bears,7,0,0,16,23,201208
Chargers,0,3,3,0,6,Browns,7,0,0,0,7,201208
Seahawks,3,14,0,7,24,Lions,7,7,0,14,28,201208
Jaguars,3,9,0,3,15,Packers,7,7,0,10,24,201208
Colts,3,0,3,7,6,19,Titans,3,7,0,3,0,13,201208
Patriots,7,21,10,7,45,Rams,7,0,0,0,7,201208
Dolphins,10,10,7,3,30,Jets,0,0,3,6,9,201208
Falcons,14,10,3,3,30,Eagles,0,7,3,7,17,201208
Redskins,0,6,3,3,12,Steelers,10,10,7,0,27,201208
Raiders,3,10,10,3,26,Chiefs,0,6,3,7,16,201208
Giants,13,10,0,6,29,Cowboys,0,10,14,0,24,201208
Saints,0,7,0,7,14,Broncos,7,10,7,10,34,201208
49ers,7,10,7,0,24,Cardinals,0,0,3,0,3,201208
Chiefs,0,3,3,7,13,Chargers,7,3,0,21,31,201209
Broncos,3,7,7,14,31,Bengals,0,3,10,10,23,201209
Ravens,14,0,0,11,25,Browns,0,9,3,3,15,201209
Cardinals,0,7,10,0,17,Packers,7,14,10,0,31,201209
Bears,28,3,6,14,51,Titans,2,3,7,8,20,201209
Dolphins,3,14,0,3,20,Colts,7,6,7,3,23,201209
Panthers,7,7,0,7,21,Redskins,3,0,3,7,13,201209
Lions,0,21,0,10,31,Jaguars,0,0,0,14,14,201209
Bills,0,6,3,0,9,Texans,7,0,7,7,21,201209
Buccaneers,0,7,21,14,42,Raiders,3,7,0,22,32,201209
Vikings,7,10,3,0,20,Seahawks,14,6,7,3,30,201209
Steelers,0,10,0,14,24,Giants,0,14,6,0,20,201209
Cowboys,6,0,0,7,13,Falcons,0,6,0,13,19,201209
Eagles,0,3,10,0,13,Saints,7,14,7,0,28,201209
Colts,3,14,7,3,27,Jaguars,0,3,0,7,10,201210
Giants,3,3,0,7,13,Bengals,14,3,14,0,31,201210
Titans,14,10,7,6,37,Dolphins,0,3,0,0,3,201210
Lions,0,3,7,14,24,Vikings,10,3,3,18,34,201210
Bills,0,17,7,7,31,Patriots,10,14,7,6,37,201210
Falcons,10,7,0,10,27,Saints,7,14,7,3,31,201210
Chargers,14,7,0,3,24,Buccaneers,7,10,7,10,34,201210
Broncos,7,10,7,12,36,Panthers,7,0,0,7,14,201210
Raiders,0,10,7,3,20,Ravens,10,17,21,7,55,201210
Jets,7,0,0,0,7,Seahawks,7,7,0,14,28,201210
Cowboys,7,3,7,21,38,Eagles,7,0,10,6,23,201210
Rams,14,0,3,7,0,24,49ers,0,7,0,17,0,24,201210
Texans,3,7,0,3,13,Bears,0,3,3,0,6,201210
Chiefs,7,3,0,3,0,13,Steelers,0,10,0,3,3,16,201210
Dolphins,7,0,0,7,14,Bills,13,6,0,0,19,201211
Cardinals,13,3,0,3,19,Falcons,0,16,0,7,23,201211
Browns,7,6,0,7,0,20,Cowboys,0,0,3,17,3,23,201211
Packers,0,7,7,10,24,Lions,3,7,7,3,20,201211
Bengals,7,14,0,7,28,Chiefs,3,3,0,0,6,201211
Jets,3,10,0,14,27,Rams,7,0,0,6,13,201211
Eagles,0,3,3,0,6,Redskins,7,10,7,7,31,201211
Buccaneers,10,0,0,11,6,27,Panthers,7,7,0,7,0,21,201211
Jaguars,7,10,10,7,3,37,Texans,7,10,3,14,9,43,201211
Saints,14,7,14,3,38,Raiders,0,7,3,7,17,201211
Chargers,7,0,9,7,23,Broncos,0,17,7,6,30,201211
Colts,14,3,0,7,24,Patriots,7,17,14,21,59,201211
Ravens,10,0,3,0,13,Steelers,7,0,3,0,10,201211
Bears,0,0,7,0,7,49ers,10,10,7,5,32,201211
Texans,0,14,10,7,3,34,Lions,7,14,3,7,0,31,201212
Redskins,0,28,0,10,38,Cowboys,3,0,10,18,31,201212
Patriots,0,35,0,14,49,Jets,0,3,9,7,19,201212
Vikings,3,0,7,0,10,Bears,10,15,3,0,28,201212
Raiders,0,0,10,0,10,Bengals,14,10,0,10,34,201212
Steelers,7,7,0,0,14,Browns,3,10,7,0,20,201212
Bills,3,3,0,7,13,Colts,7,6,7,0,20,201212
Broncos,0,7,7,3,17,Chiefs,6,0,3,0,9,201212
Seahawks,0,7,7,7,21,Dolphins,0,7,0,17,24,201212
Falcons,3,7,7,7,24,Buccaneers,7,3,3,10,23,201212
Titans,3,3,3,10,19,Jaguars,7,0,7,10,24,201212
Ravens,0,0,3,10,3,16,Chargers,0,10,0,3,0,13,201212
49ers,7,7,14,3,31,Saints,7,7,7,0,21,201212
Rams,0,14,14,3,31,Cardinals,7,10,0,0,17,201212
Packers,7,3,0,0,10,Giants,17,14,7,0,38,201212
Panthers,14,0,7,9,30,Eagles,3,12,7,0,22,201212
Saints,0,7,6,0,13,Falcons,7,10,0,6,23,201213
Jaguars,0,10,0,8,18,Bills,7,10,10,7,34,201213
Seahawks,0,10,0,7,6,23,Bears,7,0,7,3,0,17,201213
Colts,7,7,7,14,35,Lions,10,13,7,3,33,201213
Vikings,0,14,0,0,14,Packers,10,0,10,3,23,201213
Texans,14,7,3,0,24,Titans,3,0,7,0,10,201213
Panthers,7,7,0,7,21,Chiefs,10,7,7,3,27,201213
49ers,7,0,0,6,0,13,Rams,0,0,2,11,3,16,201213
Patriots,7,10,0,6,23,Dolphins,3,7,0,6,16,201213
Cardinals,0,3,0,3,6,Jets,0,0,0,7,7,201213
Buccaneers,10,0,0,13,23,Broncos,7,0,21,3,31,201213
Browns,0,10,3,7,20,Raiders,0,3,7,7,17,201213
Bengals,7,3,0,10,20,Chargers,0,13,0,0,13,201213
Steelers,3,3,7,10,23,Ravens,0,13,7,0,20,201213
Eagles,7,10,7,9,33,Cowboys,0,10,7,21,38,201213
Giants,3,10,3,0,16,Redskins,7,3,0,7,17,201213
Broncos,10,3,13,0,26,Raiders,0,7,0,6,13,201214
Rams,0,0,7,8,15,Bills,3,3,6,0,12,201214
Cowboys,3,7,0,10,20,Bengals,10,3,6,0,19,201214
Chiefs,7,0,0,0,7,Browns,3,7,10,10,30,201214
Titans,7,13,0,3,23,Colts,7,0,14,6,27,201214
Bears,0,7,0,7,14,Vikings,14,0,7,0,21,201214
Chargers,3,10,14,7,34,Steelers,0,3,7,14,24,201214
Eagles,0,10,0,13,23,Buccaneers,0,0,7,14,21,201214
Ravens,7,14,0,7,0,28,Redskins,14,0,6,8,3,31,201214
Falcons,0,0,7,13,20,Panthers,7,9,7,7,30,201214
Jets,0,0,10,7,17,Jaguars,0,3,0,7,10,201214
Dolphins,0,3,3,7,13,49ers,0,6,7,14,27,201214
Saints,7,6,14,0,27,Giants,14,7,14,17,52,201214
Cardinals,0,0,0,0,0,Seahawks,10,28,13,7,58,201214
Lions,7,7,3,3,20,Packers,0,10,7,10,27,201214
Texans,0,0,7,7,14,Patriots,14,7,7,14,42,201214
Bengals,10,0,14,10,34,Eagles,0,13,0,0,13,201215
Giants,0,0,0,0,0,Falcons,14,3,10,7,34,201215
Packers,0,14,7,0,21,Bears,0,7,3,3,13,201215
Redskins,7,3,14,14,38,Browns,7,7,0,7,21,201215
Vikings,7,23,3,3,36,Rams,0,7,0,15,22,201215
Jaguars,3,0,0,0,3,Dolphins,3,7,6,8,24,201215
Buccaneers,0,0,0,0,0,Saints,7,17,7,10,41,201215
Broncos,3,14,14,3,34,Ravens,0,0,3,14,17,201215
Colts,0,10,7,0,17,Texans,10,10,3,6,29,201215
Seahawks,14,17,16,3,50,Bills,7,10,0,0,17,201215
Lions,0,7,3,0,10,Cardinals,0,21,3,14,38,201215
Panthers,21,3,7,0,31,Chargers,0,0,0,7,7,201215
Steelers,0,10,7,7,0,24,Cowboys,3,7,7,7,3,27,201215
Chiefs,0,0,0,0,0,Raiders,3,6,3,3,15,201215
49ers,7,10,14,10,41,Patriots,0,3,7,24,34,201215
Jets,3,0,7,0,10,Titans,0,7,7,0,14,201215
Falcons,7,14,0,10,31,Lions,3,3,7,5,18,201216
Saints,7,10,7,7,3,34,Cowboys,0,14,3,14,0,31,201216
Titans,0,0,0,7,7,Packers,14,6,14,21,55,201216
Colts,7,6,0,7,20,Chiefs,3,0,10,0,13,201216
Bills,0,3,0,7,10,Dolphins,7,7,10,0,24,201216
Chargers,7,3,14,3,27,Jets,14,0,0,3,17,201216
Redskins,0,13,14,0,27,Eagles,7,3,3,7,20,201216
Bengals,7,3,0,3,13,Steelers,0,7,3,0,10,201216
Rams,0,14,14,0,28,Buccaneers,3,3,7,0,13,201216
Raiders,0,3,0,3,6,Panthers,7,7,0,3,17,201216
Patriots,3,10,3,7,23,Jaguars,10,3,0,3,16,201216
Vikings,7,6,3,7,23,Texans,3,0,3,0,6,201216
Browns,3,0,3,6,12,Broncos,7,7,7,13,34,201216
Bears,7,14,7,0,28,Cardinals,3,3,0,7,13,201216
Giants,7,0,0,7,14,Ravens,14,10,3,6,33,201216
49ers,0,6,0,7,13,Seahawks,14,14,7,7,42,201216
Buccaneers,3,10,9,0,22,Falcons,3,0,7,7,17,201217
Jets,3,6,0,0,9,Bills,7,7,0,14,28,201217
Ravens,7,0,0,10,17,Bengals,0,7,6,10,23,201217
Bears,10,10,3,3,26,Lions,3,7,7,7,24,201217
Jaguars,7,7,0,6,20,Titans,7,14,14,3,38,201217
Texans,3,3,10,0,16,Colts,7,7,7,7,28,201217
Panthers,3,10,14,17,44,Saints,0,17,7,14,38,201217
Eagles,0,7,0,0,7,Giants,21,14,0,7,42,201217
Browns,0,3,7,0,10,Steelers,0,10,7,7,24,201217
Chiefs,0,3,0,0,3,Broncos,7,14,14,3,38,201217
Packers,0,10,14,10,34,Vikings,10,10,7,10,37,201217
Dolphins,0,0,0,0,0,Patriots,7,14,0,7,28,201217
Raiders,0,7,0,14,21,Chargers,10,7,7,0,24,201217
Cardinals,3,3,0,7,13,49ers,0,7,10,10,27,201217
Rams,0,7,3,3,13,Seahawks,0,3,10,7,20,201217
Cowboys,0,7,0,11,18,Redskins,0,7,7,14,28,201217
Bengals,0,7,3,3,13,Texans,3,6,7,3,19,201218
Vikings,3,0,0,7,10,Packers,7,10,7,0,24,201218
Colts,0,6,3,0,9,Ravens,0,10,7,7,24,201218
Seahawks,0,13,0,11,24,Redskins,14,0,0,0,14,201218
Ravens,14,7,7,7,3,38,Broncos,14,7,7,7,0,35,201219
Packers,14,7,3,7,31,49ers,7,17,7,14,45,201219
Seahawks,0,0,7,21,28,Falcons,10,10,7,3,30,201219
Texans,3,10,0,15,28,Patriots,7,10,14,10,41,201219
49ers,0,14,7,7,28,Falcons,10,14,0,0,24,201220
Ravens,0,7,7,14,28,Patriots,3,10,0,0,13,201220
Ravens,7,14,7,6,34,49ers,3,3,17,8,31,201222
Ravens,7,10,0,10,27,Broncos,0,14,21,14,49,201301
Patriots,10,7,0,6,23,Bills,0,14,7,0,21,201301
Bengals,7,7,7,0,21,Bears,7,3,7,7,24,201301
Dolphins,3,3,7,10,23,Browns,0,7,3,0,10,201301
Vikings,7,7,10,0,24,Lions,3,10,14,7,34,201301
Raiders,0,7,3,7,17,Colts,7,7,0,7,21,201301
Falcons,10,0,7,0,17,Saints,0,13,7,3,23,201301
Buccaneers,7,7,0,3,17,Jets,2,10,0,6,18,201301
Titans,0,7,3,6,16,Steelers,2,0,0,7,9,201301
Seahawks,0,3,3,6,12,Panthers,0,7,0,0,7,201301
Chiefs,14,7,0,7,28,Jaguars,2,0,0,0,2,201301
Cardinals,0,10,14,0,24,Rams,0,10,3,14,27,201301
Packers,7,7,7,7,28,49ers,7,7,7,13,34,201301
Giants,3,7,7,14,31,Cowboys,3,10,14,9,36,201301
Eagles,12,14,7,0,33,Redskins,7,0,7,13,27,201301
Texans,7,0,7,17,31,Chargers,7,14,7,0,28,201301
Jets,3,0,7,0,10,Patriots,10,3,0,0,13,201302
Rams,0,3,7,14,24,Falcons,14,10,0,7,31,201302
Panthers,0,7,7,9,23,Bills,0,3,11,10,24,201302
Vikings,7,14,3,6,30,Bears,14,10,0,7,31,201302
Redskins,0,0,7,13,20,Packers,10,14,14,0,38,201302
Dolphins,14,3,7,0,24,Colts,3,14,3,0,20,201302
Cowboys,10,0,3,3,16,Chiefs,7,0,7,3,17,201302
Chargers,3,10,7,13,33,Eagles,3,7,10,10,30,201302
Browns,3,3,0,0,6,Ravens,0,0,7,7,14,201302
Titans,7,3,0,14,0,24,Texans,7,0,7,10,6,30,201302
Lions,0,14,7,0,21,Cardinals,0,10,6,9,25,201302
Saints,10,0,3,3,16,Buccaneers,7,0,0,7,14,201302
Jaguars,0,3,0,6,9,Raiders,7,3,3,6,19,201302
Broncos,0,10,14,17,41,Giants,3,6,7,7,23,201302
49ers,0,0,3,0,3,Seahawks,0,5,7,17,29,201302
Steelers,3,7,0,0,10,Bengals,7,3,7,3,20,201302
Chiefs,10,6,0,10,26,Eagles,6,0,3,7,16,201303
Packers,0,16,14,0,30,Bengals,14,0,7,13,34,201303
Rams,0,0,7,0,7,Cowboys,10,7,7,7,31,201303
Chargers,7,3,7,0,17,Titans,0,10,0,10,20,201303
Browns,7,17,0,7,31,Vikings,7,10,7,3,27,201303
Buccaneers,3,0,0,0,3,Patriots,0,17,3,3,23,201303
Cardinals,7,0,0,0,7,Saints,7,7,3,14,31,201303
Lions,7,10,0,10,27,Redskins,7,7,3,3,20,201303
Giants,0,0,0,0,0,Panthers,7,10,14,7,38,201303
Texans,3,6,0,0,9,Ravens,0,17,7,6,30,201303
Falcons,7,6,7,3,23,Dolphins,0,10,10,7,27,201303
Bills,0,6,6,8,20,Jets,7,10,3,7,27,201303
Colts,7,3,3,14,27,49ers,7,0,0,0,7,201303
Jaguars,0,0,10,7,17,Seahawks,7,17,14,7,45,201303
Bears,17,7,3,13,40,Steelers,0,10,10,3,23,201303
Raiders,0,7,7,7,21,Broncos,10,17,3,7,37,201303
49ers,0,14,7,14,35,Rams,3,0,0,8,11,201304
Ravens,0,7,7,6,20,Bills,6,14,3,0,23,201304
Bengals,0,3,3,0,6,Browns,7,0,3,7,17,201304
Bears,3,10,3,16,32,Lions,3,27,7,3,40,201304
Giants,0,7,0,0,7,Chiefs,0,10,7,14,31,201304
Steelers,7,3,7,10,27,Vikings,10,10,14,0,34,201304
Cardinals,0,0,0,13,13,Buccaneers,7,3,0,0,10,201304
Colts,0,20,14,3,37,Jaguars,3,0,0,0,3,201304
Seahawks,3,0,3,14,3,23,Texans,0,20,0,0,0,20,201304
Jets,0,6,0,7,13,Titans,10,14,0,14,38,201304
Eagles,3,10,0,7,20,Broncos,14,7,21,10,52,201304
Redskins,0,10,7,7,24,Raiders,14,0,0,0,14,201304
Cowboys,0,21,0,0,21,Chargers,7,6,7,10,30,201304
Patriots,0,10,3,17,30,Falcons,3,7,0,13,23,201304
Dolphins,3,7,0,7,17,Saints,7,14,14,3,38,201304
Bills,10,0,14,0,24,Browns,0,17,7,13,37,201305
Saints,6,14,3,3,26,Bears,0,7,3,8,18,201305
Patriots,0,3,0,3,6,Bengals,0,3,3,7,13,201305
Lions,0,3,0,6,9,Packers,3,3,10,6,22,201305
Chiefs,7,6,0,13,26,Titans,0,0,10,7,17,201305
Seahawks,12,7,9,0,28,Colts,7,10,6,11,34,201305
Jaguars,10,0,3,7,20,Rams,7,17,0,10,34,201305
Ravens,3,3,10,10,26,Dolphins,3,10,0,10,23,201305
Eagles,3,16,3,14,36,Giants,7,0,14,0,21,201305
Panthers,3,3,0,0,6,Cardinals,0,3,9,10,22,201305
Broncos,7,21,10,13,51,Cowboys,14,6,13,15,48,201305
Texans,0,0,3,0,3,49ers,14,7,3,10,34,201305
Chargers,0,0,3,14,17,Raiders,14,3,7,3,27,201305
Jets,3,14,3,10,30,Falcons,0,7,7,14,28,201305
Giants,7,7,7,0,21,Bears,7,17,3,0,27,201306
Bengals,10,7,7,0,3,27,Bills,7,3,0,14,0,24,201306
Lions,7,0,7,17,31,Browns,0,17,0,0,17,201306
Raiders,0,7,0,0,7,Chiefs,0,7,7,10,24,201306
Panthers,7,7,14,7,35,Vikings,0,3,0,7,10,201306
Steelers,0,9,7,3,19,Jets,3,3,0,0,6,201306
Eagles,7,7,7,10,31,Buccaneers,3,14,0,3,20,201306
Packers,3,3,10,3,19,Ravens,0,0,3,14,17,201306
Rams,7,10,21,0,38,Texans,0,6,0,7,13,201306
Jaguars,0,12,7,0,19,Broncos,14,0,14,7,35,201306
Titans,3,7,0,3,13,Seahawks,0,7,3,10,20,201306
Saints,7,0,10,10,27,Patriots,3,14,3,10,30,201306
Cardinals,7,7,6,0,20,49ers,6,16,0,10,32,201306
Redskins,3,3,10,0,16,Cowboys,7,7,7,10,31,201306
Colts,3,3,0,3,9,Chargers,0,10,3,6,19,201306
Seahawks,7,10,14,3,34,Cardinals,0,10,3,9,22,201307
Buccaneers,0,10,7,6,23,Falcons,7,17,0,7,31,201307
Bengals,7,7,10,3,27,Lions,7,3,7,7,24,201307
Bills,14,3,0,6,23,Dolphins,0,14,7,0,21,201307
Patriots,14,7,0,6,0,27,Jets,7,3,17,0,3,30,201307
Cowboys,0,3,7,7,17,Eagles,0,0,0,3,3,201307
Bears,10,7,7,17,41,Redskins,3,21,7,14,45,201307
Rams,2,3,7,3,15,Panthers,7,10,10,3,30,201307
Chargers,7,7,3,7,24,Jaguars,0,3,3,0,6,201307
49ers,3,14,7,7,31,Titans,0,0,0,17,17,201307
Browns,0,3,3,7,13,Packers,14,3,0,14,31,201307
Texans,3,7,6,0,16,Chiefs,7,7,3,0,17,201307
Ravens,3,3,0,10,16,Steelers,7,3,3,6,19,201307
Broncos,7,7,3,16,33,Colts,10,16,7,6,39,201307
Vikings,7,0,0,0,7,Giants,3,7,7,6,23,201307
Panthers,7,7,7,10,31,Buccaneers,3,3,0,7,13,201308
Cowboys,0,10,3,17,30,Lions,7,0,0,24,31,201308
Browns,0,10,7,0,17,Chiefs,6,14,0,3,23,201308
Dolphins,7,10,0,0,17,Patriots,0,3,17,7,27,201308
Bills,0,10,0,7,17,Saints,7,14,7,7,35,201308
Giants,6,6,0,3,15,Eagles,0,0,0,7,7,201308
49ers,14,14,7,7,42,Jaguars,0,3,7,0,10,201308
Jets,0,6,3,0,9,Bengals,14,14,14,7,49,201308
Steelers,0,3,0,15,18,Raiders,14,7,0,0,21,201308
Redskins,0,7,14,0,21,Broncos,7,0,7,31,45,201308
Falcons,3,3,0,7,13,Cardinals,0,21,3,3,27,201308
Packers,7,17,7,13,44,Vikings,7,10,0,14,31,201308
Seahawks,0,7,7,0,14,Rams,3,0,3,3,9,201308
Bengals,0,3,7,10,0,20,Dolphins,0,10,7,3,2,22,201309
Chiefs,0,3,10,10,23,Bills,7,3,3,0,13,201309
Vikings,3,7,7,6,23,Cowboys,3,3,14,7,27,201309
Titans,7,0,7,14,28,Rams,0,7,7,7,21,201309
Saints,7,7,3,3,20,Jets,3,17,3,3,26,201309
Chargers,0,14,0,10,0,24,Redskins,0,7,7,10,6,30,201309
Falcons,0,10,0,0,10,Panthers,7,7,3,17,34,201309
Eagles,7,21,21,0,49,Raiders,3,10,0,7,20,201309
Buccaneers,0,21,3,0,0,24,Seahawks,0,7,7,10,3,27,201309
Ravens,3,7,0,8,18,Browns,7,7,7,3,24,201309
Steelers,0,10,14,7,31,Patriots,7,17,3,28,55,201309
Colts,0,3,9,15,27,Texans,14,7,3,0,24,201309
Bears,7,10,7,3,27,Packers,10,0,10,0,20,201309
Redskins,10,14,3,0,27,Vikings,7,7,14,6,34,201310
Seahawks,3,20,3,7,33,Falcons,0,3,7,0,10,201310
Lions,7,0,7,7,21,Bears,7,0,3,9,19,201310
Eagles,7,3,17,0,27,Packers,0,3,7,3,13,201310
Jaguars,10,3,7,9,29,Titans,0,7,3,17,27,201310
Rams,7,21,10,0,38,Colts,0,0,8,0,8,201310
Raiders,10,7,3,0,20,Giants,7,7,7,3,24,201310
Bills,3,0,0,7,10,Steelers,0,10,7,6,23,201310
Bengals,0,0,3,14,0,17,Ravens,10,7,0,0,3,20,201310
Panthers,0,7,0,3,10,49ers,3,6,0,0,9,201310
Texans,7,10,0,7,24,Cardinals,7,7,6,7,27,201310
Broncos,7,14,7,0,28,Chargers,0,6,7,7,20,201310
Cowboys,3,7,7,0,17,Saints,7,21,7,14,49,201310
Dolphins,0,7,12,0,19,Buccaneers,10,5,0,7,22,201310
Colts,0,6,17,7,30,Titans,14,3,0,10,27,201311
Jets,0,0,7,7,14,Bills,0,20,14,3,37,201311
Ravens,10,7,0,3,0,20,Bears,0,13,0,7,3,23,201311
Browns,13,0,7,0,20,Bengals,0,31,0,10,41,201311
Redskins,0,0,0,16,16,Eagles,7,10,7,0,24,201311
Lions,0,27,0,0,27,Steelers,14,6,3,14,37,201311
Falcons,0,6,7,15,28,Buccaneers,3,21,14,3,41,201311
Cardinals,7,7,10,3,27,Jaguars,14,0,0,0,14,201311
Raiders,14,0,14,0,28,Texans,0,17,0,6,23,201311
Chargers,7,3,3,3,16,Dolphins,3,7,7,3,20,201311
49ers,0,10,7,3,20,Saints,7,7,0,9,23,201311
Packers,0,6,0,7,13,Giants,7,3,10,7,27,201311
Vikings,3,10,0,7,20,Seahawks,10,14,0,17,41,201311
Chiefs,0,10,0,7,17,Broncos,10,7,7,3,27,201311
Patriots,0,3,7,10,20,Panthers,7,3,7,7,24,201311
Saints,7,7,3,0,17,Falcons,7,6,0,0,13,201312
Steelers,3,10,7,7,27,Browns,3,0,0,8,11,201312
Buccaneers,3,14,0,7,24,Lions,0,14,7,0,21,201312
Vikings,3,10,7,3,3,26,Packers,7,0,0,16,3,26,201312
Chargers,3,7,14,17,41,Chiefs,7,7,14,10,38,201312
Bears,7,7,0,7,21,Rams,21,3,3,15,42,201312
Panthers,3,3,7,7,20,Dolphins,7,9,0,0,16,201312
Jets,3,0,0,0,3,Ravens,3,6,10,0,19,201312
Jaguars,7,3,0,3,13,Texans,0,3,3,0,6,201312
Titans,3,3,7,10,23,Raiders,3,6,3,7,19,201312
Colts,3,0,0,8,11,Cardinals,7,20,7,6,40,201312
Cowboys,7,7,7,3,24,Giants,0,6,7,8,21,201312
Broncos,17,7,0,7,0,31,Patriots,0,0,21,10,3,34,201312
49ers,7,3,14,3,27,Redskins,0,6,0,0,6,201312
Packers,0,10,0,0,10,Lions,0,17,9,14,40,201313
Raiders,7,14,0,3,24,Cowboys,7,7,7,10,31,201313
Steelers,0,0,7,13,20,Ravens,7,3,6,6,22,201313
Jaguars,7,13,0,12,32,Browns,7,7,7,7,28,201313
Titans,0,7,7,0,14,Colts,6,6,3,7,22,201313
Bears,3,3,14,0,0,20,Vikings,0,7,3,10,3,23,201313
Dolphins,0,6,14,3,23,Jets,0,0,3,0,3,201313
Cardinals,0,7,7,7,21,Eagles,7,10,7,0,24,201313
Buccaneers,6,0,0,0,6,Panthers,7,10,7,3,27,201313
Patriots,7,0,14,13,34,Texans,10,7,7,7,31,201313
Falcons,7,10,7,7,3,34,Bills,14,3,7,7,0,31,201313
Rams,0,3,3,7,13,49ers,3,10,3,7,23,201313
Broncos,0,14,14,7,35,Chiefs,7,14,0,7,28,201313
Bengals,0,7,7,3,17,Chargers,0,7,0,3,10,201313
Giants,0,14,0,10,24,Redskins,7,7,3,0,17,201313
Saints,0,7,0,0,7,Seahawks,17,10,7,0,34,201313
Texans,0,7,10,3,20,Jaguars,7,10,7,3,27,201314
Colts,0,0,14,14,28,Bengals,7,7,14,14,42,201314
Falcons,0,21,0,0,21,Packers,7,3,6,6,22,201314
Browns,3,3,13,7,26,Patriots,0,0,11,16,27,201314
Raiders,0,3,14,10,27,Jets,10,10,10,7,37,201314
Lions,0,8,6,6,20,Eagles,0,0,6,28,34,201314
Dolphins,3,7,14,10,34,Steelers,7,0,14,7,28,201314
Bills,3,0,3,0,6,Buccaneers,14,10,3,0,27,201314
Chiefs,17,21,0,7,45,Redskins,0,10,0,0,10,201314
Vikings,0,3,3,20,26,Ravens,7,0,0,22,29,201314
Titans,14,7,7,0,28,Broncos,10,10,14,17,51,201314
Rams,3,0,0,7,10,Cardinals,7,7,9,7,30,201314
Giants,0,0,7,7,14,Chargers,7,17,7,6,37,201314
Seahawks,0,14,0,3,17,49ers,6,10,0,3,19,201314
Panthers,6,0,0,7,13,Saints,0,21,3,7,31,201314
Cowboys,7,7,0,14,28,Bears,7,17,11,10,45,201314
Chargers,3,14,7,3,27,Broncos,10,0,0,10,20,201315
Redskins,7,13,0,6,26,Falcons,14,3,7,3,27,201315
Bears,0,10,7,21,38,Browns,3,7,14,7,31,201315
Texans,3,0,0,0,3,Colts,7,13,5,0,25,201315
Patriots,3,7,0,10,20,Dolphins,0,7,3,14,24,201315
Eagles,3,6,13,8,30,Vikings,7,10,10,21,48,201315
Seahawks,3,10,3,7,23,Giants,0,0,0,0,0,201315
49ers,7,10,3,13,33,Buccaneers,0,7,0,7,14,201315
Bills,3,17,0,7,27,Jaguars,3,7,3,7,20,201315
Chiefs,21,14,14,7,56,Raiders,3,14,14,0,31,201315
Jets,3,3,7,7,20,Panthers,3,13,0,14,30,201315
Packers,3,0,14,20,37,Cowboys,13,13,3,7,36,201315
Cardinals,7,3,10,14,3,37,Titans,10,0,7,17,0,34,201315
Saints,0,3,0,13,16,Rams,14,10,3,0,27,201315
Bengals,0,7,0,13,20,Steelers,21,6,3,0,30,201315
Ravens,0,9,3,6,18,Lions,7,0,3,6,16,201315
Dolphins,0,0,0,0,0,Bills,3,7,0,9,19,201316
Vikings,7,0,7,0,14,Bengals,14,14,14,0,42,201316
Colts,0,13,10,0,23,Chiefs,7,0,0,0,7,201316
Buccaneers,7,3,3,0,13,Rams,0,14,3,6,23,201316
Browns,3,7,0,3,13,Jets,0,10,0,14,24,201316
Cowboys,7,7,0,10,24,Redskins,3,3,14,3,23,201316
Saints,0,6,0,7,13,Panthers,0,7,3,7,17,201316
Titans,3,3,7,7,20,Jaguars,7,6,3,0,16,201316
Broncos,3,13,0,21,37,Texans,3,3,7,0,13,201316
Giants,3,10,0,7,3,23,Lions,0,3,9,8,0,20,201316
Cardinals,0,3,3,11,17,Seahawks,0,3,0,7,10,201316
Steelers,7,3,21,7,38,Packers,7,7,7,10,31,201316
Raiders,0,10,0,3,13,Chargers,3,7,10,6,26,201316
Patriots,14,3,3,21,41,Ravens,0,0,0,7,7,201316
Bears,0,3,8,0,11,Eagles,21,3,9,21,54,201316
Falcons,0,10,0,14,24,49ers,3,0,10,21,34,201316
Panthers,0,14,7,0,21,Falcons,7,3,7,3,20,201317
Ravens,6,0,11,0,17,Bengals,7,10,0,17,34,201317
Texans,7,0,0,3,10,Titans,0,6,7,3,16,201317
Jaguars,0,3,0,7,10,Colts,17,3,7,3,30,201317
Jets,0,14,0,6,20,Dolphins,0,7,0,0,7,201317
Lions,0,0,7,6,13,Vikings,7,0,0,7,14,201317
Redskins,0,6,0,0,6,Giants,0,10,7,3,20,201317
Browns,0,0,0,7,7,Steelers,7,7,3,3,20,201317
Packers,0,13,7,13,33,Bears,7,0,14,7,28,201317
Broncos,14,17,0,3,34,Raiders,0,0,0,14,14,201317
Bills,3,0,7,10,20,Patriots,6,10,0,18,34,201317
Buccaneers,7,7,3,0,17,Saints,14,14,7,7,42,201317
49ers,17,0,0,6,23,Cardinals,0,7,0,13,20,201317
Chiefs,14,7,3,0,0,24,Chargers,7,7,0,10,3,27,201317
Rams,0,0,3,6,9,Seahawks,7,6,7,7,27,201317
Eagles,3,14,0,7,24,Cowboys,0,10,6,6,22,201317
Chiefs,10,21,10,3,44,Colts,7,3,21,14,45,201318
Saints,0,6,14,6,26,Eagles,0,7,7,10,24,201318
Chargers,7,0,10,10,27,Bengals,0,10,0,0,10,201318
49ers,6,7,0,10,23,Packers,0,10,0,10,20,201318
Saints,0,0,0,15,15,Seahawks,6,10,0,7,23,201319
Colts,7,5,10,0,22,Patriots,14,7,8,14,43,201319
49ers,6,7,7,3,23,Panthers,0,10,0,0,10,201319
Chargers,0,0,0,17,17,Broncos,7,7,3,7,24,201319
Patriots,0,3,0,13,16,Broncos,3,10,7,6,26,201320
49ers,3,7,7,0,17,Seahawks,0,3,10,10,23,201320
Seahawks,8,14,14,7,43,Broncos,0,0,8,0,8,201322
Packers,7,3,0,6,16,Seahawks,3,14,5,14,36,201401
Saints,6,14,0,14,0,34,Falcons,0,10,14,10,3,37,201401
Bills,7,10,0,3,3,23,Bears,7,0,10,3,0,20,201401
Titans,0,10,10,6,26,Chiefs,0,3,0,7,10,201401
Vikings,3,10,7,14,34,Rams,0,0,3,3,6,201401
Patriots,10,10,0,0,20,Dolphins,7,3,13,10,33,201401
Raiders,7,0,0,7,14,Jets,3,7,3,6,19,201401
Jaguars,14,3,0,0,17,Eagles,0,0,14,20,34,201401
Browns,3,0,14,10,27,Steelers,10,17,0,3,30,201401
Bengals,6,9,0,8,23,Ravens,0,0,7,9,16,201401
Redskins,0,6,0,0,6,Texans,0,14,0,3,17,201401
49ers,21,7,0,0,28,Cowboys,3,0,7,7,17,201401
Panthers,0,10,0,10,20,Buccaneers,0,0,0,14,14,201401
Colts,0,7,3,14,24,Broncos,3,21,0,7,31,201401
Giants,0,7,0,7,14,Lions,14,0,13,8,35,201401
Chargers,0,3,14,0,17,Cardinals,0,6,0,12,18,201401
Steelers,0,3,3,0,6,Ravens,7,3,7,9,26,201402
Dolphins,0,0,10,0,10,Bills,6,3,14,6,29,201402
Falcons,3,0,0,7,10,Bengals,3,7,14,0,24,201402
Saints,0,10,7,7,24,Browns,10,6,7,3,26,201402
Cowboys,3,13,7,3,26,Titans,0,0,10,0,10,201402
Patriots,10,14,3,3,30,Vikings,7,0,0,0,7,201402
Cardinals,10,0,0,15,25,Giants,0,7,7,0,14,201402
Jaguars,0,7,0,3,10,Redskins,7,14,3,17,41,201402
Lions,0,0,7,0,7,Panthers,0,6,7,11,24,201402
Seahawks,7,7,7,0,21,Chargers,3,17,7,3,30,201402
Rams,7,3,3,6,19,Buccaneers,7,0,7,3,17,201402
Chiefs,3,7,0,7,17,Broncos,7,14,0,3,24,201402
Jets,14,7,3,0,24,Packers,3,13,15,0,31,201402
Texans,14,3,10,3,30,Raiders,0,0,0,14,14,201402
Bears,0,7,0,21,28,49ers,10,7,3,0,20,201402
Eagles,3,3,14,10,30,Colts,7,10,3,7,27,201402
Buccaneers,0,0,0,14,14,Falcons,21,14,21,0,56,201403
Chargers,7,6,7,2,22,Bills,0,3,7,0,10,201403
Titans,0,0,0,7,7,Bengals,10,9,7,7,33,201403
Ravens,3,7,7,6,23,Browns,7,0,14,0,21,201403
Packers,7,0,0,0,7,Lions,7,5,0,7,19,201403
Cowboys,0,10,10,14,34,Rams,7,14,0,10,31,201403
Raiders,3,0,6,0,9,Patriots,0,10,0,6,16,201403
Vikings,0,6,3,0,9,Saints,13,0,0,7,20,201403
Texans,0,0,10,7,17,Giants,0,14,3,13,30,201403
Redskins,14,6,7,7,34,Eagles,7,14,6,10,37,201403
Colts,10,20,0,14,44,Jaguars,0,0,3,14,17,201403
49ers,7,7,0,0,14,Cardinals,3,3,14,3,23,201403
Chiefs,0,14,7,13,34,Dolphins,0,3,12,0,15,201403
Broncos,3,0,0,17,0,20,Seahawks,3,14,0,3,6,26,201403
Steelers,3,6,14,14,37,Panthers,3,0,3,13,19,201403
Bears,14,3,7,3,27,Jets,3,10,3,3,19,201403
Giants,7,17,7,14,45,Redskins,0,7,7,0,14,201404
Packers,7,14,10,7,38,Bears,7,10,0,0,17,201404
Titans,0,10,7,0,17,Colts,14,6,14,7,41,201404
Dolphins,3,21,14,0,38,Raiders,7,0,0,7,14,201404
Lions,3,14,0,7,24,Jets,3,0,7,7,17,201404
Buccaneers,10,0,7,10,27,Steelers,10,7,7,0,24,201404
Panthers,0,7,3,0,10,Ravens,0,21,7,10,38,201404
Bills,0,10,0,7,17,Texans,0,7,10,6,23,201404
Jaguars,0,14,0,0,14,Chargers,3,14,10,6,33,201404
Falcons,7,7,14,0,28,Vikings,14,10,3,14,41,201404
Eagles,7,14,0,0,21,49ers,3,10,10,3,26,201404
Saints,0,0,3,14,17,Cowboys,7,17,7,7,38,201404
Patriots,0,0,7,7,14,Chiefs,7,10,10,14,41,201404
Vikings,0,0,0,10,10,Packers,14,14,14,0,42,201405
Texans,0,0,7,10,0,17,Cowboys,0,3,7,7,3,20,201405
Bills,0,3,3,11,17,Lions,7,7,0,0,14,201405
Browns,0,10,3,16,29,Titans,7,21,0,0,28,201405
Ravens,0,3,0,10,13,Colts,3,3,7,7,20,201405
Buccaneers,0,10,14,7,0,31,Saints,6,7,7,11,6,37,201405
Falcons,7,6,7,0,20,Giants,7,3,7,13,30,201405
Rams,0,7,7,14,28,Eagles,13,7,14,0,34,201405
Bears,14,7,3,0,24,Panthers,7,7,7,10,31,201405
Steelers,0,10,0,7,17,Jaguars,3,3,3,0,9,201405
Cardinals,6,7,7,0,20,Broncos,7,14,3,17,41,201405
Jets,0,0,0,0,0,Chargers,7,14,7,3,31,201405
Chiefs,7,3,7,0,17,49ers,3,10,3,6,22,201405
Bengals,0,3,14,0,17,Patriots,14,6,14,9,43,201405
Seahawks,7,10,0,10,27,Redskins,0,7,3,7,17,201405
Colts,24,3,6,0,33,Texans,0,14,7,7,28,201406
Patriots,0,13,10,14,37,Bills,0,7,7,8,22,201406
Panthers,7,3,14,10,3,37,Bengals,0,17,0,17,3,37,201406
Steelers,3,0,0,7,10,Browns,0,21,3,7,31,201406
Jaguars,7,0,0,7,14,Titans,3,7,3,3,16,201406
Packers,7,3,7,10,27,Dolphins,3,0,7,14,24,201406
Lions,7,3,0,7,17,Vikings,0,0,0,3,3,201406
Broncos,3,14,7,7,31,Jets,7,0,3,7,17,201406
Ravens,28,10,7,3,48,Buccaneers,0,0,10,7,17,201406
Chargers,7,7,7,10,31,Raiders,7,7,7,7,28,201406
Bears,0,13,6,8,27,Falcons,3,0,10,0,13,201406
Redskins,0,13,0,7,20,Cardinals,7,7,3,13,30,201406
Cowboys,7,10,3,10,30,Seahawks,10,0,10,3,23,201406
Giants,0,0,0,0,0,Eagles,10,10,7,0,27,201406
49ers,0,10,14,7,31,Rams,14,0,0,3,17,201406
Jets,6,6,7,6,25,Patriots,7,10,3,7,27,201407
Vikings,3,10,0,3,16,Bills,0,10,0,7,17,201407
Dolphins,7,7,7,6,27,Bears,0,0,7,7,14,201407
Saints,0,10,7,6,23,Lions,0,3,7,14,24,201407
Panthers,0,3,0,14,17,Packers,21,7,10,0,38,201407
Bengals,0,0,0,0,0,Colts,3,7,7,10,27,201407
Seahawks,3,3,7,13,26,Rams,7,14,0,7,28,201407
Titans,3,7,0,7,17,Redskins,3,3,7,6,19,201407
Browns,3,3,0,0,6,Jaguars,0,7,3,14,24,201407
Falcons,0,0,0,7,7,Ravens,7,10,3,9,29,201407
Chiefs,0,10,3,10,23,Chargers,7,7,0,6,20,201407
Giants,0,14,0,7,21,Cowboys,7,7,7,10,31,201407
Cardinals,7,7,7,3,24,Raiders,0,10,3,0,13,201407
49ers,0,10,0,7,17,Broncos,14,7,21,0,42,201407
Texans,7,6,0,10,23,Steelers,0,24,0,6,30,201407
Chargers,0,7,7,7,21,Broncos,0,14,14,7,35,201408
Lions,0,0,10,12,22,Falcons,14,7,0,0,21,201408
Ravens,0,6,8,10,24,Bengals,7,0,10,10,27,201408
Texans,0,13,14,3,30,Titans,3,0,6,7,16,201408
Rams,7,0,0,0,7,Chiefs,0,10,10,14,34,201408
Bears,0,7,8,8,23,Patriots,7,31,7,6,51,201408
Bills,14,10,6,13,43,Jets,0,17,0,6,23,201408
Vikings,0,3,7,3,6,19,Buccaneers,0,0,0,13,0,13,201408
Seahawks,0,3,3,7,13,Panthers,3,3,0,3,9,201408
Dolphins,0,10,14,3,27,Jaguars,0,3,3,7,13,201408
Eagles,7,0,10,3,20,Cardinals,0,7,7,10,24,201408
Raiders,0,6,0,7,13,Browns,6,3,0,14,23,201408
Colts,3,17,14,0,34,Steelers,7,28,7,9,51,201408
Packers,10,6,0,7,23,Saints,10,6,14,14,44,201408
Redskins,3,0,7,7,3,20,Cowboys,0,7,3,7,0,17,201408
Saints,0,14,7,7,28,Panthers,0,0,7,3,10,201409
Jaguars,3,0,7,13,23,Bengals,0,12,7,14,33,201409
Buccaneers,0,10,7,0,17,Browns,3,6,7,6,22,201409
Cardinals,0,14,0,14,28,Cowboys,10,0,0,7,17,201409
Jets,0,10,0,0,10,Chiefs,14,7,3,0,24,201409
Chargers,0,0,0,0,0,Dolphins,7,13,17,0,37,201409
Redskins,3,7,10,6,26,Vikings,0,7,7,15,29,201409
Eagles,7,10,7,7,31,Texans,7,7,0,7,21,201409
Rams,3,7,0,3,13,49ers,3,7,0,0,10,201409
Broncos,7,0,14,0,21,Patriots,3,24,10,6,43,201409
Raiders,3,0,14,7,24,Seahawks,14,10,0,6,30,201409
Ravens,7,3,0,13,23,Steelers,0,22,0,21,43,201409
Colts,3,13,21,3,40,Giants,0,3,7,14,24,201409
Browns,7,10,7,0,24,Bengals,3,0,0,0,3,201410
Chiefs,3,0,0,14,17,Bills,7,3,3,0,13,201410
Dolphins,0,3,10,3,16,Lions,10,0,0,10,20,201410
49ers,14,7,0,3,3,27,Saints,3,7,7,7,0,24,201410
Steelers,0,3,0,10,13,Jets,17,0,3,0,20,201410
Falcons,7,6,3,11,27,Buccaneers,3,7,0,7,17,201410
Cowboys,10,14,7,0,31,Jaguars,7,0,0,10,17,201410
Titans,7,0,0,0,7,Ravens,0,7,7,7,21,201410
Broncos,3,17,21,0,41,Raiders,3,7,0,7,17,201410
Rams,7,7,0,0,14,Cardinals,0,10,0,21,31,201410
Giants,7,10,0,0,17,Seahawks,7,7,3,21,38,201410
Bears,0,0,7,7,14,Packers,14,28,6,7,55,201410
Panthers,7,0,0,14,21,Eagles,17,14,7,7,45,201410
Bills,3,3,3,0,9,Dolphins,3,0,9,10,22,201411
Vikings,10,0,0,3,13,Bears,0,14,0,7,21,201411
Texans,7,7,3,6,23,Browns,0,7,0,0,7,201411
Seahawks,0,13,7,0,20,Chiefs,7,7,3,7,24,201411
Broncos,0,7,0,0,7,Rams,10,3,3,6,22,201411
Bengals,7,6,7,7,27,Saints,3,0,0,7,10,201411
49ers,3,6,7,0,16,Giants,7,0,3,0,10,201411
Buccaneers,10,3,7,7,27,Redskins,0,7,0,0,7,201411
Falcons,0,6,10,3,19,Panthers,0,3,0,14,17,201411
Raiders,3,0,0,3,6,Chargers,7,3,3,0,13,201411
Eagles,0,6,7,7,20,Packers,17,13,9,14,53,201411
Lions,3,3,0,0,6,Cardinals,14,0,0,0,14,201411
Patriots,7,7,14,14,42,Colts,3,7,3,7,20,201411
Steelers,13,0,0,14,27,Titans,7,10,7,0,24,201411
Chiefs,0,3,7,10,20,Raiders,7,7,3,7,24,201412
Browns,7,6,10,3,26,Falcons,7,7,0,10,24,201412
Buccaneers,0,10,0,3,13,Bears,0,0,21,0,21,201412
Jaguars,3,0,0,0,3,Colts,3,3,14,3,23,201412
Packers,7,7,3,7,24,Vikings,0,10,3,8,21,201412
Lions,3,3,0,3,9,Patriots,7,17,3,7,34,201412
Titans,0,17,0,7,24,Eagles,17,10,7,9,43,201412
Bengals,7,2,7,6,22,Texans,0,3,10,0,13,201412
Rams,3,7,7,7,24,Chargers,3,3,14,7,27,201412
Cardinals,0,3,0,0,3,Seahawks,3,6,10,0,19,201412
Dolphins,7,14,7,8,36,Broncos,3,14,0,22,39,201412
Redskins,0,7,3,3,13,49ers,7,3,0,7,17,201412
Cowboys,3,7,14,7,31,Giants,7,14,0,7,28,201412
Jets,3,Bills,38,201412
Ravens,3,0,0,0,34,Saints,7,7,17,7,27,201412
Bears,14,0,3,0,17,Lions,3,21,0,10,34,201413
Eagles,14,9,7,3,33,Cowboys,0,7,3,0,10,201413
Seahawks,7,6,3,3,19,49ers,0,0,3,0,3,201413
Browns,3,0,0,7,10,Bills,0,0,14,12,26,201413
Redskins,3,7,14,3,27,Colts,7,14,21,7,49,201413
Raiders,0,0,0,0,0,Rams,21,17,0,14,52,201413
Panthers,3,3,7,0,13,Vikings,14,14,0,3,31,201413
Saints,0,14,14,7,35,Steelers,3,3,7,19,32,201413
Bengals,0,7,7,0,14,Buccaneers,3,7,0,3,13,201413
Giants,0,21,0,3,24,Jaguars,0,3,13,9,25,201413
Chargers,7,3,3,21,34,Ravens,10,6,7,10,33,201413
Titans,0,0,14,7,21,Texans,14,10,7,14,45,201413
Cardinals,0,10,0,8,18,Falcons,17,3,3,6,29,201413
Patriots,0,14,0,7,21,Packers,13,10,0,3,26,201413
Broncos,14,6,3,6,29,Chiefs,0,7,3,6,16,201413
Dolphins,0,3,3,10,16,Jets,7,3,3,0,13,201413
Cowboys,0,14,21,6,41,Bears,0,7,0,21,28,201414
Steelers,0,10,7,25,42,Bengals,0,14,7,0,21,201414
Colts,0,7,9,9,25,Browns,7,7,7,3,24,201414
Buccaneers,0,10,0,7,17,Lions,7,10,10,7,34,201414
Giants,17,6,10,3,36,Titans,0,0,7,0,7,201414
Ravens,0,7,7,14,28,Dolphins,10,0,0,3,13,201414
Jets,12,3,3,6,0,24,Vikings,14,7,0,3,6,30,201414
Panthers,17,7,14,3,41,Saints,0,3,0,7,10,201414
Rams,0,6,18,0,24,Redskins,0,0,0,0,0,201414
Texans,3,7,7,10,27,Jaguars,7,6,0,0,13,201414
Bills,0,3,0,14,17,Broncos,7,7,10,0,24,201414
Chiefs,7,7,0,0,14,Cardinals,3,3,11,0,17,201414
49ers,7,3,3,0,13,Raiders,3,7,7,7,24,201414
Seahawks,0,10,14,0,24,Eagles,7,0,7,0,14,201414
Patriots,3,10,0,10,23,Chargers,0,14,0,0,14,201414
Falcons,7,0,10,20,37,Packers,7,24,3,9,43,201414
Cardinals,0,6,3,3,12,Rams,3,0,0,3,6,201415
Steelers,6,14,0,7,27,Falcons,0,7,6,7,20,201415
Packers,3,7,0,3,13,Bills,7,3,6,5,21,201415
Bengals,10,10,3,7,30,Browns,0,0,0,0,0,201415
Texans,7,0,0,3,10,Colts,0,14,0,3,17,201415
Raiders,0,3,3,7,13,Chiefs,7,3,21,0,31,201415
Dolphins,3,10,0,0,13,Patriots,7,7,24,3,41,201415
Redskins,3,7,3,0,13,Giants,7,0,10,7,24,201415
Buccaneers,7,3,0,7,17,Panthers,6,3,7,3,19,201415
Jaguars,6,6,0,0,12,Ravens,7,3,7,3,20,201415
Jets,0,3,7,6,16,Titans,3,2,6,0,11,201415
Broncos,3,6,7,6,22,Chargers,0,3,0,7,10,201415
Vikings,7,7,0,0,14,Lions,0,10,3,3,16,201415
49ers,0,7,0,0,7,Seahawks,3,0,7,7,17,201415
Cowboys,14,7,7,10,38,Eagles,0,10,14,3,27,201415
Saints,0,14,10,7,31,Bears,0,0,0,15,15,201415
Titans,7,3,0,3,13,Jaguars,0,7,7,7,21,201416
Eagles,7,7,0,10,24,Redskins,10,0,14,3,27,201416
Chargers,0,7,14,14,3,38,49ers,7,21,7,0,0,35,201416
Lions,7,0,3,10,20,Bears,0,7,7,0,14,201416
Vikings,7,10,0,18,35,Dolphins,0,7,7,23,37,201416
Falcons,3,10,7,10,30,Saints,7,0,0,7,14,201416
Patriots,0,7,3,7,17,Jets,0,10,3,3,16,201416
Chiefs,3,3,0,6,12,Steelers,3,7,7,3,20,201416
Packers,7,3,0,10,20,Buccaneers,0,3,0,0,3,201416
Browns,0,3,3,7,13,Panthers,3,7,0,7,17,201416
Ravens,0,0,7,6,13,Texans,3,13,3,6,25,201416
Giants,10,10,14,3,37,Rams,3,10,7,7,27,201416
Colts,0,0,0,7,7,Cowboys,14,14,7,7,42,201416
Bills,7,3,0,14,24,Raiders,0,13,6,7,26,201416
Seahawks,0,14,0,21,35,Cardinals,0,3,3,0,6,201416
Broncos,7,0,21,0,28,Bengals,7,13,7,10,37,201416
Colts,7,10,0,10,27,Titans,0,7,3,0,10,201417
Chargers,0,7,0,0,7,Chiefs,3,13,3,0,19,201417
Jets,7,7,10,13,37,Dolphins,3,14,7,0,24,201417
Bears,0,3,3,3,9,Vikings,3,0,7,3,13,201417
Bills,7,10,0,0,17,Patriots,3,3,3,0,9,201417
Eagles,14,3,7,10,34,Giants,10,6,3,7,26,201417
Saints,0,7,0,16,23,Buccaneers,3,17,0,0,20,201417
Cowboys,17,10,0,17,44,Redskins,7,3,0,7,17,201417
Browns,0,3,7,0,10,Ravens,0,3,0,17,20,201417
Jaguars,10,0,7,0,17,Texans,7,7,0,9,23,201417
Panthers,10,14,10,0,34,Falcons,0,3,0,0,3,201417
Raiders,7,0,7,0,14,Broncos,10,10,10,17,47,201417
Lions,0,7,7,6,20,Packers,7,7,7,9,30,201417
Cardinals,7,10,0,0,17,49ers,7,6,7,0,20,201417
Rams,3,3,0,0,6,Seahawks,0,0,6,14,20,201417
Bengals,7,3,0,7,17,Steelers,7,13,0,7,27,201417
Cardinals,0,14,0,2,16,Panthers,10,3,14,0,27,201418
Ravens,0,10,10,10,30,Steelers,3,6,0,8,17,201418
Bengals,7,3,0,0,10,Colts,7,6,10,3,26,201418
Lions,14,3,3,0,20,Cowboys,0,7,7,10,24,201418
Ravens,14,7,7,3,31,Patriots,7,7,14,7,35,201419
Panthers,0,10,0,7,17,Seahawks,7,7,0,17,31,201419
Cowboys,7,7,7,0,21,Packers,7,3,10,6,26,201419
Colts,0,14,7,3,24,Broncos,7,3,0,3,13,201419
Packers,13,3,0,6,0,22,Seahawks,0,0,7,15,6,28,201420
Colts,0,7,0,0,7,Patriots,14,3,21,7,45,201420
Patriots,0,14,0,14,28,Seahawks,0,14,10,0,24,201422
Steelers,0,3,8,10,21,Patriots,0,14,7,7,28,201501
Colts,0,0,8,6,14,Bills,7,10,7,3,27,201501
Packers,7,3,7,14,31,Bears,3,10,3,7,23,201501
Seahawks,7,3,3,18,0,31,Rams,0,10,14,7,3,34,201501
Browns,0,10,0,0,10,Jets,0,14,10,7,31,201501
Dolphins,0,7,0,10,17,Redskins,3,7,0,0,10,201501
Panthers,3,7,7,3,20,Jaguars,3,6,0,0,9,201501
Chiefs,14,13,0,0,27,Texans,6,3,0,11,20,201501
Saints,3,7,3,6,19,Cardinals,7,7,3,14,31,201501
Lions,7,14,0,7,28,Chargers,3,7,10,13,33,201501
Ravens,0,3,10,0,13,Broncos,6,3,7,3,19,201501
Bengals,7,17,9,0,33,Raiders,0,0,0,13,13,201501
Titans,21,14,7,0,42,Buccaneers,0,7,0,7,14,201501
Giants,3,10,3,10,26,Cowboys,3,3,7,14,27,201501
Eagles,0,3,14,7,24,Falcons,3,17,0,6,26,201501
Vikings,0,0,0,3,3,49ers,0,7,3,10,20,201501
Broncos,0,14,3,14,31,Chiefs,0,14,3,7,24,201502
Patriots,14,10,13,3,40,Bills,7,6,0,19,32,201502
Cardinals,14,14,14,6,48,Bears,7,13,3,0,23,201502
Chargers,3,3,7,6,19,Bengals,7,7,3,7,24,201502
Titans,0,0,7,7,14,Browns,14,7,0,7,28,201502
Lions,0,10,0,6,16,Vikings,7,10,6,3,26,201502
Buccaneers,3,7,13,3,26,Saints,0,7,0,12,19,201502
Falcons,7,3,0,14,24,Giants,0,13,7,0,20,201502
49ers,0,3,0,15,18,Steelers,8,21,0,14,43,201502
Rams,0,0,10,0,10,Redskins,10,7,0,7,24,201502
Texans,3,0,7,7,17,Panthers,0,10,7,7,24,201502
Ravens,10,10,0,13,33,Raiders,10,10,10,7,37,201502
Dolphins,3,10,7,0,20,Jaguars,10,10,0,3,23,201502
Cowboys,3,3,7,7,20,Eagles,0,0,0,10,10,201502
Seahawks,3,0,14,0,17,Packers,10,3,3,11,27,201502
Jets,7,3,0,10,20,Colts,0,0,0,7,7,201502
Redskins,0,6,0,15,21,Giants,12,3,3,14,32,201503
Raiders,3,14,3,7,27,Browns,0,3,7,10,20,201503
Falcons,7,10,8,14,39,Cowboys,14,14,0,0,28,201503
Colts,7,7,0,21,35,Titans,0,10,17,6,33,201503
Steelers,3,6,0,3,12,Rams,0,3,0,3,6,201503
Chargers,0,7,0,7,14,Vikings,3,7,14,7,31,201503
Jaguars,0,3,7,7,17,Patriots,10,10,17,14,51,201503
Eagles,3,21,0,0,24,Jets,0,7,0,10,17,201503
Saints,3,7,6,6,22,Panthers,0,10,10,7,27,201503
Bengals,7,7,0,14,28,Ravens,0,0,7,17,24,201503
Buccaneers,0,9,0,0,9,Texans,7,0,3,9,19,201503
49ers,0,7,0,0,7,Cardinals,14,17,9,7,47,201503
Bills,14,13,0,14,41,Dolphins,0,0,8,6,14,201503
Bears,0,0,0,0,0,Seahawks,3,3,14,6,26,201503
Broncos,0,14,0,10,24,Lions,0,6,6,0,12,201503
Chiefs,0,7,7,14,28,Packers,14,10,7,7,38,201503
Ravens,7,0,7,6,3,23,Steelers,3,10,7,0,0,20,201504
Jets,10,10,7,0,27,Dolphins,0,7,0,7,14,201504
Texans,0,0,0,21,21,Falcons,7,21,14,6,48,201504
Giants,9,7,0,8,24,Bills,3,0,0,7,10,201504
Raiders,0,14,3,3,20,Bears,6,10,0,6,22,201504
Chiefs,3,9,3,6,21,Bengals,14,0,15,7,36,201504
Jaguars,3,10,0,0,0,13,Colts,3,7,0,3,3,16,201504
Panthers,10,7,14,6,37,Buccaneers,3,7,7,6,23,201504
Eagles,0,0,13,7,20,Redskins,6,7,3,7,23,201504
Browns,3,10,3,11,27,Chargers,7,6,7,10,30,201504
Vikings,0,10,0,10,20,Broncos,3,10,7,3,23,201504
Rams,7,3,7,7,24,Cardinals,3,6,3,10,22,201504
Packers,7,0,10,0,17,49ers,0,3,0,0,3,201504
Cowboys,3,7,3,7,0,20,Saints,7,0,6,7,6,26,201504
Lions,0,3,0,7,10,Seahawks,0,10,3,0,13,201504
Colts,10,3,7,7,27,Texans,0,10,7,3,20,201505
Redskins,0,7,0,12,0,19,Falcons,0,3,3,13,6,25,201505
Seahawks,7,3,14,0,0,24,Bengals,7,0,0,17,3,27,201505
Rams,0,10,0,0,10,Packers,14,0,7,3,24,201505
Bills,0,0,7,7,14,Titans,0,3,7,3,13,201505
Bears,3,0,3,12,18,Chiefs,7,10,0,0,17,201505
Saints,7,0,3,7,17,Eagles,0,10,16,13,39,201505
Jaguars,0,14,10,7,31,Buccaneers,3,17,11,7,38,201505
Browns,3,6,7,14,3,33,Ravens,14,0,7,9,0,30,201505
Cardinals,0,28,7,7,42,Lions,7,0,0,10,17,201505
Patriots,3,10,7,10,30,Cowboys,3,0,3,0,6,201505
Broncos,0,3,6,7,16,Raiders,0,7,0,3,10,201505
49ers,3,3,7,14,27,Giants,3,10,7,10,30,201505
Steelers,0,3,7,14,24,Chargers,7,0,0,13,20,201505
Falcons,0,7,0,14,21,Saints,14,0,10,7,31,201506
Bengals,7,10,14,3,34,Bills,7,7,0,7,21,201506
Broncos,3,7,3,10,3,26,Browns,0,0,7,16,0,23,201506
Bears,3,10,3,18,0,34,Lions,7,14,3,10,3,37,201506
Dolphins,10,7,7,14,38,Titans,3,0,7,0,10,201506
Chiefs,0,0,0,10,10,Vikings,3,7,3,3,16,201506
Redskins,7,6,0,7,20,Jets,7,3,17,7,34,201506
Cardinals,7,3,0,3,13,Steelers,0,3,12,10,25,201506
Texans,7,3,0,21,31,Jaguars,0,7,7,6,20,201506
Panthers,0,7,7,13,27,Seahawks,3,7,10,3,23,201506
Chargers,3,7,7,3,20,Packers,14,3,7,3,27,201506
Ravens,0,6,7,7,20,49ers,6,10,3,6,25,201506
Patriots,7,13,7,7,34,Colts,7,14,0,6,27,201506
Giants,7,0,0,0,7,Eagles,7,10,7,3,27,201506
Seahawks,7,10,0,3,20,49ers,0,0,3,0,3,201507
Bills,3,10,0,18,31,Jaguars,0,27,0,7,34,201507
Vikings,3,12,10,3,28,Lions,14,3,0,2,19,201507
Falcons,0,3,7,0,10,Titans,0,7,0,0,7,201507
Saints,7,13,7,0,27,Colts,0,0,14,7,21,201507
Steelers,3,0,7,3,13,Chiefs,3,6,7,7,23,201507
Browns,0,3,3,0,6,Rams,10,0,7,7,24,201507
Texans,0,0,13,13,26,Dolphins,21,20,0,3,44,201507
Jets,3,7,7,6,23,Patriots,3,10,3,14,30,201507
Buccaneers,10,14,0,6,30,Redskins,0,7,14,10,31,201507
Raiders,10,20,7,0,37,Chargers,3,3,0,23,29,201507
Cowboys,3,10,0,7,20,Giants,0,10,10,7,27,201507
Eagles,0,6,10,0,16,Panthers,7,7,7,6,27,201507
Ravens,3,7,0,8,18,Cardinals,7,7,6,6,26,201507
Dolphins,0,0,7,0,7,Patriots,7,12,3,14,36,201508
Lions,3,0,0,7,10,Chiefs,7,17,7,14,45,201508
Buccaneers,3,10,7,0,3,23,Falcons,3,0,7,10,0,20,201508
Vikings,7,3,0,13,23,Bears,3,7,3,7,20,201508
Cardinals,7,3,14,10,34,Browns,7,13,0,0,20,201508
49ers,3,3,0,0,6,Rams,2,18,0,7,27,201508
Giants,7,14,7,21,49,Saints,14,14,14,10,52,201508
Bengals,3,3,0,10,16,Steelers,7,0,3,0,10,201508
Chargers,3,13,7,3,26,Ravens,6,7,6,10,29,201508
Titans,3,0,3,0,6,Texans,0,10,7,3,20,201508
Jets,3,3,7,7,20,Raiders,7,14,10,3,34,201508
Seahawks,3,7,0,3,13,Cowboys,3,3,3,3,12,201508
Packers,0,7,3,0,10,Broncos,7,10,7,5,29,201508
Colts,0,6,0,17,3,26,Panthers,10,0,7,6,6,29,201508
Browns,3,7,0,0,10,Bengals,7,7,3,14,31,201509
Dolphins,0,7,7,3,17,Bills,9,10,7,7,33,201509
Rams,6,9,0,3,0,18,Vikings,10,0,8,0,3,21,201509
Redskins,0,3,0,7,10,Patriots,14,3,3,7,27,201509
Titans,10,7,3,8,6,34,Saints,14,7,0,7,0,28,201509
Jaguars,3,7,3,10,23,Jets,14,0,7,7,28,201509
Raiders,7,7,7,14,35,Steelers,3,18,0,17,38,201509
Packers,7,0,7,15,29,Panthers,3,24,3,7,37,201509
Falcons,3,10,0,3,16,49ers,0,17,0,0,17,201509
Giants,10,7,3,12,32,Buccaneers,6,3,3,6,18,201509
Broncos,0,7,10,7,24,Colts,7,10,0,10,27,201509
Eagles,0,7,7,13,6,33,Cowboys,7,0,7,13,0,27,201509
Bears,0,7,0,15,22,Chargers,7,9,0,3,19,201509
Bills,0,12,10,0,22,Jets,3,0,7,7,17,201510
Lions,0,3,6,9,18,Packers,3,0,0,13,16,201510
Panthers,7,7,3,10,27,Titans,7,3,0,0,10,201510
Bears,10,14,0,13,37,Rams,10,0,3,0,13,201510
Dolphins,3,10,0,7,20,Eagles,16,0,0,3,19,201510
Browns,3,0,0,6,9,Steelers,6,15,3,6,30,201510
Cowboys,3,3,0,0,6,Buccaneers,0,3,0,7,10,201510
Saints,7,7,0,0,14,Redskins,14,13,10,10,47,201510
Jaguars,7,3,3,9,22,Ravens,0,14,0,6,20,201510
Vikings,10,10,0,10,30,Raiders,0,14,0,0,14,201510
Chiefs,10,9,3,7,29,Broncos,0,0,0,13,13,201510
Patriots,7,3,7,10,27,Giants,7,10,6,3,26,201510
Cardinals,0,22,3,14,39,Seahawks,0,7,10,15,32,201510
Texans,0,3,0,7,10,Bengals,3,3,0,0,6,201510
Titans,3,3,7,0,13,Jaguars,0,6,3,10,19,201511
Colts,0,7,7,10,24,Falcons,7,7,7,0,21,201511
Broncos,7,3,0,7,17,Bears,0,6,3,6,15,201511
Raiders,0,0,13,0,13,Lions,6,3,0,9,18,201511
Cowboys,0,14,0,10,24,Dolphins,0,7,7,0,14,201511
Buccaneers,7,21,7,10,45,Eagles,7,7,0,3,17,201511
Redskins,14,0,0,2,16,Panthers,14,17,10,3,44,201511
Rams,7,0,6,0,13,Ravens,0,3,0,13,16,201511
Jets,0,3,7,7,17,Texans,0,10,14,0,24,201511
Chiefs,6,6,7,14,33,Chargers,0,3,0,0,3,201511
Packers,6,10,3,11,30,Vikings,6,0,7,0,13,201511
49ers,0,7,6,0,13,Seahawks,13,7,3,6,29,201511
Bengals,7,7,0,17,31,Cardinals,0,7,21,6,34,201511
Bills,0,3,7,3,13,Patriots,3,7,10,0,20,201511
Eagles,0,7,0,7,14,Lions,7,17,14,7,45,201512
Panthers,10,13,7,3,33,Cowboys,3,0,3,8,14,201512
Bears,0,14,0,3,17,Packers,7,6,0,0,13,201512
Vikings,7,0,3,10,20,Falcons,0,3,0,7,10,201512
Rams,0,7,0,0,7,Bengals,7,10,14,0,31,201512
Raiders,7,3,7,7,24,Titans,6,0,8,7,21,201512
Buccaneers,3,9,0,0,12,Colts,3,3,13,6,25,201512
Bills,10,6,6,0,22,Chiefs,0,14,10,6,30,201512
Dolphins,0,0,7,13,20,Jets,7,7,7,17,38,201512
Giants,0,0,0,14,14,Redskins,0,17,0,3,20,201512
Chargers,0,21,3,7,31,Jaguars,6,3,3,13,25,201512
Saints,0,6,0,0,6,Texans,14,0,10,0,24,201512
Cardinals,3,3,7,6,19,49ers,0,3,10,0,13,201512
Steelers,3,15,3,9,30,Seahawks,0,14,6,19,39,201512
Patriots,7,7,0,10,0,24,Broncos,0,7,0,17,6,30,201512
Ravens,10,7,7,9,33,Browns,0,13,7,7,27,201512
Packers,0,0,14,13,27,Lions,17,0,3,3,23,201513
Texans,6,7,0,8,21,Bills,7,14,0,9,30,201513
49ers,6,7,0,7,6,26,Bears,6,7,0,7,0,20,201513
Bengals,7,13,14,3,37,Browns,0,3,0,0,3,201513
Jaguars,0,12,7,20,39,Titans,7,14,0,21,42,201513
Cardinals,7,3,14,3,27,Rams,0,0,3,0,3,201513
Ravens,0,3,7,3,13,Dolphins,0,15,0,0,15,201513
Seahawks,7,14,14,3,38,Vikings,0,0,7,0,7,201513
Jets,3,7,0,10,3,23,Giants,0,20,0,0,0,20,201513
Falcons,0,9,3,7,19,Buccaneers,7,0,9,7,23,201513
Chiefs,7,0,7,20,34,Raiders,7,7,6,0,20,201513
Broncos,14,3,0,0,17,Chargers,0,3,0,0,3,201513
Eagles,0,14,14,7,35,Patriots,0,14,0,14,28,201513
Panthers,0,13,14,14,41,Saints,14,2,8,14,38,201513
Colts,3,7,0,0,10,Steelers,6,15,7,17,45,201513
Cowboys,0,3,3,13,19,Redskins,0,3,3,10,16,201513
Vikings,7,3,0,10,20,Cardinals,10,0,7,6,23,201514
Redskins,7,7,7,3,24,Bears,0,7,14,0,21,201514
Steelers,7,9,7,10,33,Bengals,0,7,3,10,20,201514
49ers,0,3,0,7,10,Browns,7,3,7,7,24,201514
Chargers,0,0,3,0,3,Chiefs,0,10,0,0,10,201514
Lions,0,0,7,7,14,Rams,0,7,7,7,21,201514
Titans,0,0,8,0,8,Jets,10,17,0,3,30,201514
Bills,7,3,10,0,20,Eagles,7,10,3,3,23,201514
Saints,7,10,7,0,24,Buccaneers,0,10,0,7,17,201514
Falcons,0,0,0,0,0,Panthers,21,7,10,0,38,201514
Colts,3,10,3,0,16,Jaguars,3,6,21,21,51,201514
Seahawks,7,7,7,14,35,Ravens,0,6,0,0,6,201514
Raiders,0,0,9,6,15,Broncos,6,6,0,0,12,201514
Cowboys,0,0,7,0,7,Packers,0,14,0,14,28,201514
Patriots,7,10,3,7,27,Texans,3,3,0,0,6,201514
Giants,3,14,7,7,31,Dolphins,7,10,7,0,24,201514
Buccaneers,3,0,3,17,23,Rams,14,7,7,3,31,201515
Jets,6,3,0,10,19,Cowboys,3,7,3,3,16,201515
Texans,0,3,3,10,16,Colts,0,10,0,0,10,201515
Bears,0,7,3,7,17,Vikings,7,10,7,14,38,201515
Titans,0,3,7,6,16,Patriots,7,17,3,6,33,201515
Panthers,7,14,14,3,38,Giants,7,0,7,21,35,201515
Bills,0,0,17,8,25,Redskins,7,14,7,7,35,201515
Falcons,7,10,0,6,23,Jaguars,0,3,14,0,17,201515
Chiefs,14,10,0,10,34,Ravens,7,7,0,0,14,201515
Packers,14,0,10,6,30,Raiders,0,13,7,0,20,201515
Browns,7,3,0,3,13,Seahawks,7,13,0,10,30,201515
Broncos,14,13,0,0,27,Steelers,7,6,7,14,34,201515
Dolphins,0,0,7,7,14,Chargers,6,17,0,7,30,201515
Bengals,0,21,3,0,24,49ers,0,0,7,7,14,201515
Cardinals,7,10,13,10,40,Eagles,3,7,0,7,17,201515
Lions,7,14,7,7,35,Saints,3,0,7,17,27,201515
Chargers,7,10,0,3,0,20,Raiders,7,3,2,8,3,23,201516
Redskins,13,3,14,8,38,Eagles,7,3,7,7,24,201516
Panthers,7,0,3,3,13,Falcons,0,7,7,6,20,201516
Cowboys,3,3,0,0,6,Bills,6,0,3,7,16,201516
49ers,7,10,0,0,17,Lions,3,17,3,9,32,201516
Texans,10,7,17,0,34,Titans,0,0,0,6,6,201516
Browns,0,3,7,3,13,Chiefs,10,7,0,0,17,201516
Colts,8,7,0,3,18,Dolphins,0,6,3,3,12,201516
Patriots,0,3,10,7,0,20,Jets,3,7,7,3,6,26,201516
Bears,0,13,0,13,26,Buccaneers,7,0,7,7,21,201516
Steelers,0,3,7,7,17,Ravens,7,6,0,7,20,201516
Jaguars,0,6,13,8,27,Saints,14,10,7,7,38,201516
Packers,0,0,8,0,8,Cardinals,0,17,21,0,38,201516
Rams,10,6,0,7,23,Seahawks,0,3,7,7,17,201516
Giants,0,3,7,7,17,Vikings,3,16,13,17,49,201516
Bengals,7,7,0,3,0,17,Broncos,0,3,7,7,3,20,201516
Saints,7,7,3,3,20,Falcons,3,14,0,0,17,201517
Jets,0,7,10,0,17,Bills,7,9,3,3,22,201517
Lions,7,3,7,7,24,Bears,0,0,10,10,20,201517
Ravens,0,9,0,7,16,Bengals,0,7,14,3,24,201517
Steelers,7,7,3,11,28,Browns,3,6,0,3,12,201517
Redskins,21,3,3,7,34,Cowboys,0,14,0,9,23,201517
Titans,7,7,3,7,24,Colts,10,10,7,3,30,201517
Patriots,0,3,7,0,10,Dolphins,3,7,0,10,20,201517
Eagles,14,7,7,7,35,Giants,3,17,7,3,30,201517
Jaguars,0,3,3,0,6,Texans,3,17,0,10,30,201517
Chargers,3,3,7,7,20,Broncos,7,0,7,13,27,201517
Raiders,0,10,0,7,17,Chiefs,14,0,9,0,23,201517
Seahawks,10,20,6,0,36,Cardinals,0,6,0,0,6,201517
Rams,3,13,0,0,0,16,49ers,0,10,3,3,3,19,201517
Buccaneers,3,0,7,0,10,Panthers,0,24,7,7,38,201517
Vikings,3,3,14,0,20,Packers,3,0,0,10,13,201517
Chiefs,3,3,7,7,20,Patriots,7,7,7,6,27,201519
Packers,0,6,7,7,0,20,Cardinals,7,0,3,10,6,26,201519
Seahawks,0,0,14,10,24,Panthers,14,17,0,0,31,201519
Steelers,7,3,3,3,16,Broncos,6,3,3,11,23,201519
Patriots,6,3,3,6,18,Broncos,7,10,0,3,20,201520
Cardinals,0,7,0,8,15,Panthers,17,7,10,15,49,201520
Panthers,0,7,0,3,10,Broncos,10,3,3,8,24,201522
Panthers,7,10,0,3,20,Broncos,0,7,0,14,21,201601
Buccaneers,3,14,14,0,31,Falcons,10,3,8,3,24,201601
Vikings,0,0,12,13,25,Titans,3,7,0,6,16,201601
Chargers,7,14,3,3,0,27,Chiefs,3,0,7,17,6,33,201601
Raiders,10,0,3,22,35,Saints,3,14,7,10,34,201601
Bengals,3,10,7,3,23,Jets,7,9,0,6,22,201601
Browns,0,7,3,0,10,Eagles,7,6,9,7,29,201601
Packers,7,14,3,3,27,Jaguars,7,10,3,3,23,201601
Bills,0,7,0,0,7,Ravens,3,7,0,3,13,201601
Bears,7,7,0,0,14,Texans,0,10,3,10,23,201601
Dolphins,0,3,0,7,10,Seahawks,3,3,0,6,12,201601
Giants,0,13,0,7,20,Cowboys,3,6,7,3,19,201601
Lions,7,14,7,11,39,Colts,0,10,8,17,35,201601
Patriots,10,0,7,6,23,Cardinals,0,7,7,7,21,201601
Steelers,0,14,10,14,38,Redskins,6,0,3,7,16,201601
Rams,0,0,0,0,0,49ers,7,7,0,14,28,201601
Jets,6,14,7,10,37,Bills,7,3,14,7,31,201602
Ravens,2,10,7,6,25,Browns,20,0,0,0,20,201602
Titans,0,3,0,13,16,Lions,9,3,3,0,15,201602
Dolphins,0,3,7,14,24,Patriots,14,10,7,0,31,201602
Saints,0,3,0,10,13,Giants,0,7,3,6,16,201602
Bengals,3,3,3,7,16,Steelers,7,3,7,7,24,201602
Cowboys,10,3,7,7,27,Redskins,0,10,13,0,23,201602
49ers,3,7,0,17,27,Panthers,7,10,14,15,46,201602
Chiefs,0,3,0,9,12,Texans,7,6,0,6,19,201602
Seahawks,0,3,0,0,3,Rams,3,3,0,3,9,201602
Buccaneers,0,0,7,0,7,Cardinals,0,24,9,7,40,201602
Colts,3,3,7,7,20,Broncos,3,10,3,18,34,201602
Falcons,0,13,8,14,35,Raiders,0,7,7,14,28,201602
Jaguars,0,0,0,14,14,Chargers,7,14,14,3,38,201602
Packers,7,0,0,7,14,Vikings,0,10,7,0,17,201602
Eagles,3,6,13,7,29,Bears,0,7,0,7,14,201602
Texans,0,0,0,0,0,Patriots,10,0,10,7,27,201603
Cardinals,0,7,6,5,18,Bills,10,7,13,3,33,201603
Broncos,3,13,0,13,29,Bengals,7,7,0,3,17,201603
Lions,3,7,7,10,27,Packers,14,17,3,0,34,201603
Raiders,7,10,0,0,17,Titans,3,0,7,0,10,201603
Browns,0,13,0,11,0,24,Dolphins,7,3,7,7,6,30,201603
Redskins,6,10,7,6,29,Giants,14,7,3,3,27,201603
Vikings,2,6,8,6,22,Panthers,10,0,0,0,10,201603
Ravens,7,6,3,3,19,Jaguars,0,7,7,3,17,201603
49ers,0,3,0,15,18,Seahawks,14,10,6,7,37,201603
Rams,10,7,7,13,37,Buccaneers,6,14,0,12,32,201603
Chargers,0,13,6,3,22,Colts,10,3,7,6,26,201603
Jets,0,3,0,0,3,Chiefs,7,10,0,7,24,201603
Steelers,0,3,0,0,3,Eagles,3,10,21,0,34,201603
Bears,0,3,7,7,17,Cowboys,10,14,0,7,31,201603
Falcons,7,21,10,7,45,Saints,7,10,8,7,32,201603
Dolphins,7,0,0,0,7,Bengals,10,6,3,3,22,201604
Colts,3,3,0,21,27,Jaguars,7,10,6,7,30,201604
Panthers,0,10,0,23,33,Falcons,14,3,14,17,48,201604
Lions,0,3,3,8,14,Bears,7,0,7,3,17,201604
Bills,7,6,3,0,16,Patriots,0,0,0,0,0,201604
Seahawks,0,14,3,10,27,Jets,3,7,0,7,17,201604
Browns,0,17,3,0,20,Redskins,14,3,0,14,31,201604
Raiders,7,7,0,14,28,Ravens,0,6,6,15,27,201604
Titans,3,14,3,0,20,Texans,14,6,7,0,27,201604
Broncos,7,10,3,7,27,Buccaneers,7,0,0,0,7,201604
Rams,7,3,0,7,17,Cardinals,0,10,3,0,13,201604
Saints,7,7,7,14,35,Chargers,7,17,0,10,34,201604
Cowboys,0,14,7,3,24,49ers,7,7,3,0,17,201604
Chiefs,0,0,0,14,14,Steelers,22,7,7,7,43,201604
Giants,0,3,0,7,10,Vikings,7,7,3,7,24,201604
Cardinals,0,7,14,12,33,49ers,0,7,7,7,21,201605
Patriots,16,7,7,3,33,Browns,7,0,0,6,13,201605
Eagles,0,10,10,3,23,Lions,14,7,0,3,24,201605
Bears,3,10,0,10,23,Colts,3,13,3,10,29,201605
Titans,7,14,3,6,30,Dolphins,0,14,3,0,17,201605
Texans,0,6,0,7,13,Vikings,14,10,0,7,31,201605
Jets,3,10,0,0,13,Steelers,7,7,3,14,31,201605
Redskins,6,0,10,0,16,Ravens,7,3,0,0,10,201605
Falcons,10,3,7,3,23,Broncos,0,3,0,13,16,201605
Bengals,0,0,0,14,14,Cowboys,7,14,7,0,28,201605
Chargers,0,10,14,7,31,Raiders,3,6,18,7,34,201605
Bills,7,9,7,7,30,Rams,3,10,3,3,19,201605
Giants,0,6,3,7,16,Packers,7,10,0,6,23,201605
Buccaneers,3,3,8,3,17,Panthers,0,0,14,0,14,201605
Broncos,0,3,0,10,13,Chargers,7,3,9,2,21,201606
49ers,3,10,0,3,16,Bills,7,10,7,21,45,201606
Jaguars,0,0,0,17,17,Bears,0,10,3,3,16,201606
Rams,7,7,7,7,28,Lions,7,7,7,10,31,201606
Browns,6,7,0,13,26,Titans,7,7,7,7,28,201606
Steelers,8,0,0,7,15,Dolphins,3,13,7,7,30,201606
Bengals,0,7,7,3,17,Patriots,3,7,15,10,35,201606
Panthers,0,10,7,21,38,Saints,14,10,7,10,41,201606
Ravens,10,0,3,10,23,Giants,0,7,10,10,27,201606
Eagles,0,14,0,6,20,Redskins,7,14,3,3,27,201606
Chiefs,7,6,10,3,26,Raiders,7,3,0,0,10,201606
Cowboys,7,10,3,10,30,Packers,3,3,0,10,16,201606
Falcons,0,3,21,0,24,Seahawks,7,10,0,9,26,201606
Colts,3,10,0,10,0,23,Texans,0,3,6,14,3,26,201606
Jets,0,3,0,0,3,Cardinals,7,7,7,7,28,201606
Bears,0,3,7,0,10,Packers,3,3,7,13,26,201607
Giants,0,10,0,7,17,Rams,10,0,0,0,10,201607
Browns,0,10,7,0,17,Bengals,7,14,10,0,31,201607
Redskins,0,3,0,14,17,Lions,0,3,7,10,20,201607
Colts,7,10,3,14,34,Titans,6,7,0,13,26,201607
Saints,7,0,7,7,21,Chiefs,14,7,3,3,27,201607
Bills,3,7,7,8,25,Dolphins,3,3,8,14,28,201607
Ravens,10,6,0,0,16,Jets,7,7,10,0,24,201607
Vikings,0,3,0,7,10,Eagles,0,11,7,3,21,201607
Raiders,3,17,3,10,33,Jaguars,0,6,3,7,16,201607
Chargers,7,10,3,10,3,33,Falcons,6,21,0,3,0,30,201607
Buccaneers,0,17,10,7,34,49ers,14,0,0,3,17,201607
Patriots,7,7,6,7,27,Steelers,0,10,3,3,16,201607
Seahawks,0,0,0,3,3,6,Cardinals,0,3,0,0,3,6,201607
Texans,6,0,3,0,9,Broncos,0,14,7,6,27,201607
Jaguars,0,0,8,14,22,Titans,3,24,6,3,36,201608
Redskins,7,3,7,10,0,27,Bengals,7,0,13,7,0,27,201608
Patriots,14,10,14,3,41,Bills,3,7,7,8,25,201608
Jets,0,7,14,10,31,Browns,10,10,0,8,28,201608
Chiefs,3,14,7,6,30,Colts,0,7,7,0,14,201608
Seahawks,7,7,3,3,20,Saints,0,13,3,9,25,201608
Raiders,0,3,14,7,6,30,Buccaneers,3,7,0,14,0,24,201608
Cardinals,0,7,7,6,20,Panthers,14,10,6,0,30,201608
Lions,0,3,0,10,13,Texans,0,14,3,3,20,201608
Chargers,7,0,6,6,19,Broncos,3,7,7,10,27,201608
Packers,7,17,0,8,32,Falcons,10,9,7,7,33,201608
Eagles,3,10,7,3,0,23,Cowboys,7,3,3,10,6,29,201608
Vikings,0,3,0,7,10,Bears,3,10,7,0,20,201608
Falcons,10,10,13,10,43,Buccaneers,7,7,0,14,28,201609
Cowboys,7,14,14,0,35,Browns,3,7,0,0,10,201609
Jaguars,0,7,0,7,14,Chiefs,7,3,6,3,19,201609
Jets,10,3,0,10,23,Dolphins,7,7,6,7,27,201609
Lions,3,7,0,6,6,22,Vikings,0,3,6,7,0,16,201609
Eagles,3,7,7,6,23,Giants,14,7,7,0,28,201609
Steelers,0,0,0,14,14,Ravens,7,3,3,8,21,201609
Panthers,7,0,0,6,13,Rams,0,0,0,10,10,201609
Saints,14,17,0,10,41,49ers,3,17,3,0,23,201609
Colts,14,10,0,7,31,Packers,10,0,3,13,26,201609
Titans,0,14,7,14,35,Chargers,9,10,14,10,43,201609
Broncos,0,10,0,10,20,Raiders,6,14,0,10,30,201609
Bills,14,3,0,8,25,Seahawks,7,21,0,3,31,201609
Browns,0,7,0,0,7,Ravens,0,6,15,7,28,201610
Packers,0,16,9,0,25,Titans,21,14,6,6,47,201610
Broncos,7,3,0,15,25,Saints,0,3,14,6,23,201610
Rams,3,0,3,3,9,Jets,0,6,0,0,6,201610
Falcons,0,6,3,6,15,Eagles,7,0,3,14,24,201610
Bears,3,7,0,0,10,Buccaneers,7,10,12,7,36,201610
Vikings,0,20,0,0,20,Redskins,7,7,6,6,26,201610
Chiefs,0,3,0,17,20,Panthers,3,14,0,0,17,201610
Texans,14,0,7,3,24,Jaguars,7,3,0,11,21,201610
Dolphins,0,7,14,10,31,Chargers,0,10,7,7,24,201610
49ers,0,10,3,7,20,Cardinals,7,13,0,3,23,201610
Cowboys,10,3,10,12,35,Steelers,12,3,3,12,30,201610
Seahawks,6,13,3,9,31,Patriots,7,7,7,3,24,201610
Bengals,7,3,10,0,20,Giants,7,7,0,7,21,201610
Saints,3,0,0,17,20,Panthers,3,17,3,0,23,201611
Bills,7,3,3,3,16,Bengals,6,6,0,0,12,201611
Steelers,3,11,3,7,24,Browns,0,0,3,6,9,201611
Ravens,7,3,0,7,17,Cowboys,0,10,7,10,27,201611
Jaguars,3,6,10,0,19,Lions,0,9,7,10,26,201611
Titans,0,7,7,3,17,Colts,14,7,0,3,24,201611
Buccaneers,0,9,3,7,19,Chiefs,3,7,0,7,17,201611
Cardinals,7,10,0,7,24,Vikings,7,13,10,0,30,201611
Bears,9,7,0,0,16,Giants,6,3,13,0,22,201611
Dolphins,0,0,0,14,14,Rams,7,0,3,0,10,201611
Patriots,6,7,0,17,30,49ers,3,7,0,7,17,201611
Eagles,0,7,0,8,15,Seahawks,6,10,7,3,26,201611
Packers,0,10,0,14,24,Redskins,7,6,9,20,42,201611
Texans,3,7,7,3,20,Raiders,0,10,3,14,27,201611
Vikings,7,0,3,3,13,Lions,7,3,0,6,16,201612
Redskins,0,6,0,20,26,Cowboys,7,10,0,14,31,201612
Steelers,14,7,0,7,28,Colts,0,7,0,0,7,201612
Cardinals,7,6,0,6,19,Falcons,7,10,7,14,38,201612
Jaguars,7,0,7,7,21,Bills,0,6,14,8,28,201612
Titans,7,14,3,3,27,Bears,7,0,0,14,21,201612
Giants,0,14,0,13,27,Browns,0,6,0,7,13,201612
49ers,7,0,7,10,24,Dolphins,0,14,10,7,31,201612
Rams,7,14,0,0,21,Saints,7,21,14,7,49,201612
Bengals,0,3,6,5,14,Ravens,10,6,0,3,19,201612
Chargers,0,14,0,7,21,Texans,0,7,0,6,13,201612
Seahawks,0,5,0,0,5,Buccaneers,14,0,0,0,14,201612
Panthers,7,0,18,7,32,Raiders,7,17,0,11,35,201612
Patriots,0,10,3,9,22,Jets,3,7,0,7,17,201612
Chiefs,0,9,7,8,6,30,Broncos,0,3,7,14,3,27,201612
Packers,7,7,3,10,27,Eagles,7,3,3,0,13,201612
Cowboys,0,7,0,10,17,Vikings,3,0,3,9,15,201613
Chiefs,6,14,7,2,29,Falcons,10,6,0,12,28,201613
49ers,0,6,0,0,6,Bears,0,7,14,5,26,201613
Eagles,0,0,7,7,14,Bengals,10,9,10,3,32,201613
Texans,0,0,7,6,13,Packers,0,7,0,14,21,201613
Rams,0,0,3,7,10,Patriots,7,10,6,3,26,201613
Lions,3,10,6,9,28,Saints,0,6,0,7,13,201613
Broncos,0,10,7,3,20,Jaguars,0,3,0,7,10,201613
Dolphins,0,0,0,6,6,Ravens,14,10,0,14,38,201613
Bills,3,7,14,0,24,Raiders,3,6,14,15,38,201613
Redskins,0,6,14,3,23,Cardinals,7,3,7,14,31,201613
Giants,0,0,7,7,14,Steelers,5,9,7,3,24,201613
Buccaneers,7,0,10,11,28,Chargers,7,7,7,0,21,201613
Panthers,0,7,0,0,7,Seahawks,10,13,7,10,40,201613
Colts,14,10,10,7,41,Jets,0,3,0,7,10,201613
Raiders,3,7,3,0,13,Chiefs,0,21,0,0,21,201614
Steelers,7,7,7,6,27,Bills,0,7,0,13,20,201614
Bengals,13,7,0,3,23,Browns,0,0,7,3,10,201614
Bears,3,0,7,7,17,Lions,0,10,3,7,20,201614
Broncos,0,0,0,10,10,Titans,10,3,0,0,13,201614
Texans,3,10,3,6,22,Colts,3,0,7,7,17,201614
Cardinals,6,3,0,14,23,Dolphins,7,7,7,5,26,201614
Redskins,0,7,14,6,27,Eagles,3,10,0,9,22,201614
Chargers,0,7,9,0,16,Panthers,10,13,3,2,28,201614
Vikings,6,3,3,13,25,Jaguars,0,9,7,0,16,201614
Jets,0,3,3,11,6,23,49ers,14,3,0,0,0,17,201614
Seahawks,3,0,0,7,10,Packers,7,14,7,10,38,201614
Falcons,7,14,21,0,42,Rams,0,0,0,14,14,201614
Saints,0,8,3,0,11,Buccaneers,3,10,0,3,16,201614
Cowboys,7,0,0,0,7,Giants,0,0,10,0,10,201614
Ravens,0,3,14,6,23,Patriots,9,7,7,7,30,201614
Rams,0,3,0,0,3,Seahawks,0,10,7,7,24,201615
Dolphins,0,13,21,0,34,Jets,7,3,0,3,13,201615
Browns,3,0,10,0,13,Bills,10,7,7,9,33,201615
Packers,7,3,17,3,30,Bears,0,10,0,17,27,201615
Steelers,3,6,6,9,24,Bengals,10,10,0,0,20,201615
Titans,0,7,0,12,19,Chiefs,14,3,0,0,17,201615
Colts,10,17,0,7,34,Vikings,0,0,3,3,6,201615
Lions,0,3,3,0,6,Giants,7,3,0,7,17,201615
Eagles,3,11,0,12,26,Ravens,10,10,0,7,27,201615
Jaguars,0,13,7,0,20,Texans,0,5,6,10,21,201615
49ers,0,13,0,0,13,Falcons,21,7,10,3,41,201615
Saints,10,14,3,21,48,Cardinals,7,13,7,14,41,201615
Patriots,3,7,3,3,16,Broncos,3,0,0,0,3,201615
Raiders,3,7,3,6,19,Chargers,7,3,6,0,16,201615
Buccaneers,3,3,14,0,20,Cowboys,0,17,0,9,26,201615
Panthers,10,3,10,3,26,Redskins,3,6,0,6,15,201615
Giants,3,10,3,3,19,Eagles,14,7,0,3,24,201616
Dolphins,7,7,14,3,3,34,Bills,0,7,14,10,0,31,201616
Redskins,14,10,7,10,41,Bears,0,14,0,7,21,201616
Chargers,10,0,7,0,17,Browns,7,10,3,0,20,201616
Vikings,3,10,0,12,25,Packers,14,14,0,10,38,201616
Jets,0,0,0,3,3,Patriots,10,17,7,7,41,201616
Falcons,13,7,3,10,33,Panthers,0,3,10,3,16,201616
Titans,0,7,3,7,17,Jaguars,10,9,6,13,38,201616
Colts,0,7,7,11,25,Raiders,0,19,14,0,33,201616
49ers,7,0,0,15,22,Rams,14,0,0,7,21,201616
Buccaneers,0,7,14,3,24,Saints,7,6,15,3,31,201616
Cardinals,7,7,0,20,34,Seahawks,0,3,7,21,31,201616
Bengals,0,3,0,7,10,Texans,0,0,3,9,12,201616
Ravens,3,3,11,10,27,Steelers,7,0,3,21,31,201616
Broncos,7,3,0,0,10,Chiefs,21,0,0,12,33,201616
Lions,7,14,0,0,21,Cowboys,14,7,14,7,42,201616
Ravens,3,0,0,7,10,Bengals,14,6,0,7,27,201617
Texans,0,0,10,7,17,Titans,7,7,7,3,24,201617
Jaguars,10,7,0,3,20,Colts,0,3,14,7,24,201617
Patriots,14,6,7,8,35,Dolphins,0,7,7,0,14,201617
Bears,0,10,0,0,10,Vikings,7,17,0,14,38,201617
Bills,0,3,0,7,10,Jets,0,10,10,10,30,201617
Cowboys,0,10,3,0,13,Eagles,3,7,7,10,27,201617
Browns,7,7,0,7,3,24,Steelers,0,7,0,14,6,27,201617
Panthers,7,0,3,6,16,Buccaneers,3,0,7,7,17,201617
Saints,10,3,0,19,32,Falcons,14,21,3,0,38,201617
Raiders,0,0,6,0,6,Broncos,7,10,7,0,24,201617
Cardinals,3,13,14,14,44,Rams,0,6,0,0,6,201617
Chiefs,3,17,14,3,37,Chargers,3,7,7,10,27,201617
Seahawks,3,16,3,3,25,49ers,7,7,2,7,23,201617
Giants,3,7,0,9,19,Redskins,0,0,3,7,10,201617
Packers,0,10,7,14,31,Lions,0,14,0,10,24,201617
Raiders,7,0,0,7,14,Texans,10,10,0,7,27,201618
Lions,0,3,3,0,6,Seahawks,0,10,0,16,26,201618
Dolphins,3,3,0,6,12,Steelers,14,6,10,0,30,201618
Giants,3,3,7,0,13,Packers,0,14,10,14,38,201618
Seahawks,7,3,3,7,20,Falcons,0,19,7,10,36,201619
Texans,3,10,0,3,16,Patriots,14,3,7,10,34,201619
Packers,7,14,7,6,34,Cowboys,3,10,0,18,31,201619
Steelers,6,6,3,3,18,Chiefs,7,0,3,6,16,201619
Packers,0,0,15,6,21,Falcons,10,14,13,7,44,201620
Steelers,0,9,0,8,17,Patriots,10,7,16,3,36,201620
Patriots,0,3,6,19,6,34,Falcons,0,21,7,0,0,28,201622
Chiefs,7,7,7,21,42,Patriots,7,10,10,0,27,201701
Jets,0,6,6,0,12,Bills,0,7,7,7,21,201701
Falcons,3,7,3,10,23,Bears,0,10,0,7,17,201701
Ravens,3,14,3,0,20,Bengals,0,0,0,0,0,201701
Steelers,7,7,7,0,21,Browns,7,0,3,8,18,201701
Cardinals,10,0,7,6,23,Lions,0,9,6,20,35,201701
Raiders,7,6,3,10,26,Titans,7,3,3,3,16,201701
Eagles,7,9,3,11,30,Redskins,0,14,3,0,17,201701
Jaguars,3,16,7,3,29,Texans,0,0,7,0,7,201701
Colts,3,0,0,6,9,Rams,10,17,10,9,46,201701
Seahawks,0,3,3,3,9,Packers,0,0,14,3,17,201701
Panthers,7,6,10,0,23,49ers,0,0,3,0,3,201701
Giants,0,0,3,0,3,Cowboys,3,13,0,3,19,201701
Saints,19,Vikings,29,201701
Chargers,3,3,3,10,21,Broncos,3,13,3,10,24,201701
Texans,3,7,0,3,13,Bengals,0,6,3,0,9,201702
Cardinals,0,3,0,10,3,16,Colts,10,0,0,3,0,13,201702
Eagles,3,0,7,10,20,Chiefs,3,3,7,14,27,201702
Patriots,20,10,3,3,36,Saints,3,10,0,7,20,201702
Vikings,0,3,6,0,9,Steelers,7,7,6,6,26,201702
Bears,0,0,0,7,7,Buccaneers,10,16,0,3,29,201702
Bills,0,0,0,3,3,Panthers,3,3,0,3,9,201702
Titans,3,3,17,14,37,Jaguars,3,0,0,13,16,201702
Browns,0,7,3,0,10,Ravens,7,14,0,3,24,201702
Jets,0,10,3,7,20,Raiders,7,14,7,17,45,201702
Dolphins,3,0,10,6,19,Chargers,0,10,7,0,17,201702
Cowboys,0,10,0,7,17,Broncos,7,14,14,7,42,201702
Redskins,3,17,0,7,27,Rams,0,10,7,3,20,201702
49ers,0,6,0,3,9,Seahawks,6,0,0,6,12,201702
Packers,7,0,3,13,23,Falcons,7,17,10,0,34,201702
Lions,7,10,0,7,24,Giants,0,7,3,0,10,201702
Rams,14,10,10,7,41,49ers,7,6,7,19,39,201703
Ravens,0,0,0,7,7,Jaguars,10,13,14,7,44,201703
Broncos,3,10,3,0,16,Bills,0,13,7,6,26,201703
Steelers,0,7,7,3,0,17,Bears,7,10,0,0,6,23,201703
Falcons,7,13,3,7,30,Lions,0,13,10,3,26,201703
Browns,0,14,0,14,28,Colts,7,21,0,3,31,201703
Buccaneers,3,0,14,0,17,Vikings,7,14,10,3,34,201703
Texans,10,10,7,6,33,Patriots,7,14,7,8,36,201703
Dolphins,0,0,0,6,6,Jets,0,10,10,0,20,201703
Giants,0,0,0,24,24,Eagles,0,7,7,13,27,201703
Saints,7,10,7,10,34,Panthers,3,3,7,0,13,201703
Seahawks,0,7,7,13,27,Titans,0,9,21,3,33,201703
Bengals,7,14,0,3,0,24,Packers,7,0,7,10,3,27,201703
Chiefs,14,3,0,7,24,Chargers,7,3,0,0,10,201703
Raiders,0,0,7,3,10,Redskins,7,7,7,6,27,201703
Cowboys,0,7,7,14,28,Cardinals,7,0,7,3,17,201703
Bears,0,7,0,7,14,Packers,14,7,7,7,35,201704
Saints,0,3,7,10,20,Dolphins,0,0,0,0,0,201704
Bills,0,7,7,9,23,Falcons,0,10,0,7,17,201704
Bengals,0,21,10,0,31,Browns,0,0,0,7,7,201704
Rams,3,13,10,9,35,Cowboys,3,21,0,6,30,201704
Lions,0,3,11,0,14,Vikings,0,7,0,0,7,201704
Panthers,3,14,6,10,33,Patriots,3,13,0,14,30,201704
Jaguars,7,3,0,10,0,20,Jets,7,3,10,0,3,23,201704
Steelers,3,16,0,7,26,Ravens,0,0,9,0,9,201704
Titans,0,14,0,0,14,Texans,14,16,7,20,57,201704
49ers,3,3,6,0,3,15,Cardinals,0,6,3,3,6,18,201704
Eagles,10,6,3,7,26,Chargers,0,10,0,14,24,201704
Giants,0,10,7,6,23,Buccaneers,13,3,0,9,25,201704
Raiders,0,7,0,3,10,Broncos,10,0,6,0,16,201704
Colts,2,13,3,0,18,Seahawks,3,7,22,14,46,201704
Redskins,10,0,7,3,20,Chiefs,0,7,10,12,29,201704
Patriots,3,10,3,3,19,Buccaneers,0,7,0,7,14,201705
Bills,3,7,3,3,16,Bengals,7,3,0,10,20,201705
Jets,0,3,7,7,17,Browns,0,0,7,7,14,201705
Panthers,3,14,10,0,27,Lions,3,7,0,14,24,201705
49ers,3,3,0,17,0,23,Colts,3,3,10,7,3,26,201705
Titans,0,3,7,0,10,Dolphins,10,0,0,6,16,201705
Chargers,0,10,7,10,27,Giants,9,0,7,6,22,201705
Cardinals,0,7,0,0,7,Eagles,21,0,10,3,34,201705
Jaguars,0,7,13,10,30,Steelers,3,3,3,0,9,201705
Ravens,14,10,0,6,30,Raiders,3,7,7,0,17,201705
Seahawks,0,10,3,3,16,Rams,0,10,0,0,10,201705
Packers,6,6,3,20,35,Cowboys,7,14,0,10,31,201705
Chiefs,3,20,0,19,42,Texans,0,7,6,21,34,201705
Vikings,0,3,14,3,20,Bears,2,0,7,8,17,201705
Eagles,3,7,11,7,28,Panthers,3,7,6,7,23,201706
Dolphins,0,0,14,6,20,Falcons,10,7,0,0,17,201706
Packers,0,10,0,0,10,Vikings,0,14,3,6,23,201706
Lions,7,3,14,14,38,Saints,17,14,14,7,52,201706
Patriots,0,14,7,3,24,Jets,7,7,0,3,17,201706
49ers,0,7,10,7,24,Redskins,7,10,0,9,26,201706
Bears,0,10,7,7,3,27,Ravens,0,3,7,14,0,24,201706
Browns,3,0,0,14,17,Texans,10,14,9,0,33,201706
Buccaneers,0,0,6,27,33,Cardinals,14,10,7,7,38,201706
Rams,17,7,0,3,27,Jaguars,14,0,3,0,17,201706
Steelers,2,10,0,7,19,Chiefs,3,0,0,10,13,201706
Chargers,0,7,0,10,17,Raiders,7,3,0,6,16,201706
Giants,3,14,3,3,23,Broncos,0,3,0,7,10,201706
Colts,3,10,6,3,22,Titans,6,3,6,21,36,201706
Chiefs,10,10,10,0,30,Raiders,14,0,7,10,31,201707
Buccaneers,6,0,7,14,27,Bills,3,7,7,13,30,201707
Panthers,0,3,0,0,3,Bears,7,10,0,0,17,201707
Titans,3,3,0,3,3,12,Browns,0,3,3,3,0,9,201707
Saints,0,7,9,10,26,Packers,7,7,0,3,17,201707
Jaguars,14,6,7,0,27,Colts,0,0,0,0,0,201707
Cardinals,0,0,0,0,0,Rams,3,20,3,7,33,201707
Jets,14,7,7,0,28,Dolphins,7,7,0,17,31,201707
Ravens,3,3,3,7,16,Vikings,3,6,9,6,24,201707
Cowboys,14,6,13,7,40,49ers,3,0,0,7,10,201707
Seahawks,0,3,7,14,24,Giants,0,7,0,0,7,201707
Bengals,7,7,0,0,14,Steelers,7,13,6,3,29,201707
Broncos,0,0,0,0,0,Chargers,7,7,0,7,21,201707
Falcons,0,0,0,7,7,Patriots,0,17,3,3,23,201707
Redskins,3,7,7,7,24,Eagles,0,17,7,10,34,201707
Dolphins,0,0,0,0,0,Ravens,7,13,0,20,40,201708
Vikings,3,9,11,10,33,Browns,6,7,3,0,16,201708
Raiders,7,0,0,7,14,Bills,0,14,6,14,34,201708
Colts,0,13,7,3,23,Bengals,3,7,7,7,24,201708
Chargers,7,0,0,6,13,Patriots,0,15,3,3,21,201708
Bears,0,3,3,6,12,Saints,7,7,0,6,20,201708
Falcons,7,6,3,9,25,Jets,7,10,0,3,20,201708
49ers,0,0,7,3,10,Eagles,3,14,10,6,33,201708
Panthers,7,3,0,7,17,Buccaneers,0,0,3,0,3,201708
Texans,14,7,3,14,38,Seahawks,14,7,6,14,41,201708
Cowboys,7,7,9,10,33,Redskins,10,3,0,6,19,201708
Steelers,3,7,10,0,20,Lions,3,9,0,3,15,201708
Broncos,0,3,10,6,19,Chiefs,14,3,3,9,29,201708
Bills,0,7,0,14,21,Jets,7,3,14,10,34,201709
Ravens,3,3,0,14,20,Titans,10,6,0,7,23,201709
Buccaneers,0,3,0,7,10,Saints,9,7,14,0,30,201709
Rams,7,20,21,3,51,Giants,7,3,0,7,17,201709
Broncos,3,6,0,14,23,Eagles,17,14,13,7,51,201709
Falcons,10,0,0,7,17,Panthers,0,14,6,0,20,201709
Bengals,0,7,0,0,7,Jaguars,3,10,3,7,23,201709
Colts,7,3,7,3,20,Texans,0,7,0,7,14,201709
Cardinals,7,7,0,6,20,49ers,0,3,7,0,10,201709
Redskins,0,7,3,7,17,Seahawks,2,0,0,12,14,201709
Chiefs,0,10,7,0,17,Cowboys,7,7,7,7,28,201709
Raiders,3,10,7,7,27,Dolphins,0,9,7,8,24,201709
Lions,7,7,3,13,30,Packers,0,3,0,14,17,201709
Seahawks,7,8,0,7,22,Cardinals,0,7,3,6,16,201710
Saints,7,10,20,10,47,Bills,3,0,0,7,10,201710
Packers,3,7,3,10,23,Bears,3,3,0,10,16,201710
Browns,10,0,14,0,24,Lions,3,14,7,14,38,201710
Bengals,6,7,0,7,20,Titans,7,10,0,7,24,201710
Steelers,0,3,6,11,20,Colts,0,10,7,0,17,201710
Jets,0,3,0,7,10,Buccaneers,3,0,6,6,15,201710
Vikings,7,21,7,3,38,Redskins,10,7,3,10,30,201710
Chargers,0,7,7,3,0,17,Jaguars,6,0,8,3,3,20,201710
Texans,0,7,0,0,7,Rams,3,6,21,3,33,201710
Cowboys,7,0,0,0,7,Falcons,3,7,7,10,27,201710
Giants,6,7,0,8,21,49ers,3,14,0,14,31,201710
Patriots,14,13,7,7,41,Broncos,6,3,7,0,16,201710
Dolphins,0,7,7,7,21,Panthers,3,14,21,7,45,201710
Titans,7,0,10,0,17,Steelers,10,6,7,17,40,201711
Lions,0,21,0,6,27,Bears,10,7,0,7,24,201711
Jaguars,7,3,0,9,19,Browns,0,7,0,0,7,201711
Ravens,0,6,7,10,23,Packers,0,0,0,0,0,201711
Buccaneers,3,17,0,10,30,Dolphins,7,0,6,7,20,201711
Rams,7,0,0,0,7,Vikings,0,7,0,17,24,201711
Redskins,10,7,7,7,0,31,Saints,10,3,0,18,3,34,201711
Chiefs,0,3,0,6,0,9,Giants,0,6,0,3,3,12,201711
Cardinals,0,14,7,0,21,Texans,0,10,7,14,31,201711
Bills,7,0,3,14,24,Chargers,10,27,10,7,54,201711
Bengals,6,7,0,7,20,Broncos,7,0,3,7,17,201711
Patriots,7,10,13,3,33,Raiders,0,0,0,8,8,201711
Eagles,7,0,16,14,37,Cowboys,6,3,0,0,9,201711
Falcons,14,10,7,3,34,Seahawks,7,10,6,8,31,201711
Vikings,13,7,7,3,30,Lions,0,10,6,7,23,201712
Chargers,0,3,13,12,28,Cowboys,0,0,0,6,6,201712
Giants,0,3,7,0,10,Redskins,0,3,7,10,20,201712
Buccaneers,3,3,7,7,20,Falcons,3,17,7,7,34,201712
Browns,3,3,3,7,16,Bengals,7,9,7,7,30,201712
Titans,6,0,7,7,20,Colts,0,13,3,0,16,201712
Bills,7,6,3,0,16,Chiefs,0,3,7,0,10,201712
Dolphins,0,10,0,7,17,Patriots,14,7,7,7,35,201712
Panthers,3,9,6,17,35,Jets,3,7,7,10,27,201712
Bears,0,0,3,0,3,Eagles,7,17,0,7,31,201712
Seahawks,0,7,7,10,24,49ers,0,3,3,7,13,201712
Broncos,0,0,0,14,14,Raiders,0,14,7,0,21,201712
Saints,7,3,0,10,20,Rams,10,7,3,6,26,201712
Jaguars,0,3,7,14,24,Cardinals,3,10,3,11,27,201712
Packers,14,0,7,7,28,Steelers,6,8,7,10,31,201712
Texans,7,3,3,3,16,Ravens,0,17,0,6,23,201712
Redskins,0,7,0,7,14,Cowboys,0,17,0,21,38,201713
Vikings,0,7,0,7,14,Falcons,3,3,3,0,9,201713
Patriots,3,6,14,0,23,Bills,0,3,0,0,3,201713
49ers,3,6,3,3,15,Bears,7,7,0,0,14,201713
Buccaneers,7,3,0,10,0,20,Packers,3,14,0,3,6,26,201713
Texans,3,7,0,3,13,Titans,0,10,7,7,24,201713
Broncos,0,3,6,0,9,Dolphins,2,14,10,9,35,201713
Chiefs,14,3,7,7,31,Jets,14,7,6,11,38,201713
Colts,0,3,7,0,10,Jaguars,7,9,11,3,30,201713
Lions,0,0,13,7,20,Ravens,3,17,0,24,44,201713
Browns,0,7,0,3,10,Chargers,0,9,10,0,19,201713
Giants,7,0,0,10,17,Raiders,7,3,0,14,24,201713
Panthers,7,7,0,7,21,Saints,7,14,7,3,31,201713
Rams,16,3,7,6,32,Cardinals,0,13,0,3,16,201713
Eagles,0,3,0,7,10,Seahawks,10,0,7,7,24,201713
Steelers,0,3,7,13,23,Bengals,10,7,3,0,20,201713
Saints,3,7,7,0,17,Falcons,3,7,0,10,20,201714
Colts,0,0,0,7,0,7,Bills,0,7,0,0,6,13,201714
Bears,6,6,7,14,33,Bengals,7,0,0,0,7,201714
Packers,7,0,0,14,6,27,Browns,7,7,7,0,0,21,201714
Raiders,0,0,0,15,15,Chiefs,3,13,10,0,26,201714
Cowboys,3,7,0,20,30,Giants,0,10,0,0,10,201714
Lions,7,7,7,3,24,Buccaneers,7,0,0,14,21,201714
Vikings,7,6,0,11,24,Panthers,7,7,10,7,31,201714
49ers,0,13,10,3,26,Texans,3,6,7,0,16,201714
Jets,0,0,0,0,0,Broncos,10,3,7,3,23,201714
Titans,0,7,0,0,7,Cardinals,0,0,6,6,12,201714
Redskins,0,6,0,7,13,Chargers,13,10,7,0,30,201714
Eagles,14,10,7,12,43,Rams,7,7,14,7,35,201714
Seahawks,0,0,10,14,24,Jaguars,3,0,21,6,30,201714
Ravens,0,14,17,7,38,Steelers,7,13,0,19,39,201714
Patriots,0,10,0,10,20,Dolphins,6,7,14,0,27,201714
Broncos,0,7,15,3,25,Colts,7,3,3,0,13,201715
Bears,0,3,0,7,10,Lions,3,10,7,0,20,201715
Chargers,0,6,7,0,13,Chiefs,3,7,10,10,30,201715
Dolphins,3,3,0,10,16,Bills,7,14,3,0,24,201715
Ravens,3,14,10,0,27,Browns,0,10,0,0,10,201715
Bengals,0,0,0,7,7,Vikings,17,7,3,7,34,201715
Jets,0,10,3,6,19,Saints,10,7,0,14,31,201715
Eagles,7,14,10,3,34,Giants,13,10,6,0,29,201715
Cardinals,3,6,3,3,15,Redskins,7,7,3,3,20,201715
Packers,7,7,3,7,24,Panthers,7,3,14,7,31,201715
Texans,0,0,7,0,7,Jaguars,7,24,7,7,45,201715
Rams,13,21,6,2,42,Seahawks,0,0,7,0,7,201715
Patriots,7,3,6,11,27,Steelers,7,10,7,0,24,201715
Titans,0,10,3,10,23,49ers,6,10,0,9,25,201715
Cowboys,3,7,7,3,20,Raiders,0,0,10,7,17,201715
Falcons,7,10,0,7,24,Buccaneers,7,0,7,7,21,201715
Colts,0,7,6,3,16,Ravens,3,10,3,7,23,201716
Vikings,10,0,3,3,16,Packers,0,0,0,0,0,201716
Browns,0,3,0,0,3,Bears,6,0,14,0,20,201716
Lions,7,0,3,7,17,Bengals,0,6,7,13,26,201716
Rams,6,7,7,7,27,Titans,3,10,7,3,23,201716
Dolphins,3,10,0,0,13,Chiefs,3,17,3,6,29,201716
Bills,3,10,3,0,16,Patriots,0,13,10,14,37,201716
Falcons,0,0,3,10,13,Saints,3,10,7,3,23,201716
Chargers,0,7,7,0,14,Jets,0,0,7,0,7,201716
Broncos,3,0,0,8,11,Redskins,0,10,3,14,27,201716
Buccaneers,3,6,7,3,19,Panthers,3,9,3,7,22,201716
Jaguars,0,16,3,14,33,49ers,10,6,7,21,44,201716
Seahawks,0,7,7,7,21,Cowboys,0,9,3,0,12,201716
Giants,0,0,0,0,0,Cardinals,3,7,6,7,23,201716
Steelers,10,10,7,7,34,Texans,0,0,0,6,6,201716
Raiders,0,7,3,0,10,Eagles,7,0,3,9,19,201716
Packers,3,0,0,8,11,Lions,3,17,7,8,35,201717
Texans,3,10,0,0,13,Colts,0,7,7,8,22,201717
Bears,0,7,0,3,10,Vikings,7,9,7,0,23,201717
Jets,3,0,0,3,6,Patriots,7,14,3,2,26,201717
Redskins,7,3,0,0,10,Giants,15,0,0,3,18,201717
Cowboys,0,0,0,6,6,Eagles,0,0,0,0,0,201717
Browns,0,14,10,0,24,Steelers,7,14,7,0,28,201717
Panthers,0,7,0,3,10,Falcons,7,0,6,9,22,201717
Chiefs,7,7,10,3,27,Broncos,3,7,0,14,24,201717
Jaguars,0,3,0,7,10,Titans,0,12,3,0,15,201717
49ers,10,10,7,7,34,Rams,3,3,0,7,13,201717
Bills,7,3,9,3,22,Dolphins,0,0,3,13,16,201717
Raiders,0,10,0,0,10,Chargers,0,20,10,0,30,201717
Cardinals,10,10,3,3,26,Seahawks,7,0,7,10,24,201717
Saints,14,0,3,7,24,Buccaneers,7,6,0,18,31,201717
Bengals,7,10,7,7,31,Ravens,0,10,7,10,27,201717
Titans,0,3,7,12,22,Chiefs,14,7,0,0,21,201718
Falcons,6,7,6,7,26,Rams,0,10,0,3,13,201718
Bills,0,3,0,0,3,Jaguars,0,3,7,0,10,201718
Panthers,0,9,3,14,26,Saints,7,14,3,7,31,201718
Falcons,3,7,0,0,10,Eagles,0,9,3,3,15,201719
Titans,7,0,0,7,14,Patriots,0,21,7,7,35,201719
Jaguars,14,14,0,17,45,Steelers,0,14,7,21,42,201719
Saints,0,0,7,17,24,Vikings,10,7,0,12,29,201719
Jaguars,0,14,3,3,20,Patriots,3,7,0,14,24,201720
Vikings,7,0,0,0,7,Eagles,7,17,7,7,38,201720
Eagles,9,13,7,12,41,Patriots,3,9,14,7,33,201722
Falcons,3,3,0,6,12,Eagles,0,3,7,8,18,201801
Steelers,0,7,14,0,0,21,Browns,0,0,7,14,0,21,201801
Bengals,3,7,7,17,34,Colts,3,13,7,0,23,201801
Titans,3,0,0,17,20,Dolphins,0,7,3,17,27,201801
49ers,0,3,10,3,16,Vikings,3,7,14,0,24,201801
Texans,3,3,7,7,20,Patriots,7,14,3,3,27,201801
Buccaneers,14,17,10,7,48,Saints,10,14,0,16,40,201801
Jaguars,3,10,0,7,20,Giants,3,3,3,6,15,201801
Bills,0,0,3,0,3,Ravens,14,12,14,7,47,201801
Chiefs,14,3,14,7,38,Chargers,6,6,0,16,28,201801
Seahawks,7,3,7,7,24,Broncos,7,10,3,7,27,201801
Redskins,0,21,0,3,24,Cardinals,0,0,0,6,6,201801
Cowboys,0,0,0,8,8,Panthers,0,10,0,6,16,201801
Bears,7,10,3,3,23,Packers,0,0,3,21,24,201801
Jets,7,10,31,0,48,Lions,7,3,7,0,17,201801
Rams,7,3,10,13,33,Raiders,7,6,0,0,13,201801
Ravens,0,14,3,6,23,Bengals,14,14,0,6,34,201802
Panthers,3,7,0,14,24,Falcons,3,14,7,7,31,201802
Chargers,14,14,0,3,31,Bills,0,6,7,7,20,201802
Vikings,7,0,0,22,0,29,Packers,7,10,3,9,0,29,201802
Texans,0,7,3,7,17,Titans,14,0,0,6,20,201802
Browns,3,3,6,6,18,Saints,3,0,0,18,21,201802
Dolphins,7,13,0,0,20,Jets,0,0,6,6,12,201802
Chiefs,21,0,14,7,42,Steelers,0,21,7,9,37,201802
Eagles,0,7,7,7,21,Buccaneers,7,13,7,0,27,201802
Colts,7,7,0,7,21,Redskins,0,3,3,3,9,201802
Cardinals,0,0,0,0,0,Rams,0,19,8,7,34,201802
Lions,7,3,3,14,27,49ers,3,10,14,3,30,201802
Raiders,3,9,7,0,19,Broncos,0,0,10,10,20,201802
Patriots,0,3,7,10,20,Jaguars,14,7,3,7,31,201802
Giants,0,0,3,10,13,Cowboys,10,0,3,7,20,201802
Seahawks,0,3,0,14,17,Bears,7,3,0,14,24,201802
Jets,0,14,0,3,17,Browns,0,3,11,7,21,201803
Saints,7,9,7,14,6,43,Falcons,7,7,7,16,0,37,201803
49ers,0,10,14,3,27,Chiefs,14,21,0,3,38,201803
Raiders,7,3,7,3,20,Dolphins,0,7,7,14,28,201803
Bills,17,10,0,0,27,Vikings,0,0,0,6,6,201803
Colts,7,0,6,3,16,Eagles,7,3,3,7,20,201803
Packers,0,10,7,0,17,Redskins,14,14,0,3,31,201803
Bengals,7,7,7,0,21,Panthers,7,14,7,3,31,201803
Titans,3,0,3,3,9,Jaguars,0,3,0,3,6,201803
Broncos,14,0,0,0,14,Ravens,10,10,7,0,27,201803
Giants,7,13,0,7,27,Texans,3,3,3,13,22,201803
Chargers,6,7,7,3,23,Rams,14,7,14,0,35,201803
Bears,0,3,10,3,16,Cardinals,14,0,0,0,14,201803
Cowboys,0,3,3,7,13,Seahawks,0,17,0,7,24,201803
Patriots,0,3,7,0,10,Lions,3,10,7,6,26,201803
Steelers,6,24,0,0,30,Buccaneers,7,3,3,14,27,201803
Vikings,7,13,8,3,31,Rams,7,21,10,0,38,201804
Bengals,14,14,0,9,37,Falcons,7,17,3,9,36,201804
Buccaneers,0,3,0,7,10,Bears,14,24,7,3,48,201804
Lions,7,3,0,14,24,Cowboys,3,10,7,6,26,201804
Bills,0,0,0,0,0,Packers,6,10,3,3,22,201804
Eagles,0,10,7,3,3,23,Titans,3,0,7,10,6,26,201804
Texans,14,7,7,3,6,37,Colts,7,3,7,14,3,34,201804
Dolphins,0,0,0,7,7,Patriots,3,21,7,7,38,201804
Jets,0,0,3,9,12,Jaguars,3,13,9,6,31,201804
Browns,3,14,11,14,0,42,Raiders,7,7,7,21,3,45,201804
Seahawks,7,0,10,3,20,Cardinals,0,10,0,7,17,201804
Saints,0,12,7,14,33,Giants,7,0,3,8,18,201804
49ers,14,3,7,3,27,Chargers,6,11,9,3,29,201804
Ravens,14,0,3,9,26,Steelers,0,14,0,0,14,201804
Chiefs,3,7,3,14,27,Broncos,3,10,7,3,23,201804
Colts,0,3,7,14,24,Patriots,7,17,0,14,38,201805
Titans,3,3,0,6,12,Bills,7,0,3,3,13,201805
Dolphins,0,14,3,0,17,Bengals,0,0,3,24,27,201805
Ravens,3,0,3,3,0,9,Browns,0,6,3,0,3,12,201805
Packers,0,0,14,9,23,Lions,14,10,0,7,31,201805
Jaguars,0,0,7,7,14,Chiefs,7,13,3,7,30,201805
Broncos,7,3,0,6,16,Jets,0,21,3,10,34,201805
Falcons,0,10,0,7,17,Steelers,13,0,14,14,41,201805
Giants,3,10,3,15,31,Panthers,7,13,0,13,33,201805
Raiders,0,3,0,7,10,Chargers,3,14,3,6,26,201805
Vikings,3,14,3,3,23,Eagles,0,3,3,15,21,201805
Cardinals,7,7,0,14,28,49ers,6,0,0,12,18,201805
Rams,7,10,7,9,33,Seahawks,7,10,14,0,31,201805
Cowboys,6,0,7,3,0,16,Texans,0,10,3,3,3,19,201805
Redskins,3,10,0,6,19,Saints,6,20,14,3,43,201805
Eagles,14,10,7,3,34,Giants,3,3,7,0,13,201806
Buccaneers,6,7,3,13,29,Falcons,7,17,0,10,34,201806
Steelers,0,14,3,11,28,Bengals,7,7,0,7,21,201806
Chargers,7,14,14,3,38,Browns,0,6,0,8,14,201806
Seahawks,7,10,3,7,27,Raiders,0,0,0,3,3,201806
Bears,0,0,21,7,0,28,Dolphins,7,0,6,15,3,31,201806
Cardinals,3,7,0,7,17,Vikings,10,3,14,0,27,201806
Colts,7,6,7,14,34,Jets,10,13,10,9,42,201806
Panthers,0,6,3,8,17,Redskins,14,3,0,6,23,201806
Bills,0,0,6,7,13,Texans,7,3,0,10,20,201806
Rams,6,7,7,3,23,Broncos,3,0,7,10,20,201806
Jaguars,0,0,7,0,7,Cowboys,10,14,6,10,40,201806
Ravens,7,7,7,0,21,Titans,0,0,0,0,0,201806
Chiefs,6,3,17,14,40,Patriots,10,14,3,16,43,201806
49ers,14,10,3,3,30,Packers,17,3,3,10,33,201806
Broncos,21,14,7,3,45,Cardinals,3,0,7,0,10,201807
Titans,3,3,7,6,19,Chargers,10,0,7,3,20,201807
Patriots,7,14,10,7,38,Bears,10,7,7,7,31,201807
Bills,0,0,5,0,5,Colts,0,24,0,13,37,201807
Lions,7,10,9,6,32,Dolphins,0,7,7,7,21,201807
Vikings,7,3,10,17,37,Jets,7,0,3,7,17,201807
Panthers,0,0,0,21,21,Eagles,0,10,7,0,17,201807
Browns,2,0,7,14,0,23,Buccaneers,3,13,7,0,3,26,201807
Texans,6,7,7,0,20,Jaguars,0,0,7,0,7,201807
Saints,0,7,0,17,24,Ravens,0,10,7,6,23,201807
Rams,3,19,10,7,39,49ers,0,7,3,0,10,201807
Cowboys,0,7,0,10,17,Redskins,7,0,3,10,20,201807
Bengals,0,7,3,0,10,Chiefs,7,17,14,7,45,201807
Giants,0,3,3,14,20,Falcons,0,10,0,13,23,201807
Dolphins,7,3,10,3,23,Texans,7,7,14,14,42,201808
Eagles,0,10,7,7,24,Jaguars,3,3,6,6,18,201808
Jets,0,3,0,7,10,Bears,7,0,7,10,24,201808
Buccaneers,0,9,7,18,34,Bengals,7,20,7,3,37,201808
Seahawks,0,21,0,7,28,Lions,7,0,0,7,14,201808
Broncos,7,7,0,9,23,Chiefs,3,13,14,0,30,201808
Redskins,7,0,3,10,20,Giants,0,3,0,10,13,201808
Browns,6,0,6,6,18,Steelers,0,14,9,10,33,201808
Ravens,7,0,7,7,21,Panthers,7,17,3,9,36,201808
Colts,10,3,8,21,42,Raiders,0,14,14,0,28,201808
Packers,7,3,10,7,27,Rams,0,8,15,6,29,201808
49ers,2,3,7,3,15,Cardinals,0,3,0,15,18,201808
Saints,7,10,10,3,30,Vikings,7,6,0,7,20,201808
Patriots,3,6,3,13,25,Bills,0,3,3,0,6,201808
Raiders,3,0,0,0,3,49ers,7,10,14,3,34,201809
Bears,0,28,3,10,41,Bills,0,0,3,6,9,201809
Chiefs,7,14,13,3,37,Browns,3,12,0,6,21,201809
Jets,0,3,0,3,6,Dolphins,0,6,0,7,13,201809
Lions,0,6,0,3,9,Vikings,7,10,0,7,24,201809
Falcons,7,14,7,10,38,Redskins,0,7,7,0,14,201809
Buccaneers,0,14,7,7,28,Panthers,14,21,0,7,42,201809
Steelers,7,7,6,3,23,Ravens,3,3,7,3,16,201809
Texans,7,9,0,3,19,Broncos,3,7,7,0,17,201809
Chargers,6,13,0,6,25,Seahawks,7,3,0,7,17,201809
Rams,7,10,10,8,35,Saints,14,21,0,10,45,201809
Packers,3,7,7,0,17,Patriots,7,10,0,14,31,201809
Titans,0,14,7,7,28,Cowboys,7,7,0,0,14,201809
Panthers,7,7,0,7,21,Steelers,21,10,14,7,52,201810
Lions,0,7,3,12,22,Bears,13,13,8,0,34,201810
Saints,7,28,10,6,51,Bengals,7,0,0,7,14,201810
Falcons,0,10,0,6,16,Browns,7,7,14,0,28,201810
Patriots,3,7,0,0,10,Titans,17,7,3,7,34,201810
Jaguars,7,9,7,3,26,Colts,14,15,0,0,29,201810
Cardinals,7,0,7,0,14,Chiefs,10,10,0,6,26,201810
Bills,14,17,7,3,41,Jets,0,3,7,0,10,201810
Redskins,3,3,0,10,16,Buccaneers,0,3,0,0,3,201810
Chargers,0,10,7,3,20,Raiders,3,0,0,3,6,201810
Dolphins,3,6,3,0,12,Packers,7,7,14,3,31,201810
Seahawks,14,0,7,10,31,Rams,7,10,3,16,36,201810
Cowboys,3,10,0,14,27,Eagles,0,3,10,7,20,201810
Giants,7,3,10,7,27,49ers,3,10,7,3,23,201810
Packers,14,7,0,3,24,Seahawks,3,14,0,10,27,201811
Cowboys,3,0,3,16,22,Falcons,0,6,3,10,19,201811
Panthers,7,0,0,12,19,Lions,7,3,3,7,20,201811
Titans,0,3,0,7,10,Colts,7,17,7,7,38,201811
Buccaneers,0,7,7,21,35,Giants,7,7,10,14,38,201811
Texans,10,7,3,3,23,Redskins,0,7,7,7,21,201811
Steelers,0,0,6,14,20,Jaguars,0,9,7,0,16,201811
Bengals,0,7,14,0,21,Ravens,7,6,8,3,24,201811
Raiders,7,7,6,3,23,Cardinals,14,0,0,7,21,201811
Broncos,0,7,7,9,23,Chargers,6,7,6,3,22,201811
Eagles,0,7,0,0,7,Saints,10,14,14,10,48,201811
Vikings,0,0,3,17,20,Bears,3,11,0,11,25,201811
Chiefs,7,16,7,21,51,Rams,13,10,17,14,54,201811
Bears,0,9,0,14,23,Lions,0,7,6,3,16,201812
Redskins,0,7,6,10,23,Cowboys,7,3,14,7,31,201812
Falcons,3,0,7,7,17,Saints,7,10,7,7,31,201812
Jaguars,0,14,0,7,21,Bills,14,0,0,10,24,201812
Browns,14,14,7,0,35,Bengals,0,7,7,6,20,201812
Patriots,7,3,10,7,27,Jets,7,3,3,0,13,201812
Giants,9,10,0,3,22,Eagles,0,11,3,11,25,201812
49ers,0,6,3,0,9,Buccaneers,7,6,7,7,27,201812
Seahawks,0,10,7,13,30,Panthers,3,10,7,7,27,201812
Raiders,7,3,7,0,17,Ravens,3,10,7,14,34,201812
Cardinals,10,0,0,0,10,Chargers,0,28,14,3,45,201812
Steelers,0,10,7,0,17,Broncos,3,7,7,7,24,201812
Dolphins,7,7,3,7,24,Colts,7,7,0,13,27,201812
Packers,7,7,0,3,17,Vikings,7,7,10,0,24,201812
Titans,10,0,7,0,17,Texans,7,17,3,7,34,201812
Saints,0,0,10,0,10,Cowboys,10,3,0,0,13,201813
Ravens,7,3,6,10,26,Falcons,3,7,0,6,16,201813
Broncos,0,7,14,3,24,Bengals,0,3,7,0,10,201813
Rams,3,10,3,14,30,Lions,0,3,10,3,16,201813
Cardinals,0,7,10,3,20,Packers,0,10,0,7,17,201813
Bills,0,6,3,8,17,Dolphins,7,7,0,7,21,201813
Bears,7,7,0,13,0,27,Giants,7,3,14,3,3,30,201813
Panthers,7,0,10,0,17,Buccaneers,10,7,7,0,24,201813
Colts,0,0,0,0,0,Jaguars,0,3,0,3,6,201813
Browns,0,0,7,6,13,Texans,10,13,3,3,29,201813
Jets,10,6,6,0,22,Titans,0,6,7,13,26,201813
Chiefs,10,9,14,7,40,Raiders,0,7,9,17,33,201813
Vikings,0,7,3,0,10,Patriots,7,3,7,7,24,201813
49ers,0,3,7,6,16,Seahawks,6,14,7,16,43,201813
Chargers,7,0,8,18,33,Steelers,13,10,0,7,30,201813
Redskins,0,13,0,0,13,Eagles,7,7,0,14,28,201813
Jaguars,2,0,7,0,9,Titans,7,9,14,0,30,201814
Jets,3,10,0,14,27,Bills,14,3,3,3,23,201814
Panthers,7,10,3,0,20,Browns,7,10,0,9,26,201814
Falcons,7,0,0,13,20,Packers,7,13,14,0,34,201814
Ravens,0,10,7,7,0,24,Chiefs,7,10,0,7,3,27,201814
Patriots,6,21,0,6,33,Dolphins,7,14,7,6,34,201814
Saints,0,3,8,17,28,Buccaneers,7,7,0,0,14,201814
Giants,7,27,6,0,40,Redskins,0,0,0,16,16,201814
Colts,0,17,7,0,24,Texans,7,0,7,7,21,201814
Bengals,3,9,0,9,21,Chargers,7,10,3,6,26,201814
Broncos,0,0,7,7,14,49ers,3,17,0,0,20,201814
Eagles,0,0,6,17,0,23,Cowboys,3,3,3,14,6,29,201814
Steelers,0,14,0,7,21,Raiders,7,3,0,14,24,201814
Lions,0,3,7,7,17,Cardinals,0,0,0,3,3,201814
Rams,3,3,0,0,6,Bears,3,3,9,0,15,201814
Vikings,0,0,0,7,7,Seahawks,0,3,0,18,21,201814
Chargers,0,7,7,15,29,Chiefs,14,0,7,7,28,201815
Texans,3,13,0,13,29,Jets,3,6,6,7,22,201815
Browns,7,3,0,7,17,Broncos,7,3,3,3,16,201815
Cardinals,7,0,0,7,14,Falcons,10,16,7,7,40,201815
Lions,0,13,0,0,13,Bills,0,7,0,7,14,201815
Packers,0,3,11,3,17,Bears,7,7,0,10,24,201815
Raiders,0,7,6,3,16,Bengals,7,13,0,10,30,201815
Cowboys,0,0,0,0,0,Colts,7,3,10,3,23,201815
Dolphins,0,10,7,0,17,Vikings,21,0,3,17,41,201815
Titans,7,0,7,3,17,Giants,0,0,0,0,0,201815
Redskins,3,0,3,10,16,Jaguars,0,10,0,3,13,201815
Buccaneers,0,9,3,0,12,Ravens,0,10,7,3,20,201815
Seahawks,6,7,0,10,0,23,49ers,7,10,3,3,3,26,201815
Patriots,7,0,3,0,10,Steelers,7,7,0,3,17,201815
Eagles,3,10,17,0,30,Rams,7,6,0,10,23,201815
Saints,3,3,0,6,12,Panthers,7,0,0,2,9,201815
Redskins,3,7,3,3,16,Titans,6,3,0,16,25,201816
Ravens,3,3,10,6,22,Chargers,0,3,7,0,10,201816
Bengals,0,0,0,18,18,Browns,0,16,7,3,26,201816
Buccaneers,3,10,0,7,20,Cowboys,14,3,10,0,27,201816
Vikings,0,14,3,10,27,Lions,3,6,0,0,9,201816
Giants,14,3,7,3,27,Colts,0,7,14,7,28,201816
Jaguars,7,0,0,10,17,Dolphins,7,0,0,0,7,201816
Bills,0,0,6,6,12,Patriots,7,7,7,3,24,201816
Packers,0,17,3,18,6,44,Jets,7,14,14,3,0,38,201816
Texans,0,16,0,14,30,Eagles,7,6,10,9,32,201816
Falcons,7,3,14,0,24,Panthers,7,3,0,0,10,201816
Rams,7,14,3,7,31,Cardinals,3,6,0,0,9,201816
Bears,0,7,7,0,14,49ers,0,9,0,0,9,201816
Steelers,3,11,14,0,28,Saints,7,10,7,7,31,201816
Chiefs,3,7,7,14,31,Seahawks,7,7,10,14,38,201816
Broncos,0,0,7,7,14,Raiders,7,10,0,10,27,201816
Dolphins,0,14,3,0,17,Bills,14,0,14,14,42,201817
Lions,7,14,3,7,31,Packers,0,0,0,0,0,201817
Jets,3,0,0,0,3,Patriots,7,14,7,10,38,201817
Panthers,13,10,7,3,33,Saints,0,0,0,14,14,201817
Cowboys,0,14,7,15,36,Giants,0,7,11,17,35,201817
Falcons,0,7,17,10,34,Buccaneers,7,10,3,12,32,201817
Jaguars,3,0,0,0,3,Texans,3,14,0,3,20,201817
Chargers,0,7,7,9,23,Broncos,0,3,0,6,9,201817
Raiders,0,3,0,0,3,Chiefs,14,7,7,7,35,201817
49ers,3,7,7,15,32,Rams,14,17,14,3,48,201817
Bears,7,6,0,11,24,Vikings,0,3,7,0,10,201817
Bengals,0,10,0,3,13,Steelers,0,3,7,6,16,201817
Cardinals,3,10,8,3,24,Seahawks,7,7,7,6,27,201817
Eagles,3,7,7,7,24,Redskins,0,0,0,0,0,201817
Browns,7,0,7,10,24,Ravens,10,10,3,3,26,201817
Colts,7,10,7,9,33,Titans,0,10,7,0,17,201817
Colts,14,7,0,0,21,Texans,0,0,0,7,7,201818
Seahawks,0,6,8,8,22,Cowboys,3,7,0,14,24,201818
Chargers,6,6,0,11,23,Ravens,0,0,3,14,17,201818
Eagles,3,0,7,6,16,Bears,0,6,0,9,15,201818
Colts,0,7,0,6,13,Chiefs,14,10,0,7,31,201819
Cowboys,7,0,8,7,22,Rams,3,17,3,7,30,201819
Chargers,7,0,7,14,28,Patriots,14,21,3,3,41,201819
Eagles,14,0,0,0,14,Saints,0,10,7,3,20,201819
Rams,0,10,7,6,3,26,Saints,13,0,7,3,0,23,201820
Patriots,7,7,3,14,6,37,Chiefs,0,0,7,24,0,31,201820
Patriots,0,3,0,10,13,Rams,0,0,3,0,3,201822
Packers,0,7,0,3,10,Bears,3,0,0,0,3,201901
Titans,3,9,10,21,43,Browns,6,0,7,0,13,201901
Ravens,21,21,10,7,59,Dolphins,0,10,0,0,10,201901
Falcons,0,0,0,12,12,Vikings,14,7,7,0,28,201901
Bills,0,0,3,14,17,Jets,6,0,10,0,16,201901
Washington,10,10,0,7,27,Eagles,0,7,14,11,32,201901
Rams,0,13,10,7,30,Panthers,0,3,10,14,27,201901
Chiefs,17,6,7,10,40,Jaguars,7,6,0,13,26,201901
Colts,0,6,10,8,0,24,Chargers,7,10,7,0,6,30,201901
Bengals,3,14,0,3,20,Seahawks,0,14,0,7,21,201901
Giants,7,0,3,7,17,Cowboys,7,14,14,0,35,201901
Lions,0,17,0,7,3,27,Cardinals,0,3,3,18,3,27,201901
49ers,3,3,14,11,31,Buccaneers,0,7,7,3,17,201901
Steelers,0,0,3,0,3,Patriots,7,13,10,3,33,201901
Texans,0,14,7,7,28,Saints,0,3,14,13,30,201901
Broncos,0,0,6,10,16,Raiders,7,7,0,10,24,201901
Buccaneers,3,7,7,3,20,Panthers,3,6,3,2,14,201902
49ers,14,10,10,7,41,Bengals,7,3,0,7,17,201902
Chargers,7,3,0,0,10,Lions,6,0,0,7,13,201902
Vikings,0,10,6,0,16,Packers,14,7,0,0,21,201902
Colts,7,6,0,6,19,Titans,0,7,10,0,17,201902
Patriots,7,6,10,20,43,Dolphins,0,0,0,0,0,201902
Bills,7,14,0,7,28,Giants,7,0,0,7,14,201902
Seahawks,0,7,14,7,28,Steelers,0,10,3,13,26,201902
Cowboys,0,14,7,10,31,Washington,0,7,7,7,21,201902
Cardinals,3,3,3,8,17,Ravens,7,10,0,6,23,201902
Jaguars,0,3,0,9,12,Texans,3,3,0,7,13,201902
Chiefs,0,28,0,0,28,Raiders,10,0,0,0,10,201902
Bears,0,6,7,3,16,Broncos,3,0,0,11,14,201902
Saints,0,3,3,3,9,Rams,3,3,14,7,27,201902
Eagles,0,6,6,8,20,Falcons,3,7,7,7,24,201902
Browns,6,10,7,0,23,Jets,0,3,0,0,3,201902
Titans,0,0,0,7,7,Jaguars,14,0,3,3,20,201903
Bengals,0,0,7,10,17,Bills,8,6,0,7,21,201903
Dolphins,3,3,0,0,6,Cowboys,10,0,14,7,31,201903
Broncos,0,10,6,0,16,Packers,7,10,7,3,27,201903
Falcons,0,3,7,14,24,Colts,10,10,0,7,27,201903
Ravens,6,0,7,15,28,Chiefs,0,23,7,3,33,201903
Raiders,0,7,0,7,14,Vikings,7,14,7,6,34,201903
Jets,0,0,7,7,14,Patriots,13,7,10,0,30,201903
Lions,7,13,0,7,27,Eagles,10,0,7,7,24,201903
Panthers,0,14,14,10,38,Cardinals,7,3,10,0,20,201903
Giants,3,7,15,7,32,Buccaneers,12,16,0,3,31,201903
Texans,0,7,14,6,27,Chargers,7,10,0,3,20,201903
Steelers,6,0,7,7,20,49ers,0,3,14,7,24,201903
Saints,7,13,7,6,33,Seahawks,7,0,0,20,27,201903
Rams,3,0,7,10,20,Browns,0,6,7,0,13,201903
Bears,7,21,0,3,31,Washington,0,3,6,6,15,201903
Eagles,0,21,6,7,34,Packers,7,13,7,0,27,201904
Titans,14,10,0,0,24,Falcons,7,0,3,0,10,201904
Patriots,13,0,3,0,16,Bills,0,3,7,0,10,201904
Chiefs,0,13,7,14,34,Lions,10,3,10,7,30,201904
Raiders,14,7,3,7,31,Colts,7,3,0,14,24,201904
Chargers,10,7,3,10,30,Dolphins,7,3,0,0,10,201904
Washington,0,3,0,0,3,Giants,7,10,7,0,24,201904
Browns,7,3,14,16,40,Ravens,0,7,3,15,25,201904
Panthers,3,7,0,6,16,Texans,0,3,7,0,10,201904
Buccaneers,7,21,3,24,55,Rams,0,17,3,20,40,201904
Seahawks,10,10,0,7,27,Cardinals,0,3,0,7,10,201904
Vikings,0,0,0,6,6,Bears,7,3,6,0,16,201904
Jaguars,3,3,14,6,26,Broncos,7,10,0,7,24,201904
Cowboys,3,0,7,0,10,Saints,0,9,0,3,12,201904
Bengals,3,0,0,0,3,Steelers,0,10,14,3,27,201904
Rams,6,7,13,3,29,Seahawks,7,7,7,9,30,201905
Cardinals,7,6,0,13,26,Bengals,3,3,3,14,23,201905
Bills,0,7,0,7,14,Titans,0,0,7,0,7,201905
Bears,0,0,21,0,21,Raiders,0,17,0,7,24,201905
Buccaneers,7,3,7,7,24,Saints,3,14,7,7,31,201905
Vikings,3,15,7,3,28,Giants,0,7,3,0,10,201905
Jets,0,0,0,6,6,Eagles,14,7,3,7,31,201905
Ravens,10,7,0,6,3,26,Steelers,7,6,7,3,0,23,201905
Patriots,6,6,14,7,33,Washington,7,0,0,0,7,201905
Jaguars,7,10,7,3,27,Panthers,14,7,7,6,34,201905
Falcons,7,10,0,15,32,Texans,7,9,17,20,53,201905
Broncos,14,3,0,3,20,Chargers,0,0,7,6,13,201905
Packers,14,3,14,3,34,Cowboys,0,0,10,14,24,201905
Colts,7,6,0,6,19,Chiefs,3,7,0,3,13,201905
Browns,0,3,0,0,3,49ers,14,7,7,3,31,201905
Giants,0,14,0,0,14,Patriots,7,14,0,14,35,201906
Panthers,10,7,10,10,37,Buccaneers,0,7,3,16,26,201906
Seahawks,6,12,7,7,32,Browns,14,6,0,8,28,201906
Texans,3,20,0,8,31,Chiefs,17,0,7,0,24,201906
Washington,0,7,10,0,17,Dolphins,0,3,0,13,16,201906
Eagles,0,10,10,0,20,Vikings,10,14,7,7,38,201906
Saints,3,0,3,7,13,Jaguars,0,3,3,0,6,201906
Bengals,7,3,0,7,17,Ravens,14,3,3,3,23,201906
49ers,7,0,10,3,20,Rams,7,0,0,0,7,201906
Falcons,7,3,10,13,33,Cardinals,3,17,7,7,34,201906
Titans,0,0,0,0,0,Broncos,3,3,7,3,16,201906
Cowboys,0,6,3,13,22,Jets,7,14,0,3,24,201906
Steelers,14,7,3,0,24,Chargers,0,0,0,17,17,201906
Lions,10,3,6,3,22,Packers,0,10,3,10,23,201906
Chiefs,10,10,7,3,30,Broncos,6,0,0,0,6,201907
Rams,3,10,14,10,37,Falcons,3,0,0,7,10,201907
Dolphins,0,14,0,7,21,Bills,6,3,0,22,31,201907
Jaguars,0,6,3,18,27,Bengals,0,7,3,7,17,201907
Vikings,7,14,7,14,42,Lions,14,7,3,6,30,201907
Raiders,3,7,7,7,24,Packers,7,14,14,7,42,201907
Texans,0,9,7,7,23,Colts,7,7,14,2,30,201907
Cardinals,14,3,7,3,27,Giants,0,14,0,7,21,201907
49ers,0,0,3,6,9,Washington,0,0,0,0,0,201907
Chargers,3,7,0,10,20,Titans,3,7,0,13,23,201907
Saints,9,3,14,10,36,Bears,7,3,0,15,25,201907
Ravens,3,10,7,10,30,Seahawks,0,13,0,3,16,201907
Eagles,7,0,3,0,10,Cowboys,14,13,0,10,37,201907
Patriots,17,7,2,7,33,Jets,0,0,0,0,0,201907
Washington,0,6,3,0,9,Vikings,3,10,3,3,19,201908
Seahawks,3,21,0,3,27,Falcons,0,0,11,9,20,201908
Eagles,3,8,13,7,31,Bills,0,7,6,0,13,201908
Chargers,0,7,3,7,17,Bears,0,9,7,0,16,201908
Giants,0,13,6,7,26,Lions,14,3,7,7,31,201908
Buccaneers,3,12,8,0,23,Titans,14,3,3,7,27,201908
Broncos,0,6,7,0,13,Colts,0,3,9,3,15,201908
Bengals,0,10,0,0,10,Rams,3,14,7,0,24,201908
Cardinals,3,3,3,0,9,Saints,0,10,7,14,31,201908
Jets,7,0,0,8,15,Jaguars,13,6,3,7,29,201908
Panthers,3,0,10,0,13,49ers,14,13,14,10,51,201908
Browns,0,7,3,3,13,Patriots,17,0,7,3,27,201908
Raiders,7,7,7,3,24,Texans,7,3,3,14,27,201908
Packers,14,0,3,14,31,Chiefs,0,17,0,7,24,201908
Dolphins,14,0,0,0,14,Steelers,0,10,7,10,27,201908
49ers,7,14,7,0,28,Cardinals,7,0,7,11,25,201909
Texans,3,6,10,7,26,Jaguars,0,3,0,0,3,201909
Washington,0,6,3,0,9,Bills,10,7,0,7,24,201909
Vikings,7,3,6,7,23,Chiefs,7,3,10,6,26,201909
Jets,7,5,3,3,18,Dolphins,0,21,3,2,26,201909
Bears,0,0,7,7,14,Eagles,3,9,7,3,22,201909
Colts,3,13,2,6,24,Steelers,3,10,7,6,26,201909
Titans,0,0,7,13,20,Panthers,0,17,7,6,30,201909
Lions,7,7,3,7,24,Raiders,7,10,0,14,31,201909
Buccaneers,14,7,3,10,0,34,Seahawks,7,6,8,13,6,40,201909
Browns,0,12,0,7,19,Broncos,7,10,7,0,24,201909
Packers,0,0,3,8,11,Chargers,6,3,10,7,26,201909
Patriots,0,13,7,0,20,Ravens,10,7,7,13,37,201909
Cowboys,3,10,3,21,37,Giants,3,9,3,3,18,201909
Chargers,0,14,3,7,24,Raiders,10,7,3,6,26,201910
Lions,3,3,0,7,13,Bears,0,7,13,0,20,201910
Ravens,14,14,21,0,49,Bengals,0,10,0,3,13,201910
Bills,0,7,2,7,16,Browns,6,3,3,7,19,201910
Chiefs,10,3,9,10,32,Titans,0,13,7,15,35,201910
Falcons,3,10,0,13,26,Saints,3,3,3,0,9,201910
Giants,0,13,14,0,27,Jets,14,0,10,10,34,201910
Cardinals,3,10,7,7,27,Buccaneers,7,10,3,10,30,201910
Dolphins,3,7,0,6,16,Colts,0,0,6,6,12,201910
Panthers,7,3,0,6,16,Packers,7,7,10,0,24,201910
Rams,7,0,3,2,12,Steelers,7,7,0,3,17,201910
Vikings,14,3,11,0,28,Cowboys,0,14,7,3,24,201910
Seahawks,0,7,14,3,3,27,49ers,10,0,0,14,0,24,201910
Steelers,0,0,7,0,7,Browns,7,7,0,7,21,201911
Cowboys,3,21,3,8,35,Lions,7,7,7,6,27,201911
Jaguars,7,0,0,6,13,Colts,7,3,14,9,33,201911
Bills,6,17,7,7,37,Dolphins,0,14,0,6,20,201911
Broncos,10,10,3,0,23,Vikings,0,0,7,20,27,201911
Saints,13,7,7,7,34,Buccaneers,0,7,10,0,17,201911
Jets,6,14,0,14,34,Washington,0,3,0,14,17,201911
Falcons,10,10,6,3,29,Panthers,0,0,0,3,3,201911
Texans,0,0,0,7,7,Ravens,0,14,13,14,41,201911
Cardinals,9,7,3,7,26,49ers,0,10,7,19,36,201911
Bengals,7,0,3,0,10,Raiders,0,14,0,3,17,201911
Patriots,0,9,8,0,17,Eagles,3,7,0,0,10,201911
Bears,0,0,7,0,7,Rams,0,10,0,7,17,201911
Chiefs,0,10,14,0,24,Chargers,3,6,8,0,17,201911
Colts,0,10,7,0,17,Texans,0,10,3,7,20,201912
Buccaneers,7,12,6,10,35,Falcons,10,0,3,9,22,201912
Broncos,0,0,3,0,3,Bills,3,3,7,7,20,201912
Giants,0,7,0,7,14,Bears,0,3,16,0,19,201912
Steelers,0,3,7,6,16,Bengals,0,7,3,0,10,201912
Dolphins,0,3,14,7,24,Browns,14,14,0,13,41,201912
Panthers,6,9,9,7,31,Saints,14,3,14,3,34,201912
Raiders,3,0,0,0,3,Jets,3,10,21,0,34,201912
Seahawks,7,3,0,7,17,Eagles,3,0,0,6,9,201912
Lions,0,6,7,3,16,Washington,3,10,0,6,19,201912
Jaguars,0,3,8,9,20,Titans,0,7,28,7,42,201912
Cowboys,0,6,0,3,9,Patriots,7,3,0,3,13,201912
Packers,0,0,8,0,8,49ers,10,13,7,7,37,201912
Ravens,14,14,7,10,45,Rams,0,6,0,0,6,201912
Bears,7,3,7,7,24,Lions,14,3,0,3,20,201913
Bills,0,13,10,3,26,Cowboys,7,0,0,8,15,201913
Saints,7,10,3,6,26,Falcons,0,9,0,9,18,201913
Jets,3,3,0,0,6,Bengals,7,10,5,0,22,201913
Titans,7,0,10,14,31,Colts,7,3,7,0,17,201913
Eagles,10,11,7,3,31,Dolphins,7,7,12,11,37,201913
Packers,14,3,0,14,31,Giants,7,3,3,0,13,201913
Browns,3,7,0,3,13,Steelers,0,10,7,3,20,201913
Washington,3,9,3,14,29,Panthers,14,0,0,7,21,201913
Buccaneers,15,10,0,3,28,Jaguars,0,0,3,8,11,201913
49ers,7,7,3,0,17,Ravens,7,10,0,3,20,201913
Rams,3,17,14,0,34,Cardinals,0,0,0,7,7,201913
Chargers,0,10,0,10,20,Broncos,14,3,0,6,23,201913
Raiders,0,0,0,9,9,Chiefs,7,14,10,9,40,201913
Patriots,3,0,6,13,22,Texans,7,7,7,7,28,201913
Vikings,7,10,0,13,30,Seahawks,7,3,17,10,37,201913
Cowboys,7,0,0,17,24,Bears,0,17,7,7,31,201914
Panthers,0,10,0,10,20,Falcons,3,10,17,10,40,201914
Ravens,3,7,7,7,24,Bills,0,6,3,8,17,201914
Bengals,6,7,3,3,19,Browns,7,7,10,3,27,201914
Washington,0,6,3,6,15,Packers,14,0,3,3,20,201914
Lions,0,0,0,7,7,Vikings,7,10,0,3,20,201914
49ers,7,21,7,13,48,Saints,13,14,6,13,46,201914
Dolphins,3,6,3,9,21,Jets,0,16,0,6,22,201914
Colts,10,17,8,0,35,Buccaneers,14,7,7,10,38,201914
Broncos,14,17,7,0,38,Texans,0,3,7,14,24,201914
Chargers,7,17,14,7,45,Jaguars,3,0,7,0,10,201914
Titans,7,14,7,14,42,Raiders,7,14,0,0,21,201914
Chiefs,3,17,3,0,23,Patriots,7,0,6,3,16,201914
Steelers,10,3,7,3,23,Cardinals,0,10,0,7,17,201914
Seahawks,3,0,6,3,12,Rams,7,14,0,7,28,201914
Giants,0,17,0,0,0,17,Eagles,0,3,7,7,6,23,201914
Jets,0,7,0,14,21,Ravens,13,8,14,7,42,201915
Patriots,7,6,14,7,34,Bengals,10,0,0,3,13,201915
Buccaneers,14,7,3,14,38,Lions,0,3,7,7,17,201915
Bears,0,3,0,10,13,Packers,7,0,14,0,21,201915
Texans,0,14,0,10,24,Titans,0,0,7,14,21,201915
Broncos,0,3,0,0,3,Chiefs,6,9,8,0,23,201915
Dolphins,0,10,3,7,20,Giants,0,7,16,13,36,201915
Eagles,3,7,7,20,37,Washington,7,7,0,13,27,201915
Seahawks,13,7,3,7,30,Panthers,0,7,3,14,24,201915
Jaguars,3,0,3,14,20,Raiders,10,6,0,0,16,201915
Browns,0,10,7,7,24,Cardinals,7,14,7,10,38,201915
Vikings,6,13,6,14,39,Chargers,3,7,0,0,10,201915
Rams,0,7,0,14,21,Cowboys,7,21,3,13,44,201915
Falcons,0,10,0,19,29,49ers,0,10,3,9,22,201915
Bills,0,7,0,10,17,Steelers,0,3,7,0,10,201915
Colts,0,0,0,7,7,Saints,3,17,14,0,34,201915
Texans,10,7,3,3,23,Buccaneers,3,14,3,0,20,201916
Bills,3,7,7,0,17,Patriots,7,3,3,11,24,201916
Rams,7,14,7,3,31,49ers,3,21,0,10,34,201916
Jaguars,0,3,3,6,12,Falcons,14,3,0,7,24,201916
Ravens,0,14,7,10,31,Browns,0,6,3,6,15,201916
Saints,0,10,21,7,38,Titans,14,0,7,7,28,201916
Panthers,0,3,3,0,6,Colts,14,7,3,14,38,201916
Bengals,0,6,6,23,0,35,Dolphins,14,7,7,7,3,38,201916
Steelers,0,10,0,0,10,Jets,7,3,3,3,16,201916
Giants,14,14,7,0,6,41,Washington,7,7,7,14,0,35,201916
Lions,3,7,7,0,17,Broncos,0,10,3,14,27,201916
Raiders,7,7,7,3,24,Chargers,0,7,7,3,17,201916
Cowboys,0,6,0,3,9,Eagles,10,0,7,0,17,201916
Cardinals,7,10,3,7,27,Seahawks,7,0,0,6,13,201916
Chiefs,7,10,0,9,26,Bears,0,0,3,0,3,201916
Packers,3,6,8,6,23,Vikings,3,7,0,0,10,201916
Jets,0,3,0,10,13,Bills,0,0,3,3,6,201917
Browns,7,9,0,7,23,Bengals,13,7,3,10,33,201917
Packers,0,3,7,13,23,Lions,7,10,0,3,20,201917
Chargers,0,7,7,7,21,Chiefs,3,7,14,7,31,201917
Bears,6,5,7,3,21,Vikings,0,6,0,13,19,201917
Dolphins,3,7,7,10,27,Patriots,0,10,7,7,24,201917
Falcons,10,6,0,6,6,28,Buccaneers,0,22,0,0,0,22,201917
Saints,14,21,7,0,42,Panthers,0,3,7,0,10,201917
Washington,0,10,6,0,16,Cowboys,6,14,17,10,47,201917
Raiders,0,3,0,12,15,Broncos,0,10,3,3,16,201917
Cardinals,7,3,7,7,24,Rams,3,14,0,14,31,201917
Eagles,3,7,7,17,34,Giants,0,3,14,0,17,201917
Colts,10,10,0,0,20,Jaguars,3,13,8,14,38,201917
Steelers,0,7,3,0,10,Ravens,6,10,0,12,28,201917
Titans,7,7,7,14,35,Texans,7,0,7,0,14,201917
49ers,10,3,6,7,26,Seahawks,0,0,7,14,21,201917
Bills,7,6,3,3,0,19,Texans,0,0,8,11,3,22,201918
Titans,7,7,0,6,20,Patriots,3,10,0,0,13,201918
Vikings,3,10,7,0,6,26,Saints,3,7,0,10,0,20,201918
Seahawks,3,7,7,0,17,Eagles,0,3,6,0,9,201918
Vikings,7,3,0,0,10,49ers,7,7,10,3,27,201919
Titans,7,7,14,0,28,Ravens,0,6,0,6,12,201919
Texans,21,3,7,0,31,Chiefs,0,28,13,10,51,201919
Seahawks,3,0,14,6,23,Packers,7,14,7,0,28,201919
Titans,10,7,0,7,24,Chiefs,7,14,0,14,35,201920
Packers,0,0,7,13,20,49ers,7,20,7,3,37,201920
49ers,3,7,10,0,20,Chiefs,7,3,0,21,31,201922
Texans,7,0,0,13,20,Chiefs,0,17,7,10,34,202001
Seahawks,14,0,14,10,38,Falcons,3,9,0,13,25,202001
Jets,0,3,7,7,17,Bills,14,7,0,6,27,202001
Bears,3,3,0,21,27,Lions,3,10,10,0,23,202001
Packers,3,19,7,14,43,Vikings,7,3,0,24,34,202001
Dolphins,0,3,0,8,11,Patriots,0,7,7,7,21,202001
Eagles,10,7,0,0,17,Washington,0,7,7,13,27,202001
Raiders,7,10,10,7,34,Panthers,9,6,0,15,30,202001
Colts,7,10,0,3,20,Jaguars,0,14,3,10,27,202001
Browns,6,0,0,0,6,Ravens,10,14,7,7,38,202001
Chargers,0,6,0,10,16,Bengals,7,0,6,0,13,202001
Buccaneers,7,0,10,6,23,Saints,0,17,7,10,34,202001
Cardinals,7,3,0,14,24,49ers,10,3,0,7,20,202001
Cowboys,0,14,3,0,17,Rams,7,6,7,0,20,202001
Steelers,3,13,0,10,26,Giants,3,7,0,6,16,202001
Titans,0,7,0,9,16,Broncos,7,0,0,7,14,202001
Bengals,3,10,3,14,30,Browns,7,14,7,7,35,202002
Giants,0,0,3,10,13,Bears,10,7,0,0,17,202002
Falcons,20,9,0,10,39,Cowboys,0,10,14,16,40,202002
Lions,14,0,0,7,21,Packers,3,14,17,8,42,202002
Jaguars,7,3,7,13,30,Titans,14,10,6,3,33,202002
Vikings,3,0,0,8,11,Colts,0,15,3,10,28,202002
Bills,7,10,0,14,31,Dolphins,7,3,3,15,28,202002
49ers,7,14,3,7,31,Jets,3,0,3,7,13,202002
Rams,14,7,3,13,37,Eagles,3,13,0,3,19,202002
Broncos,0,3,11,7,21,Steelers,7,10,0,9,26,202002
Panthers,0,0,7,10,17,Buccaneers,14,7,0,10,31,202002
Washington,0,0,3,12,15,Cardinals,14,6,0,10,30,202002
Chiefs,0,6,3,11,3,23,Chargers,7,7,3,3,0,20,202002
Ravens,3,17,3,10,33,Texans,0,10,0,6,16,202002
Patriots,7,7,3,13,30,Seahawks,7,7,14,7,35,202002
Saints,10,7,0,7,24,Raiders,0,17,7,10,34,202002
Dolphins,14,7,7,3,31,Jaguars,0,7,0,6,13,202003
Bears,3,7,0,20,30,Falcons,6,10,10,0,26,202003
Rams,0,3,14,15,32,Bills,7,14,7,7,35,202003
Washington,7,0,13,0,20,Browns,0,17,0,17,34,202003
Titans,6,3,16,6,31,Vikings,7,10,7,6,30,202003
Raiders,3,7,0,10,20,Patriots,0,13,10,13,36,202003
49ers,6,10,7,13,36,Giants,0,6,3,0,9,202003
Bengals,0,10,7,6,0,23,Eagles,0,13,3,7,0,23,202003
Texans,7,14,0,0,21,Steelers,3,14,3,8,28,202003
Jets,7,0,0,0,7,Colts,7,10,14,5,36,202003
Panthers,6,12,0,3,21,Chargers,0,7,3,6,16,202003
Buccaneers,10,13,5,0,28,Broncos,0,10,0,0,10,202003
Lions,3,14,3,6,26,Cardinals,7,6,10,0,23,202003
Cowboys,9,6,7,9,31,Seahawks,9,14,7,8,38,202003
Packers,3,10,14,10,37,Saints,7,10,10,3,30,202003
Chiefs,6,21,0,7,34,Ravens,3,7,3,7,20,202003
Broncos,3,14,7,13,37,Jets,7,6,3,12,28,202004
Jaguars,7,6,0,12,25,Bengals,3,7,17,6,33,202004
Browns,7,24,10,8,49,Cowboys,14,0,0,24,38,202004
Saints,7,21,7,0,35,Lions,14,0,7,8,29,202004
Seahawks,10,7,0,14,31,Dolphins,3,6,3,11,23,202004
Chargers,14,10,7,0,31,Buccaneers,7,7,14,10,38,202004
Ravens,7,14,7,3,31,Washington,0,10,0,7,17,202004
Cardinals,0,7,7,7,21,Panthers,14,7,7,3,31,202004
Vikings,7,10,7,7,31,Texans,0,6,10,7,23,202004
Giants,0,6,0,3,9,Rams,7,3,0,7,17,202004
Colts,7,6,3,3,19,Bears,0,3,0,8,11,202004
Bills,7,10,0,13,30,Raiders,3,10,3,7,23,202004
Eagles,8,0,3,14,25,49ers,7,0,7,6,20,202004
Patriots,0,3,0,7,10,Chiefs,6,0,7,13,26,202004
Falcons,0,3,6,7,16,Packers,7,13,7,3,30,202004
Buccaneers,10,3,3,3,19,Bears,0,14,0,6,20,202005
Panthers,3,17,0,3,23,Falcons,7,0,3,6,16,202005
Raiders,3,21,0,16,40,Chiefs,7,17,0,8,32,202005
Cardinals,7,10,7,6,30,Jets,0,3,7,0,10,202005
Eagles,7,7,8,7,29,Steelers,7,10,14,7,38,202005
Rams,6,14,3,7,30,Washington,7,3,0,0,10,202005
Bengals,0,0,0,3,3,Ravens,10,7,3,7,27,202005
Jaguars,0,7,0,7,14,Texans,0,10,3,17,30,202005
Dolphins,14,16,7,6,43,49ers,0,7,10,0,17,202005
Colts,7,3,10,3,23,Browns,3,17,7,5,32,202005
Giants,14,6,3,11,34,Cowboys,3,21,7,6,37,202005
Vikings,7,6,6,7,26,Seahawks,0,0,21,6,27,202005
Chargers,6,14,0,7,0,27,Saints,3,7,3,14,3,30,202005
Bills,7,3,0,6,16,Titans,7,14,7,14,42,202005
Texans,0,10,13,13,0,36,Titans,14,7,0,15,6,42,202006
Bengals,14,10,3,0,27,Colts,0,21,0,10,31,202006
Falcons,10,10,10,10,40,Vikings,0,0,7,16,23,202006
Broncos,6,6,6,0,18,Patriots,0,3,0,9,12,202006
Washington,0,10,0,9,19,Giants,10,3,0,7,20,202006
Ravens,14,3,7,6,30,Eagles,0,0,6,22,28,202006
Browns,0,7,0,0,7,Steelers,10,14,7,7,38,202006
Bears,7,6,7,3,23,Panthers,3,3,0,10,16,202006
Lions,7,10,7,10,34,Jaguars,3,0,7,6,16,202006
Jets,0,0,0,0,0,Dolphins,7,14,3,0,24,202006
Packers,10,0,0,0,10,Buccaneers,0,28,10,0,38,202006
Rams,0,6,3,7,16,49ers,7,14,0,3,24,202006
Chiefs,7,6,7,6,26,Bills,3,7,0,7,17,202006
Cardinals,0,21,7,10,38,Cowboys,0,3,0,7,10,202006
Giants,7,0,7,7,21,Eagles,7,3,0,12,22,202007
Lions,7,3,3,10,23,Falcons,0,14,0,8,22,202007
Browns,3,7,7,20,37,Bengals,7,10,3,14,34,202007
Steelers,7,17,3,0,27,Titans,0,7,10,7,24,202007
Panthers,3,14,7,0,24,Saints,7,14,3,3,27,202007
Bills,0,6,6,6,18,Jets,3,7,0,0,10,202007
Cowboys,3,0,0,0,3,Washington,9,13,0,3,25,202007
Packers,7,14,7,7,35,Texans,0,0,7,13,20,202007
Buccaneers,7,14,3,21,45,Raiders,7,3,7,3,20,202007
Chiefs,10,14,6,13,43,Broncos,6,3,0,7,16,202007
49ers,7,16,7,3,33,Patriots,0,3,3,0,6,202007
Jaguars,0,14,15,0,29,Chargers,9,7,20,3,39,202007
Seahawks,10,17,0,7,0,34,Cardinals,7,10,7,10,3,37,202007
Bears,0,3,0,7,10,Rams,7,3,14,0,24,202007
Falcons,6,10,3,6,25,Panthers,7,7,3,0,17,202008
Patriots,0,6,8,7,21,Bills,7,0,7,10,24,202008
Titans,0,7,0,13,20,Bengals,3,14,0,14,31,202008
Raiders,0,6,0,10,16,Browns,0,3,3,0,6,202008
Colts,0,20,0,21,41,Lions,7,0,7,7,21,202008
Vikings,7,7,14,0,28,Packers,7,7,0,8,22,202008
Jets,3,6,0,0,9,Chiefs,14,7,7,7,35,202008
Rams,7,3,0,7,17,Dolphins,7,21,0,0,28,202008
Steelers,7,0,14,7,28,Ravens,7,10,0,7,24,202008
Chargers,0,14,10,6,30,Broncos,3,0,7,21,31,202008
Saints,3,7,6,7,3,26,Bears,3,10,0,10,0,23,202008
49ers,0,7,0,20,27,Seahawks,6,7,14,10,37,202008
Cowboys,3,6,0,0,9,Eagles,7,0,8,8,23,202008
Buccaneers,3,3,9,10,25,Giants,7,7,3,6,23,202008
Packers,7,14,10,3,34,49ers,3,0,0,14,17,202009
Broncos,0,3,3,21,27,Falcons,10,10,7,7,34,202009
Seahawks,0,10,10,14,34,Bills,14,10,3,17,44,202009
Bears,0,0,0,17,17,Titans,3,7,7,7,24,202009
Ravens,7,0,7,10,24,Colts,7,3,0,0,10,202009
Panthers,7,10,0,14,31,Chiefs,3,10,7,13,33,202009
Lions,0,10,0,10,20,Vikings,13,7,7,7,34,202009
Giants,10,10,3,0,23,Washington,0,3,7,10,20,202009
Texans,10,10,7,0,27,Jaguars,7,9,3,6,25,202009
Raiders,7,7,14,3,31,Chargers,0,17,3,6,26,202009
Steelers,0,9,0,15,24,Cowboys,3,10,6,0,19,202009
Dolphins,14,10,0,10,34,Cardinals,7,10,14,0,31,202009
Saints,14,17,0,7,38,Buccaneers,0,0,0,3,3,202009
Patriots,7,3,7,13,30,Jets,3,17,7,0,27,202009
Colts,3,10,14,7,34,Titans,7,10,0,0,17,202010
Texans,0,0,0,7,7,Browns,3,0,0,7,10,202010
Washington,3,0,7,17,27,Lions,7,10,7,6,30,202010
Jaguars,3,7,7,3,20,Packers,0,17,0,7,24,202010
Eagles,3,0,14,0,17,Giants,7,7,7,6,27,202010
Buccaneers,7,10,12,17,46,Panthers,14,3,0,6,23,202010
Broncos,3,3,0,6,12,Raiders,7,3,10,17,37,202010
Chargers,0,7,7,7,21,Dolphins,14,3,3,9,29,202010
Bills,7,9,7,7,30,Cardinals,3,6,17,6,32,202010
Seahawks,7,6,0,3,16,Rams,10,7,6,0,23,202010
49ers,7,3,0,3,13,Saints,0,17,0,10,27,202010
Bengals,0,7,0,3,10,Steelers,12,10,7,7,36,202010
Ravens,0,10,7,0,17,Patriots,0,13,10,0,23,202010
Vikings,7,0,6,6,19,Bears,3,3,7,0,13,202010
Cardinals,0,7,7,7,21,Seahawks,7,9,7,5,28,202011
Eagles,0,0,7,10,17,Browns,0,7,5,10,22,202011
Falcons,3,6,0,0,9,Saints,3,7,7,7,24,202011
Bengals,0,9,0,0,9,Washington,7,0,10,3,20,202011
Lions,0,0,0,0,0,Panthers,7,0,10,3,20,202011
Steelers,0,17,0,10,27,Jaguars,3,0,0,0,3,202011
Titans,7,3,3,11,6,30,Ravens,3,11,7,3,0,24,202011
Patriots,7,3,7,3,20,Texans,7,14,3,3,27,202011
Dolphins,7,3,0,3,13,Broncos,7,6,7,0,20,202011
Jets,6,0,13,9,28,Chargers,7,17,7,3,34,202011
Packers,7,21,0,3,0,31,Colts,7,7,11,6,3,34,202011
Cowboys,6,10,0,15,31,Vikings,7,0,7,14,28,202011
Chiefs,7,7,7,14,35,Raiders,14,3,0,14,31,202011
Rams,7,10,7,3,27,Buccaneers,0,14,3,7,24,202011
Texans,13,10,3,15,41,Lions,7,7,3,8,25,202012
Washington,7,10,3,21,41,Cowboys,3,10,3,0,16,202012
Raiders,0,3,3,0,6,Falcons,6,10,14,13,43,202012
Chargers,6,0,8,3,17,Bills,7,10,7,3,27,202012
Giants,7,3,3,6,19,Bengals,7,3,0,7,17,202012
Titans,14,21,3,7,45,Colts,7,7,0,12,26,202012
Panthers,0,7,14,6,27,Vikings,7,3,0,18,28,202012
Cardinals,10,0,0,7,17,Patriots,0,7,10,3,20,202012
Dolphins,3,10,0,7,20,Jets,3,0,0,0,3,202012
Browns,7,10,3,7,27,Jaguars,3,10,6,6,25,202012
Saints,0,17,7,7,31,Broncos,0,0,3,0,3,202012
49ers,7,0,10,6,23,Rams,3,0,10,7,20,202012
Chiefs,17,3,7,0,27,Buccaneers,0,7,3,14,24,202012
Bears,3,7,0,15,25,Packers,6,21,14,0,41,202012
Seahawks,0,14,3,6,23,Eagles,0,6,3,8,17,202012
Ravens,7,0,0,7,14,Steelers,6,6,0,7,19,202012
Saints,7,7,7,0,21,Falcons,3,6,0,7,16,202013
Lions,6,7,7,14,34,Bears,9,14,0,7,30,202013
Browns,10,28,3,0,41,Titans,0,7,14,14,35,202013
Bengals,7,0,0,0,7,Dolphins,0,6,10,3,19,202013
Jaguars,9,0,7,8,0,24,Vikings,0,6,13,5,3,27,202013
Raiders,7,10,7,7,31,Jets,7,6,0,15,28,202013
Colts,14,10,0,2,26,Texans,10,10,0,0,20,202013
Rams,0,14,3,21,38,Cardinals,7,0,7,14,28,202013
Giants,0,0,14,3,17,Seahawks,3,2,0,7,12,202013
Eagles,3,0,0,13,16,Packers,0,14,6,10,30,202013
Patriots,7,21,7,10,45,Chargers,0,0,0,0,0,202013
Broncos,3,7,6,0,16,Chiefs,3,6,10,3,22,202013
Washington,0,3,7,13,23,Steelers,0,14,0,3,17,202013
Bills,0,17,10,7,34,49ers,7,0,10,7,24,202013
Cowboys,3,7,0,7,17,Ravens,7,10,7,10,34,202013
Patriots,0,3,0,0,3,Rams,10,7,7,0,24,202014
Texans,0,7,0,0,7,Bears,7,23,3,3,36,202014
Cowboys,10,7,3,10,30,Bengals,0,7,0,0,7,202014
Chiefs,0,14,16,3,33,Dolphins,7,3,0,17,27,202014
Cardinals,3,10,7,6,26,Giants,0,0,7,0,7,202014
Vikings,0,6,8,0,14,Buccaneers,0,17,6,3,26,202014
Broncos,6,7,12,7,32,Panthers,0,7,3,17,27,202014
Titans,7,10,14,0,31,Jaguars,0,3,7,0,10,202014
Colts,10,10,7,17,44,Raiders,7,7,6,7,27,202014
Jets,3,0,0,0,3,Seahawks,7,16,14,3,40,202014
Packers,7,7,7,10,31,Lions,7,7,0,10,24,202014
Saints,0,0,14,7,21,Eagles,0,17,0,7,24,202014
Falcons,7,10,0,0,17,Chargers,7,3,7,3,20,202014
Washington,0,13,10,0,23,49ers,7,0,0,8,15,202014
Steelers,0,7,0,8,15,Bills,0,9,14,3,26,202014
Ravens,7,14,13,13,47,Browns,7,7,6,22,42,202014
Chargers,7,10,7,0,6,30,Raiders,3,7,7,7,3,27,202015
Bills,7,14,17,10,48,Broncos,0,13,0,6,19,202015
Panthers,3,0,7,6,16,Packers,7,14,0,3,24,202015
Buccaneers,0,0,21,10,31,Falcons,7,10,7,3,27,202015
49ers,7,7,10,9,33,Cowboys,14,3,7,17,41,202015
Lions,7,8,3,7,25,Titans,14,10,0,22,46,202015
Texans,0,10,3,7,20,Colts,14,0,3,10,27,202015
Patriots,0,6,3,3,12,Dolphins,0,0,7,15,22,202015
Bears,10,10,7,6,33,Vikings,7,3,10,7,27,202015
Seahawks,3,10,7,0,20,Washington,0,3,0,12,15,202015
Jaguars,0,0,7,7,14,Ravens,9,17,7,7,40,202015
Jets,7,6,10,0,23,Rams,0,3,7,10,20,202015
Eagles,0,20,6,0,26,Cardinals,16,10,0,7,33,202015
Chiefs,7,7,7,11,32,Saints,0,9,6,14,29,202015
Browns,0,13,0,7,20,Giants,3,0,0,3,6,202015
Steelers,0,0,10,7,17,Bengals,3,14,0,10,27,202015
Vikings,7,7,13,6,33,Saints,14,10,7,21,52,202016
Buccaneers,13,21,13,0,47,Lions,0,0,7,0,7,202016
49ers,7,0,7,6,20,Cardinals,3,3,0,6,12,202016
Dolphins,3,3,7,13,26,Raiders,7,6,3,9,25,202016
Falcons,0,7,0,7,14,Chiefs,0,7,0,10,17,202016
Browns,3,0,7,6,16,Jets,7,6,7,3,23,202016
Colts,7,14,3,0,24,Steelers,0,7,7,14,28,202016
Bears,7,6,21,7,41,Jaguars,3,7,0,7,17,202016
Giants,0,3,3,7,13,Ravens,14,6,0,7,27,202016
Bengals,7,3,14,13,37,Texans,3,7,14,7,31,202016
Broncos,0,0,3,13,16,Chargers,3,10,0,6,19,202016
Panthers,6,14,0,0,20,Washington,0,3,3,7,13,202016
Eagles,14,3,0,0,17,Cowboys,3,17,10,7,37,202016
Rams,3,3,0,3,9,Seahawks,0,6,7,7,20,202016
Titans,0,7,7,0,14,Packers,6,13,14,7,40,202016
Bills,3,21,7,7,38,Patriots,3,6,0,0,9,202016
Dolphins,3,3,7,13,26,Bills,0,28,7,21,56,202017
Ravens,10,7,21,0,38,Bengals,0,3,0,0,3,202017
Steelers,0,6,3,13,22,Browns,7,3,7,7,24,202017
Vikings,7,14,10,6,37,Lions,6,10,13,6,35,202017
Jets,0,7,7,0,14,Patriots,7,0,7,14,28,202017
Cowboys,3,6,7,3,19,Giants,6,14,0,3,23,202017
Falcons,3,7,10,7,27,Buccaneers,10,13,0,21,44,202017
Packers,0,21,0,14,35,Bears,7,6,3,0,16,202017
Raiders,3,14,0,15,32,Broncos,10,0,6,15,31,202017
Jaguars,0,7,7,0,14,Colts,10,10,0,8,28,202017
Chargers,7,17,7,7,38,Chiefs,7,7,0,7,21,202017
Cardinals,7,0,0,0,7,Rams,0,12,3,3,18,202017
Seahawks,3,3,0,20,26,49ers,0,3,6,14,23,202017
Saints,7,9,10,7,33,Panthers,7,0,0,0,7,202017
Titans,3,14,14,10,41,Texans,3,6,19,10,38,202017
Washington,10,7,0,3,20,Eagles,0,14,0,0,14,202017
Colts,3,7,0,14,24,Bills,7,7,3,10,27,202018
Rams,3,17,0,10,30,Seahawks,0,10,3,7,20,202018
Buccaneers,9,9,0,13,31,Washington,0,7,9,7,23,202018
Ravens,0,10,7,3,20,Titans,10,0,0,3,13,202018
Bears,0,3,0,6,9,Saints,7,0,7,7,21,202018
Browns,28,7,0,13,48,Steelers,0,10,13,14,37,202018
Rams,3,7,8,0,18,Packers,3,16,6,7,32,202019
Ravens,0,3,0,0,3,Bills,3,0,14,0,17,202019
Browns,3,0,7,7,17,Chiefs,6,13,3,0,22,202019
Buccaneers,0,13,7,10,30,Saints,6,7,7,0,20,202019
Buccaneers,7,14,7,3,31,Packers,0,10,13,3,26,202020
Bills,9,3,3,9,24,Chiefs,0,21,10,7,38,202020
Chiefs,3,3,3,0,9,Buccaneers,7,14,10,0,31,202022
Cowboys,7,9,10,3,29,Buccaneers,7,14,7,3,31,202101
Eagles,7,8,7,10,32,Falcons,3,3,0,0,6,202101
Steelers,0,0,6,17,23,Bills,3,7,0,6,16,202101
Vikings,0,7,7,10,0,24,Bengals,0,14,7,3,3,27,202101
49ers,7,24,7,3,41,Lions,0,10,7,16,33,202101
Cardinals,10,14,14,0,38,Titans,0,6,7,0,13,202101
Seahawks,7,14,0,7,28,Colts,3,7,0,6,16,202101
Chargers,7,6,0,7,20,Washington,3,6,7,0,16,202101
Jets,0,0,8,6,14,Panthers,0,16,0,3,19,202101
Jaguars,0,7,7,7,21,Texans,14,13,7,3,37,202101
Browns,8,14,0,7,29,Chiefs,3,7,10,13,33,202101
Dolphins,7,3,7,0,17,Patriots,0,10,3,3,16,202101
Packers,0,3,0,0,3,Saints,3,14,7,14,38,202101
Broncos,0,10,7,10,27,Giants,0,7,0,6,13,202101
Bears,0,7,7,0,14,Rams,10,3,14,7,34,202101
Ravens,7,7,3,10,0,27,Raiders,0,10,0,17,6,33,202101
Giants,7,3,10,9,29,Washington,0,14,3,13,30,202102
Bengals,0,0,3,14,17,Bears,7,0,0,13,20,202102
Texans,7,7,0,7,21,Browns,7,7,10,7,31,202102
Rams,7,3,7,10,27,Colts,0,6,8,10,24,202102
Bills,14,0,7,14,35,Dolphins,0,0,0,0,0,202102
Patriots,10,3,9,3,25,Jets,0,3,0,3,6,202102
49ers,0,7,0,10,17,Eagles,3,0,0,8,11,202102
Raiders,3,6,7,10,26,Steelers,0,7,0,10,17,202102
Saints,0,0,0,7,7,Panthers,7,10,0,9,26,202102
Broncos,3,7,10,3,23,Jaguars,7,0,0,6,13,202102
Vikings,14,9,7,3,33,Cardinals,7,17,7,3,34,202102
Falcons,0,10,15,0,25,Buccaneers,7,14,7,20,48,202102
Cowboys,14,0,0,6,20,Chargers,3,8,3,3,17,202102
Titans,3,6,7,14,3,33,Seahawks,3,21,0,6,0,30,202102
Chiefs,14,7,14,0,35,Ravens,7,10,7,12,36,202102
Lions,7,10,0,0,17,Packers,7,7,14,7,35,202102
Panthers,7,0,7,10,24,Texans,0,6,0,3,9,202103
Washington,0,14,0,7,21,Bills,7,20,9,7,43,202103
Bears,3,0,3,0,6,Browns,0,10,3,13,26,202103
Ravens,0,10,6,3,19,Lions,0,0,7,10,17,202103
Colts,0,10,3,3,16,Titans,7,7,0,11,25,202103
Chargers,0,14,0,16,30,Chiefs,0,3,14,7,24,202103
Saints,7,7,7,7,28,Patriots,0,3,3,7,13,202103
Falcons,0,7,0,10,17,Giants,3,3,0,8,14,202103
Bengals,7,7,10,0,24,Steelers,0,7,0,3,10,202103
Cardinals,7,0,17,7,31,Jaguars,0,13,6,0,19,202103
Jets,0,0,0,0,0,Broncos,7,10,3,6,26,202103
Dolphins,14,0,0,11,3,28,Raiders,2,10,7,6,6,31,202103
Buccaneers,0,7,10,7,24,Rams,0,14,17,3,34,202103
Seahawks,10,7,0,0,17,Vikings,7,14,3,6,30,202103
Packers,10,7,0,13,30,49ers,0,7,7,14,28,202103
Eagles,7,0,7,7,21,Cowboys,14,6,7,14,41,202103
Jaguars,7,7,0,7,21,Bengals,0,0,14,10,24,202104
Washington,0,13,9,12,34,Falcons,3,14,6,7,30,202104
Texans,0,0,0,0,0,Bills,7,9,3,21,40,202104
Lions,0,0,7,7,14,Bears,7,7,10,0,24,202104
Panthers,7,7,0,14,28,Cowboys,7,6,20,3,36,202104
Colts,0,7,10,10,27,Dolphins,3,0,0,14,17,202104
Browns,0,11,0,3,14,Vikings,7,0,0,0,7,202104
Giants,0,7,3,11,6,27,Saints,0,7,7,7,0,21,202104
Titans,3,6,0,15,0,24,Jets,0,7,3,14,3,27,202104
Chiefs,7,14,7,14,42,Eagles,10,3,3,14,30,202104
Cardinals,7,17,10,3,37,Rams,10,3,0,7,20,202104
Seahawks,0,7,14,7,28,49ers,7,0,6,8,21,202104
Ravens,0,17,0,6,23,Broncos,0,7,0,0,7,202104
Steelers,7,3,0,7,17,Packers,0,17,10,0,27,202104
Buccaneers,3,3,7,6,19,Patriots,0,7,0,10,17,202104
Raiders,0,0,14,0,14,Chargers,7,14,0,7,28,202104
Rams,0,3,13,10,26,Seahawks,0,7,0,10,17,202105
Jets,0,3,6,11,20,Falcons,10,10,0,7,27,202105
Packers,0,16,3,3,3,25,Bengals,7,7,0,8,0,22,202105
Lions,3,3,0,11,17,Vikings,3,10,0,6,19,202105
Broncos,3,3,0,13,19,Steelers,7,10,7,3,27,202105
Dolphins,10,0,7,0,17,Buccaneers,7,17,0,21,45,202105
Saints,7,13,0,13,33,Washington,6,7,3,6,22,202105
Eagles,3,3,7,8,21,Panthers,10,5,0,3,18,202105
Titans,7,17,7,6,37,Jaguars,6,7,0,6,19,202105
Patriots,0,9,6,10,25,Texans,6,9,7,0,22,202105
Bears,0,14,0,6,20,Raiders,3,0,0,6,9,202105
Browns,3,17,7,15,42,Chargers,7,6,8,26,47,202105
Giants,0,10,3,7,20,Cowboys,3,14,10,17,44,202105
49ers,0,0,7,3,10,Cardinals,7,3,0,7,17,202105
Bills,7,17,7,7,38,Chiefs,3,10,0,7,20,202105
Colts,7,3,12,3,0,25,Ravens,0,3,6,16,6,31,202105
Buccaneers,14,7,7,0,28,Eagles,7,0,7,8,22,202106
Dolphins,7,6,0,7,20,Jaguars,3,7,7,6,23,202106
Packers,0,10,7,7,24,Bears,7,0,0,7,14,202106
Bengals,7,3,10,14,34,Lions,0,0,0,11,11,202106
Texans,0,3,0,0,3,Colts,7,3,14,7,31,202106
Rams,0,28,3,7,38,Giants,3,0,0,8,11,202106
Chiefs,7,3,7,14,31,Washington,3,10,0,0,13,202106
Vikings,6,6,13,3,6,34,Panthers,7,3,7,11,0,28,202106
Chargers,0,6,0,0,6,Ravens,7,10,10,7,34,202106
Cardinals,7,16,7,7,37,Browns,0,14,0,0,14,202106
Raiders,10,7,14,3,34,Broncos,7,0,3,14,24,202106
Cowboys,7,3,7,12,6,35,Patriots,14,0,0,15,0,29,202106
Seahawks,0,0,14,6,0,20,Steelers,0,14,3,3,3,23,202106
Bills,3,17,11,0,31,Titans,0,17,7,10,34,202106
Broncos,0,0,7,7,14,Browns,10,0,7,0,17,202107
Washington,7,0,0,3,10,Packers,7,7,7,3,24,202107
Chiefs,0,0,3,0,3,Titans,14,13,0,0,27,202107
Falcons,0,13,7,10,30,Dolphins,7,0,7,14,28,202107
Jets,0,7,6,0,13,Patriots,14,17,3,20,54,202107
Panthers,3,0,0,0,3,Giants,0,5,7,13,25,202107
Bengals,3,10,14,14,41,Ravens,0,10,7,0,17,202107
Eagles,7,0,0,15,22,Raiders,0,17,13,3,33,202107
Lions,10,6,3,0,19,Rams,3,14,0,11,28,202107
Texans,2,3,0,0,5,Cardinals,0,17,7,7,31,202107
Bears,0,3,0,0,3,Buccaneers,21,14,0,3,38,202107
Colts,7,6,7,10,30,49ers,12,0,0,6,18,202107
Saints,0,10,0,3,13,Seahawks,7,0,3,0,10,202107
Packers,0,10,7,7,24,Cardinals,7,0,7,7,21,202108
Panthers,3,6,3,7,19,Falcons,3,7,0,3,13,202108
Dolphins,0,3,0,8,11,Bills,3,0,7,16,26,202108
49ers,3,6,6,18,33,Bears,3,10,3,6,22,202108
Steelers,0,3,6,6,15,Browns,3,0,7,0,10,202108
Eagles,7,10,21,6,44,Lions,0,0,0,6,6,202108
Titans,0,14,7,10,3,34,Colts,14,3,7,7,0,31,202108
Bengals,0,17,7,7,31,Jets,7,7,3,17,34,202108
Rams,7,17,14,0,38,Texans,0,0,0,22,22,202108
Patriots,7,6,3,11,27,Chargers,7,7,3,7,24,202108
Jaguars,0,0,0,7,7,Seahawks,7,10,7,7,31,202108
Washington,0,3,7,0,10,Broncos,0,10,0,7,17,202108
Buccaneers,7,0,14,6,27,Saints,7,9,7,13,36,202108
Cowboys,0,3,10,7,20,Vikings,7,3,3,3,16,202108
Giants,0,10,0,7,17,Chiefs,7,7,0,6,20,202108
Jets,7,3,6,14,30,Colts,7,21,14,3,45,202109
Browns,7,17,10,7,41,Bengals,7,3,0,6,16,202109
Broncos,6,10,3,11,30,Cowboys,0,0,0,16,16,202109
Texans,0,6,0,3,9,Dolphins,7,10,0,0,17,202109
Falcons,3,7,7,10,27,Saints,0,0,3,22,25,202109
Raiders,7,6,3,0,16,Giants,7,3,7,6,23,202109
Patriots,0,14,10,0,24,Panthers,0,6,0,0,6,202109
Bills,3,3,0,0,6,Jaguars,3,3,0,3,9,202109
Vikings,7,10,7,7,0,31,Ravens,3,7,7,14,3,34,202109
Chargers,7,0,9,11,27,Eagles,0,10,7,7,24,202109
Packers,0,0,0,7,7,Chiefs,7,6,0,0,13,202109
Cardinals,14,3,14,0,31,49ers,0,7,7,3,17,202109
Titans,0,21,0,7,28,Rams,3,0,3,10,16,202109
Bears,0,3,3,21,27,Steelers,7,7,6,9,29,202109
Ravens,3,0,0,7,10,Dolphins,0,6,0,16,22,202110
Falcons,3,0,0,0,3,Cowboys,7,29,7,0,43,202110
Saints,0,6,6,9,21,Titans,3,10,7,3,23,202110
Jaguars,6,3,0,8,17,Colts,17,3,0,3,23,202110
Browns,7,0,0,0,7,Patriots,7,17,7,14,45,202110
Bills,10,7,21,7,45,Jets,0,3,0,14,17,202110
Lions,0,10,6,0,0,16,Steelers,7,3,3,3,0,16,202110
Buccaneers,0,6,7,6,19,Washington,6,10,7,6,29,202110
Panthers,17,6,8,3,34,Cardinals,0,0,3,7,10,202110
Vikings,0,13,7,7,27,Chargers,0,10,7,3,20,202110
Eagles,10,10,7,3,30,Broncos,0,10,3,0,13,202110
Seahawks,0,0,0,0,0,Packers,0,3,0,14,17,202110
Chiefs,7,10,10,14,41,Raiders,0,7,7,0,14,202110
Rams,0,7,0,3,10,49ers,14,7,3,7,31,202110
Patriots,3,10,0,12,25,Falcons,0,0,0,0,0,202111
Colts,14,10,14,3,41,Bills,0,7,0,8,15,202111
Ravens,0,6,0,10,16,Bears,0,0,7,6,13,202111
Lions,0,0,7,3,10,Browns,0,13,0,0,13,202111
Texans,3,9,7,3,22,Titans,0,0,6,7,13,202111
Packers,3,7,7,14,31,Vikings,9,7,7,11,34,202111
Dolphins,7,0,7,10,24,Jets,7,0,7,3,17,202111
Saints,0,7,0,22,29,Eagles,14,13,6,7,40,202111
Washington,0,14,7,6,27,Panthers,7,7,0,7,21,202111
49ers,3,17,7,3,30,Jaguars,0,3,0,7,10,202111
Bengals,3,7,3,19,32,Raiders,3,3,0,7,13,202111
Cowboys,3,0,3,3,9,Chiefs,9,7,3,0,19,202111
Cardinals,7,6,3,7,23,Seahawks,0,6,0,7,13,202111
Steelers,3,7,0,27,37,Chargers,7,10,10,14,41,202111
Giants,3,7,0,0,10,Buccaneers,7,10,10,3,30,202111
Bears,0,13,0,3,16,Lions,7,0,7,0,14,202112
Raiders,14,3,10,6,3,36,Cowboys,6,7,6,14,0,33,202112
Bills,7,3,14,7,31,Saints,0,0,0,6,6,202112
Steelers,3,0,0,7,10,Bengals,10,21,3,7,41,202112
Buccaneers,0,14,14,10,38,Colts,3,21,0,7,31,202112
Panthers,7,3,0,0,10,Dolphins,7,14,6,6,33,202112
Titans,0,13,0,0,13,Patriots,7,9,10,10,36,202112
Eagles,0,0,0,7,7,Giants,3,0,7,3,13,202112
Falcons,7,7,7,0,21,Jaguars,0,3,8,3,14,202112
Jets,3,8,7,3,21,Texans,0,14,0,0,14,202112
Chargers,0,7,0,6,13,Broncos,7,7,0,14,28,202112
Rams,0,17,0,11,28,Packers,7,13,16,0,36,202112
Vikings,7,7,12,0,26,49ers,7,7,20,0,34,202112
Browns,0,3,7,0,10,Ravens,3,3,7,3,16,202112
Seahawks,7,2,0,6,15,Washington,3,6,8,0,17,202112
Cowboys,7,6,7,7,27,Saints,0,7,3,7,17,202113
Buccaneers,13,7,7,3,30,Falcons,7,10,0,0,17,202113
Cardinals,14,7,3,9,33,Bears,0,7,7,8,22,202113
Chargers,16,8,0,17,41,Bengals,0,13,9,0,22,202113
Vikings,6,0,9,12,27,Lions,0,20,3,6,29,202113
Giants,0,3,3,3,9,Dolphins,0,10,0,10,20,202113
Eagles,7,17,3,6,33,Jets,12,6,0,0,18,202113
Colts,7,7,7,10,31,Texans,0,0,0,0,0,202113
Washington,7,0,0,10,17,Raiders,0,3,3,9,15,202113
Jaguars,0,7,0,0,7,Rams,10,6,14,7,37,202113
Ravens,0,7,3,9,19,Steelers,0,3,0,17,20,202113
49ers,14,9,0,0,23,Seahawks,7,14,9,0,30,202113
Broncos,0,3,0,6,9,Chiefs,10,0,3,9,22,202113
Patriots,8,3,0,3,14,Bills,7,0,3,0,10,202113
Steelers,0,0,7,21,28,Vikings,6,17,6,7,36,202114
Ravens,0,6,3,13,22,Browns,10,14,0,0,24,202114
Jaguars,0,0,0,0,0,Titans,7,3,7,3,20,202114
Raiders,0,3,6,0,9,Chiefs,14,21,3,10,48,202114
Saints,3,7,3,17,30,Jets,0,6,0,3,9,202114
Cowboys,18,6,3,0,27,Washington,0,0,8,12,20,202114
Falcons,7,10,3,9,29,Panthers,7,0,7,7,21,202114
Seahawks,10,6,3,14,33,Texans,7,6,0,0,13,202114
Lions,0,10,0,0,10,Broncos,14,3,14,7,38,202114
Giants,7,0,0,14,21,Chargers,7,17,6,7,37,202114
49ers,3,14,3,0,6,26,Bengals,3,3,0,14,3,23,202114
Bills,0,3,7,17,0,27,Buccaneers,7,17,0,3,6,33,202114
Bears,3,24,0,3,30,Packers,0,21,17,7,45,202114
Rams,0,13,14,3,30,Cardinals,3,10,0,10,23,202114
Chiefs,7,3,3,15,6,34,Chargers,0,14,0,14,0,28,202115
Patriots,0,0,0,17,17,Colts,14,3,3,7,27,202115
Panthers,0,8,0,6,14,Bills,0,17,7,7,31,202115
Cardinals,0,0,6,6,12,Lions,3,14,7,6,30,202115
Jets,10,7,0,7,24,Dolphins,0,10,7,14,31,202115
Cowboys,6,9,6,0,21,Giants,3,0,3,0,6,202115
Titans,10,3,0,0,13,Steelers,0,3,7,9,19,202115
Texans,14,6,3,7,30,Jaguars,3,7,3,3,16,202115
Bengals,3,3,9,0,15,Broncos,0,3,7,0,10,202115
Falcons,3,7,3,0,13,49ers,3,14,14,0,31,202115
Packers,0,14,7,10,31,Ravens,7,7,3,13,30,202115
Saints,3,3,0,3,9,Buccaneers,0,0,0,0,0,202115
Raiders,7,3,0,6,16,Browns,0,0,7,7,14,202115
Vikings,7,3,7,0,17,Bears,0,3,0,6,9,202115
Seahawks,0,3,7,0,10,Rams,3,0,7,10,20,202115
Washington,10,0,0,7,17,Eagles,0,10,10,7,27,202115
49ers,7,3,0,7,17,Titans,0,0,10,10,20,202116
Browns,6,6,3,7,22,Packers,7,14,3,0,24,202116
Colts,7,5,3,7,22,Cardinals,6,0,7,3,16,202116
Lions,3,7,3,3,16,Falcons,0,10,3,7,20,202116
Ravens,7,7,0,7,21,Bengals,10,21,3,7,41,202116
Rams,7,6,7,10,30,Vikings,0,3,10,10,23,202116
Bills,7,10,3,13,33,Patriots,0,7,7,7,21,202116
Jaguars,3,9,3,6,21,Jets,6,7,3,10,26,202116
Giants,0,3,0,7,10,Eagles,0,3,17,14,34,202116
Buccaneers,7,12,10,3,32,Panthers,3,3,0,0,6,202116
Chargers,6,6,3,14,29,Texans,7,10,0,24,41,202116
Bears,0,7,7,11,25,Seahawks,7,10,7,0,24,202116
Steelers,0,0,3,7,10,Chiefs,14,9,7,6,36,202116
Broncos,0,13,0,0,13,Raiders,0,7,7,3,17,202116
Washington,0,7,0,7,14,Cowboys,21,21,7,7,56,202116
Dolphins,10,0,7,3,20,Saints,0,3,0,0,3,202116
Falcons,2,13,0,0,15,Bills,14,0,8,7,29,202117
Giants,0,3,0,0,3,Bears,14,8,7,0,29,202117
Chiefs,14,14,0,3,31,Bengals,7,10,7,10,34,202117
Dolphins,0,3,0,0,3,Titans,7,10,0,17,34,202117
Raiders,7,6,0,10,23,Colts,0,10,7,3,20,202117
Jaguars,3,0,0,7,10,Patriots,7,21,13,9,50,202117
Buccaneers,7,3,7,11,28,Jets,7,10,7,0,24,202117
Eagles,0,7,7,6,20,Washington,10,6,0,0,16,202117
Rams,0,7,0,13,20,Ravens,7,6,3,3,19,202117
Broncos,0,3,0,10,13,Chargers,7,10,3,14,34,202117
Texans,0,7,0,0,7,49ers,0,3,7,13,23,202117
Cardinals,3,10,9,3,25,Cowboys,0,7,0,15,22,202117
Panthers,3,7,0,0,10,Saints,3,6,3,6,18,202117
Lions,0,7,15,7,29,Seahawks,10,21,7,13,51,202117
Vikings,0,3,7,0,10,Packers,3,17,10,7,37,202117
Browns,0,0,7,7,14,Steelers,0,10,3,13,26,202117
Chiefs,7,3,7,11,28,Broncos,7,7,7,3,24,202118
Cowboys,10,20,0,21,51,Eagles,7,10,3,6,26,202118
Bengals,0,7,3,6,16,Browns,7,7,0,7,21,202118
Packers,7,6,3,14,30,Lions,7,10,7,13,37,202118
Bears,3,11,3,0,17,Vikings,0,3,7,21,31,202118
Washington,3,3,6,10,22,Giants,0,0,0,7,7,202118
Colts,0,3,0,8,11,Jaguars,7,6,10,3,26,202118
Steelers,3,0,3,7,3,16,Ravens,0,3,7,3,0,13,202118
Titans,0,21,0,7,28,Texans,0,0,10,15,25,202118
Saints,7,17,0,6,30,Falcons,3,3,7,7,20,202118
Jets,0,7,3,0,10,Bills,10,3,0,14,27,202118
49ers,0,3,14,7,3,27,Rams,3,14,0,7,0,24,202118
Patriots,0,7,3,14,24,Dolphins,14,3,7,9,33,202118
Seahawks,7,10,7,14,38,Cardinals,7,3,14,6,30,202118
Panthers,7,0,3,7,17,Buccaneers,0,10,7,24,41,202118
Chargers,0,14,0,15,3,32,Raiders,10,7,3,9,6,35,202118
Raiders,3,10,0,6,19,Bengals,10,10,3,3,26,202119
Patriots,0,3,7,7,17,Bills,14,13,6,14,47,202119
Eagles,0,0,0,15,15,Buccaneers,14,3,14,0,31,202119
49ers,10,6,7,0,23,Cowboys,0,7,0,10,17,202119
Steelers,0,7,7,7,21,Chiefs,0,21,14,7,42,202119
Cardinals,0,0,8,3,11,Rams,7,14,7,6,34,202119
Bengals,6,3,7,3,19,Titans,0,6,10,0,16,202120
49ers,0,0,3,10,13,Packers,7,0,0,3,10,202120
Rams,10,10,7,3,30,Buccaneers,3,0,10,14,27,202120
Bills,7,7,7,15,0,36,Chiefs,7,7,9,13,6,42,202120
Bengals,3,7,11,3,3,27,Chiefs,7,14,0,3,0,24,202121
49ers,0,10,7,0,17,Rams,0,7,0,13,20,202121
Rams,7,6,3,7,23,Bengals,3,7,10,0,20,202123
