Away,AP1,AP2,AP3,AOT1,Away_Final,Home,HP1,HP2,HP3,HOT1,Home_Final,Date,P1M,P2M,P3M,FinalMargin,FinalTotal,HomeMargin,Season,OT_Flag,Weekday,TravelDist,Playoffs
Hurricanes,1,3,0,0,4,Wild,1,1,1,0,3,20101007,0,2,1,1,7,-1,2010,0,3,995,0
Flyers,0,2,1,0,3,Penguins,0,0,2,0,2,20101007,0,2,1,1,5,-1,2010,0,3,257,0
Canadiens,1,0,1,0,2,Maple Leafs,2,0,1,0,3,20101007,1,1,1,1,5,1,2010,0,3,303,0
Flames,0,0,0,0,0,Oilers,1,0,3,0,4,20101007,1,1,4,4,4,4,2010,0,3,171,0
Blackhawks,1,1,1,0,3,Avalanche,1,2,0,1,4,20101007,0,1,0,1,7,1,2010,1,3,916,0
Stars,1,2,0,1,4,Devils,2,1,0,0,3,20101008,-1,0,0,1,7,-1,2010,1,4,1362,0
Wild,1,0,0,0,1,Hurricanes,0,1,0,1,2,20101008,-1,0,0,1,3,1,2010,1,4,995,0
Sharks,2,0,1,0,3,Blue Jackets,2,0,0,0,2,20101008,0,0,1,1,5,-1,2010,0,4,2090,0
Ducks,0,0,0,0,0,Red Wings,2,2,0,0,4,20101008,2,4,4,4,4,4,2010,0,4,1979,0
Sabres,1,0,1,0,2,Senators,0,1,0,0,1,20101008,1,0,1,1,3,-1,2010,0,4,219,0
Capitals,1,0,1,0,2,Jets,1,2,1,0,4,20101008,0,2,2,2,6,2,2010,0,4,541,0
Flyers,0,0,1,0,1,Blues,1,0,0,1,2,20101009,1,1,0,1,3,1,2010,1,5,808,0
Ducks,0,1,0,0,1,Predators,0,3,1,0,4,20101009,0,2,3,3,5,3,2010,0,5,1776,0
Canadiens,1,0,2,0,3,Penguins,0,1,1,0,2,20101009,1,0,1,1,5,-1,2010,0,5,474,0
Jets,0,2,1,0,3,Lightning,2,2,1,0,5,20101009,2,2,2,2,8,2,2010,0,5,416,0
Red Wings,1,1,1,0,3,Blackhawks,1,1,0,0,2,20101009,0,0,1,1,5,-1,2010,0,5,238,0
Devils,2,0,0,0,2,Capitals,1,4,2,0,7,20101009,-1,3,5,5,9,5,2010,0,5,198,0
Coyotes,1,3,1,0,5,Bruins,0,0,2,0,2,20101009,1,4,3,3,7,-3,2010,0,5,2295,0
Stars,2,1,1,1,5,Islanders,0,2,1,1,4,20101009,2,1,1,1,9,-1,2010,0,5,1370,0
Rangers,2,2,2,0,6,Sabres,0,1,2,0,3,20101009,2,3,3,3,9,-3,2010,0,5,292,0
Blue Jackets,1,0,1,1,3,Sharks,1,0,1,0,2,20101009,0,0,0,1,5,-1,2010,1,5,2090,0
Kings,0,0,1,1,2,Canucks,0,1,0,0,1,20101009,0,-1,0,1,3,-1,2010,1,5,1076,0
Senators,0,0,1,0,1,Maple Leafs,2,1,2,0,5,20101009,2,3,4,4,6,4,2010,0,5,203,0
Panthers,0,2,0,0,2,Oilers,0,3,0,0,3,20101010,0,1,1,1,5,1,2010,0,6,2569,0
Kings,0,0,1,0,1,Flames,0,1,2,0,3,20101010,0,1,2,2,4,2,2010,0,6,1197,0
Bruins,0,2,1,0,3,Coyotes,0,0,0,0,0,20101010,0,2,3,3,3,-3,2010,0,6,2295,0
Senators,0,1,1,0,2,Capitals,1,1,0,1,3,20101011,1,1,0,1,5,1,2010,1,0,446,0
Rangers,1,2,1,0,4,Islanders,2,1,3,0,6,20101011,1,0,2,2,10,2,2010,0,0,0,0
Ducks,0,1,0,0,1,Blues,2,2,1,0,5,20101011,2,3,4,4,6,4,2010,0,0,1586,0
Penguins,1,1,1,0,3,Devils,0,0,1,0,1,20101011,1,2,2,2,4,-2,2010,0,0,306,0
Blackhawks,1,2,1,0,4,Sabres,2,0,1,0,3,20101011,-1,1,1,1,7,-1,2010,0,0,453,0
Avalanche,0,1,1,0,2,Flyers,2,0,2,0,4,20101011,2,1,2,2,6,2,2010,0,0,1574,0
Panthers,0,1,0,0,1,Canucks,1,0,1,0,2,20101011,1,0,1,1,3,1,2010,0,0,2803,0
Avalanche,1,1,2,1,5,Red Wings,1,2,1,0,4,20101012,0,-1,0,1,9,-1,2010,1,1,1154,0
Jets,0,1,0,0,1,Kings,0,0,3,0,3,20101012,0,-1,2,2,4,2,2010,0,1,1932,0
Devils,0,0,0,1,1,Sabres,0,0,0,0,0,20101013,0,0,0,1,1,-1,2010,1,2,284,0
Islanders,1,0,0,0,1,Capitals,0,1,1,0,2,20101013,-1,0,1,1,3,1,2010,0,2,204,0
Lightning,0,1,2,1,4,Canadiens,2,0,1,0,3,20101013,-2,-1,0,1,7,-1,2010,1,2,1311,0
Maple Leafs,1,3,0,0,4,Penguins,2,1,0,0,3,20101013,-1,1,1,1,7,-1,2010,0,2,222,0
Predators,1,0,2,0,3,Blackhawks,2,0,0,0,2,20101013,-1,-1,1,1,5,-1,2010,0,2,395,0
Canucks,2,0,1,0,3,Ducks,1,1,2,0,4,20101013,-1,0,1,1,7,1,2010,0,2,1076,0
Hurricanes,0,0,2,0,2,Senators,1,1,1,0,3,20101014,1,2,1,1,5,1,2010,0,3,673,0
Lightning,1,1,1,0,3,Flyers,1,0,1,0,2,20101014,0,1,1,1,5,-1,2010,0,3,928,0
Blues,1,1,1,0,3,Predators,3,1,0,0,4,20101014,2,2,1,1,7,1,2010,0,3,253,0
Red Wings,0,0,1,0,1,Stars,1,3,0,0,4,20101014,1,4,3,3,5,3,2010,0,3,999,0
Oilers,0,2,0,0,2,Wild,1,2,1,0,4,20101014,1,1,2,2,6,2,2010,0,3,1083,0
Panthers,2,0,1,0,3,Flames,0,0,0,0,0,20101014,2,2,3,3,3,-3,2010,0,3,2493,0
Canucks,0,0,1,0,1,Kings,1,1,2,0,4,20101015,1,2,3,3,5,3,2010,0,4,1076,0
Jets,1,1,2,1,5,Ducks,1,2,1,0,4,20101015,0,-1,0,1,9,-1,2010,1,4,1932,0
Canadiens,0,2,0,0,2,Sabres,0,0,1,0,1,20101015,0,2,1,1,3,-1,2010,0,4,311,0
Blackhawks,2,2,1,0,5,Blue Jackets,0,1,1,0,2,20101015,2,3,3,3,7,-3,2010,0,4,275,0
Maple Leafs,0,3,0,1,4,Rangers,1,0,2,0,3,20101015,-1,2,0,1,7,-1,2010,1,4,341,0
Avalanche,1,1,1,0,3,Devils,0,1,1,0,2,20101015,1,1,1,1,5,-1,2010,0,4,1618,0
Islanders,0,2,0,0,2,Penguins,0,2,0,1,3,20101015,0,0,0,1,5,1,2010,1,4,314,0
Capitals,0,0,2,1,3,Predators,1,1,0,0,2,20101016,-1,-2,0,1,5,-1,2010,1,5,566,0
Oilers,1,2,0,0,3,Flames,1,1,3,0,5,20101016,0,-1,2,2,8,2,2010,0,5,171,0
Red Wings,0,1,0,1,2,Coyotes,1,0,0,0,1,20101016,-1,0,0,1,3,-1,2010,1,5,1687,0
Blues,2,0,0,0,2,Stars,1,1,0,1,3,20101016,-1,0,0,1,5,1,2010,1,5,547,0
Sabres,2,1,0,0,3,Blackhawks,1,1,2,0,4,20101016,-1,-1,1,1,7,1,2010,0,5,453,0
Blue Jackets,1,1,1,0,3,Wild,0,2,0,0,2,20101016,1,0,1,1,5,-1,2010,0,5,626,0
Lightning,0,0,0,0,0,Panthers,4,0,2,0,6,20101016,4,4,6,6,6,6,2010,0,5,205,0
Avalanche,0,0,2,0,2,Islanders,0,3,2,0,5,20101016,0,3,3,3,7,3,2010,0,5,1627,0
Bruins,0,4,0,0,4,Devils,0,1,0,0,1,20101016,0,3,3,3,5,-3,2010,0,5,196,0
Senators,1,2,0,0,3,Canadiens,1,2,1,0,4,20101016,0,0,1,1,7,1,2010,0,5,104,0
Penguins,1,1,3,0,5,Flyers,1,0,0,0,1,20101016,0,1,4,4,6,-4,2010,0,5,257,0
Jets,0,2,2,0,4,Sharks,2,0,0,0,2,20101016,-2,0,2,2,6,-2,2010,0,5,2109,0
Hurricanes,0,1,0,0,1,Canucks,2,1,2,0,5,20101017,2,2,4,4,6,4,2010,0,6,2409,0
Coyotes,0,0,2,0,2,Ducks,0,2,1,0,3,20101017,0,2,1,1,5,1,2010,0,6,356,0
Blues,0,1,1,0,2,Blackhawks,0,0,2,1,3,20101018,0,-1,0,1,5,1,2010,1,0,260,0
Stars,1,1,2,0,4,Lightning,2,2,1,0,5,20101018,1,2,1,1,9,1,2010,0,0,916,0
Islanders,0,1,0,1,2,Maple Leafs,0,0,1,0,1,20101018,0,1,0,1,3,-1,2010,1,0,341,0
Avalanche,1,0,2,0,3,Rangers,1,0,0,0,1,20101018,0,0,2,2,4,-2,2010,0,0,1627,0
Senators,0,1,1,0,2,Penguins,3,2,0,0,5,20101018,3,4,3,3,7,3,2010,0,0,392,0
Bruins,2,0,1,0,3,Capitals,0,1,0,0,1,20101019,2,1,2,2,4,-2,2010,0,1,394,0
Flames,0,0,0,1,1,Predators,0,0,0,0,0,20101019,0,0,0,1,1,-1,2010,1,1,1692,0
Canucks,1,0,1,0,2,Wild,3,3,0,0,6,20101019,2,5,4,4,8,4,2010,0,1,1427,0
Hurricanes,2,1,2,0,5,Sharks,0,2,0,0,2,20101019,2,1,3,3,7,-3,2010,0,1,2382,0
Sabres,1,2,1,0,4,Jets,0,0,1,0,1,20101020,1,3,3,3,5,-3,2010,0,2,698,0
Ducks,0,0,1,0,1,Blue Jackets,0,2,1,0,3,20101020,0,2,2,2,4,2,2010,0,2,1973,0
Canucks,0,0,1,0,1,Blackhawks,1,0,0,1,2,20101020,1,1,0,1,3,1,2010,1,2,1775,0
Hurricanes,2,1,0,0,3,Kings,2,1,1,0,4,20101020,0,0,1,1,7,1,2010,0,2,2231,0
Islanders,1,1,0,1,3,Lightning,1,1,0,0,2,20101021,0,0,0,1,5,-1,2010,1,3,1004,0
Kings,0,1,1,0,2,Coyotes,2,1,1,0,4,20101021,2,2,2,2,6,2,2010,0,3,356,0
Wild,3,0,1,0,4,Oilers,1,0,1,0,2,20101021,2,2,2,2,6,-2,2010,0,3,1083,0
Sharks,1,2,1,0,4,Avalanche,1,0,1,0,2,20101021,0,2,2,2,6,-2,2010,0,3,927,0
Penguins,0,2,1,1,4,Predators,1,1,1,0,3,20101021,-1,0,0,1,7,-1,2010,1,3,471,0
Stars,2,2,0,0,4,Panthers,0,0,1,0,1,20101021,2,4,3,3,5,-3,2010,0,3,1110,0
Flames,2,0,0,0,2,Red Wings,1,1,2,0,4,20101021,-1,0,2,2,6,2,2010,0,3,1573,0
Rangers,2,0,0,0,2,Maple Leafs,0,0,1,0,1,20101021,2,2,1,1,3,-1,2010,0,3,341,0
Ducks,2,0,1,0,3,Flyers,1,1,0,0,2,20101021,1,0,1,1,5,-1,2010,0,3,2388,0
Capitals,0,0,1,0,1,Bruins,1,2,1,0,4,20101021,1,3,3,3,5,3,2010,0,3,394,0
Devils,1,1,1,0,3,Canadiens,0,0,0,0,0,20101021,1,2,3,3,3,-3,2010,0,3,342,0
Wild,0,0,1,0,1,Canucks,1,1,3,0,5,20101022,1,2,4,4,6,4,2010,0,4,1427,0
Flames,3,1,2,0,6,Blue Jackets,1,0,1,0,2,20101022,2,3,4,4,8,-4,2010,0,4,1670,0
Senators,1,2,1,0,4,Sabres,1,1,0,0,2,20101022,0,1,2,2,6,-2,2010,0,4,219,0
Lightning,3,1,1,0,5,Jets,0,1,1,0,2,20101022,3,3,3,3,7,-3,2010,0,4,416,0
Blackhawks,1,1,0,0,2,Blues,1,1,2,0,4,20101022,0,0,2,2,6,2,2010,0,4,260,0
Penguins,0,0,0,0,0,Blues,0,0,0,1,1,20101023,0,0,0,1,1,1,2010,1,5,557,0
Kings,2,2,2,0,6,Avalanche,2,1,1,0,4,20101023,0,1,2,2,10,-2,2010,0,5,830,0
Sharks,1,2,3,0,6,Oilers,1,0,0,0,1,20101023,0,2,5,5,7,-5,2010,0,5,1190,0
Predators,1,0,0,0,1,Stars,0,0,0,0,0,20101023,1,1,1,1,1,-1,2010,0,5,616,0
Hurricanes,0,2,1,1,4,Coyotes,0,0,3,0,3,20101023,0,2,0,1,7,-1,2010,1,5,1898,0
Islanders,1,2,0,0,3,Panthers,2,1,1,0,4,20101023,1,0,1,1,7,1,2010,0,5,1091,0
Blue Jackets,0,1,2,0,3,Blackhawks,2,0,0,0,2,20101023,-2,-1,1,1,5,-1,2010,0,5,275,0
Maple Leafs,0,2,0,0,2,Flyers,2,1,2,0,5,20101023,2,1,3,3,7,3,2010,0,5,334,0
Canadiens,1,2,0,0,3,Senators,0,0,0,0,0,20101023,1,3,3,3,3,-3,2010,0,5,104,0
Sabres,2,3,1,0,6,Devils,0,0,1,0,1,20101023,2,5,5,5,7,-5,2010,0,5,284,0
Ducks,1,2,1,0,4,Red Wings,1,2,2,0,5,20101023,0,0,1,1,9,1,2010,0,5,1979,0
Rangers,2,1,0,0,3,Bruins,1,1,0,0,2,20101023,1,1,1,1,5,-1,2010,0,5,190,0
Jets,1,1,1,0,3,Capitals,0,1,2,1,4,20101023,-1,-1,0,1,7,1,2010,1,5,541,0
Predators,2,1,1,0,4,Lightning,1,0,2,0,3,20101024,1,2,1,1,7,-1,2010,0,6,621,0
Devils,0,0,1,0,1,Rangers,0,2,1,0,3,20101024,0,2,2,2,4,2,2010,0,6,8,0
Sharks,0,0,0,0,0,Flames,4,0,0,0,4,20101024,4,4,4,4,4,4,2010,0,6,1027,0
Flyers,0,0,1,0,1,Blue Jackets,1,1,0,0,2,20101025,1,2,1,1,3,1,2010,0,0,414,0
Coyotes,0,1,1,0,2,Canadiens,0,2,0,1,3,20101025,0,1,0,1,5,1,2010,1,0,2175,0
Kings,1,1,0,1,3,Wild,2,0,0,0,2,20101025,-1,0,0,1,5,-1,2010,1,0,1521,0
Ducks,0,3,2,0,5,Stars,1,0,1,0,2,20101026,-1,2,3,3,7,-3,2010,0,1,1237,0
Oilers,1,1,2,0,4,Flames,2,2,0,1,5,20101026,1,2,0,1,9,1,2010,1,1,171,0
Avalanche,1,1,1,0,3,Canucks,1,1,1,1,4,20101026,0,0,0,1,7,1,2010,1,1,1105,0
Coyotes,0,1,1,0,2,Senators,3,0,2,0,5,20101026,3,2,3,3,7,3,2010,0,1,2071,0
Panthers,0,1,0,0,1,Maple Leafs,1,0,2,0,3,20101026,1,0,2,2,4,2,2010,0,1,1234,0
Sabres,1,0,2,0,3,Flyers,1,3,2,0,6,20101026,0,3,3,3,9,3,2010,0,1,279,0
Capitals,1,0,2,0,3,Hurricanes,0,0,0,0,0,20101027,1,1,3,3,3,-3,2010,0,2,233,0
Jets,1,2,3,0,6,Rangers,1,1,2,0,4,20101027,0,1,2,2,10,-2,2010,0,2,745,0
Islanders,1,0,2,0,3,Canadiens,2,1,2,0,5,20101027,1,2,2,2,8,2,2010,0,2,343,0
Penguins,3,0,0,0,3,Lightning,2,1,2,0,5,20101027,-1,0,2,2,8,2,2010,0,2,874,0
Kings,1,0,0,0,1,Blackhawks,1,1,1,0,3,20101027,0,1,2,2,4,2,2010,0,2,1741,0
Devils,0,1,1,0,2,Sharks,3,1,1,0,5,20101027,3,3,3,3,7,3,2010,0,2,2540,0
Avalanche,1,2,3,0,6,Flames,2,2,1,0,5,20101028,-1,-1,1,1,11,-1,2010,0,3,898,0
Kings,1,2,2,0,5,Stars,1,0,1,0,2,20101028,0,2,3,3,7,-3,2010,0,3,1237,0
Capitals,0,0,1,0,1,Wild,1,1,0,0,2,20101028,1,2,1,1,3,1,2010,0,3,931,0
Blues,0,1,2,0,3,Predators,0,0,0,0,0,20101028,0,1,3,3,3,-3,2010,0,3,253,0
Maple Leafs,0,0,0,0,0,Bruins,1,1,0,0,2,20101028,1,2,2,2,2,2,2010,0,3,430,0
Oilers,1,0,1,0,2,Blue Jackets,2,0,0,1,3,20101028,1,1,0,1,5,1,2010,1,3,1703,0
Panthers,1,0,2,0,3,Senators,0,3,2,0,5,20101028,-1,2,2,2,8,2,2010,0,3,1370,0
Coyotes,3,0,1,0,4,Red Wings,0,1,1,0,2,20101028,3,2,2,2,6,-2,2010,0,3,1687,0
Oilers,4,2,1,0,7,Blackhawks,2,1,1,0,4,20101029,2,3,3,3,11,-3,2010,0,4,1437,0
Devils,0,1,1,0,2,Ducks,0,1,0,0,1,20101029,0,0,1,1,3,-1,2010,0,4,2436,0
Sabres,2,0,1,0,3,Jets,0,2,1,1,4,20101029,-2,0,0,1,7,1,2010,1,4,698,0
Flyers,0,2,1,0,3,Penguins,1,0,1,0,2,20101029,-1,1,1,1,5,-1,2010,0,4,257,0
Hurricanes,1,2,1,0,4,Rangers,0,3,0,0,3,20101029,1,0,1,1,7,-1,2010,0,4,423,0
Canadiens,1,0,2,0,3,Islanders,0,1,0,0,1,20101029,1,0,2,2,4,-2,2010,0,4,343,0
Devils,0,1,0,0,1,Kings,1,2,0,0,3,20101030,1,2,2,2,4,2,2010,0,5,2436,0
Capitals,1,6,0,0,7,Flames,2,0,0,0,2,20101030,-1,5,5,5,9,-5,2010,0,5,1967,0
Lightning,0,1,2,0,3,Coyotes,0,0,0,0,0,20101030,0,1,3,3,3,-3,2010,0,5,1793,0
Blue Jackets,0,0,1,0,1,Avalanche,1,3,1,0,5,20101030,1,4,4,4,6,4,2010,0,5,1163,0
Blackhawks,0,0,3,0,3,Wild,0,0,1,0,1,20101030,0,0,2,2,4,-2,2010,0,5,355,0
Jets,3,0,0,0,3,Blues,1,0,2,1,4,20101030,-2,-2,0,1,7,1,2010,1,5,467,0
Sabres,0,0,0,0,0,Stars,1,1,2,0,4,20101030,1,2,4,4,4,4,2010,0,5,1197,0
Rangers,1,1,0,0,2,Maple Leafs,0,0,0,0,0,20101030,1,2,2,2,2,-2,2010,0,5,341,0
Islanders,0,1,0,0,1,Flyers,2,4,0,0,6,20101030,2,5,5,5,7,5,2010,0,5,80,0
Bruins,1,2,1,0,4,Senators,0,0,0,0,0,20101030,1,3,4,4,4,-4,2010,0,5,320,0
Panthers,1,1,1,0,3,Canadiens,0,1,0,0,1,20101030,1,1,2,2,4,-2,2010,0,5,1418,0
Penguins,1,1,1,0,3,Hurricanes,0,0,0,0,0,20101030,1,2,3,3,3,-3,2010,0,5,330,0
Predators,0,1,1,0,2,Red Wings,2,1,2,0,5,20101030,2,2,3,3,7,3,2010,0,5,470,0
Ducks,0,0,2,0,2,Sharks,2,3,0,0,5,20101030,2,5,3,3,7,3,2010,0,5,305,0
Devils,0,0,0,0,0,Canucks,1,1,1,0,3,20101101,1,2,3,3,3,3,2010,0,0,2421,0
Hurricanes,0,1,1,0,2,Flyers,1,1,1,0,3,20101101,1,1,1,1,5,1,2010,0,0,345,0
Blackhawks,1,0,1,0,2,Rangers,1,0,2,0,3,20101101,0,0,1,1,5,1,2010,0,0,711,0
Senators,1,2,0,0,3,Maple Leafs,0,0,2,0,2,20101102,1,3,1,1,5,-1,2010,0,1,203,0
Canadiens,0,0,0,0,0,Blue Jackets,2,0,1,0,3,20101102,2,2,3,3,3,3,2010,0,1,605,0
Sharks,0,0,0,0,0,Wild,0,1,0,0,1,20101102,0,1,1,1,1,1,2010,0,1,1570,0
Canucks,3,0,1,0,4,Oilers,0,1,2,0,3,20101102,3,2,1,1,7,-1,2010,0,1,514,0
Lightning,0,1,1,0,2,Ducks,1,0,1,1,3,20101103,1,0,0,1,5,1,2010,1,2,2149,0
Predators,2,1,0,0,3,Coyotes,1,1,2,0,4,20101103,-1,-1,1,1,7,1,2010,0,2,1442,0
Red Wings,0,2,0,0,2,Flames,1,0,0,0,1,20101103,-1,1,1,1,3,-1,2010,0,2,1573,0
Penguins,0,1,1,0,2,Stars,2,2,1,0,5,20101103,2,3,3,3,7,3,2010,0,2,1069,0
Jets,1,1,2,0,4,Panthers,1,1,1,0,3,20101103,0,0,1,1,7,-1,2010,0,2,605,0
Maple Leafs,1,0,3,0,4,Capitals,0,3,1,1,5,20101103,-1,2,0,1,9,1,2010,1,2,349,0
Islanders,0,0,2,0,2,Hurricanes,3,2,2,0,7,20101103,3,5,5,5,9,5,2010,0,2,423,0
Bruins,3,1,1,0,5,Sabres,0,1,1,0,2,20101103,3,3,3,3,7,-3,2010,0,2,399,0
Devils,1,1,3,0,5,Blackhawks,0,1,2,0,3,20101103,1,1,2,2,8,-2,2010,0,2,703,0
Canucks,1,1,1,0,3,Avalanche,0,0,1,0,1,20101104,1,2,2,2,4,-2,2010,0,3,1105,0
Lightning,0,0,0,0,0,Kings,0,0,1,0,1,20101104,0,0,1,1,1,1,2010,0,3,2149,0
Sharks,0,0,0,0,0,Blues,1,1,0,0,2,20101104,1,2,2,2,2,2,2010,0,3,1719,0
Rangers,0,1,0,0,1,Flyers,0,3,1,0,4,20101104,0,2,3,3,5,3,2010,0,3,80,0
Blue Jackets,0,1,2,0,3,Jets,0,0,0,0,0,20101104,0,1,3,3,3,-3,2010,0,3,436,0
Islanders,0,0,1,0,1,Senators,1,2,1,0,4,20101104,1,3,3,3,5,3,2010,0,3,334,0
Rangers,1,1,1,0,3,Devils,0,0,0,0,0,20101105,1,2,3,3,3,-3,2010,0,4,8,0
Bruins,0,0,3,0,3,Capitals,0,3,2,0,5,20101105,0,3,2,2,8,2,2010,0,4,394,0
Canadiens,1,2,0,0,3,Sabres,1,1,0,0,2,20101105,0,1,1,1,5,-1,2010,0,4,311,0
Hurricanes,3,0,1,0,4,Panthers,3,1,3,0,7,20101105,0,1,3,3,11,3,2010,0,4,696,0
Flames,1,0,0,0,1,Wild,1,0,1,0,2,20101105,0,0,1,1,3,1,2010,0,4,1043,0
Coyotes,0,1,2,0,3,Stars,1,4,1,0,6,20101105,1,4,3,3,9,3,2010,0,4,884,0
Red Wings,1,1,1,0,3,Oilers,0,1,0,0,1,20101105,1,1,2,2,4,-2,2010,0,4,1592,0
Penguins,0,1,1,0,2,Ducks,0,3,0,0,3,20101105,0,2,1,1,5,1,2010,0,4,2132,0
Lightning,1,0,1,0,2,Sharks,2,2,1,0,5,20101106,1,3,3,3,7,3,2010,0,5,2365,0
Red Wings,0,3,1,0,4,Canucks,1,2,3,0,6,20101106,1,0,2,2,10,2,2010,0,5,1967,0
Predators,0,0,1,0,1,Kings,2,2,0,0,4,20101106,2,4,3,3,5,3,2010,0,5,1776,0
Penguins,0,3,0,1,4,Coyotes,2,1,0,0,3,20101106,-2,0,0,1,7,-1,2010,1,5,1824,0
Stars,0,0,0,0,0,Avalanche,1,2,2,0,5,20101106,1,3,5,5,5,5,2010,0,5,661,0
Wild,1,1,1,0,3,Blue Jackets,1,1,0,0,2,20101106,0,0,1,1,5,-1,2010,0,5,626,0
Sabres,0,1,1,1,3,Maple Leafs,1,1,0,0,2,20101106,-1,-1,0,1,5,-1,2010,1,5,57,0
Flyers,1,0,1,0,2,Islanders,0,1,0,0,1,20101106,1,0,1,1,3,-1,2010,0,5,80,0
Senators,1,1,1,0,3,Canadiens,0,1,1,0,2,20101106,1,1,1,1,5,-1,2010,0,5,104,0
Panthers,0,0,2,0,2,Hurricanes,0,1,2,0,3,20101106,0,1,1,1,5,1,2010,0,5,696,0
Blues,1,0,0,1,2,Bruins,0,0,1,0,1,20101106,1,1,0,1,3,-1,2010,1,5,1035,0
Blackhawks,2,2,0,1,5,Jets,1,3,0,0,4,20101106,1,0,0,1,9,-1,2010,1,5,587,0
Flyers,1,1,0,0,2,Capitals,1,1,0,1,3,20101107,0,0,0,1,5,1,2010,1,6,123,0
Oilers,0,0,2,0,2,Blackhawks,1,0,0,0,1,20101107,-1,-1,1,1,3,-1,2010,0,6,1437,0
Blues,0,1,1,0,2,Rangers,0,0,0,0,0,20101107,0,1,2,2,2,-2,2010,0,6,871,0
Predators,2,0,2,0,4,Ducks,2,0,3,0,5,20101107,0,0,1,1,9,1,2010,0,6,1776,0
Coyotes,1,1,0,0,2,Red Wings,1,0,1,1,3,20101108,0,-1,0,1,5,1,2010,1,0,1687,0
Maple Leafs,0,0,0,0,0,Lightning,3,0,1,0,4,20101109,3,3,4,4,4,4,2010,0,1,1096,0
Ducks,1,1,0,1,3,Sharks,1,0,1,0,2,20101109,0,1,0,1,5,-1,2010,1,1,305,0
Jets,1,0,1,0,2,Senators,2,2,1,0,5,20101109,1,3,3,3,7,3,2010,0,1,914,0
Flames,0,1,3,0,4,Avalanche,1,0,1,0,2,20101109,-1,0,2,2,6,-2,2010,0,1,898,0
Canucks,0,0,0,0,0,Canadiens,1,0,1,0,2,20101109,1,1,2,2,2,2,2010,0,1,2273,0
Capitals,1,2,2,0,5,Rangers,2,1,0,0,3,20101109,-1,0,2,2,8,-2,2010,0,1,204,0
Oilers,0,0,1,0,1,Hurricanes,4,1,2,0,7,20101109,4,5,6,6,8,6,2010,0,1,2076,0
Sabres,0,3,1,1,5,Devils,1,3,0,0,4,20101110,-1,-1,0,1,9,-1,2010,1,2,284,0
Bruins,2,0,5,0,7,Penguins,2,2,0,0,4,20101110,0,-2,3,3,11,-3,2010,0,2,481,0
Blues,0,1,0,0,1,Blue Jackets,3,3,2,0,8,20101110,3,5,7,7,9,7,2010,0,2,395,0
Maple Leafs,0,0,1,0,1,Panthers,1,1,2,0,4,20101110,1,2,3,3,5,3,2010,0,2,1234,0
Coyotes,0,2,0,0,2,Blackhawks,1,0,0,0,1,20101110,-1,1,1,1,3,-1,2010,0,2,1450,0
Islanders,0,0,0,0,0,Ducks,0,0,1,0,1,20101110,0,0,1,1,1,1,2010,0,2,2445,0
Islanders,0,1,0,0,1,Sharks,0,1,0,1,2,20101111,0,0,0,1,3,1,2010,1,3,2549,0
Stars,1,0,0,0,1,Kings,1,0,2,0,3,20101111,0,0,2,2,4,2,2010,0,3,1237,0
Predators,0,1,1,1,3,Blues,1,0,1,0,2,20101111,-1,0,0,1,5,-1,2010,1,3,253,0
Canucks,1,1,4,0,6,Senators,1,0,1,0,2,20101111,0,1,4,4,8,-4,2010,0,3,2191,0
Oilers,0,0,2,0,2,Red Wings,3,2,1,0,6,20101111,3,5,4,4,8,4,2010,0,3,1592,0
Lightning,1,0,2,0,3,Capitals,0,2,4,0,6,20101111,-1,1,3,3,9,3,2010,0,3,818,0
Sabres,0,2,0,0,2,Rangers,1,1,0,1,3,20101111,1,0,0,1,5,1,2010,1,3,292,0
Flyers,2,2,4,0,8,Hurricanes,0,0,1,0,1,20101111,2,4,7,7,9,-7,2010,0,3,345,0
Canadiens,1,0,2,0,3,Bruins,1,0,0,0,1,20101111,0,0,2,2,4,-2,2010,0,3,270,0
Wild,0,0,1,0,1,Jets,2,1,2,0,5,20101111,2,3,4,4,6,4,2010,0,3,908,0
Oilers,2,1,0,0,3,Devils,1,1,1,1,4,20101112,-1,-1,0,1,7,1,2010,1,4,2016,0
Lightning,0,0,1,0,1,Penguins,0,2,3,0,5,20101112,0,2,4,4,6,4,2010,0,4,874,0
Avalanche,1,3,1,0,5,Blue Jackets,1,0,0,0,1,20101112,0,3,4,4,6,-4,2010,0,4,1163,0
Wild,1,0,0,0,1,Panthers,2,0,0,0,2,20101112,1,1,1,1,3,1,2010,0,4,1513,0
Flames,1,1,2,0,4,Coyotes,0,3,2,0,5,20101112,-1,1,1,1,9,1,2010,0,4,1224,0
Stars,1,0,1,0,2,Ducks,1,0,3,0,4,20101112,0,0,2,2,6,2,2010,0,4,1237,0
Penguins,0,1,3,0,4,Jets,1,0,1,0,2,20101113,-1,0,2,2,6,-2,2010,0,5,521,0
Islanders,1,0,0,0,1,Kings,2,1,2,0,5,20101113,1,2,4,4,6,4,2010,0,5,2445,0
Blackhawks,1,2,0,0,3,Predators,0,2,1,1,4,20101113,-1,-1,0,1,7,1,2010,1,5,395,0
Blues,1,1,1,0,3,Coyotes,1,3,1,0,5,20101113,0,2,2,2,8,2,2010,0,5,1270,0
Canucks,2,1,2,0,5,Maple Leafs,2,1,0,0,3,20101113,0,0,2,2,8,-2,2010,0,5,2090,0
Flames,0,1,2,0,3,Sharks,2,1,1,0,4,20101113,2,2,1,1,7,1,2010,0,5,1027,0
Hurricanes,0,2,0,0,2,Canadiens,2,3,2,0,7,20101113,2,3,5,5,9,5,2010,0,5,727,0
Avalanche,0,0,1,0,1,Red Wings,1,2,0,0,3,20101113,1,3,2,2,4,2,2010,0,5,1154,0
Capitals,1,0,1,0,2,Sabres,0,2,0,1,3,20101113,-1,1,0,1,5,1,2010,1,5,292,0
Senators,1,0,1,0,2,Bruins,0,0,0,0,0,20101113,1,1,2,2,2,-2,2010,0,5,320,0
Panthers,0,1,1,0,2,Flyers,2,3,0,0,5,20101113,2,4,3,3,7,3,2010,0,5,1021,0
Oilers,0,2,0,0,2,Rangers,1,4,3,0,8,20101114,1,3,6,6,10,6,2010,0,6,2024,0
Wild,3,0,1,0,4,Lightning,1,0,0,0,1,20101114,2,2,3,3,5,-3,2010,0,6,1318,0
Jets,1,3,0,0,4,Capitals,3,1,2,0,6,20101114,2,0,2,2,10,2,2010,0,6,541,0
Ducks,1,0,1,0,2,Blackhawks,1,1,0,1,3,20101114,0,1,0,1,5,1,2010,1,6,1741,0
Kings,1,1,1,0,3,Sharks,2,1,3,0,6,20101115,1,1,3,3,9,3,2010,0,0,305,0
Blues,1,1,1,0,3,Avalanche,3,2,1,0,6,20101115,2,3,3,3,9,3,2010,0,0,794,0
Rangers,0,1,1,1,3,Penguins,0,0,2,0,2,20101115,0,1,0,1,5,-1,2010,1,0,314,0
Senators,1,0,0,0,1,Flyers,2,1,2,0,5,20101115,1,2,4,4,6,4,2010,0,0,373,0
Canucks,0,1,2,0,3,Sabres,2,1,0,1,4,20101115,2,2,0,1,7,1,2010,1,0,2137,0
Devils,0,0,0,0,0,Bruins,1,1,1,0,3,20101115,1,2,3,3,3,3,2010,0,0,196,0
Flyers,0,0,0,0,0,Canadiens,1,1,1,0,3,20101116,1,2,3,3,3,3,2010,0,1,400,0
Predators,3,1,0,0,4,Maple Leafs,1,4,0,0,5,20101116,-2,1,1,1,9,1,2010,0,1,646,0
Ducks,0,1,0,0,1,Stars,1,0,1,0,2,20101116,1,0,1,1,3,1,2010,0,1,1237,0
Blackhawks,2,2,1,0,5,Oilers,0,0,0,0,0,20101117,2,4,5,5,5,-5,2010,0,2,1437,0
Blue Jackets,1,1,3,0,5,Kings,1,1,1,0,3,20101117,0,0,2,2,8,-2,2010,0,2,1973,0
Coyotes,0,2,1,0,3,Flames,0,0,1,0,1,20101117,0,2,2,2,4,-2,2010,0,2,1224,0
Sharks,1,2,0,0,3,Avalanche,1,0,2,1,4,20101117,0,-2,0,1,7,1,2010,1,2,927,0
Ducks,0,1,0,0,1,Wild,0,1,0,1,2,20101117,0,0,0,1,3,1,2010,1,2,1521,0
Blues,1,2,0,0,3,Red Wings,1,2,4,0,7,20101117,0,0,4,4,10,4,2010,0,2,454,0
Lightning,1,1,2,0,4,Islanders,0,1,1,0,2,20101117,1,1,2,2,6,-2,2010,0,2,1004,0
Sabres,0,2,0,0,2,Capitals,2,1,1,0,4,20101117,2,1,2,2,6,2,2010,0,2,292,0
Canucks,0,1,0,0,1,Penguins,1,2,0,0,3,20101117,1,2,2,2,4,2,2010,0,2,2168,0
Bruins,0,2,1,0,3,Rangers,0,1,1,0,2,20101117,0,1,1,1,5,-1,2010,0,2,190,0
Senators,0,0,1,0,1,Hurricanes,4,0,3,0,7,20101117,4,4,6,6,8,6,2010,0,2,673,0
Panthers,0,2,0,0,2,Jets,1,0,0,0,1,20101117,-1,1,1,1,3,-1,2010,0,2,605,0
Panthers,0,0,0,0,0,Bruins,1,0,3,0,4,20101118,1,1,4,4,4,4,2010,0,3,1257,0
Lightning,4,3,1,0,8,Flyers,5,2,0,0,7,20101118,-1,0,1,1,15,-1,2010,0,3,928,0
Devils,0,1,0,0,1,Maple Leafs,0,2,1,0,3,20101118,0,1,2,2,4,2,2010,0,3,333,0
Predators,0,1,2,0,3,Canadiens,0,0,0,0,0,20101118,0,1,3,3,3,-3,2010,0,3,937,0
Sharks,1,2,1,0,4,Stars,2,0,2,1,5,20101118,1,-1,0,1,9,1,2010,1,3,1449,0
Coyotes,0,2,1,1,4,Oilers,1,2,0,0,3,20101119,-1,-1,0,1,7,-1,2010,1,4,1392,0
Blackhawks,1,0,1,0,2,Flames,2,2,3,0,7,20101119,1,3,5,5,9,5,2010,0,4,1397,0
Rangers,0,0,1,0,1,Avalanche,0,4,1,0,5,20101119,0,4,4,4,6,4,2010,0,4,1627,0
Senators,1,0,1,0,2,Blues,0,3,2,0,5,20101119,-1,2,3,3,7,3,2010,0,4,860,0
Blue Jackets,1,3,0,0,4,Ducks,0,2,1,0,3,20101119,1,2,1,1,7,-1,2010,0,4,1973,0
Wild,1,1,1,1,4,Red Wings,0,1,2,0,3,20101119,1,1,0,1,7,-1,2010,1,4,542,0
Hurricanes,2,1,1,0,4,Penguins,2,1,1,1,5,20101119,0,0,0,1,9,1,2010,1,4,330,0
Capitals,0,0,0,0,0,Jets,3,1,1,0,5,20101119,3,4,5,5,5,5,2010,0,4,541,0
Kings,1,1,0,0,2,Sabres,0,2,2,0,4,20101119,-1,0,2,2,6,2,2010,0,4,2193,0
Kings,2,1,0,1,4,Bruins,0,2,1,0,3,20101120,2,1,0,1,7,-1,2010,1,5,2590,0
Lightning,1,1,0,0,2,Sabres,1,0,0,0,1,20101120,0,1,1,1,3,-1,2010,0,5,1051,0
Predators,0,1,0,1,2,Hurricanes,1,0,0,0,1,20101120,-1,0,0,1,3,-1,2010,1,5,456,0
Maple Leafs,0,0,0,0,0,Canadiens,0,1,1,0,2,20101120,0,1,2,2,2,2,2010,0,5,303,0
Panthers,0,4,0,0,4,Islanders,1,0,0,0,1,20101120,-1,3,3,3,5,-3,2010,0,5,1091,0
Flyers,0,2,2,1,5,Capitals,1,0,3,0,4,20101120,-1,1,0,1,9,-1,2010,1,5,123,0
Avalanche,1,2,0,1,4,Stars,0,2,1,0,3,20101120,1,1,0,1,7,-1,2010,1,5,661,0
Devils,1,1,0,0,2,Blues,1,1,1,0,3,20101120,0,0,1,1,5,1,2010,0,5,863,0
Rangers,0,3,2,0,5,Wild,0,0,2,0,2,20101120,0,3,3,3,7,-3,2010,0,5,1016,0
Blackhawks,0,4,3,0,7,Canucks,0,0,1,0,1,20101120,0,4,6,6,8,-6,2010,0,5,1775,0
Blue Jackets,1,1,1,0,3,Sharks,0,0,0,0,0,20101120,1,2,3,3,3,-3,2010,0,5,2090,0
Oilers,0,2,2,0,4,Ducks,0,2,0,0,2,20101121,0,0,2,2,6,-2,2010,0,6,1368,0
Coyotes,0,2,1,0,3,Canucks,0,2,0,0,2,20101121,0,0,1,1,5,-1,2010,0,6,1228,0
Flames,1,2,1,0,4,Red Wings,1,0,3,1,5,20101121,0,-2,0,1,9,1,2010,1,6,1573,0
Islanders,0,1,0,0,1,Jets,0,0,1,1,2,20101121,0,-1,0,1,3,1,2010,1,6,745,0
Penguins,2,0,1,0,3,Panthers,1,1,0,0,2,20101122,1,0,1,1,5,-1,2010,0,0,1013,0
Kings,1,1,0,0,2,Senators,1,1,1,0,3,20101122,0,0,1,1,5,1,2010,0,0,2345,0
Predators,0,0,0,0,0,Blue Jackets,1,1,0,0,2,20101122,1,2,2,2,2,2,2010,0,0,333,0
Bruins,0,0,1,0,1,Lightning,0,3,0,0,3,20101122,0,3,2,2,4,2,2010,0,0,1183,0
Canadiens,2,0,0,0,2,Flyers,0,1,2,0,3,20101122,-2,-1,1,1,5,1,2010,0,0,400,0
Flames,0,1,0,0,1,Rangers,0,2,0,0,2,20101122,0,1,1,1,3,1,2010,0,0,2023,0
Capitals,0,0,0,0,0,Devils,3,2,0,0,5,20101122,3,5,5,5,5,5,2010,0,0,198,0
Stars,0,1,0,0,1,Maple Leafs,1,2,1,0,4,20101122,1,2,3,3,5,3,2010,0,0,1201,0
Oilers,0,0,0,0,0,Coyotes,1,2,2,0,5,20101123,1,3,5,5,5,5,2010,0,1,1392,0
Rangers,0,0,3,0,3,Lightning,2,3,0,0,5,20101124,2,5,2,2,8,2,2010,0,2,1004,0
Blackhawks,0,1,1,0,2,Sharks,1,2,2,0,5,20101124,1,2,3,3,7,3,2010,0,2,1837,0
Avalanche,0,1,1,0,2,Canucks,1,1,2,0,4,20101124,1,1,2,2,6,2,2010,0,2,1105,0
Flyers,2,1,3,0,6,Wild,0,1,0,0,1,20101124,2,2,5,5,7,-5,2010,0,2,983,0
Blues,1,0,0,1,2,Predators,0,1,0,0,1,20101124,1,0,0,1,3,-1,2010,1,2,253,0
Stars,0,1,1,0,2,Senators,0,1,0,0,1,20101124,0,0,1,1,3,-1,2010,0,2,1404,0
Bruins,0,0,3,0,3,Panthers,0,1,0,0,1,20101124,0,-1,2,2,4,-2,2010,0,2,1257,0
Kings,0,1,0,0,1,Canadiens,2,2,0,0,4,20101124,2,3,3,3,5,3,2010,0,2,2448,0
Red Wings,1,0,0,0,1,Jets,2,2,1,0,5,20101124,1,3,4,4,6,4,2010,0,2,597,0
Blue Jackets,2,1,0,1,4,Islanders,1,2,0,0,3,20101124,1,0,0,1,7,-1,2010,1,2,476,0
Capitals,1,1,1,0,3,Hurricanes,0,0,2,0,2,20101124,1,2,1,1,5,-1,2010,0,2,233,0
Penguins,1,0,0,0,1,Sabres,0,0,0,0,0,20101124,1,1,1,1,1,-1,2010,0,2,178,0
Flames,0,0,1,0,1,Devils,1,0,0,1,2,20101124,1,1,0,1,3,1,2010,1,2,2015,0
Avalanche,1,1,0,0,2,Oilers,2,0,1,0,3,20101125,1,0,1,1,5,1,2010,0,3,1036,0
Sharks,1,0,0,0,1,Canucks,1,2,3,0,6,20101126,0,2,5,5,7,5,2010,0,4,821,0
Blues,1,1,0,0,2,Stars,0,1,2,0,3,20101126,-1,-1,1,1,5,1,2010,0,4,547,0
Rangers,1,0,2,0,3,Panthers,0,0,0,0,0,20101126,1,1,3,3,3,-3,2010,0,4,1091,0
Maple Leafs,0,0,1,0,1,Sabres,2,0,1,0,3,20101126,2,2,2,2,4,2,2010,0,4,57,0
Red Wings,0,1,1,0,2,Blue Jackets,0,0,1,0,1,20101126,0,1,1,1,3,-1,2010,0,4,163,0
Lightning,0,0,0,0,0,Capitals,1,4,1,0,6,20101126,1,5,6,6,6,6,2010,0,4,818,0
Canadiens,0,0,0,0,0,Jets,1,2,0,0,3,20101126,1,3,3,3,3,3,2010,0,4,992,0
Predators,0,0,2,0,2,Wild,3,1,1,0,5,20101126,3,4,3,3,7,3,2010,0,4,696,0
Senators,1,0,0,0,1,Penguins,0,1,1,0,2,20101126,-1,0,1,1,3,1,2010,0,4,392,0
Flames,0,1,1,1,3,Flyers,0,2,0,0,2,20101126,0,-1,0,1,5,-1,2010,1,4,2003,0
Devils,0,0,0,0,0,Islanders,1,1,0,0,2,20101126,1,2,2,2,2,2,2010,0,4,8,0
Hurricanes,1,1,1,0,3,Bruins,0,0,0,0,0,20101126,1,2,3,3,3,-3,2010,0,4,609,0
Blackhawks,0,1,3,0,4,Ducks,1,0,0,0,1,20101126,-1,0,3,3,5,-3,2010,0,4,1741,0
Blackhawks,0,1,1,0,2,Kings,0,0,1,0,1,20101127,0,1,1,1,3,-1,2010,0,5,1741,0
Sharks,1,2,1,0,4,Oilers,1,0,2,0,3,20101127,0,2,1,1,7,-1,2010,0,5,1190,0
Wild,2,1,1,0,4,Avalanche,1,4,2,0,7,20101127,-1,2,3,3,11,3,2010,0,5,698,0
Rangers,0,0,1,1,2,Predators,1,0,0,0,1,20101127,-1,-1,0,1,3,-1,2010,1,5,758,0
Ducks,1,2,3,0,6,Coyotes,1,2,1,0,4,20101127,0,0,2,2,10,-2,2010,0,5,356,0
Panthers,0,1,2,1,4,Lightning,1,1,1,0,3,20101127,-1,-1,0,1,7,-1,2010,1,5,205,0
Maple Leafs,0,0,0,0,0,Senators,1,2,0,0,3,20101127,1,3,3,3,3,3,2010,0,5,203,0
Sabres,0,0,1,0,1,Canadiens,1,2,0,0,3,20101127,1,3,2,2,4,2,2010,0,5,311,0
Flames,0,0,1,0,1,Penguins,0,2,2,0,4,20101127,0,2,3,3,5,3,2010,0,5,1777,0
Flyers,0,0,1,0,1,Devils,1,0,0,1,2,20101127,1,1,0,1,3,1,2010,1,5,75,0
Stars,0,0,2,0,2,Blues,0,1,0,0,1,20101127,0,-1,1,1,3,-1,2010,0,5,547,0
Blue Jackets,1,0,1,0,2,Red Wings,0,2,2,0,4,20101128,-1,1,2,2,6,2,2010,0,6,163,0
Hurricanes,0,1,1,0,2,Capitals,2,0,0,1,3,20101128,2,1,0,1,5,1,2010,1,6,233,0
Bruins,0,1,0,0,1,Jets,3,1,0,0,4,20101128,3,3,3,3,5,3,2010,0,6,935,0
Kings,0,0,0,0,0,Ducks,0,1,1,0,2,20101129,0,1,2,2,2,2,2010,0,0,0,0
Wild,0,0,0,0,0,Flames,0,2,1,0,3,20101129,0,2,3,3,3,3,2010,0,0,1043,0
Oilers,0,1,3,0,4,Senators,1,0,0,0,1,20101129,-1,0,3,3,5,-3,2010,0,0,1754,0
Stars,1,2,1,0,4,Hurricanes,0,1,0,0,1,20101129,1,2,3,3,5,-3,2010,0,0,1055,0
Penguins,1,2,0,0,3,Rangers,0,1,0,0,1,20101129,1,2,2,2,4,-2,2010,0,0,314,0
Lightning,0,1,2,1,4,Maple Leafs,1,1,1,0,3,20101130,-1,-1,0,1,7,-1,2010,1,1,1096,0
Blues,1,1,3,0,5,Blackhawks,2,3,2,0,7,20101130,1,3,2,2,12,2,2010,0,1,260,0
Coyotes,0,0,0,0,0,Predators,1,1,1,0,3,20101130,1,2,3,3,3,3,2010,0,1,1442,0
Jets,1,0,1,1,3,Avalanche,0,0,2,0,2,20101130,1,1,0,1,5,-1,2010,1,1,1209,0
Red Wings,2,2,1,0,5,Sharks,1,1,1,0,3,20101130,1,2,2,2,8,-2,2010,0,1,2071,0
Panthers,0,1,2,0,3,Ducks,1,2,2,0,5,20101201,1,2,2,2,8,2,2010,0,2,2335,0
Canucks,2,1,4,0,7,Flames,1,1,0,0,2,20101201,1,1,5,5,9,-5,2010,0,2,426,0
Coyotes,1,1,2,0,4,Wild,0,0,2,0,2,20101201,1,2,2,2,6,-2,2010,0,2,1278,0
Bruins,2,0,1,0,3,Flyers,0,0,0,0,0,20101201,2,2,3,3,3,-3,2010,0,2,270,0
Predators,1,1,1,1,4,Blue Jackets,0,1,2,0,3,20101201,1,1,0,1,7,-1,2010,1,2,333,0
Oilers,1,0,2,1,4,Canadiens,1,2,0,0,3,20101201,0,-2,0,1,7,-1,2010,1,2,1826,0
Capitals,1,1,2,0,4,Blues,0,1,0,0,1,20101201,1,1,3,3,5,-3,2010,0,2,708,0
Sharks,1,1,2,0,4,Senators,0,0,0,0,0,20101202,1,2,4,4,4,-4,2010,0,3,2408,0
Panthers,1,1,0,0,2,Kings,1,0,2,0,3,20101202,0,-1,1,1,5,1,2010,0,3,2335,0
Capitals,0,0,1,0,1,Stars,0,1,1,0,2,20101202,0,1,1,1,3,1,2010,0,3,1181,0
Oilers,1,2,2,0,5,Maple Leafs,0,0,0,0,0,20101202,1,3,5,5,5,-5,2010,0,3,1683,0
Rangers,2,2,2,0,6,Islanders,1,2,2,0,5,20101202,1,1,1,1,11,-1,2010,0,3,0,0
Canadiens,2,3,0,0,5,Devils,0,0,1,0,1,20101202,2,5,4,4,6,-4,2010,0,3,342,0
Lightning,0,1,0,0,1,Bruins,2,2,4,0,8,20101202,2,3,7,7,9,7,2010,0,3,1183,0
Jets,1,1,0,0,2,Penguins,1,2,0,0,3,20101202,0,1,1,1,5,1,2010,0,3,521,0
Avalanche,0,0,1,0,1,Hurricanes,0,0,1,1,2,20101203,0,0,0,1,3,1,2010,1,4,1459,0
Islanders,0,0,0,0,0,Rangers,0,1,1,0,2,20101203,0,1,2,2,2,2,2010,0,4,0,0
Blue Jackets,0,0,0,0,0,Sabres,2,1,2,0,5,20101203,2,3,5,5,5,5,2010,0,4,293,0
Flames,0,1,1,1,3,Wild,0,1,1,0,2,20101203,0,0,0,1,5,-1,2010,1,4,1043,0
Canucks,0,1,2,0,3,Blackhawks,0,0,0,0,0,20101203,0,1,3,3,3,-3,2010,0,4,1775,0
Red Wings,1,2,1,0,4,Ducks,0,0,0,0,0,20101203,1,3,4,4,4,-4,2010,0,4,1979,0
Panthers,0,1,0,1,2,Coyotes,0,1,0,0,1,20101204,0,0,0,1,3,-1,2010,1,5,1978,0
Red Wings,1,1,0,0,2,Kings,0,2,0,1,3,20101204,-1,0,0,1,5,1,2010,1,5,1979,0
Blues,0,0,1,0,1,Oilers,0,0,1,1,2,20101204,0,0,0,1,3,1,2010,1,5,1508,0
Hurricanes,1,1,0,0,2,Predators,3,0,2,0,5,20101204,2,1,3,3,7,3,2010,0,5,456,0
Avalanche,1,1,3,0,5,Lightning,1,3,2,0,6,20101204,0,2,1,1,11,1,2010,0,5,1521,0
Wild,0,1,2,0,3,Stars,1,1,1,1,4,20101204,1,1,0,1,7,1,2010,1,5,863,0
Jets,0,2,1,0,3,Capitals,0,1,0,0,1,20101204,0,1,2,2,4,-2,2010,0,5,541,0
Devils,2,0,1,0,3,Flyers,1,1,3,0,5,20101204,-1,0,2,2,8,2,2010,0,5,75,0
Sharks,1,0,0,0,1,Canadiens,1,1,1,0,3,20101204,0,1,2,2,4,2,2010,0,5,2508,0
Penguins,4,3,0,0,7,Blue Jackets,0,1,1,0,2,20101204,4,6,5,5,9,-5,2010,0,5,161,0
Bruins,1,0,1,0,2,Maple Leafs,1,0,1,1,3,20101204,0,0,0,1,5,1,2010,1,5,430,0
Sabres,0,0,0,1,1,Senators,0,0,0,0,0,20101204,0,0,0,1,1,-1,2010,1,5,219,0
Flyers,1,0,2,0,3,Islanders,0,0,2,0,2,20101205,1,1,1,1,5,-1,2010,0,6,80,0
Senators,0,1,2,0,3,Rangers,0,1,0,0,1,20101205,0,0,2,2,4,-2,2010,0,6,334,0
Coyotes,1,1,1,0,3,Ducks,0,0,0,0,0,20101205,1,2,3,3,3,-3,2010,0,6,356,0
Blues,1,1,1,0,3,Canucks,1,1,0,0,2,20101205,0,0,1,1,5,-1,2010,0,6,1778,0
Flames,2,0,0,0,2,Blackhawks,3,0,1,0,4,20101205,1,1,2,2,6,2,2010,0,6,1397,0
Devils,1,0,0,0,1,Penguins,1,1,0,0,2,20101206,0,1,1,1,3,1,2010,0,0,306,0
Maple Leafs,1,0,3,1,5,Capitals,2,2,0,0,4,20101206,-1,-3,0,1,9,-1,2010,1,0,349,0
Predators,2,0,0,0,2,Jets,0,1,1,1,3,20101206,-2,-1,0,1,5,1,2010,1,0,215,0
Stars,0,1,1,0,2,Blue Jackets,1,0,1,1,3,20101206,1,0,0,1,5,1,2010,1,0,912,0
Sharks,1,3,1,0,5,Red Wings,2,0,0,0,2,20101206,-1,2,3,3,7,-3,2010,0,0,2071,0
Ducks,0,1,1,1,3,Oilers,0,0,2,0,2,20101207,0,1,0,1,5,-1,2010,1,1,1368,0
Lightning,0,2,0,0,2,Flames,2,1,1,0,4,20101207,2,1,2,2,6,2,2010,0,1,2289,0
Avalanche,0,2,1,0,3,Panthers,1,1,1,1,4,20101207,1,0,0,1,7,1,2010,1,1,1724,0
Senators,1,0,0,0,1,Canadiens,1,0,3,0,4,20101207,0,0,3,3,5,3,2010,0,1,104,0
Sabres,0,1,1,0,2,Bruins,1,0,1,1,3,20101207,1,0,0,1,5,1,2010,1,1,399,0
Sharks,1,0,3,1,5,Flyers,0,3,1,0,4,20101208,1,-2,0,1,9,-1,2010,1,2,2499,0
Maple Leafs,0,0,2,0,2,Penguins,1,3,1,0,5,20101208,1,4,3,3,7,3,2010,0,2,222,0
Predators,1,1,1,0,3,Red Wings,0,1,1,0,2,20101208,1,1,1,1,5,-1,2010,0,2,470,0
Stars,0,3,0,0,3,Blackhawks,2,2,1,0,5,20101208,2,1,2,2,8,2,2010,0,2,802,0
Ducks,1,2,1,0,4,Canucks,2,0,2,1,5,20101208,1,-1,0,1,9,1,2010,1,2,1076,0
Flames,0,0,1,0,1,Kings,1,0,1,0,2,20101209,1,1,1,1,3,1,2010,0,3,1197,0
Wild,2,0,1,0,3,Coyotes,1,0,1,0,2,20101209,1,1,1,1,5,-1,2010,0,3,1278,0
Blue Jackets,0,0,1,0,1,Blues,2,1,1,0,4,20101209,2,3,3,3,5,3,2010,0,3,395,0
Rangers,1,1,3,0,5,Senators,1,2,0,0,3,20101209,0,-1,2,2,8,-2,2010,0,3,334,0
Sharks,0,2,1,0,3,Sabres,1,2,3,0,6,20101209,1,1,3,3,9,3,2010,0,3,2279,0
Flyers,2,2,0,0,4,Maple Leafs,0,1,0,0,1,20101209,2,3,3,3,5,-3,2010,0,3,334,0
Islanders,0,1,1,0,2,Bruins,1,1,3,0,5,20101209,1,1,3,3,7,3,2010,0,3,190,0
Panthers,0,1,2,0,3,Capitals,0,0,0,0,0,20101209,0,1,3,3,3,-3,2010,0,3,924,0
Hurricanes,0,1,0,0,1,Stars,1,0,0,1,2,20101210,1,0,0,1,3,1,2010,1,4,1055,0
Lightning,2,0,1,0,3,Oilers,1,2,0,1,4,20101210,-1,1,0,1,7,1,2010,1,4,2367,0
Flames,0,0,2,0,2,Ducks,1,1,0,1,3,20101210,1,2,0,1,5,1,2010,1,4,1197,0
Avalanche,0,2,2,0,4,Jets,1,1,0,0,2,20101210,-1,0,2,2,6,-2,2010,0,4,1209,0
Canadiens,1,0,1,0,2,Red Wings,1,2,1,0,4,20101210,0,2,2,2,6,2,2010,0,4,508,0
Devils,0,2,0,0,2,Senators,1,2,0,0,3,20101210,1,1,1,1,5,1,2010,0,4,330,0
Flyers,0,1,0,1,2,Bruins,0,0,1,0,1,20101211,0,1,0,1,3,-1,2010,1,5,270,0
Penguins,2,0,3,0,5,Sabres,1,0,1,0,2,20101211,1,1,3,3,7,-3,2010,0,5,178,0
Red Wings,2,1,1,0,4,Devils,0,0,1,0,1,20101211,2,3,3,3,5,-3,2010,0,5,471,0
Jets,0,1,4,0,5,Islanders,1,1,2,0,4,20101211,-1,-1,1,1,9,-1,2010,0,5,745,0
Canadiens,0,1,0,0,1,Maple Leafs,2,0,1,0,3,20101211,2,1,2,2,4,2,2010,0,5,303,0
Avalanche,2,1,0,0,3,Capitals,1,0,1,0,2,20101211,1,2,1,1,5,-1,2010,0,5,1489,0
Rangers,0,1,0,0,1,Blue Jackets,0,1,2,0,3,20101211,0,0,2,2,4,2,2010,0,5,476,0
Hurricanes,0,0,1,1,2,Blues,0,0,1,0,1,20101211,0,0,0,1,3,-1,2010,1,5,665,0
Stars,0,1,1,0,2,Coyotes,3,0,2,0,5,20101211,3,2,3,3,7,3,2010,0,5,884,0
Panthers,0,0,0,0,0,Predators,2,0,1,0,3,20101211,2,2,3,3,3,3,2010,0,5,816,0
Wild,1,1,0,1,3,Kings,0,1,1,0,2,20101211,1,1,0,1,5,-1,2010,1,5,1521,0
Blackhawks,1,0,0,0,1,Sharks,1,0,0,1,2,20101211,0,0,0,1,3,1,2010,1,5,1837,0
Lightning,1,3,0,1,5,Canucks,1,1,2,0,4,20101211,0,2,0,1,9,-1,2010,1,5,2598,0
Wild,1,1,0,0,2,Ducks,2,3,1,0,6,20101212,1,3,4,4,8,4,2010,0,6,1521,0
Capitals,0,0,0,0,0,Rangers,1,4,2,0,7,20101212,1,5,7,7,7,7,2010,0,6,204,0
Canucks,1,1,0,0,2,Oilers,0,0,1,0,1,20101212,1,2,1,1,3,-1,2010,0,6,514,0
Kings,1,1,3,0,5,Red Wings,0,0,0,0,0,20101213,1,2,5,5,5,-5,2010,0,0,1979,0
Jets,2,1,0,1,4,Senators,0,1,2,0,3,20101213,2,2,0,1,7,-1,2010,1,0,914,0
Islanders,0,0,0,0,0,Predators,1,2,2,0,5,20101213,1,3,5,5,5,5,2010,0,0,758,0
Blue Jackets,0,1,1,0,2,Flames,2,0,0,1,3,20101213,2,1,0,1,5,1,2010,1,0,1670,0
Blackhawks,3,1,1,0,5,Avalanche,3,1,3,0,7,20101213,0,0,2,2,12,2,2010,0,0,916,0
Stars,1,1,0,1,3,Sharks,0,2,0,0,2,20101213,1,0,0,1,5,-1,2010,1,0,1449,0
Penguins,0,1,1,0,2,Flyers,1,1,1,0,3,20101214,1,1,1,1,5,1,2010,0,1,257,0
Maple Leafs,1,2,1,0,4,Oilers,1,0,0,0,1,20101214,0,2,3,3,5,-3,2010,0,1,1683,0
Jets,1,0,0,0,1,Lightning,0,1,0,1,2,20101215,-1,0,0,1,3,1,2010,1,2,416,0
Blue Jackets,0,1,1,0,2,Canucks,1,1,0,1,3,20101215,1,1,0,1,5,1,2010,1,2,2050,0
Avalanche,1,0,3,0,4,Blackhawks,0,1,2,0,3,20101215,1,0,1,1,7,-1,2010,0,2,916,0
Sharks,1,1,0,0,2,Predators,0,1,2,0,3,20101215,-1,-1,1,1,5,1,2010,0,2,1934,0
Flyers,1,1,3,0,5,Canadiens,0,1,2,0,3,20101215,1,1,2,2,8,-2,2010,0,2,400,0
Hurricanes,0,1,3,0,4,Panthers,3,0,0,0,3,20101215,-3,-2,1,1,7,-1,2010,0,2,696,0
Ducks,0,1,0,1,2,Capitals,1,0,0,0,1,20101215,-1,0,0,1,3,-1,2010,1,2,2294,0
Blues,0,1,1,0,2,Red Wings,0,3,2,0,5,20101215,0,2,3,3,7,3,2010,0,2,454,0
Rangers,0,0,4,0,4,Penguins,1,0,0,0,1,20101215,-1,-1,3,3,5,-3,2010,0,2,314,0
Coyotes,0,0,0,0,0,Devils,2,0,1,0,3,20101215,2,2,3,3,3,3,2010,0,2,2131,0
Bruins,1,0,1,0,2,Sabres,1,0,2,0,3,20101215,0,0,1,1,5,1,2010,0,2,399,0
Ducks,0,1,1,0,2,Islanders,3,0,0,0,3,20101216,3,2,1,1,5,1,2010,0,3,2445,0
Coyotes,2,1,0,0,3,Rangers,1,1,1,1,4,20101216,-1,-1,0,1,7,1,2010,1,3,2139,0
Hurricanes,0,0,2,1,3,Jets,0,2,0,0,2,20101216,0,-2,0,1,5,-1,2010,1,3,354,0
Bruins,1,1,1,0,3,Canadiens,3,1,0,0,4,20101216,2,2,1,1,7,1,2010,0,3,270,0
Kings,1,3,0,0,4,Blues,1,3,2,0,6,20101216,0,0,2,2,10,2,2010,0,3,1586,0
Senators,0,2,1,0,3,Wild,1,0,0,0,1,20101216,-1,1,2,2,4,-2,2010,0,3,838,0
Sharks,1,2,0,1,4,Stars,1,1,1,0,3,20101216,0,1,0,1,7,-1,2010,1,3,1449,0
Maple Leafs,1,0,1,0,2,Flames,1,3,1,0,5,20101216,0,3,3,3,7,3,2010,0,3,1682,0
Blue Jackets,2,0,1,0,3,Oilers,3,3,0,0,6,20101216,1,4,3,3,9,3,2010,0,3,1703,0
Red Wings,1,0,0,0,1,Blackhawks,2,1,1,0,4,20101217,1,2,3,3,5,3,2010,0,4,238,0
Senators,2,1,2,0,5,Avalanche,1,2,2,1,6,20101217,-1,0,0,1,11,1,2010,1,4,1515,0
Predators,1,1,1,0,3,Devils,0,0,1,0,1,20101217,1,2,2,2,4,-2,2010,0,4,750,0
Sabres,0,1,1,0,2,Panthers,4,1,1,0,6,20101217,4,4,4,4,8,4,2010,0,4,1184,0
Wild,0,2,1,0,3,Flames,0,0,1,0,1,20101218,0,2,2,2,4,-2,2010,0,5,1043,0
Kings,4,2,0,0,6,Predators,1,0,0,0,1,20101218,3,5,5,5,7,-5,2010,0,5,1776,0
Sharks,2,1,1,0,4,Blues,0,1,0,0,1,20101218,2,2,3,3,5,-3,2010,0,5,1719,0
Stars,1,0,1,0,2,Blue Jackets,1,0,0,0,1,20101218,0,0,1,1,3,-1,2010,0,5,912,0
Devils,0,1,0,0,1,Jets,3,1,3,0,7,20101218,3,3,6,6,8,6,2010,0,5,739,0
Sabres,0,1,0,0,1,Lightning,0,2,1,0,3,20101218,0,1,2,2,4,2,2010,0,5,1051,0
Coyotes,1,0,2,1,4,Islanders,0,2,1,0,3,20101218,1,-1,0,1,7,-1,2010,1,5,2139,0
Ducks,1,0,1,0,2,Hurricanes,2,1,1,0,4,20101218,1,2,2,2,6,2,2010,0,5,2231,0
Capitals,0,1,1,0,2,Bruins,3,0,0,0,3,20101218,3,2,1,1,5,1,2010,0,5,394,0
Rangers,0,0,1,0,1,Flyers,0,1,3,0,4,20101218,0,1,3,3,5,3,2010,0,5,80,0
Maple Leafs,0,0,1,0,1,Canucks,1,1,2,0,4,20101218,1,2,3,3,5,3,2010,0,5,2090,0
Stars,2,0,1,1,4,Red Wings,2,1,0,0,3,20101219,0,-1,0,1,7,-1,2010,1,6,999,0
Kings,0,1,1,0,2,Blackhawks,1,2,0,0,3,20101219,1,2,1,1,5,1,2010,0,6,1741,0
Capitals,0,3,0,0,3,Senators,2,0,0,0,2,20101219,-2,1,1,1,5,-1,2010,0,6,446,0
Canadiens,1,1,0,0,2,Avalanche,1,2,0,0,3,20101219,0,1,1,1,5,1,2010,0,6,1618,0
Hurricanes,1,0,0,0,1,Lightning,2,3,0,0,5,20101220,1,4,4,4,6,4,2010,0,0,585,0
Flames,0,1,0,0,1,Wild,1,0,3,0,4,20101220,1,0,3,3,5,3,2010,0,0,1043,0
Ducks,1,2,0,0,3,Bruins,0,0,0,0,0,20101220,1,3,3,3,3,-3,2010,0,0,2590,0
Canucks,0,2,1,0,3,Blues,0,1,0,0,1,20101220,0,1,2,2,4,-2,2010,0,0,1778,0
Coyotes,0,0,1,0,1,Penguins,2,3,1,0,6,20101220,2,5,5,5,7,5,2010,0,0,1824,0
Panthers,2,2,1,0,5,Flyers,0,0,0,0,0,20101220,2,4,5,5,5,-5,2010,0,0,1021,0
Jets,2,1,3,0,6,Maple Leafs,0,1,2,0,3,20101220,2,2,3,3,9,-3,2010,0,0,733,0
Kings,1,1,3,0,5,Avalanche,0,0,0,0,0,20101221,1,2,5,5,5,-5,2010,0,1,830,0
Canadiens,0,1,1,0,2,Stars,2,2,1,0,5,20101221,2,3,3,3,7,3,2010,0,1,1505,0
Devils,0,1,0,0,1,Capitals,1,3,1,0,5,20101221,1,3,4,4,6,4,2010,0,1,198,0
Oilers,0,0,1,0,1,Sharks,0,2,0,0,2,20101221,0,2,1,1,3,1,2010,0,1,1190,0
Blues,1,1,2,0,4,Jets,1,0,1,0,2,20101221,0,1,2,2,6,-2,2010,0,1,467,0
Ducks,0,0,2,0,2,Sabres,3,1,1,0,5,20101221,3,4,3,3,7,3,2010,0,1,2193,0
Flames,0,1,0,0,1,Blue Jackets,1,1,1,0,3,20101221,1,1,2,2,4,2,2010,0,1,1670,0
Lightning,1,0,0,0,1,Islanders,0,1,0,1,2,20101222,-1,0,0,1,3,1,2010,1,2,1004,0
Panthers,1,0,1,0,2,Penguins,3,1,1,0,5,20101222,2,3,3,3,7,3,2010,0,2,1013,0
Canucks,0,3,1,0,4,Red Wings,1,1,2,1,5,20101222,1,-1,0,1,9,1,2010,1,2,1967,0
Predators,0,0,1,0,1,Blackhawks,1,1,2,0,4,20101222,1,2,3,3,5,3,2010,0,2,395,0
Senators,1,1,0,0,2,Predators,0,1,0,0,1,20101223,1,1,1,1,3,-1,2010,0,3,845,0
Coyotes,0,1,0,0,1,Sharks,0,2,2,0,4,20101223,0,1,3,3,5,3,2010,0,3,614,0
Oilers,0,1,1,0,2,Kings,0,1,1,1,3,20101223,0,0,0,1,5,1,2010,1,3,1368,0
Wild,2,1,0,0,3,Avalanche,1,0,0,0,1,20101223,1,2,2,2,4,-2,2010,0,3,698,0
Flames,1,0,1,1,3,Stars,1,0,1,0,2,20101223,0,0,0,1,5,-1,2010,1,3,1536,0
Red Wings,1,2,0,0,3,Blues,3,1,0,0,4,20101223,2,1,1,1,7,1,2010,0,3,454,0
Panthers,3,0,1,0,4,Sabres,0,3,0,0,3,20101223,3,0,1,1,7,-1,2010,0,3,1184,0
Penguins,1,0,1,1,3,Capitals,0,1,1,0,2,20101223,1,0,0,1,5,-1,2010,1,3,190,0
Lightning,2,1,0,1,4,Rangers,2,0,1,0,3,20101223,0,1,0,1,7,-1,2010,1,3,1004,0
Islanders,3,1,1,0,5,Devils,0,1,0,0,1,20101223,3,3,4,4,6,-4,2010,0,3,8,0
Canadiens,0,3,0,0,3,Hurricanes,0,2,0,0,2,20101223,0,1,1,1,5,-1,2010,0,3,727,0
Jets,0,1,0,0,1,Bruins,1,2,1,0,4,20101223,1,2,3,3,5,3,2010,0,3,935,0
Canucks,3,3,1,0,7,Blue Jackets,0,1,2,0,3,20101223,3,5,4,4,10,-4,2010,0,3,2050,0
Red Wings,2,2,0,0,4,Wild,0,0,1,0,1,20101226,2,4,3,3,5,-3,2010,0,6,542,0
Oilers,0,2,0,0,2,Canucks,0,1,2,0,3,20101226,0,-1,1,1,5,1,2010,0,6,514,0
Coyotes,0,1,0,0,1,Stars,0,0,0,0,0,20101226,0,1,1,1,1,-1,2010,0,6,884,0
Penguins,0,0,1,0,1,Senators,2,1,0,0,3,20101226,2,3,2,2,4,2,2010,0,6,392,0
Lightning,1,1,0,1,3,Jets,0,1,1,0,2,20101226,1,1,0,1,5,-1,2010,1,6,416,0
Ducks,0,1,0,0,1,Kings,0,4,0,0,4,20101226,0,3,3,3,5,3,2010,0,6,0,0
Canadiens,0,0,1,0,1,Islanders,1,1,2,0,4,20101226,1,2,3,3,5,3,2010,0,6,343,0
Maple Leafs,1,2,1,0,4,Devils,0,0,1,0,1,20101226,1,3,3,3,5,-3,2010,0,6,333,0
Capitals,1,2,0,0,3,Hurricanes,0,1,1,0,2,20101226,1,2,1,1,5,-1,2010,0,6,233,0
Blue Jackets,0,0,1,0,1,Blackhawks,1,0,3,0,4,20101226,1,1,3,3,5,3,2010,0,6,275,0
Predators,0,0,0,0,0,Blues,0,1,1,0,2,20101226,0,1,2,2,2,2,2010,0,6,253,0
Islanders,2,0,0,0,2,Rangers,2,2,3,0,7,20101227,0,2,5,5,9,5,2010,0,0,0,0
Bruins,0,1,1,1,3,Panthers,0,2,0,0,2,20101227,0,-1,0,1,5,-1,2010,1,0,1257,0
Wild,1,1,1,0,3,Blue Jackets,0,1,2,1,4,20101227,-1,-1,0,1,7,1,2010,1,0,626,0
Sabres,1,0,1,0,2,Flames,0,2,3,0,5,20101227,-1,1,3,3,7,3,2010,0,0,1731,0
Red Wings,2,0,1,1,4,Avalanche,2,0,1,0,3,20101227,0,0,0,1,7,-1,2010,1,0,1154,0
Kings,0,0,4,0,4,Sharks,0,0,0,0,0,20101227,0,0,4,4,4,-4,2010,0,0,305,0
Ducks,3,0,0,0,3,Coyotes,0,1,0,0,1,20101228,3,2,2,2,4,-2,2010,0,1,356,0
Sabres,1,1,2,0,4,Oilers,1,0,1,0,2,20101228,0,1,2,2,6,-2,2010,0,1,1734,0
Stars,0,1,3,0,4,Predators,0,1,1,0,2,20101228,0,0,2,2,6,-2,2010,0,1,616,0
Blackhawks,1,0,0,0,1,Blues,0,1,2,0,3,20101228,-1,0,2,2,4,2,2010,0,1,260,0
Flyers,0,1,1,0,2,Canucks,1,3,2,0,6,20101228,1,3,4,4,8,4,2010,0,1,2404,0
Canadiens,0,0,0,0,0,Capitals,2,0,1,0,3,20101228,2,2,3,3,3,3,2010,0,1,495,0
Hurricanes,3,0,1,0,4,Maple Leafs,2,1,0,0,3,20101228,1,0,1,1,7,-1,2010,0,1,544,0
Jets,2,0,1,0,3,Penguins,2,1,3,0,6,20101228,0,1,3,3,9,3,2010,0,1,521,0
Bruins,1,1,2,0,4,Lightning,1,1,1,0,3,20101228,0,0,1,1,7,-1,2010,0,1,1183,0
Rangers,1,1,1,0,3,Devils,1,0,0,0,1,20101229,0,1,2,2,4,-2,2010,0,2,8,0
Penguins,0,1,0,0,1,Islanders,0,1,0,1,2,20101229,0,0,0,1,3,1,2010,1,2,314,0
Hurricanes,2,1,1,0,4,Senators,0,0,0,0,0,20101229,2,3,4,4,4,-4,2010,0,2,673,0
Sharks,1,2,0,0,3,Wild,1,1,3,0,5,20101229,0,-1,2,2,8,2,2010,0,2,1570,0
Red Wings,1,2,4,0,7,Stars,0,3,0,0,3,20101229,1,0,4,4,10,-4,2010,0,2,999,0
Kings,3,0,0,0,3,Coyotes,4,2,0,0,6,20101229,1,3,3,3,9,3,2010,0,2,356,0
Flyers,2,4,1,0,7,Kings,2,2,0,0,4,20101230,0,2,3,3,11,-3,2010,0,3,2388,0
Avalanche,3,0,0,1,4,Oilers,0,1,2,0,3,20101230,3,2,0,1,7,-1,2010,1,3,1036,0
Sharks,1,2,2,0,5,Blackhawks,1,2,0,0,3,20101230,0,0,2,2,8,-2,2010,0,3,1837,0
Bruins,1,1,0,0,2,Jets,1,1,0,1,3,20101230,0,0,0,1,5,1,2010,1,3,935,0
Blue Jackets,1,1,1,0,3,Maple Leafs,2,0,0,0,2,20101230,-1,0,1,1,5,-1,2010,0,3,313,0
Canadiens,1,0,0,0,1,Lightning,0,2,2,0,4,20101230,-1,1,3,3,5,3,2010,0,3,1311,0
Coyotes,0,0,3,0,3,Blues,1,2,1,0,4,20101231,1,3,1,1,7,1,2010,0,4,1270,0
Jets,0,0,1,0,1,Devils,1,1,1,0,3,20101231,1,2,2,2,4,2,2010,0,4,739,0
Canadiens,0,2,0,1,3,Panthers,0,2,0,0,2,20101231,0,0,0,1,5,-1,2010,1,4,1418,0
Islanders,2,1,0,1,4,Red Wings,1,1,1,0,3,20101231,1,1,0,1,7,-1,2010,1,4,480,0
Senators,0,1,2,0,3,Blue Jackets,1,2,0,1,4,20101231,1,2,0,1,7,1,2010,1,4,512,0
Canucks,2,2,0,0,4,Stars,0,0,1,0,1,20101231,2,4,3,3,5,-3,2010,0,4,1766,0
Flyers,0,1,1,0,2,Ducks,1,2,2,0,5,20101231,1,2,3,3,7,3,2010,0,4,2388,0
Avalanche,0,0,2,0,2,Flames,0,3,0,0,3,20101231,0,3,1,1,5,1,2010,0,4,898,0
Predators,1,1,2,0,4,Wild,0,0,1,0,1,20101231,1,2,3,3,5,-3,2010,0,4,696,0
Sharks,0,1,0,0,1,Kings,0,0,0,0,0,20110101,0,1,1,1,1,-1,2010,0,5,305,0
Flames,1,1,0,0,2,Oilers,0,1,0,0,1,20110101,1,1,1,1,3,-1,2010,0,5,171,0
Capitals,0,2,1,0,3,Penguins,0,1,0,0,1,20110101,0,1,2,2,4,-2,2010,0,5,190,0
Bruins,4,0,2,0,6,Sabres,3,2,1,1,7,20110101,-1,1,0,1,13,1,2010,1,5,399,0
Maple Leafs,3,2,0,0,5,Senators,0,1,0,0,1,20110101,3,4,4,4,6,-4,2010,0,5,203,0
Devils,1,1,1,0,3,Hurricanes,4,1,1,0,6,20110101,3,3,3,3,9,3,2010,0,5,419,0
Rangers,0,0,1,0,1,Lightning,1,0,0,1,2,20110101,1,1,0,1,3,1,2010,1,5,1004,0
Rangers,0,0,0,0,0,Panthers,0,1,2,0,3,20110102,0,1,3,3,3,3,2010,0,6,1091,0
Stars,1,0,3,0,4,Blues,2,0,0,0,2,20110102,-1,-1,2,2,6,-2,2010,0,6,547,0
Blue Jackets,1,0,0,0,1,Predators,0,3,1,0,4,20110102,-1,2,3,3,5,3,2010,0,6,333,0
Coyotes,1,0,4,0,5,Wild,1,2,2,1,6,20110102,0,2,0,1,11,1,2010,1,6,1278,0
Canucks,1,0,1,0,2,Avalanche,0,0,1,0,1,20110102,1,1,1,1,3,-1,2010,0,6,1105,0
Blackhawks,1,0,0,0,1,Ducks,1,1,0,0,2,20110102,0,1,1,1,3,1,2010,0,6,1741,0
Jets,1,2,0,1,4,Canadiens,1,1,1,0,3,20110102,0,1,0,1,7,-1,2010,1,6,992,0
Flyers,0,3,0,0,3,Red Wings,0,0,2,0,2,20110102,0,3,1,1,5,-1,2010,0,6,441,0
Canucks,1,2,1,0,4,Sharks,0,3,0,0,3,20110103,1,0,1,1,7,-1,2010,0,0,821,0
Blackhawks,1,1,2,0,4,Kings,1,1,1,0,3,20110103,0,0,1,1,7,-1,2010,0,0,1741,0
Bruins,0,2,0,0,2,Maple Leafs,1,0,0,0,1,20110103,-1,1,1,1,3,-1,2010,0,0,430,0
Panthers,1,1,1,1,4,Hurricanes,1,0,2,0,3,20110103,0,1,0,1,7,-1,2010,1,0,696,0
Islanders,3,1,1,0,5,Flames,1,1,0,0,2,20110103,2,2,3,3,7,-3,2010,0,0,2023,0
Wild,1,0,1,0,2,Devils,0,1,0,0,1,20110104,1,0,1,1,3,-1,2010,0,1,1007,0
Lightning,0,0,0,1,1,Capitals,0,0,0,0,0,20110104,0,0,0,1,1,-1,2010,1,1,818,0
Red Wings,1,2,2,0,5,Oilers,1,0,2,0,3,20110104,0,2,2,2,8,-2,2010,0,1,1592,0
Sabres,1,0,2,0,3,Avalanche,2,0,1,1,4,20110104,1,1,0,1,7,1,2010,1,1,1366,0
Blue Jackets,0,1,1,0,2,Coyotes,0,2,2,0,4,20110104,0,1,2,2,6,2,2010,0,1,1664,0
Predators,1,1,2,0,4,Ducks,0,0,1,0,1,20110105,1,2,3,3,5,-3,2010,0,2,1776,0
Flames,0,0,1,0,1,Canucks,2,1,0,0,3,20110105,2,3,2,2,4,2,2010,0,2,426,0
Stars,2,0,2,0,4,Blackhawks,0,2,0,0,2,20110105,2,0,2,2,6,-2,2010,0,2,802,0
Lightning,0,0,1,0,1,Penguins,5,2,1,0,8,20110105,5,7,7,7,9,7,2010,0,2,874,0
Hurricanes,0,0,1,0,1,Rangers,0,0,1,1,2,20110105,0,0,0,1,3,1,2010,1,2,423,0
Jets,2,1,0,0,3,Panthers,1,0,1,0,2,20110105,1,2,1,1,5,-1,2010,0,2,605,0
Wild,0,1,2,0,3,Bruins,0,1,0,0,1,20110106,0,0,2,2,4,-2,2010,0,3,1120,0
Flyers,0,2,2,0,4,Devils,1,1,0,0,2,20110106,-1,0,2,2,6,-2,2010,0,3,75,0
Blues,2,0,3,0,5,Maple Leafs,1,3,1,1,6,20110106,-1,2,0,1,11,1,2010,1,3,659,0
Penguins,1,0,0,0,1,Canadiens,0,1,0,1,2,20110106,-1,0,0,1,3,1,2010,1,3,474,0
Islanders,0,1,0,0,1,Oilers,2,0,0,0,2,20110106,2,1,1,1,3,1,2010,0,3,2024,0
Coyotes,1,0,1,0,2,Avalanche,0,0,0,0,0,20110106,1,1,2,2,2,-2,2010,0,3,585,0
Predators,0,3,2,0,5,Kings,0,2,0,0,2,20110106,0,1,3,3,7,-3,2010,0,3,1776,0
Sabres,2,1,0,0,3,Sharks,0,0,0,0,0,20110106,2,3,3,3,3,-3,2010,0,3,2279,0
Blue Jackets,0,0,0,0,0,Ducks,1,2,3,0,6,20110107,1,3,6,6,6,6,2010,0,4,1973,0
Oilers,0,1,0,0,1,Canucks,0,3,3,0,6,20110107,0,2,5,5,7,5,2010,0,4,514,0
Maple Leafs,2,6,1,0,9,Jets,1,0,2,0,3,20110107,1,7,6,6,12,-6,2010,0,4,733,0
Rangers,0,1,1,1,3,Stars,1,1,0,0,2,20110107,-1,-1,0,1,5,-1,2010,1,4,1370,0
Senators,0,1,1,0,2,Blackhawks,0,1,1,1,3,20110107,0,0,0,1,5,1,2010,1,4,628,0
Hurricanes,0,2,3,0,5,Panthers,2,0,1,0,3,20110107,-2,0,2,2,8,-2,2010,0,4,696,0
Red Wings,1,2,1,1,5,Flames,2,2,0,0,4,20110107,-1,-1,0,1,9,-1,2010,1,4,1573,0
Blue Jackets,0,1,3,0,4,Kings,3,1,2,0,6,20110108,3,3,2,2,10,2,2010,0,5,1973,0
Red Wings,0,0,1,1,2,Canucks,0,1,0,0,1,20110108,0,-1,0,1,3,-1,2010,1,5,1967,0
Sabres,0,1,0,1,2,Coyotes,0,1,0,0,1,20110108,0,0,0,1,3,-1,2010,1,5,1902,0
Rangers,0,2,0,0,2,Blues,0,1,0,0,1,20110108,0,1,1,1,3,-1,2010,0,5,871,0
Wild,2,0,2,0,4,Penguins,0,0,0,0,0,20110108,2,2,4,4,4,-4,2010,0,5,741,0
Panthers,1,0,1,0,2,Capitals,0,1,2,0,3,20110108,-1,0,1,1,5,1,2010,0,5,924,0
Predators,1,0,1,0,2,Sharks,0,1,0,0,1,20110108,1,0,1,1,3,-1,2010,0,5,1934,0
Devils,0,1,0,0,1,Flyers,2,0,0,0,2,20110108,2,1,1,1,3,1,2010,0,5,75,0
Bruins,0,2,0,0,2,Canadiens,0,0,2,1,3,20110108,0,-2,0,1,5,1,2010,1,5,270,0
Islanders,2,1,0,1,4,Avalanche,2,0,1,0,3,20110108,0,1,0,1,7,-1,2010,1,5,1627,0
Lightning,0,0,2,0,2,Senators,0,1,0,0,1,20110108,0,-1,1,1,3,-1,2010,0,5,1251,0
Jets,1,1,1,0,3,Hurricanes,1,2,0,1,4,20110109,0,1,0,1,7,1,2010,1,6,354,0
Lightning,2,0,1,0,3,Devils,1,0,5,0,6,20110109,-1,-1,3,3,9,3,2010,0,6,1000,0
Stars,2,0,2,0,4,Wild,0,0,0,0,0,20110109,2,2,4,4,4,-4,2010,0,6,863,0
Islanders,0,0,0,0,0,Blackhawks,1,4,0,0,5,20110109,1,5,5,5,5,5,2010,0,6,711,0
Sharks,0,0,0,0,0,Ducks,0,1,0,0,1,20110109,0,1,1,1,1,1,2010,0,6,305,0
Bruins,0,0,4,0,4,Penguins,0,2,0,0,2,20110110,0,-2,2,2,6,-2,2010,0,0,481,0
Coyotes,0,2,2,0,4,Blues,1,0,2,0,3,20110110,-1,1,1,1,7,-1,2010,0,0,1270,0
Red Wings,2,1,1,0,4,Avalanche,4,1,0,0,5,20110110,2,2,1,1,9,1,2010,0,0,1154,0
Maple Leafs,0,2,1,0,3,Kings,1,1,0,0,2,20110110,-1,0,1,1,5,-1,2010,0,0,2170,0
Maple Leafs,0,0,4,0,4,Sharks,1,0,1,0,2,20110111,-1,-1,2,2,6,-2,2010,0,1,2249,0
Wild,1,0,0,0,1,Predators,1,1,3,0,5,20110111,0,1,4,4,6,4,2010,0,1,696,0
Capitals,0,2,1,0,3,Panthers,2,1,0,1,4,20110111,2,1,0,1,7,1,2010,1,1,924,0
Oilers,0,0,2,0,2,Stars,1,1,1,0,3,20110111,1,2,1,1,5,1,2010,0,1,1655,0
Coyotes,0,2,2,0,4,Blue Jackets,2,1,0,0,3,20110111,-2,-1,1,1,7,-1,2010,0,1,1664,0
Canadiens,0,1,1,0,2,Rangers,1,0,0,0,1,20110111,-1,0,1,1,3,-1,2010,0,1,343,0
Canucks,1,1,1,1,4,Islanders,0,1,2,0,3,20110111,1,1,0,1,7,-1,2010,1,1,2429,0
Flames,2,1,2,0,5,Hurricanes,2,3,0,1,6,20110111,0,2,0,1,11,1,2010,1,1,2038,0
Senators,0,0,0,0,0,Bruins,2,3,1,0,6,20110111,2,5,6,6,6,6,2010,0,1,320,0
Flyers,1,1,3,0,5,Sabres,2,0,0,0,2,20110111,-1,0,3,3,7,-3,2010,0,1,279,0
Blues,0,2,2,0,4,Ducks,3,0,4,0,7,20110112,3,1,3,3,11,3,2010,0,2,1586,0
Penguins,1,2,2,0,5,Canadiens,1,1,0,0,2,20110112,0,1,3,3,7,-3,2010,0,2,474,0
Capitals,0,0,0,0,0,Lightning,2,1,0,0,3,20110112,2,3,3,3,3,3,2010,0,2,818,0
Avalanche,0,0,0,0,0,Blackhawks,2,1,1,0,4,20110112,2,3,4,4,4,4,2010,0,2,916,0
Flyers,1,2,2,0,5,Bruins,1,1,5,0,7,20110113,0,-1,2,2,12,2,2010,0,3,270,0
Hurricanes,0,1,1,0,2,Sabres,1,1,1,0,3,20110113,1,1,1,1,5,1,2010,0,3,491,0
Senators,2,4,0,0,6,Islanders,1,1,2,0,4,20110113,1,4,2,2,10,-2,2010,0,3,334,0
Predators,1,0,1,0,2,Panthers,1,0,2,0,3,20110113,0,0,1,1,5,1,2010,0,3,816,0
Maple Leafs,0,0,1,0,1,Coyotes,1,0,4,0,5,20110113,1,1,4,4,6,4,2010,0,3,1885,0
Blues,1,2,0,0,3,Kings,0,1,0,0,1,20110113,1,2,2,2,4,-2,2010,0,3,1586,0
Oilers,1,2,2,0,5,Sharks,0,0,2,0,2,20110113,1,3,3,3,7,-3,2010,0,3,1190,0
Canucks,0,0,0,0,0,Rangers,0,1,0,0,1,20110113,0,1,1,1,1,1,2010,0,3,2429,0
Canucks,1,2,1,0,4,Capitals,1,0,1,0,2,20110114,0,2,2,2,6,-2,2010,0,4,2359,0
Red Wings,0,2,0,0,2,Blue Jackets,2,0,0,1,3,20110114,2,0,0,1,5,1,2010,1,4,163,0
Flames,0,3,0,0,3,Senators,0,0,2,0,2,20110114,0,3,1,1,5,-1,2010,0,4,1773,0
Devils,4,0,1,0,5,Lightning,1,1,0,0,2,20110114,3,2,3,3,7,-3,2010,0,4,1000,0
Flyers,0,2,3,0,5,Jets,0,2,0,0,2,20110114,0,0,3,3,7,-3,2010,0,4,665,0
Avalanche,2,1,1,0,4,Wild,0,0,1,0,1,20110114,2,3,3,3,5,-3,2010,0,4,698,0
Penguins,1,1,1,0,3,Bruins,0,2,0,0,2,20110115,1,0,1,1,5,-1,2010,0,5,481,0
Lightning,2,1,1,0,4,Hurricanes,2,3,1,0,6,20110115,0,2,2,2,10,2,2010,0,5,585,0
Blue Jackets,2,1,2,0,5,Red Wings,2,2,1,1,6,20110115,0,1,0,1,11,1,2010,1,5,163,0
Blues,1,1,0,0,2,Sharks,1,1,2,0,4,20110115,0,0,2,2,6,2,2010,0,5,1719,0
Oilers,2,0,0,0,2,Kings,2,1,2,0,5,20110115,0,1,3,3,7,3,2010,0,5,1368,0
Blackhawks,1,1,0,0,2,Predators,0,0,2,1,3,20110115,-1,-2,0,1,5,1,2010,1,5,395,0
Rangers,1,0,1,0,2,Canadiens,3,0,0,0,3,20110115,2,2,1,1,5,1,2010,0,5,343,0
Jets,0,1,0,0,1,Stars,1,2,3,0,6,20110115,1,2,5,5,7,5,2010,0,5,719,0
Devils,1,0,1,0,2,Panthers,1,1,0,1,3,20110115,0,1,0,1,5,1,2010,1,5,1090,0
Flames,0,0,1,1,2,Maple Leafs,0,0,1,0,1,20110115,0,0,0,1,3,-1,2010,1,5,1682,0
Ducks,1,0,1,0,2,Coyotes,1,3,2,0,6,20110115,0,3,4,4,8,4,2010,0,5,356,0
Sabres,0,1,2,0,3,Islanders,0,4,1,0,5,20110115,0,3,2,2,8,2,2010,0,5,292,0
Senators,1,0,0,0,1,Capitals,0,0,3,0,3,20110116,-1,-1,2,2,4,2,2010,0,6,446,0
Canucks,0,0,0,0,0,Wild,0,2,2,0,4,20110116,0,2,4,4,4,4,2010,0,6,1427,0
Predators,2,0,1,0,3,Blackhawks,1,1,4,0,6,20110116,-1,0,3,3,9,3,2010,0,6,395,0
Flyers,2,1,0,0,3,Rangers,0,0,2,0,2,20110116,2,3,1,1,5,-1,2010,0,6,80,0
Oilers,0,2,0,0,2,Ducks,2,1,0,0,3,20110116,2,1,1,1,5,1,2010,0,6,1368,0
Kings,1,0,0,0,1,Stars,0,2,0,0,2,20110117,-1,1,1,1,3,1,2010,0,0,1237,0
Jets,0,0,2,1,3,Panthers,0,0,2,0,2,20110117,0,0,0,1,5,-1,2010,1,0,605,0
Devils,2,3,0,0,5,Islanders,0,2,0,0,2,20110117,2,3,3,3,7,-3,2010,0,0,8,0
Sharks,1,2,1,0,4,Coyotes,1,0,1,0,2,20110117,0,2,2,2,6,-2,2010,0,0,614,0
Hurricanes,0,0,0,0,0,Bruins,3,2,2,0,7,20110117,3,5,7,7,7,7,2010,0,0,609,0
Flames,0,2,2,0,4,Canadiens,2,2,0,1,5,20110117,2,2,0,1,9,1,2010,1,0,1852,0
Canucks,1,2,0,0,3,Avalanche,1,2,0,1,4,20110118,0,0,0,1,7,1,2010,1,1,1105,0
Wild,2,0,2,0,4,Oilers,0,0,1,0,1,20110118,2,2,3,3,5,-3,2010,0,1,1083,0
Predators,2,2,1,0,5,Coyotes,2,0,0,0,2,20110118,0,2,3,3,7,-3,2010,0,1,1442,0
Kings,0,1,0,0,1,Blues,1,0,1,0,2,20110118,1,0,1,1,3,1,2010,0,1,1586,0
Red Wings,0,1,0,0,1,Penguins,2,1,1,0,4,20110118,2,2,3,3,5,3,2010,0,1,205,0
Ducks,1,0,0,1,2,Senators,0,1,0,0,1,20110118,1,0,0,1,3,-1,2010,1,1,2345,0
Canadiens,1,0,0,0,1,Sabres,0,1,0,1,2,20110118,-1,0,0,1,3,1,2010,1,1,311,0
Capitals,0,0,2,0,2,Flyers,1,1,0,1,3,20110118,1,2,0,1,5,1,2010,1,1,123,0
Bruins,1,0,2,0,3,Hurricanes,1,0,1,0,2,20110118,0,0,1,1,5,-1,2010,0,1,609,0
Blue Jackets,1,1,0,0,2,Lightning,1,1,0,1,3,20110118,0,0,0,1,5,1,2010,1,1,830,0
Maple Leafs,0,0,0,0,0,Rangers,4,2,1,0,7,20110119,4,6,7,7,7,7,2010,0,2,341,0
Blue Jackets,1,0,1,1,3,Panthers,2,0,0,0,2,20110119,-1,-1,0,1,5,-1,2010,1,2,993,0
Wild,2,1,3,0,6,Flames,0,0,0,0,0,20110119,2,3,6,6,6,-6,2010,0,2,1043,0
Stars,1,2,1,0,4,Oilers,1,1,0,0,2,20110120,0,1,2,2,6,-2,2010,0,3,1655,0
Sharks,0,1,0,1,2,Canucks,1,0,0,0,1,20110120,-1,0,0,1,3,-1,2010,1,3,821,0
Predators,2,0,3,0,5,Avalanche,0,0,1,0,1,20110120,2,2,4,4,6,-4,2010,0,3,1019,0
Red Wings,1,2,0,1,4,Blues,0,1,2,0,3,20110120,1,2,0,1,7,-1,2010,1,3,454,0
Coyotes,0,2,0,0,2,Kings,0,0,0,0,0,20110120,0,2,2,2,2,-2,2010,0,3,356,0
Ducks,1,1,0,0,2,Maple Leafs,1,2,2,0,5,20110120,0,1,3,3,7,3,2010,0,3,2170,0
Senators,0,2,0,0,2,Flyers,2,1,3,0,6,20110120,2,1,4,4,8,4,2010,0,3,373,0
Capitals,1,1,0,0,2,Islanders,0,1,0,0,1,20110120,1,1,1,1,3,-1,2010,0,3,204,0
Penguins,0,0,0,0,0,Devils,2,0,0,0,2,20110120,2,2,2,2,2,2,2010,0,3,306,0
Rangers,0,0,1,0,1,Hurricanes,2,1,1,0,4,20110120,2,3,3,3,5,3,2010,0,3,423,0
Lightning,1,0,1,1,3,Jets,1,1,0,0,2,20110120,0,-1,0,1,5,-1,2010,1,3,416,0
Sabres,0,2,2,0,4,Bruins,1,1,0,0,2,20110120,-1,0,2,2,6,-2,2010,0,3,399,0
Stars,2,1,1,0,4,Flames,2,3,2,0,7,20110121,0,2,3,3,11,3,2010,0,4,1536,0
Lightning,1,0,0,1,2,Panthers,1,0,0,0,1,20110121,0,0,0,1,3,-1,2010,1,4,205,0
Canadiens,2,3,2,0,7,Senators,1,0,0,0,1,20110121,1,4,6,6,8,-6,2010,0,4,104,0
Islanders,2,1,2,0,5,Sabres,0,0,2,0,2,20110121,2,3,3,3,7,-3,2010,0,4,292,0
Devils,2,0,1,0,3,Flyers,0,1,0,0,1,20110122,2,1,2,2,4,-2,2010,0,5,75,0
Blackhawks,1,2,1,0,4,Red Wings,1,0,0,0,1,20110122,0,2,3,3,5,-3,2010,0,5,238,0
Bruins,2,2,2,0,6,Avalanche,1,0,1,0,2,20110122,1,3,4,4,8,-4,2010,0,5,1765,0
Ducks,1,2,0,1,4,Canadiens,0,1,2,0,3,20110122,1,2,0,1,7,-1,2010,1,5,2448,0
Hurricanes,0,0,2,0,2,Penguins,0,1,2,0,3,20110122,0,1,1,1,5,1,2010,0,5,330,0
Capitals,1,0,3,0,4,Maple Leafs,0,0,1,0,1,20110122,1,1,3,3,5,-3,2010,0,5,349,0
Rangers,0,1,1,1,3,Jets,1,1,0,0,2,20110122,-1,-1,0,1,5,-1,2010,1,5,745,0
Blue Jackets,1,1,3,0,5,Blues,2,0,0,0,2,20110122,-1,0,3,3,7,-3,2010,0,5,395,0
Kings,3,0,1,0,4,Coyotes,1,2,0,0,3,20110122,2,0,1,1,7,-1,2010,0,5,356,0
Flames,2,0,1,1,4,Canucks,1,1,1,0,3,20110122,1,0,0,1,7,-1,2010,1,5,426,0
Wild,1,1,1,0,3,Sharks,1,2,1,0,4,20110122,0,1,1,1,7,1,2010,0,5,1570,0
Jets,0,0,1,0,1,Lightning,0,5,2,0,7,20110123,0,5,6,6,8,6,2010,0,6,416,0
Predators,1,0,1,1,3,Oilers,0,0,2,0,2,20110123,1,1,0,1,5,-1,2010,1,6,1758,0
Panthers,0,1,1,0,2,Devils,2,2,1,0,5,20110123,2,3,3,3,7,3,2010,0,6,1090,0
Sabres,1,1,3,0,5,Islanders,0,2,1,0,3,20110123,1,0,2,2,8,-2,2010,0,6,292,0
Flyers,0,1,3,0,4,Blackhawks,0,0,1,0,1,20110123,0,1,3,3,5,-3,2010,0,6,664,0
Bruins,0,0,0,0,0,Kings,1,0,1,0,2,20110124,1,1,2,2,2,2,2010,0,0,2590,0
Stars,1,0,0,0,1,Canucks,3,2,2,0,7,20110124,2,4,6,6,8,6,2010,0,0,1766,0
Predators,0,1,0,0,1,Flames,1,1,1,0,3,20110124,1,1,2,2,4,2,2010,0,0,1692,0
Rangers,0,0,1,1,2,Capitals,0,1,0,0,1,20110124,0,-1,0,1,3,-1,2010,1,0,204,0
Blues,0,2,1,0,3,Avalanche,0,2,2,0,4,20110124,0,0,1,1,7,1,2010,0,0,794,0
Maple Leafs,1,0,3,0,4,Hurricanes,1,1,4,0,6,20110124,0,1,2,2,10,2,2010,0,0,544,0
Oilers,0,1,3,0,4,Coyotes,1,1,1,0,3,20110125,-1,-1,1,1,7,-1,2010,0,1,1392,0
Wild,1,2,1,0,4,Blackhawks,2,0,0,0,2,20110125,-1,1,2,2,6,-2,2010,0,1,355,0
Maple Leafs,0,0,0,0,0,Lightning,2,0,0,0,2,20110125,2,2,2,2,2,2,2010,0,1,1096,0
Sabres,2,0,0,1,3,Senators,1,0,1,0,2,20110125,1,1,0,1,5,-1,2010,1,1,219,0
Ducks,2,0,1,0,3,Blue Jackets,1,0,1,0,2,20110125,1,1,1,1,5,-1,2010,0,1,1973,0
Islanders,0,0,0,0,0,Penguins,0,0,1,0,1,20110125,0,0,1,1,1,1,2010,0,1,314,0
Panthers,1,2,1,0,4,Rangers,0,1,2,0,3,20110125,1,2,1,1,7,-1,2010,0,1,1091,0
Canadiens,0,1,1,0,2,Flyers,2,2,1,0,5,20110125,2,3,3,3,7,3,2010,0,1,400,0
Hurricanes,1,2,1,0,4,Islanders,0,1,1,0,2,20110126,1,2,2,2,6,-2,2010,0,2,423,0
Capitals,0,0,0,0,0,Jets,0,1,0,0,1,20110126,0,1,1,1,1,1,2010,0,2,541,0
Devils,1,0,0,0,1,Red Wings,1,0,2,0,3,20110126,0,0,2,2,4,2,2010,0,2,471,0
Oilers,0,1,0,0,1,Stars,1,2,0,0,3,20110126,1,2,2,2,4,2,2010,0,2,1655,0
Coyotes,2,1,2,0,5,Avalanche,1,0,1,0,2,20110126,1,2,3,3,7,-3,2010,0,2,585,0
Blues,0,0,1,0,1,Flames,1,2,1,0,4,20110126,1,3,3,3,5,3,2010,0,2,1440,0
Predators,0,0,1,0,1,Canucks,0,0,2,0,2,20110126,0,0,1,1,3,1,2010,0,2,2030,0
Sharks,0,2,0,0,2,Kings,0,1,1,1,3,20110126,0,-1,0,1,5,1,2010,1,2,305,0
Panthers,0,0,1,0,1,Bruins,1,1,0,0,2,20110126,1,2,1,1,3,1,2010,0,2,1257,0
Blackhawks,2,3,2,0,7,Blue Jackets,1,2,1,0,4,20110201,1,2,3,3,11,-3,2010,0,1,275,0
Kings,0,0,0,0,0,Wild,0,0,0,1,1,20110201,0,0,0,1,1,1,2010,1,1,1521,0
Canucks,0,3,1,0,4,Stars,0,1,0,0,1,20110201,0,2,3,3,5,-3,2010,0,1,1766,0
Coyotes,2,1,0,0,3,Sharks,0,1,4,0,5,20110201,-2,-2,2,2,8,2,2010,0,1,614,0
Flames,0,0,2,1,3,Predators,1,0,1,0,2,20110201,-1,-1,0,1,5,-1,2010,1,1,1692,0
Canadiens,0,2,0,1,3,Capitals,2,0,0,0,2,20110201,-2,0,0,1,5,-1,2010,1,1,495,0
Penguins,0,3,0,1,4,Rangers,1,2,0,0,3,20110201,-1,0,0,1,7,-1,2010,1,1,314,0
Bruins,0,1,2,0,3,Hurricanes,0,1,1,0,2,20110201,0,0,1,1,5,-1,2010,0,1,609,0
Senators,0,1,0,0,1,Devils,0,1,1,0,2,20110201,0,0,1,1,3,1,2010,0,1,330,0
Panthers,1,1,1,0,3,Maple Leafs,2,1,0,1,4,20110201,1,1,0,1,7,1,2010,1,1,1234,0
Islanders,0,3,1,0,4,Jets,1,0,0,0,1,20110201,-1,2,3,3,5,-3,2010,0,1,745,0
Flyers,0,0,0,0,0,Lightning,3,0,1,0,4,20110201,3,3,4,4,4,4,2010,0,1,928,0
Sharks,3,1,0,0,4,Ducks,0,2,1,0,3,20110202,3,2,1,1,7,-1,2010,0,2,305,0
Kings,0,2,1,0,3,Oilers,0,1,0,0,1,20110202,0,1,2,2,4,-2,2010,0,2,1368,0
Canucks,1,2,3,0,6,Coyotes,0,0,0,0,0,20110202,1,3,6,6,6,-6,2010,0,2,1228,0
Islanders,0,0,0,0,0,Penguins,2,0,1,0,3,20110202,2,2,3,3,3,3,2010,0,2,314,0
Red Wings,2,2,3,0,7,Senators,3,1,1,0,5,20110202,-1,0,2,2,12,-2,2010,0,2,406,0
Panthers,1,0,1,0,2,Canadiens,0,1,2,0,3,20110202,-1,0,1,1,5,1,2010,0,2,1418,0
Stars,0,1,2,0,3,Bruins,4,0,2,0,6,20110203,4,3,3,3,9,3,2010,0,3,1548,0
Devils,1,2,0,0,3,Rangers,0,1,1,0,2,20110203,1,2,1,1,5,-1,2010,0,3,8,0
Predators,1,0,1,0,2,Flyers,1,0,2,0,3,20110203,0,0,1,1,5,1,2010,0,3,683,0
Hurricanes,0,0,0,0,0,Maple Leafs,0,2,1,0,3,20110203,0,2,3,3,3,3,2010,0,3,544,0
Flames,1,1,2,0,4,Jets,0,2,0,0,2,20110203,1,0,2,2,6,-2,2010,0,3,1907,0
Wild,2,1,1,0,4,Avalanche,0,1,2,0,3,20110203,2,2,1,1,7,-1,2010,0,3,698,0
Oilers,1,2,0,0,3,Blues,2,2,1,0,5,20110204,1,1,2,2,8,2,2010,0,4,1508,0
Capitals,1,2,2,0,5,Lightning,1,1,0,0,2,20110204,0,1,3,3,7,-3,2010,0,4,818,0
Blackhawks,0,2,1,0,3,Canucks,1,1,2,0,4,20110204,1,0,1,1,7,1,2010,0,4,1775,0
Sabres,2,0,0,0,2,Penguins,0,3,0,0,3,20110204,-2,1,1,1,5,1,2010,0,4,178,0
Panthers,2,0,1,1,4,Devils,2,1,0,0,3,20110204,0,-1,0,1,7,-1,2010,1,4,1090,0
Blue Jackets,1,1,1,0,3,Red Wings,0,0,0,0,0,20110204,1,2,3,3,3,-3,2010,0,4,163,0
Kings,2,1,0,1,4,Flames,1,1,1,0,3,20110205,1,1,0,1,7,-1,2010,1,5,1197,0
Wild,0,0,0,0,0,Coyotes,0,0,1,0,1,20110205,0,0,1,1,1,1,2010,0,5,1278,0
Oilers,2,0,1,0,3,Blue Jackets,1,1,2,0,4,20110205,-1,0,1,1,7,1,2010,0,5,1703,0
Stars,0,1,0,0,1,Flyers,1,1,1,0,3,20110205,1,1,2,2,4,2,2010,0,5,1297,0
Senators,3,0,0,0,3,Islanders,3,0,2,0,5,20110205,0,0,2,2,8,2,2010,0,5,334,0
Red Wings,0,0,0,0,0,Predators,1,1,1,0,3,20110205,1,2,3,3,3,3,2010,0,5,470,0
Maple Leafs,0,1,1,0,2,Sabres,2,3,1,0,6,20110205,2,4,4,4,8,4,2010,0,5,57,0
Ducks,1,0,2,0,3,Avalanche,0,0,0,0,0,20110205,1,1,3,3,3,-3,2010,0,5,830,0
Rangers,0,0,0,0,0,Canadiens,0,1,1,0,2,20110205,0,1,2,2,2,2,2010,0,5,343,0
Sharks,1,0,1,0,2,Bruins,0,0,0,0,0,20110205,1,1,2,2,2,-2,2010,0,5,2678,0
Jets,1,0,2,0,3,Hurricanes,0,1,2,1,4,20110205,-1,0,0,1,7,1,2010,1,5,354,0
Penguins,0,0,0,0,0,Capitals,1,1,1,0,3,20110206,1,2,3,3,3,3,2010,0,6,190,0
Devils,2,1,1,0,4,Canadiens,0,1,0,0,1,20110206,2,2,3,3,5,-3,2010,0,6,342,0
Blues,0,3,0,0,3,Lightning,1,2,0,1,4,20110206,1,0,0,1,7,1,2010,1,6,861,0
Jets,2,1,1,0,4,Maple Leafs,0,3,2,0,5,20110207,-2,0,1,1,9,1,2010,0,0,733,0
Rangers,0,0,2,0,2,Red Wings,0,1,2,0,3,20110207,0,1,1,1,5,1,2010,0,0,480,0
Oilers,1,1,2,0,4,Predators,0,0,0,0,0,20110207,1,2,4,4,4,-4,2010,0,0,1758,0
Blackhawks,0,1,0,0,1,Flames,1,0,2,0,3,20110207,1,0,2,2,4,2,2010,0,0,1397,0
Avalanche,0,0,0,0,0,Coyotes,1,1,1,0,3,20110207,1,2,3,3,3,3,2010,0,0,585,0
Senators,0,2,0,0,2,Canucks,2,1,1,0,4,20110207,2,1,2,2,6,2,2010,0,0,2191,0
Blues,0,1,1,0,2,Panthers,1,0,0,0,1,20110208,-1,0,1,1,3,-1,2010,0,1,1061,0
Sharks,0,0,2,0,2,Capitals,0,0,0,0,0,20110208,0,0,2,2,2,-2,2010,0,1,2416,0
Sabres,1,1,5,0,7,Lightning,1,2,1,0,4,20110208,0,-1,3,3,11,-3,2010,0,1,1051,0
Maple Leafs,2,0,3,0,5,Islanders,1,1,1,0,3,20110208,1,0,2,2,8,-2,2010,0,1,341,0
Blue Jackets,1,2,1,0,4,Penguins,0,0,1,0,1,20110208,1,3,3,3,5,-3,2010,0,1,161,0
Hurricanes,0,1,1,0,2,Devils,0,1,1,1,3,20110208,0,0,0,1,5,1,2010,1,1,419,0
Ducks,1,2,1,0,4,Canucks,0,1,2,0,3,20110209,1,2,1,1,7,-1,2010,0,2,1076,0
Senators,2,0,0,0,2,Flames,1,2,2,0,5,20110209,-1,1,3,3,7,3,2010,0,2,1773,0
Coyotes,1,0,1,1,3,Stars,1,1,0,0,2,20110209,0,-1,0,1,5,-1,2010,1,2,884,0
Blackhawks,1,1,2,0,4,Oilers,0,0,1,0,1,20110209,1,2,3,3,5,-3,2010,0,2,1437,0
Predators,2,2,0,0,4,Red Wings,0,1,0,0,1,20110209,2,3,3,3,5,-3,2010,0,2,470,0
Sharks,0,2,1,0,3,Blue Jackets,2,0,0,0,2,20110209,-2,0,1,1,5,-1,2010,0,2,2090,0
Canadiens,0,4,2,0,6,Bruins,2,4,2,0,8,20110209,2,2,2,2,14,2,2010,0,2,270,0
Avalanche,1,0,1,0,2,Wild,2,1,0,0,3,20110209,1,2,1,1,5,1,2010,0,2,698,0
Hurricanes,0,0,1,0,1,Flyers,0,0,2,0,2,20110210,0,0,1,1,3,1,2010,0,3,345,0
Kings,1,0,0,0,1,Penguins,1,0,0,1,2,20110210,0,0,0,1,3,1,2010,1,3,2132,0
Devils,0,0,1,1,2,Maple Leafs,0,1,0,0,1,20110210,0,-1,0,1,3,-1,2010,1,3,333,0
Islanders,1,1,1,1,4,Canadiens,1,2,0,0,3,20110210,0,-1,0,1,7,-1,2010,1,3,343,0
Sabres,0,1,1,1,3,Panthers,0,1,1,0,2,20110210,0,0,0,1,5,-1,2010,1,3,1184,0
Wild,1,1,2,1,5,Blues,2,0,2,0,4,20110211,-1,0,0,1,9,-1,2010,1,4,466,0
Ducks,1,2,1,1,5,Flames,0,2,2,0,4,20110211,1,1,0,1,9,-1,2010,1,4,1197,0
Rangers,0,1,1,0,2,Jets,1,0,2,0,3,20110211,1,0,1,1,5,1,2010,0,4,745,0
Blackhawks,3,0,0,0,3,Stars,0,2,1,1,4,20110211,-3,-1,0,1,7,1,2010,1,4,802,0
Penguins,0,2,1,0,3,Islanders,4,4,1,0,9,20110211,4,6,6,6,12,6,2010,0,4,314,0
Sharks,0,0,1,0,1,Devils,0,0,2,0,2,20110211,0,0,1,1,3,1,2010,0,4,2540,0
Red Wings,2,3,1,0,6,Bruins,1,0,0,0,1,20110211,1,4,5,5,7,-5,2010,0,4,611,0
Avalanche,1,0,0,0,1,Blue Jackets,0,2,1,0,3,20110211,-1,1,2,2,4,2,2010,0,4,1163,0
Kings,0,1,3,0,4,Capitals,1,0,0,0,1,20110212,-1,0,3,3,5,-3,2010,0,5,2294,0
Senators,2,0,3,0,5,Oilers,1,1,1,0,3,20110212,1,0,2,2,8,-2,2010,0,5,1754,0
Maple Leafs,0,0,0,0,0,Canadiens,0,2,1,0,3,20110212,0,2,3,3,3,3,2010,0,5,303,0
Hurricanes,0,1,2,0,3,Lightning,0,2,1,1,4,20110212,0,1,0,1,7,1,2010,1,5,585,0
Blackhawks,0,1,1,0,2,Coyotes,1,1,0,1,3,20110212,1,1,0,1,5,1,2010,1,5,1450,0
Avalanche,1,1,1,0,3,Predators,1,1,3,0,5,20110212,0,0,2,2,8,2,2010,0,5,1019,0
Blues,0,1,0,0,1,Wild,1,2,0,0,3,20110212,1,2,2,2,4,2,2010,0,5,466,0
Flames,0,2,0,0,2,Canucks,1,2,1,0,4,20110212,1,1,2,2,6,2,2010,0,5,426,0
Ducks,1,2,1,0,4,Oilers,0,0,0,0,0,20110213,1,3,4,4,4,-4,2010,0,6,1368,0
Hurricanes,1,1,1,0,3,Jets,0,1,1,0,2,20110213,1,1,1,1,5,-1,2010,0,6,354,0
Sharks,1,0,1,0,2,Panthers,0,1,2,0,3,20110213,-1,0,1,1,5,1,2010,0,6,2558,0
Kings,0,1,0,0,1,Flyers,0,0,0,0,0,20110213,0,1,1,1,1,-1,2010,0,6,2388,0
Bruins,2,0,0,0,2,Red Wings,1,2,1,0,4,20110213,-1,1,2,2,6,2,2010,0,6,611,0
Blue Jackets,1,1,0,0,2,Stars,1,0,0,0,1,20110213,0,1,1,1,3,-1,2010,0,6,912,0
Islanders,2,1,3,1,7,Sabres,3,1,2,0,6,20110213,-1,-1,0,1,13,-1,2010,1,6,292,0
Penguins,2,0,1,0,3,Rangers,2,3,0,0,5,20110213,0,3,2,2,8,2,2010,0,6,314,0
Canucks,1,0,1,0,2,Blues,2,1,0,0,3,20110214,1,2,1,1,5,1,2010,0,0,1778,0
Capitals,0,1,1,0,2,Coyotes,0,2,1,0,3,20110214,0,1,1,1,5,1,2010,0,0,1977,0
Flames,5,0,4,0,9,Avalanche,0,1,0,0,1,20110214,5,4,8,8,10,-8,2010,0,0,898,0
Canucks,1,2,1,0,4,Wild,1,0,0,0,1,20110215,0,2,3,3,5,-3,2010,0,1,1427,0
Stars,0,1,0,0,1,Oilers,1,2,1,0,4,20110215,1,2,3,3,5,3,2010,0,1,1655,0
Sharks,0,1,0,1,2,Predators,1,0,0,0,1,20110215,-1,0,0,1,3,-1,2010,1,1,1934,0
Flyers,1,2,0,1,4,Lightning,0,3,0,0,3,20110215,1,0,0,1,7,-1,2010,1,1,928,0
Islanders,0,1,2,1,4,Senators,1,1,1,0,3,20110215,-1,-1,0,1,7,-1,2010,1,1,334,0
Sabres,0,1,1,1,3,Canadiens,1,1,0,0,2,20110215,-1,-1,0,1,5,-1,2010,1,1,311,0
Maple Leafs,1,1,2,0,4,Bruins,1,1,1,0,3,20110215,0,0,1,1,7,-1,2010,0,1,430,0
Stars,0,2,0,0,2,Flames,1,1,2,0,4,20110216,1,0,2,2,6,2,2010,0,2,1536,0
Penguins,1,1,0,1,3,Avalanche,0,2,0,0,2,20110216,1,0,0,1,5,-1,2010,1,2,1317,0
Wild,0,0,1,0,1,Blackhawks,1,0,2,0,3,20110216,1,1,2,2,4,2,2010,0,2,355,0
Capitals,2,2,3,0,7,Ducks,3,2,1,0,6,20110216,-1,-1,1,1,13,-1,2010,0,2,2294,0
Kings,1,1,1,1,4,Blue Jackets,1,1,1,0,3,20110216,0,0,0,1,7,-1,2010,1,2,1973,0
Hurricanes,0,0,2,0,2,Devils,0,1,2,0,3,20110216,0,1,1,1,5,1,2010,0,2,419,0
Maple Leafs,0,1,1,0,2,Sabres,0,0,1,0,1,20110216,0,1,1,1,3,-1,2010,0,2,57,0
Flyers,2,1,1,0,4,Panthers,0,0,2,0,2,20110216,2,3,2,2,6,-2,2010,0,2,1021,0
Bruins,3,3,0,0,6,Islanders,0,2,1,0,3,20110217,3,4,3,3,9,-3,2010,0,3,190,0
Kings,1,0,2,0,3,Rangers,0,1,2,1,4,20110217,-1,0,0,1,7,1,2010,1,3,2445,0
Red Wings,2,2,2,0,6,Lightning,0,2,0,0,2,20110217,2,2,4,4,8,-4,2010,0,3,994,0
Canucks,0,1,0,0,1,Predators,0,3,0,0,3,20110217,0,2,2,2,4,2,2010,0,3,2030,0
Canadiens,0,1,0,0,1,Oilers,1,0,3,0,4,20110217,1,0,3,3,5,3,2010,0,3,1826,0
Jets,1,2,0,0,3,Coyotes,2,2,0,0,4,20110217,1,1,1,1,7,1,2010,0,3,1588,0
Capitals,1,0,1,0,2,Sharks,1,0,2,0,3,20110217,0,0,1,1,5,1,2010,0,3,2416,0
Ducks,1,0,0,0,1,Wild,2,2,1,0,5,20110218,1,3,4,4,6,4,2010,0,4,1521,0
Blue Jackets,1,3,0,0,4,Blackhawks,2,1,0,0,3,20110218,-1,1,1,1,7,-1,2010,0,4,275,0
Red Wings,2,1,1,0,4,Panthers,1,1,1,0,3,20110218,1,1,1,1,7,-1,2010,0,4,1155,0
Flyers,0,1,1,0,2,Hurricanes,2,0,1,0,3,20110218,2,1,1,1,5,1,2010,0,4,345,0
Blues,0,2,1,0,3,Sabres,0,0,0,0,0,20110218,0,2,3,3,3,-3,2010,0,4,660,0
Rangers,0,0,0,0,0,Devils,0,1,0,0,1,20110218,0,1,1,1,1,1,2010,0,4,8,0
Bruins,0,1,3,0,4,Senators,0,1,1,0,2,20110218,0,0,2,2,6,-2,2010,0,4,320,0
Avalanche,0,0,0,0,0,Sharks,3,0,1,0,4,20110219,3,3,4,4,4,4,2010,0,5,927,0
Coyotes,0,2,1,0,3,Predators,0,1,1,0,2,20110219,0,1,1,1,5,-1,2010,0,5,1442,0
Ducks,3,0,0,0,3,Blues,4,4,1,0,9,20110219,1,5,6,6,12,6,2010,0,5,1586,0
Panthers,0,1,1,1,3,Lightning,1,0,1,0,2,20110219,-1,0,0,1,5,-1,2010,1,5,205,0
Stars,1,0,1,0,2,Canucks,1,1,3,0,5,20110219,0,1,3,3,7,3,2010,0,5,1766,0
Kings,0,0,0,0,0,Islanders,1,1,1,0,3,20110219,1,2,3,3,3,3,2010,0,5,2445,0
Devils,3,0,1,0,4,Hurricanes,0,0,1,0,1,20110219,3,3,3,3,5,-3,2010,0,5,419,0
Jets,1,1,1,0,3,Oilers,0,1,4,0,5,20110219,-1,-1,2,2,8,2,2010,0,5,1973,0
Senators,0,0,0,1,1,Maple Leafs,0,0,0,0,0,20110219,0,0,0,1,1,-1,2010,1,5,203,0
Capitals,0,1,1,0,2,Sabres,0,1,0,0,1,20110220,0,0,1,1,3,-1,2010,0,6,292,0
Flyers,1,2,1,0,4,Rangers,1,0,1,0,2,20110220,0,2,2,2,6,-2,2010,0,6,80,0
Red Wings,0,0,1,1,2,Wild,0,0,1,0,1,20110220,0,0,0,1,3,-1,2010,1,6,542,0
Penguins,0,1,1,0,2,Blackhawks,1,0,1,1,3,20110220,1,0,0,1,5,1,2010,1,6,409,0
Canadiens,0,0,0,0,0,Flames,1,2,1,0,4,20110220,1,3,4,4,4,4,2010,0,6,1852,0
Capitals,0,1,0,0,1,Penguins,0,0,0,0,0,20110221,0,1,1,1,1,-1,2010,0,0,190,0
Panthers,0,0,1,0,1,Islanders,2,2,1,0,5,20110221,2,4,4,4,6,4,2010,0,0,1091,0
Blackhawks,0,4,1,0,5,Blues,2,0,1,0,3,20110221,-2,2,2,2,8,-2,2010,0,0,260,0
Devils,0,0,1,0,1,Stars,0,0,0,0,0,20110222,0,0,1,1,1,-1,2010,0,1,1362,0
Oilers,0,1,0,0,1,Wild,0,1,3,0,4,20110222,0,0,3,3,5,3,2010,0,1,1083,0
Canadiens,2,1,0,0,3,Canucks,0,1,1,0,2,20110222,2,2,1,1,5,-1,2010,0,1,2273,0
Avalanche,2,0,2,0,4,Blues,1,1,1,0,3,20110222,1,0,1,1,7,-1,2010,0,1,794,0
Bruins,1,0,2,0,3,Flames,0,0,1,0,1,20110222,1,1,2,2,4,-2,2010,0,1,2089,0
Predators,0,0,0,0,0,Blue Jackets,0,0,4,0,4,20110222,0,0,4,4,4,4,2010,0,1,333,0
Islanders,0,1,0,0,1,Maple Leafs,1,0,1,0,2,20110222,1,0,1,1,3,1,2010,0,1,341,0
Coyotes,0,0,2,1,3,Flyers,1,0,1,0,2,20110222,-1,-1,0,1,5,-1,2010,1,1,2078,0
Sharks,1,2,1,0,4,Red Wings,0,2,1,0,3,20110222,1,1,1,1,7,-1,2010,0,1,2071,0
Rangers,1,1,0,2,4,Hurricanes,1,0,2,0,3,20110222,0,1,-1,1,7,-1,2010,1,1,423,0
Jets,0,1,0,0,1,Sabres,1,2,1,0,4,20110223,1,2,3,3,5,3,2010,0,2,698,0
Panthers,0,1,0,0,1,Senators,1,2,2,0,5,20110223,1,2,4,4,6,4,2010,0,2,1370,0
Sharks,0,1,1,1,3,Penguins,1,0,1,0,2,20110223,-1,0,0,1,5,-1,2010,1,2,2242,0
Coyotes,0,1,2,0,3,Lightning,5,2,1,0,8,20110223,5,6,5,5,11,5,2010,0,2,1793,0
Oilers,1,2,2,0,5,Avalanche,0,1,0,0,1,20110223,1,2,4,4,6,-4,2010,0,2,1036,0
Kings,2,0,1,0,3,Ducks,1,1,0,0,2,20110223,1,0,1,1,5,-1,2010,0,2,0,0
Wild,0,2,0,0,2,Kings,1,1,2,0,4,20110224,1,0,2,2,6,2,2010,0,3,1521,0
Blues,0,2,0,0,2,Canucks,2,0,1,0,3,20110224,2,0,1,1,5,1,2010,0,3,1778,0
Blackhawks,1,0,2,0,3,Predators,0,0,0,0,0,20110224,1,1,3,3,3,-3,2010,0,3,395,0
Stars,2,1,1,0,4,Red Wings,0,0,1,0,1,20110224,2,3,3,3,5,-3,2010,0,3,999,0
Islanders,1,0,2,0,3,Flyers,0,2,1,1,4,20110224,-1,1,0,1,7,1,2010,1,3,80,0
Maple Leafs,3,1,1,0,5,Canadiens,1,2,1,0,4,20110224,2,1,1,1,9,-1,2010,0,3,303,0
Penguins,0,1,0,0,1,Hurricanes,2,1,1,0,4,20110225,2,2,3,3,5,3,2010,0,4,330,0
Rangers,2,2,2,0,6,Capitals,0,0,0,0,0,20110225,2,4,6,6,6,-6,2010,0,4,204,0
Coyotes,2,0,1,0,3,Blue Jackets,2,2,1,0,5,20110225,0,2,2,2,8,2,2010,0,4,1664,0
Senators,0,1,1,0,2,Sabres,1,1,2,0,4,20110225,1,1,2,2,6,2,2010,0,4,219,0
Devils,0,0,1,0,1,Lightning,0,2,0,0,2,20110225,0,2,1,1,3,1,2010,0,4,1000,0
Panthers,1,0,0,1,2,Jets,0,1,0,0,1,20110225,1,0,0,1,3,-1,2010,1,4,605,0
Sharks,1,1,1,1,4,Flames,1,2,0,0,3,20110225,0,-1,0,1,7,-1,2010,1,4,1027,0
Blues,2,1,2,0,5,Oilers,0,0,0,0,0,20110225,2,3,5,5,5,-5,2010,0,4,1508,0
Wild,1,0,1,1,3,Ducks,0,1,1,0,2,20110225,1,0,0,1,5,-1,2010,1,4,1521,0
Flyers,1,0,0,0,1,Senators,0,2,2,0,4,20110226,-1,1,3,3,5,3,2010,0,5,373,0
Bruins,0,1,2,0,3,Canucks,1,0,0,0,1,20110226,-1,0,2,2,4,-2,2010,0,5,2504,0
Penguins,1,2,2,1,6,Maple Leafs,1,1,3,0,5,20110226,0,1,0,1,11,-1,2010,1,5,222,0
Capitals,0,1,2,0,3,Islanders,1,1,0,0,2,20110226,-1,-1,1,1,5,-1,2010,0,5,204,0
Predators,0,2,0,0,2,Stars,1,0,2,0,3,20110226,1,-1,1,1,5,1,2010,0,5,616,0
Red Wings,0,1,1,1,3,Sabres,2,0,0,0,2,20110226,-2,-1,0,1,5,-1,2010,1,5,215,0
Avalanche,0,0,3,0,3,Kings,1,2,1,0,4,20110226,1,3,1,1,7,1,2010,0,5,830,0
Hurricanes,1,2,0,0,3,Canadiens,2,1,1,0,4,20110226,1,0,1,1,7,1,2010,0,5,727,0
Avalanche,1,0,1,0,2,Ducks,0,2,1,0,3,20110227,-1,1,1,1,5,1,2010,0,6,830,0
Bruins,2,1,0,0,3,Oilers,1,0,1,0,2,20110227,1,2,1,1,5,-1,2010,0,6,2074,0
Coyotes,0,3,0,0,3,Blackhawks,2,1,0,1,4,20110227,2,0,0,1,7,1,2010,1,6,1450,0
Blues,0,0,0,0,0,Flames,0,0,1,0,1,20110227,0,0,1,1,1,1,2010,0,6,1440,0
Devils,0,2,0,0,2,Panthers,0,0,1,0,1,20110227,0,2,1,1,3,-1,2010,0,6,1090,0
Blue Jackets,0,1,1,0,2,Predators,0,0,3,0,3,20110227,0,-1,1,1,5,1,2010,0,6,333,0
Lightning,1,0,1,0,2,Rangers,0,1,0,0,1,20110227,1,0,1,1,3,-1,2010,0,6,1004,0
Maple Leafs,2,0,0,0,2,Jets,0,0,2,1,3,20110227,-2,-2,0,1,5,1,2010,1,6,733,0
Blackhawks,0,3,1,0,4,Wild,0,0,2,0,2,20110228,0,3,2,2,6,-2,2010,0,0,355,0
Red Wings,3,1,3,0,7,Kings,1,0,3,0,4,20110228,2,3,3,3,11,-3,2010,0,0,1979,0
Stars,1,0,2,0,3,Coyotes,0,0,2,0,2,20110301,1,1,1,1,5,-1,2010,0,1,884,0
Avalanche,0,0,1,0,1,Sharks,0,0,1,1,2,20110301,0,0,0,1,3,1,2010,1,1,927,0
Blue Jackets,0,1,0,0,1,Canucks,1,0,0,1,2,20110301,1,0,0,1,3,1,2010,1,1,2050,0
Flames,1,0,5,0,6,Blues,0,0,0,0,0,20110301,1,1,6,6,6,-6,2010,0,1,1440,0
Predators,1,0,0,0,1,Oilers,1,0,0,1,2,20110301,0,0,0,1,3,1,2010,1,1,1758,0
Canadiens,1,1,1,0,3,Jets,0,0,1,0,1,20110301,1,2,2,2,4,-2,2010,0,1,992,0
Islanders,0,1,0,0,1,Capitals,0,0,1,1,2,20110301,0,-1,0,1,3,1,2010,1,1,204,0
Sabres,1,1,1,0,3,Rangers,0,1,1,0,2,20110301,1,1,1,1,5,-1,2010,0,1,292,0
Panthers,0,1,0,0,1,Hurricanes,2,0,0,0,2,20110301,2,1,1,1,3,1,2010,0,1,696,0
Bruins,0,0,1,0,1,Senators,0,0,0,0,0,20110301,0,0,1,1,1,-1,2010,0,1,320,0
Lightning,0,1,0,0,1,Devils,0,1,1,0,2,20110302,0,0,1,1,3,1,2010,0,2,1000,0
Wild,0,0,1,0,1,Islanders,2,2,0,0,4,20110302,2,4,3,3,5,3,2010,0,2,1016,0
Penguins,1,1,0,0,2,Maple Leafs,1,0,1,1,3,20110302,0,-1,0,1,5,1,2010,1,2,222,0
Flames,1,0,3,0,4,Blackhawks,2,2,2,0,6,20110302,1,3,2,2,10,2,2010,0,2,1397,0
Red Wings,0,1,0,0,1,Ducks,0,0,1,1,2,20110302,0,-1,0,1,3,1,2010,1,2,1979,0
Red Wings,1,0,0,0,1,Sharks,1,1,1,0,3,20110303,0,1,2,2,4,2,2010,0,3,2071,0
Coyotes,0,0,0,0,0,Kings,0,0,1,0,1,20110303,0,0,1,1,1,1,2010,0,3,356,0
Predators,0,0,3,0,3,Canucks,0,0,0,0,0,20110303,0,0,3,3,3,-3,2010,0,3,2030,0
Blue Jackets,0,1,1,0,2,Oilers,2,1,1,0,4,20110303,2,2,2,2,6,2,2010,0,3,1703,0
Canadiens,2,1,1,0,4,Panthers,0,0,0,0,0,20110303,2,3,4,4,4,-4,2010,0,3,1418,0
Sabres,0,2,0,0,2,Hurricanes,0,2,0,1,3,20110303,0,0,0,1,5,1,2010,1,3,491,0
Blues,1,1,0,0,2,Capitals,0,2,1,0,3,20110303,-1,0,1,1,5,1,2010,0,3,708,0
Maple Leafs,1,1,1,0,3,Flyers,1,1,0,0,2,20110303,0,0,1,1,5,-1,2010,0,3,334,0
Wild,0,2,1,0,3,Rangers,1,0,0,0,1,20110303,-1,1,2,2,4,-2,2010,0,3,1016,0
Lightning,0,1,0,0,1,Bruins,0,1,1,0,2,20110303,0,0,1,1,3,1,2010,0,3,1183,0
Senators,1,0,2,0,3,Jets,0,0,1,0,1,20110303,1,1,2,2,4,-2,2010,0,3,914,0
Stars,0,3,0,0,3,Ducks,1,0,2,1,4,20110304,1,-2,0,1,7,1,2010,1,4,1237,0
Hurricanes,1,0,1,0,2,Blackhawks,2,0,3,0,5,20110304,1,1,3,3,7,3,2010,0,4,641,0
Blue Jackets,1,1,1,0,3,Flames,2,2,0,0,4,20110304,1,2,1,1,7,1,2010,0,4,1670,0
Penguins,0,1,0,0,1,Devils,0,1,0,1,2,20110304,0,0,0,1,3,1,2010,1,4,306,0
Rangers,1,2,1,0,4,Senators,0,0,1,0,1,20110304,1,3,3,3,5,-3,2010,0,4,334,0
Red Wings,2,2,0,0,4,Coyotes,1,0,3,1,5,20110305,-1,-3,0,1,9,1,2010,1,5,1687,0
Blues,0,0,2,0,2,Islanders,2,1,2,0,5,20110305,2,3,3,3,7,3,2010,0,5,871,0
Sabres,0,3,2,0,5,Flyers,2,1,0,0,3,20110305,-2,0,2,2,8,-2,2010,0,5,279,0
Canucks,1,0,2,0,3,Kings,1,0,0,0,1,20110305,0,0,2,2,4,-2,2010,0,5,1076,0
Penguins,0,2,0,1,3,Bruins,0,1,1,0,2,20110305,0,1,0,1,5,-1,2010,1,5,481,0
Canadiens,2,1,1,0,4,Lightning,0,1,1,0,2,20110305,2,2,2,2,6,-2,2010,0,5,1311,0
Blackhawks,3,2,0,0,5,Maple Leafs,0,1,2,0,3,20110305,3,4,2,2,8,-2,2010,0,5,436,0
Panthers,1,0,2,0,3,Jets,0,1,2,1,4,20110305,-1,0,0,1,7,1,2010,1,5,605,0
Oilers,2,2,1,0,5,Avalanche,0,1,0,0,1,20110305,2,3,4,4,6,-4,2010,0,5,1036,0
Stars,1,0,2,0,3,Sharks,1,1,0,0,2,20110305,0,-1,1,1,5,-1,2010,0,5,1449,0
Sabres,1,1,0,1,3,Wild,0,2,0,0,2,20110306,1,0,0,1,5,-1,2010,1,6,729,0
Capitals,1,1,0,1,3,Panthers,1,0,1,0,2,20110306,0,1,0,1,5,-1,2010,1,6,924,0
Predators,2,0,0,0,2,Flames,1,1,1,0,3,20110306,-1,0,1,1,5,1,2010,0,6,1692,0
Flyers,0,0,0,0,0,Rangers,2,2,3,0,7,20110306,2,4,7,7,7,7,2010,0,6,80,0
Canucks,1,1,1,0,3,Ducks,0,0,0,0,0,20110306,1,2,3,3,3,-3,2010,0,6,1076,0
Devils,0,1,1,1,3,Islanders,0,1,1,0,2,20110306,0,0,0,1,5,-1,2010,1,6,8,0
Stars,0,1,2,1,4,Kings,1,1,1,0,3,20110307,-1,-1,0,1,7,-1,2010,1,0,1237,0
Blue Jackets,3,1,0,0,4,Blues,3,1,0,1,5,20110307,0,0,0,1,9,1,2010,1,0,395,0
Capitals,0,0,1,1,2,Lightning,1,0,0,0,1,20110307,-1,-1,0,1,3,-1,2010,1,0,818,0
Canucks,1,2,0,1,4,Coyotes,2,1,0,0,3,20110308,-1,0,0,1,7,-1,2010,1,1,1228,0
Avalanche,0,2,0,0,2,Wild,1,1,3,0,5,20110308,1,0,3,3,7,3,2010,0,1,698,0
Blackhawks,0,2,0,0,2,Panthers,3,0,0,0,3,20110308,3,1,1,1,5,1,2010,0,1,1189,0
Bruins,0,0,1,0,1,Canadiens,2,2,0,0,4,20110308,2,4,3,3,5,3,2010,0,1,270,0
Predators,1,1,0,0,2,Sharks,1,1,0,1,3,20110308,0,0,0,1,5,1,2010,1,1,1934,0
Oilers,0,1,0,0,1,Flyers,2,1,1,0,4,20110308,2,2,3,3,5,3,2010,0,1,2011,0
Maple Leafs,0,2,1,0,3,Islanders,0,2,1,1,4,20110308,0,0,0,1,7,1,2010,1,1,341,0
Senators,0,1,1,0,2,Devils,0,0,1,0,1,20110308,0,1,1,1,3,-1,2010,0,1,330,0
Sabres,1,0,0,0,1,Penguins,0,2,1,0,3,20110308,-1,1,2,2,4,2,2010,0,1,178,0
Jets,2,0,0,1,3,Hurricanes,0,1,1,0,2,20110309,2,1,0,1,5,-1,2010,1,2,354,0
Oilers,0,0,0,0,0,Capitals,0,2,3,0,5,20110309,0,2,5,5,5,5,2010,0,2,1985,0
Blues,0,1,2,1,4,Blue Jackets,0,3,0,0,3,20110309,0,-2,0,1,7,-1,2010,1,2,395,0
Kings,0,2,0,0,2,Red Wings,1,0,0,0,1,20110309,-1,1,1,1,3,-1,2010,0,2,1979,0
Blackhawks,1,1,1,0,3,Lightning,2,1,0,1,4,20110309,1,1,0,1,7,1,2010,1,2,1004,0
Flames,3,0,0,1,4,Stars,1,1,1,0,3,20110309,2,1,0,1,7,-1,2010,1,2,1536,0
Rangers,1,0,1,0,2,Ducks,3,0,2,0,5,20110309,2,2,3,3,7,3,2010,0,2,2445,0
Flames,0,0,0,0,0,Coyotes,0,1,2,0,3,20110310,0,1,3,3,3,3,2010,0,3,1224,0
Canucks,2,1,1,1,5,Sharks,0,2,2,0,4,20110310,2,1,0,1,9,-1,2010,1,3,821,0
Wild,0,0,0,0,0,Predators,3,0,1,0,4,20110310,3,3,4,4,4,4,2010,0,3,696,0
Sabres,0,2,1,1,4,Bruins,1,1,1,0,3,20110310,-1,0,0,1,7,-1,2010,1,3,399,0
Senators,0,0,2,0,2,Panthers,0,0,1,0,1,20110310,0,0,1,1,3,-1,2010,0,3,1370,0
Flyers,1,2,0,0,3,Maple Leafs,0,1,1,0,2,20110310,1,2,1,1,5,-1,2010,0,3,334,0
Canadiens,1,0,0,0,1,Blues,1,1,2,0,4,20110310,0,1,3,3,5,3,2010,0,3,962,0
Bruins,1,1,0,0,2,Islanders,0,1,3,0,4,20110311,-1,-1,2,2,6,2,2010,0,4,190,0
Hurricanes,0,1,0,0,1,Capitals,0,0,2,0,2,20110311,0,-1,1,1,3,1,2010,0,4,233,0
Kings,2,1,1,0,4,Blue Jackets,1,0,1,0,2,20110311,1,2,2,2,6,-2,2010,0,4,1973,0
Oilers,1,0,0,0,1,Red Wings,0,0,1,1,2,20110311,-1,-1,0,1,3,1,2010,1,4,1592,0
Senators,1,1,0,0,2,Lightning,0,0,1,0,1,20110311,1,2,1,1,3,-1,2010,0,4,1251,0
Devils,0,1,1,1,3,Jets,0,1,1,0,2,20110311,0,0,0,1,5,-1,2010,1,4,739,0
Wild,0,0,0,0,0,Stars,1,3,0,0,4,20110311,1,4,4,4,4,4,2010,0,4,863,0
Ducks,0,4,2,0,6,Avalanche,1,1,0,0,2,20110311,-1,2,4,4,8,-4,2010,0,4,830,0
Rangers,1,1,0,1,3,Sharks,1,1,0,0,2,20110312,0,0,0,1,5,-1,2010,1,5,2549,0
Canucks,1,3,0,0,4,Flames,2,1,0,0,3,20110312,-1,1,1,1,7,-1,2010,0,5,426,0
Avalanche,0,2,0,0,2,Predators,2,1,1,0,4,20110312,2,1,2,2,6,2,2010,0,5,1019,0
Red Wings,2,1,2,0,5,Blues,1,0,2,0,3,20110312,1,2,2,2,8,-2,2010,0,5,454,0
Lightning,0,1,2,0,3,Panthers,0,1,2,1,4,20110312,0,0,0,1,7,1,2010,1,5,205,0
Jets,0,0,4,1,5,Flyers,1,2,1,0,4,20110312,-1,-3,0,1,9,-1,2010,1,5,665,0
Islanders,0,2,0,0,2,Devils,1,0,1,1,3,20110312,1,-1,0,1,5,1,2010,1,5,8,0
Blue Jackets,1,1,1,0,3,Hurricanes,0,0,2,0,2,20110312,1,2,1,1,5,-1,2010,0,5,374,0
Canadiens,1,2,0,0,3,Penguins,0,0,0,0,0,20110312,1,3,3,3,3,-3,2010,0,5,474,0
Sabres,1,2,0,0,3,Maple Leafs,1,1,2,0,4,20110312,0,-1,1,1,7,1,2010,0,5,57,0
Coyotes,2,2,1,0,5,Ducks,1,1,0,0,2,20110313,1,2,3,3,7,-3,2010,0,6,356,0
Oilers,0,0,1,0,1,Penguins,1,2,2,0,5,20110313,1,3,4,4,6,4,2010,0,6,1797,0
Senators,2,1,1,0,4,Sabres,2,3,1,0,6,20110313,0,2,2,2,10,2,2010,0,6,219,0
Blackhawks,1,1,1,0,3,Capitals,2,0,1,1,4,20110313,1,0,0,1,7,1,2010,1,6,594,0
Kings,1,1,1,0,3,Stars,0,1,1,0,2,20110313,1,1,1,1,5,-1,2010,0,6,1237,0
Lightning,1,3,2,0,6,Maple Leafs,0,2,0,0,2,20110314,1,2,4,4,8,-4,2010,0,0,1096,0
Sharks,2,1,0,0,3,Blackhawks,1,5,0,0,6,20110314,-1,3,3,3,9,3,2010,0,0,1837,0
Wild,0,1,1,0,2,Canucks,3,0,1,0,4,20110314,3,2,2,2,6,2,2010,0,0,1427,0
Penguins,1,3,1,0,5,Senators,0,1,0,0,1,20110315,1,3,4,4,6,-4,2010,0,1,392,0
Sharks,0,2,4,0,6,Stars,0,2,1,0,3,20110315,0,0,3,3,9,-3,2010,0,1,1449,0
Kings,1,2,1,0,4,Predators,1,0,1,0,2,20110315,0,2,2,2,6,-2,2010,0,1,1776,0
Flyers,1,2,0,0,3,Panthers,2,0,0,0,2,20110315,-1,1,1,1,5,-1,2010,0,1,1021,0
Coyotes,1,1,2,0,4,Flames,1,0,2,0,3,20110315,0,1,1,1,7,-1,2010,0,1,1224,0
Hurricanes,1,0,0,0,1,Sabres,0,0,0,0,0,20110315,1,1,1,1,1,-1,2010,0,1,491,0
Islanders,0,2,1,0,3,Rangers,2,3,1,0,6,20110315,2,3,3,3,9,3,2010,0,1,0,0
Jets,2,0,0,0,2,Devils,1,1,2,0,4,20110315,-1,0,2,2,6,2,2010,0,1,739,0
Capitals,2,0,2,0,4,Canadiens,1,1,0,0,2,20110315,1,0,2,2,6,-2,2010,0,1,495,0
Bruins,0,1,1,1,3,Blue Jackets,1,0,1,0,2,20110315,-1,0,0,1,5,-1,2010,1,1,642,0
Maple Leafs,1,2,0,0,3,Hurricanes,1,0,0,0,1,20110316,0,2,2,2,4,-2,2010,0,2,544,0
Capitals,1,1,0,0,2,Red Wings,2,0,1,0,3,20110316,1,0,1,1,5,1,2010,0,2,394,0
Avalanche,2,0,0,0,2,Canucks,0,1,3,0,4,20110316,-2,-1,2,2,6,2,2010,0,2,1105,0
Blues,0,1,0,0,1,Ducks,0,1,1,0,2,20110316,0,0,1,1,3,1,2010,0,2,1586,0
Wild,1,1,0,0,2,Sharks,1,1,1,0,3,20110317,0,0,1,1,5,1,2010,0,3,1570,0
Blues,1,1,2,0,4,Kings,0,0,0,0,0,20110317,1,2,4,4,4,-4,2010,0,3,1586,0
Coyotes,1,1,1,0,3,Oilers,0,0,1,0,1,20110317,1,2,2,2,4,-2,2010,0,3,1392,0
Avalanche,1,0,1,0,2,Flames,3,0,2,0,5,20110317,2,2,3,3,7,3,2010,0,3,898,0
Blackhawks,0,0,0,0,0,Stars,1,2,2,0,5,20110317,1,3,5,5,5,5,2010,0,3,802,0
Bruins,1,1,1,0,3,Predators,1,1,1,1,4,20110317,0,0,0,1,7,1,2010,1,3,941,0
Maple Leafs,0,0,0,0,0,Panthers,0,3,1,0,4,20110317,0,3,4,4,4,4,2010,0,3,1234,0
Devils,0,0,1,0,1,Senators,1,0,2,0,3,20110317,1,1,2,2,4,2,2010,0,3,330,0
Lightning,0,1,1,0,2,Canadiens,0,1,1,1,3,20110317,0,0,0,1,5,1,2010,1,3,1311,0
Red Wings,2,0,0,0,2,Blue Jackets,0,0,0,0,0,20110317,2,2,2,2,2,-2,2010,0,3,163,0
Flyers,1,1,1,0,3,Jets,1,2,0,1,4,20110317,0,1,0,1,7,1,2010,1,3,665,0
Islanders,1,1,0,0,2,Hurricanes,1,0,1,1,3,20110318,0,-1,0,1,5,1,2010,1,4,423,0
Capitals,1,1,1,0,3,Devils,0,0,0,0,0,20110318,1,2,3,3,3,-3,2010,0,4,198,0
Canadiens,1,1,1,0,3,Rangers,5,0,1,0,6,20110318,4,3,3,3,9,3,2010,0,4,343,0
Coyotes,0,0,3,0,3,Canucks,0,0,1,0,1,20110318,0,0,2,2,4,-2,2010,0,4,1228,0
Blues,0,1,2,0,3,Sharks,3,2,0,0,5,20110319,3,4,2,2,8,2,2010,0,5,1719,0
Ducks,1,0,0,1,2,Kings,0,0,1,0,1,20110319,1,1,0,1,3,-1,2010,1,5,0,0
Avalanche,1,1,0,1,3,Oilers,0,1,1,0,2,20110319,1,1,0,1,5,-1,2010,1,5,1036,0
Flyers,1,1,0,1,3,Stars,0,1,1,0,2,20110319,1,1,0,1,5,-1,2010,1,5,1297,0
Red Wings,1,0,0,0,1,Predators,0,1,2,0,3,20110319,-1,0,2,2,4,2,2010,0,5,470,0
Bruins,1,0,1,0,2,Maple Leafs,2,3,0,0,5,20110319,1,4,3,3,7,3,2010,0,5,430,0
Islanders,0,1,2,1,4,Panthers,0,2,1,0,3,20110319,0,-1,0,1,7,-1,2010,1,5,1091,0
Lightning,1,1,0,0,2,Senators,0,0,2,1,3,20110319,-1,-2,0,1,5,1,2010,1,5,1251,0
Jets,1,1,0,0,2,Sabres,3,2,3,0,8,20110319,2,3,6,6,10,6,2010,0,5,698,0
Blue Jackets,1,1,2,1,5,Wild,1,1,2,0,4,20110319,0,0,0,1,9,-1,2010,1,5,626,0
Flames,1,2,1,0,4,Ducks,3,0,1,1,5,20110320,2,0,0,1,9,1,2010,1,6,1197,0
Blackhawks,1,0,1,0,2,Coyotes,0,1,0,0,1,20110320,1,0,1,1,3,-1,2010,0,6,1450,0
Canadiens,2,4,2,0,8,Wild,0,0,1,0,1,20110320,2,6,7,7,9,-7,2010,0,6,938,0
Predators,1,0,2,1,4,Sabres,0,3,0,0,3,20110320,1,-2,0,1,7,-1,2010,1,6,626,0
Rangers,1,0,4,0,5,Penguins,1,0,1,0,2,20110320,0,0,3,3,7,-3,2010,0,6,314,0
Devils,1,1,1,0,3,Blue Jackets,0,0,0,0,0,20110320,1,2,3,3,3,-3,2010,0,6,467,0
Penguins,2,2,0,1,5,Red Wings,0,1,3,0,4,20110321,2,3,0,1,9,-1,2010,1,0,205,0
Flames,0,0,1,0,1,Kings,0,0,1,1,2,20110321,0,0,0,1,3,1,2010,1,0,1197,0
Oilers,0,1,0,0,1,Predators,2,1,0,0,3,20110322,2,2,2,2,4,2,2010,0,1,1758,0
Blue Jackets,1,1,2,0,4,Avalanche,1,0,3,1,5,20110322,0,-1,0,1,9,1,2010,1,1,1163,0
Maple Leafs,1,1,1,0,3,Wild,0,0,0,0,0,20110322,1,2,3,3,3,-3,2010,0,1,691,0
Blues,1,0,0,0,1,Coyotes,0,2,0,0,2,20110322,-1,1,1,1,3,1,2010,0,1,1270,0
Islanders,1,2,2,0,5,Lightning,1,0,1,0,2,20110322,0,2,3,3,7,-3,2010,0,1,1004,0
Panthers,0,0,0,0,0,Rangers,0,0,1,0,1,20110322,0,0,1,1,1,1,2010,0,1,1091,0
Sabres,0,1,1,0,2,Canadiens,0,0,0,0,0,20110322,0,1,2,2,2,-2,2010,0,1,311,0
Senators,2,0,1,0,3,Hurricanes,2,1,1,0,4,20110322,0,1,1,1,7,1,2010,0,1,673,0
Devils,1,0,0,0,1,Bruins,1,1,2,0,4,20110322,0,1,3,3,5,3,2010,0,1,196,0
Capitals,2,1,1,1,5,Flyers,0,2,2,0,4,20110322,2,1,0,1,9,-1,2010,1,1,123,0
Canucks,0,1,1,0,2,Red Wings,0,0,1,0,1,20110323,0,1,1,1,3,-1,2010,0,2,1967,0
Panthers,0,0,0,0,0,Blackhawks,0,1,3,0,4,20110323,0,1,4,4,4,4,2010,0,2,1189,0
Ducks,0,1,2,1,4,Stars,0,1,2,0,3,20110323,0,0,0,1,7,-1,2010,1,2,1237,0
Flames,2,1,0,0,3,Sharks,4,1,1,0,6,20110323,2,2,3,3,9,3,2010,0,2,1027,0
Maple Leafs,2,1,1,0,4,Avalanche,1,1,1,0,3,20110324,1,1,1,1,7,-1,2010,0,3,1341,0
Sharks,0,1,2,0,3,Kings,0,2,1,1,4,20110324,0,1,0,1,7,1,2010,1,3,305,0
Blue Jackets,0,0,0,0,0,Coyotes,0,2,1,0,3,20110324,0,2,3,3,3,3,2010,0,3,1664,0
Oilers,0,0,0,0,0,Blues,0,1,3,0,4,20110324,0,1,4,4,4,4,2010,0,3,1508,0
Ducks,1,0,3,0,4,Predators,3,1,1,0,5,20110324,2,3,1,1,9,1,2010,0,3,1776,0
Senators,0,1,0,1,2,Rangers,0,0,1,0,1,20110324,0,1,0,1,3,-1,2010,1,3,334,0
Jets,1,1,0,0,2,Islanders,0,1,0,0,1,20110324,1,1,1,1,3,-1,2010,0,3,745,0
Canadiens,0,0,0,0,0,Bruins,3,0,4,0,7,20110324,3,3,7,7,7,7,2010,0,3,270,0
Penguins,0,1,0,1,2,Flyers,1,0,0,0,1,20110324,-1,0,0,1,3,-1,2010,1,3,257,0
Devils,0,0,0,0,0,Penguins,0,0,0,1,1,20110325,0,0,0,1,1,1,2010,1,4,306,0
Panthers,1,0,1,0,2,Sabres,1,1,2,0,4,20110325,0,1,2,2,6,2,2010,0,4,1184,0
Capitals,0,0,0,0,0,Senators,0,1,1,0,2,20110325,0,1,2,2,2,2,2010,0,4,446,0
Hurricanes,1,1,2,0,4,Lightning,1,0,2,0,3,20110325,0,1,1,1,7,-1,2010,0,4,585,0
Canucks,0,2,1,0,3,Jets,0,0,1,0,1,20110325,0,2,2,2,4,-2,2010,0,4,2240,0
Stars,1,1,0,0,2,Predators,1,2,1,0,4,20110326,0,1,2,2,6,2,2010,0,5,616,0
Flames,0,1,3,1,5,Oilers,1,2,1,0,4,20110326,-1,-2,0,1,9,-1,2010,1,5,171,0
Sharks,1,2,1,0,4,Coyotes,1,0,0,0,1,20110326,0,2,3,3,5,-3,2010,0,5,614,0
Ducks,0,0,2,0,2,Blackhawks,1,0,0,0,1,20110326,-1,-1,1,1,3,-1,2010,0,5,1741,0
Blues,2,2,2,0,6,Wild,2,0,1,0,3,20110326,0,2,3,3,9,-3,2010,0,5,466,0
Flyers,3,0,1,0,4,Islanders,1,0,0,0,1,20110326,2,2,3,3,5,-3,2010,0,5,80,0
Lightning,2,1,1,0,4,Hurricanes,2,0,0,0,2,20110326,0,1,2,2,6,-2,2010,0,5,585,0
Maple Leafs,1,0,1,0,2,Red Wings,1,1,2,0,4,20110326,0,1,2,2,6,2,2010,0,5,205,0
Devils,0,0,0,0,0,Sabres,2,0,0,0,2,20110326,2,2,2,2,2,2,2010,0,5,284,0
Avalanche,0,1,0,0,1,Kings,2,0,2,0,4,20110326,2,1,3,3,5,3,2010,0,5,830,0
Rangers,1,0,0,0,1,Bruins,0,0,0,0,0,20110326,1,1,1,1,1,-1,2010,0,5,190,0
Capitals,1,0,1,0,2,Canadiens,0,0,0,0,0,20110326,1,1,2,2,2,-2,2010,0,5,495,0
Panthers,0,1,0,0,1,Penguins,0,1,0,1,2,20110327,0,0,0,1,3,1,2010,1,6,1013,0
Senators,1,1,2,0,4,Jets,1,2,1,1,5,20110327,0,1,0,1,9,1,2010,1,6,914,0
Canucks,1,0,3,0,4,Blue Jackets,0,0,1,0,1,20110327,1,1,3,3,5,-3,2010,0,6,2050,0
Bruins,0,1,1,0,2,Flyers,1,0,0,0,1,20110327,-1,0,1,1,3,-1,2010,0,6,270,0
Avalanche,2,1,1,0,4,Ducks,0,3,2,0,5,20110328,-2,0,1,1,9,1,2010,0,0,830,0
Blackhawks,2,0,0,1,3,Red Wings,1,0,1,0,2,20110328,1,1,0,1,5,-1,2010,1,0,238,0
Canucks,0,0,3,0,3,Predators,0,1,0,0,1,20110329,0,-1,2,2,4,-2,2010,0,1,2030,0
Panthers,0,1,1,0,2,Blue Jackets,1,1,0,1,3,20110329,1,1,0,1,5,1,2010,1,1,993,0
Stars,0,1,0,0,1,Coyotes,0,1,0,1,2,20110329,0,0,0,1,3,1,2010,1,1,884,0
Wild,1,0,1,1,3,Blues,1,0,1,0,2,20110329,0,0,0,1,5,-1,2010,1,1,466,0
Kings,0,2,0,0,2,Oilers,0,0,0,0,0,20110329,0,2,2,2,2,-2,2010,0,1,1368,0
Senators,0,0,2,0,2,Lightning,0,2,3,0,5,20110329,0,2,3,3,7,3,2010,0,1,1251,0
Sabres,1,2,0,0,3,Maple Leafs,2,2,0,0,4,20110329,1,1,1,1,7,1,2010,0,1,57,0
Blackhawks,0,0,0,0,0,Bruins,0,2,1,0,3,20110329,0,2,3,3,3,3,2010,0,1,849,0
Hurricanes,0,1,1,1,3,Capitals,0,2,0,0,2,20110329,0,-1,0,1,5,-1,2010,1,1,233,0
Flyers,1,2,2,0,5,Penguins,1,1,0,0,2,20110329,0,1,3,3,7,-3,2010,0,1,257,0
Jets,0,0,1,0,1,Canadiens,2,0,1,0,3,20110329,2,2,2,2,4,2,2010,0,1,992,0
Rangers,0,0,0,0,0,Sabres,0,1,0,0,1,20110330,0,1,1,1,1,1,2010,0,2,292,0
Canadiens,0,1,1,0,2,Hurricanes,2,2,2,0,6,20110330,2,3,4,4,8,4,2010,0,2,727,0
Islanders,0,0,2,0,2,Devils,1,1,1,0,3,20110330,1,2,1,1,5,1,2010,0,2,8,0
Blues,3,5,2,0,10,Red Wings,2,1,0,0,3,20110330,1,5,7,7,13,-7,2010,0,2,454,0
Ducks,2,1,1,0,4,Flames,1,0,1,0,2,20110330,1,2,2,2,6,-2,2010,0,2,1197,0
Stars,0,0,0,0,0,Sharks,1,2,3,0,6,20110331,1,3,6,6,6,6,2010,0,3,1449,0
Kings,1,0,0,0,1,Canucks,0,2,1,0,3,20110331,-1,1,2,2,4,2,2010,0,3,1076,0
Predators,1,1,1,0,3,Avalanche,0,0,2,0,2,20110331,1,2,1,1,5,-1,2010,0,3,1019,0
Oilers,0,1,1,0,2,Wild,2,2,0,0,4,20110331,2,3,2,2,6,2,2010,0,3,1083,0
Senators,1,3,0,0,4,Panthers,0,1,0,0,1,20110331,1,3,3,3,5,-3,2010,0,3,1370,0
Jets,0,0,1,0,1,Flyers,0,0,0,0,0,20110331,0,0,1,1,1,-1,2010,0,3,665,0
Blue Jackets,0,2,1,0,3,Capitals,1,2,0,1,4,20110331,1,1,0,1,7,1,2010,1,3,326,0
Rangers,1,0,1,0,2,Islanders,0,4,2,0,6,20110331,-1,3,4,4,8,4,2010,0,3,0,0
Maple Leafs,1,1,1,1,4,Bruins,0,3,0,0,3,20110331,1,-1,0,1,7,-1,2010,1,3,430,0
Penguins,0,0,1,0,1,Lightning,2,0,0,0,2,20110331,2,2,1,1,3,1,2010,0,3,874,0
Avalanche,1,1,1,1,4,Coyotes,0,1,2,0,3,20110401,1,1,0,1,7,-1,2010,1,4,585,0
Flyers,1,0,1,0,2,Devils,0,2,2,0,4,20110401,-1,1,2,2,6,2,2010,0,4,75,0
Blackhawks,2,0,1,1,4,Blue Jackets,1,1,1,0,3,20110401,1,0,0,1,7,-1,2010,1,4,275,0
Flames,0,1,2,0,3,Blues,1,1,0,0,2,20110401,-1,-1,1,1,5,-1,2010,0,4,1440,0
Penguins,1,1,2,0,4,Panthers,2,0,0,0,2,20110402,-1,0,2,2,6,-2,2010,0,5,1013,0
Sabres,2,0,2,0,4,Capitals,2,0,2,1,5,20110402,0,0,0,1,9,1,2010,1,5,292,0
Ducks,2,0,0,0,2,Sharks,0,2,2,0,4,20110402,-2,0,2,2,6,2,2010,0,5,305,0
Oilers,1,2,1,0,4,Canucks,0,1,0,0,1,20110402,1,2,3,3,5,-3,2010,0,5,514,0
Maple Leafs,1,1,2,0,4,Senators,0,1,1,0,2,20110402,1,1,2,2,6,-2,2010,0,5,203,0
Lightning,0,2,1,0,3,Wild,1,0,0,0,1,20110402,-1,1,2,2,4,-2,2010,0,5,1318,0
Canadiens,1,0,2,0,3,Devils,0,0,1,0,1,20110402,1,1,2,2,4,-2,2010,0,5,342,0
Stars,0,1,0,0,1,Kings,0,1,2,0,3,20110402,0,0,2,2,4,2,2010,0,5,1237,0
Red Wings,0,2,1,1,4,Predators,1,2,0,0,3,20110402,-1,-1,0,1,7,-1,2010,1,5,470,0
Hurricanes,1,0,3,0,4,Islanders,1,1,0,0,2,20110402,0,-1,2,2,6,-2,2010,0,5,423,0
Jets,1,1,0,0,2,Bruins,1,1,1,0,3,20110402,0,0,1,1,5,1,2010,0,5,935,0
Rangers,1,1,0,1,3,Flyers,1,0,1,0,2,20110403,0,1,0,1,5,-1,2010,1,6,80,0
Wild,0,1,1,0,2,Red Wings,2,1,1,0,4,20110403,2,2,2,2,6,2,2010,0,6,542,0
Sabres,1,0,0,1,2,Hurricanes,0,1,0,0,1,20110403,1,0,0,1,3,-1,2010,1,6,491,0
Blues,2,2,2,0,6,Blue Jackets,1,0,0,0,1,20110403,1,3,5,5,7,-5,2010,0,6,395,0
Lightning,1,0,1,0,2,Blackhawks,0,0,0,0,0,20110403,1,1,2,2,2,-2,2010,0,6,1004,0
Flames,0,1,1,0,2,Avalanche,0,0,1,0,1,20110403,0,1,1,1,3,-1,2010,0,6,898,0
Stars,2,2,0,0,4,Ducks,2,1,0,0,3,20110403,0,1,1,1,7,-1,2010,0,6,1237,0
Kings,0,1,0,0,1,Sharks,2,4,0,0,6,20110404,2,5,5,5,7,5,2010,0,0,305,0
Bruins,2,1,0,0,3,Rangers,0,2,3,0,5,20110404,-2,-1,2,2,8,2,2010,0,0,190,0
Lightning,1,0,1,0,2,Sabres,1,2,1,0,4,20110405,0,2,2,2,6,2,2010,0,1,1051,0
Capitals,1,1,0,1,3,Maple Leafs,1,1,0,0,2,20110405,0,0,0,1,5,-1,2010,1,1,349,0
Blackhawks,0,1,0,0,1,Canadiens,0,1,0,1,2,20110405,0,0,0,1,3,1,2010,1,1,732,0
Flyers,1,1,0,0,2,Senators,1,2,2,0,5,20110405,0,1,3,3,7,3,2010,0,1,373,0
Devils,0,1,1,0,2,Penguins,1,1,2,0,4,20110405,1,1,2,2,6,2,2010,0,1,306,0
Avalanche,1,0,0,0,1,Blues,1,1,1,0,3,20110405,0,1,2,2,4,2,2010,0,1,794,0
Jets,0,0,3,0,3,Predators,3,1,2,0,6,20110405,3,4,3,3,9,3,2010,0,1,215,0
Blue Jackets,0,0,0,0,0,Stars,1,0,2,0,3,20110405,1,1,3,3,3,3,2010,0,1,912,0
Canucks,0,0,0,0,0,Oilers,1,0,1,0,2,20110405,1,1,2,2,2,2,2010,0,1,514,0
Oilers,0,0,1,0,1,Flames,0,3,3,0,6,20110406,0,3,5,5,7,5,2010,0,2,171,0
Coyotes,2,0,0,0,2,Kings,1,1,0,1,3,20110406,-1,0,0,1,5,1,2010,1,2,356,0
Sharks,0,1,1,0,2,Ducks,2,4,0,0,6,20110406,2,5,4,4,8,4,2010,0,2,305,0
Blues,1,1,1,0,3,Blackhawks,0,3,0,1,4,20110406,-1,1,0,1,7,1,2010,1,2,260,0
Red Wings,0,0,0,0,0,Hurricanes,0,2,1,0,3,20110406,0,2,3,3,3,3,2010,0,2,511,0
Maple Leafs,0,0,2,0,2,Devils,1,2,1,0,4,20110406,1,3,2,2,6,2,2010,0,2,333,0
Islanders,0,2,0,0,2,Bruins,1,2,0,0,3,20110406,1,1,1,1,5,1,2010,0,2,190,0
Panthers,0,0,2,0,2,Capitals,2,1,2,0,5,20110406,2,3,3,3,7,3,2010,0,2,924,0
Jets,0,2,1,0,3,Rangers,0,0,0,0,0,20110407,0,2,3,3,3,-3,2010,0,3,745,0
Canadiens,0,1,1,0,2,Senators,0,0,2,1,3,20110407,0,-1,0,1,5,1,2010,1,3,104,0
Avalanche,0,1,1,0,2,Stars,2,0,2,0,4,20110407,2,1,2,2,6,2,2010,0,3,661,0
Wild,0,0,0,0,0,Canucks,2,2,1,0,5,20110407,2,4,5,5,5,5,2010,0,3,1427,0
Kings,1,0,0,0,1,Ducks,0,1,1,0,2,20110408,-1,0,1,1,3,1,2010,0,4,0,0
Sharks,0,1,2,0,3,Coyotes,1,2,1,0,4,20110408,1,2,1,1,7,1,2010,0,4,614,0
Stars,1,1,1,0,3,Avalanche,0,1,1,0,2,20110408,1,1,1,1,5,-1,2010,0,4,661,0
Wild,1,1,1,0,3,Oilers,0,1,0,0,1,20110408,1,1,2,2,4,-2,2010,0,4,1083,0
Blue Jackets,0,1,0,0,1,Predators,1,2,1,0,4,20110408,1,2,3,3,5,3,2010,0,4,333,0
Panthers,1,0,1,0,2,Lightning,2,2,0,0,4,20110408,1,3,2,2,6,2,2010,0,4,205,0
Blackhawks,3,1,0,0,4,Red Wings,0,1,1,0,2,20110408,3,3,2,2,6,-2,2010,0,4,238,0
Flyers,1,2,0,0,3,Sabres,0,2,1,1,4,20110408,-1,-1,0,1,7,1,2010,1,4,279,0
Penguins,1,1,1,1,4,Islanders,0,1,2,0,3,20110408,1,1,0,1,7,-1,2010,1,4,314,0
Hurricanes,2,1,3,0,6,Jets,0,0,1,0,1,20110408,2,3,5,5,7,-5,2010,0,4,354,0
Ducks,2,1,0,0,3,Kings,0,1,0,0,1,20110409,2,2,2,2,4,-2,2010,0,5,0,0
Sabres,0,3,2,0,5,Blue Jackets,0,2,2,0,4,20110409,0,1,1,1,9,-1,2010,0,5,293,0
Canucks,0,0,2,1,3,Flames,0,2,0,0,2,20110409,0,-2,0,1,5,-1,2010,1,5,426,0
Predators,0,0,0,0,0,Blues,0,1,1,0,2,20110409,0,1,2,2,2,2,2010,0,5,253,0
Capitals,0,0,0,0,0,Panthers,0,0,1,0,1,20110409,0,0,1,1,1,1,2010,0,5,924,0
Coyotes,0,0,1,0,1,Sharks,0,2,1,0,3,20110409,0,2,2,2,4,2,2010,0,5,614,0
Islanders,3,1,0,0,4,Flyers,3,2,2,0,7,20110409,0,1,3,3,11,3,2010,0,5,80,0
Devils,2,0,0,0,2,Rangers,1,3,1,0,5,20110409,-1,2,3,3,7,3,2010,0,5,8,0
Canadiens,2,1,1,0,4,Maple Leafs,1,0,0,0,1,20110409,1,2,3,3,5,-3,2010,0,5,303,0
Lightning,3,1,2,0,6,Hurricanes,0,1,1,0,2,20110409,3,3,4,4,8,-4,2010,0,5,585,0
Senators,1,0,0,0,1,Bruins,1,1,1,0,3,20110409,0,1,2,2,4,2,2010,0,5,320,0
Red Wings,0,2,2,0,4,Blackhawks,0,1,2,0,3,20110410,0,1,1,1,7,-1,2010,0,6,238,0
Bruins,1,0,1,0,2,Devils,1,0,2,0,3,20110410,0,0,1,1,5,1,2010,0,6,196,0
Oilers,1,2,0,0,3,Avalanche,2,0,1,1,4,20110410,1,-1,0,1,7,1,2010,1,6,1036,0
Penguins,0,4,1,0,5,Jets,1,0,1,0,2,20110410,-1,3,3,3,7,-3,2010,0,6,521,0
Stars,2,1,0,0,3,Wild,1,2,2,0,5,20110410,-1,0,2,2,8,2,2010,0,6,863,0
Blackhawks,0,0,0,0,0,Canucks,2,0,0,0,2,20110413,2,2,2,2,2,2,2010,0,2,1775,1
Rangers,0,0,1,0,1,Capitals,0,0,1,1,2,20110413,0,0,0,1,3,1,2010,1,2,204,1
Predators,1,2,1,0,4,Ducks,0,0,1,0,1,20110413,1,3,3,3,5,-3,2010,0,2,1776,1
Coyotes,1,0,1,0,2,Red Wings,0,3,1,0,4,20110413,-1,2,2,2,6,2,2010,0,2,1687,1
Lightning,0,0,0,0,0,Penguins,0,0,3,0,3,20110413,0,0,3,3,3,3,2010,0,2,874,1
Kings,0,2,0,0,2,Sharks,1,1,0,1,3,20110414,1,0,0,1,5,1,2010,1,3,305,1
Sabres,0,0,1,0,1,Flyers,0,0,0,0,0,20110414,0,0,1,1,1,-1,2010,0,3,279,1
Canadiens,1,0,1,0,2,Bruins,0,0,0,0,0,20110414,1,1,2,2,2,-2,2010,0,3,270,1
Lightning,3,1,1,0,5,Penguins,0,1,0,0,1,20110415,3,3,4,4,6,-4,2010,0,4,874,1
Rangers,0,0,0,0,0,Capitals,0,2,0,0,2,20110415,0,2,2,2,2,2,2010,0,4,204,1
Predators,0,1,2,0,3,Ducks,2,2,1,0,5,20110415,2,3,2,2,8,2,2010,0,4,1776,1
Blackhawks,0,1,2,0,3,Canucks,1,2,1,0,4,20110415,1,2,1,1,7,1,2010,0,4,1775,1
Coyotes,0,1,2,0,3,Red Wings,3,1,0,0,4,20110416,3,3,1,1,7,1,2010,0,5,1687,1
Sabres,3,0,1,0,4,Flyers,3,2,0,0,5,20110416,0,2,1,1,9,1,2010,0,5,279,1
Canadiens,2,1,0,0,3,Bruins,0,1,0,0,1,20110416,2,2,2,2,4,-2,2010,0,5,270,1
Kings,2,1,1,0,4,Sharks,0,0,0,0,0,20110416,2,3,4,4,4,-4,2010,0,5,305,1
Canucks,0,2,1,0,3,Blackhawks,1,1,0,0,2,20110417,-1,0,1,1,5,-1,2010,0,6,1775,1
Capitals,0,1,1,0,2,Rangers,0,1,2,0,3,20110417,0,0,1,1,5,1,2010,0,6,204,1
Ducks,0,2,1,0,3,Predators,2,0,2,0,4,20110417,2,0,1,1,7,1,2010,0,6,1776,1
Penguins,2,0,1,0,3,Lightning,1,0,1,0,2,20110418,1,1,1,1,5,-1,2010,0,0,874,1
Red Wings,2,1,1,0,4,Coyotes,0,1,1,0,2,20110418,2,2,2,2,6,-2,2010,0,0,1687,1
Bruins,2,1,1,0,4,Canadiens,0,1,1,0,2,20110418,2,2,2,2,6,-2,2010,0,0,270,1
Flyers,1,2,1,0,4,Sabres,1,1,0,0,2,20110418,0,1,2,2,6,-2,2010,0,0,279,1
Canucks,1,0,1,0,2,Blackhawks,1,4,2,0,7,20110419,0,4,5,5,9,5,2010,0,1,1775,1
Sharks,0,5,0,1,6,Kings,3,2,0,0,5,20110419,-3,0,0,1,11,-1,2010,1,1,305,1
Capitals,0,0,3,1,4,Rangers,0,3,0,0,3,20110420,0,-3,0,1,7,-1,2010,1,2,204,1
Penguins,1,1,0,1,3,Lightning,0,1,1,0,2,20110420,1,1,0,1,5,-1,2010,1,2,874,1
Flyers,0,0,0,0,0,Sabres,1,0,0,0,1,20110420,1,1,1,1,1,1,2010,0,2,279,1
Ducks,2,1,3,0,6,Predators,1,2,0,0,3,20110420,1,0,3,3,9,-3,2010,0,2,1776,1
Red Wings,2,1,3,0,6,Coyotes,2,1,0,0,3,20110420,0,0,3,3,9,-3,2010,0,2,1687,1
Bruins,0,3,1,1,5,Canadiens,1,2,1,0,4,20110421,-1,0,0,1,9,-1,2010,1,3,270,1
Blackhawks,3,2,0,0,5,Canucks,0,0,0,0,0,20110421,3,5,5,5,5,-5,2010,0,3,1775,1
Sharks,0,3,3,0,6,Kings,0,2,1,0,3,20110421,0,1,3,3,9,-3,2010,0,3,305,1
Predators,1,0,2,1,4,Ducks,0,1,2,0,3,20110422,1,0,0,1,7,-1,2010,1,4,1776,1
Sabres,3,0,0,1,4,Flyers,0,2,1,0,3,20110422,3,1,0,1,7,-1,2010,1,4,279,1
Kings,3,0,0,0,3,Sharks,0,1,0,0,1,20110423,3,2,2,2,4,-2,2010,0,5,305,1
Canadiens,0,0,1,0,1,Bruins,0,0,1,1,2,20110423,0,0,0,1,3,1,2010,1,5,270,1
Rangers,0,0,1,0,1,Capitals,1,1,1,0,3,20110423,1,2,2,2,4,2,2010,0,5,204,1
Lightning,2,3,3,0,8,Penguins,0,0,2,0,2,20110423,2,5,6,6,10,-6,2010,0,5,874,1
Flyers,1,2,1,1,5,Sabres,3,1,0,0,4,20110424,-2,-1,0,1,9,-1,2010,1,6,279,1
Ducks,1,1,0,0,2,Predators,1,1,2,0,4,20110424,0,0,2,2,6,2,2010,0,6,1776,1
Canucks,2,0,1,0,3,Blackhawks,1,1,1,1,4,20110424,-1,0,0,1,7,1,2010,1,6,1775,1
Penguins,1,0,1,0,2,Lightning,1,1,2,0,4,20110425,0,1,2,2,6,2,2010,0,0,874,1
Sharks,0,2,1,1,4,Kings,0,1,2,0,3,20110425,0,1,0,1,7,-1,2010,1,0,305,1
Bruins,0,1,0,0,1,Canadiens,1,1,0,0,2,20110426,1,1,1,1,3,1,2010,0,1,270,1
Sabres,0,0,2,0,2,Flyers,1,2,2,0,5,20110426,1,3,3,3,7,3,2010,0,1,279,1
Blackhawks,0,0,1,0,1,Canucks,1,0,0,1,2,20110426,1,1,0,1,3,1,2010,1,1,1775,1
Canadiens,1,1,1,0,3,Bruins,2,0,1,1,4,20110427,1,0,0,1,7,1,2010,1,2,270,1
Lightning,0,1,0,0,1,Penguins,0,0,0,0,0,20110427,0,1,1,1,1,-1,2010,0,2,874,1
Predators,0,0,0,0,0,Canucks,0,1,0,0,1,20110428,0,1,1,1,1,1,2010,0,3,2030,1
Lightning,1,2,1,0,4,Capitals,1,1,0,0,2,20110429,0,1,2,2,6,-2,2010,0,4,818,1
Red Wings,1,0,0,0,1,Sharks,0,0,1,1,2,20110429,-1,-1,0,1,3,1,2010,1,4,2071,1
Bruins,2,3,2,0,7,Flyers,1,1,1,0,3,20110430,1,3,4,4,10,-4,2010,0,5,270,1
Predators,0,0,1,1,2,Canucks,0,1,0,0,1,20110430,0,-1,0,1,3,-1,2010,1,5,2030,1
Red Wings,0,0,1,0,1,Sharks,1,0,1,0,2,20110501,1,1,1,1,3,1,2010,0,6,2071,1
Lightning,1,0,1,1,3,Capitals,0,1,1,0,2,20110501,1,0,0,1,5,-1,2010,1,6,818,1
Bruins,2,0,0,1,3,Flyers,2,0,0,0,2,20110502,0,0,0,1,5,-1,2010,1,0,270,1
Capitals,0,3,0,0,3,Lightning,1,1,2,0,4,20110503,1,-1,1,1,7,1,2010,0,1,818,1
Canucks,0,1,1,1,3,Predators,1,0,1,0,2,20110503,-1,0,0,1,5,-1,2010,1,1,2030,1
Flyers,0,1,0,0,1,Bruins,2,2,1,0,5,20110504,2,3,4,4,6,4,2010,0,2,270,1
Capitals,1,1,1,0,3,Lightning,1,2,2,0,5,20110504,0,1,2,2,8,2,2010,0,2,818,1
Sharks,1,1,1,1,4,Red Wings,1,2,0,0,3,20110504,0,-1,0,1,7,-1,2010,1,2,2071,1
Canucks,1,1,2,0,4,Predators,1,0,1,0,2,20110505,0,1,2,2,6,-2,2010,0,3,2030,1
Flyers,0,1,0,0,1,Bruins,1,0,4,0,5,20110506,1,0,4,4,6,4,2010,0,4,270,1
Sharks,1,1,1,0,3,Red Wings,3,0,1,0,4,20110506,2,1,1,1,7,1,2010,0,4,2071,1
Predators,1,1,2,0,4,Canucks,2,0,1,0,3,20110507,-1,0,1,1,7,-1,2010,0,5,2030,1
Red Wings,0,1,3,0,4,Sharks,1,1,1,0,3,20110508,-1,-1,1,1,7,-1,2010,0,6,2071,1
Canucks,2,0,0,0,2,Predators,0,1,0,0,1,20110509,2,1,1,1,3,-1,2010,0,0,2030,1
Sharks,0,0,1,0,1,Red Wings,0,0,3,0,3,20110510,0,0,2,2,4,2,2010,0,1,2071,1
Red Wings,0,1,1,0,2,Sharks,2,0,1,0,3,20110512,2,1,1,1,5,1,2010,0,3,2071,1
Lightning,3,0,2,0,5,Bruins,1,0,1,0,2,20110514,2,2,3,3,7,-3,2010,0,5,1183,1
Sharks,1,1,0,0,2,Canucks,0,1,2,0,3,20110515,-1,-1,1,1,5,1,2010,0,6,821,1
Lightning,2,1,2,0,5,Bruins,1,5,0,0,6,20110517,-1,3,1,1,11,1,2010,0,1,1183,1
Sharks,2,0,1,0,3,Canucks,2,1,4,0,7,20110518,0,1,4,4,10,4,2010,0,2,821,1
Bruins,1,0,1,0,2,Lightning,0,0,0,0,0,20110519,1,1,2,2,2,-2,2010,0,3,1183,1
Canucks,0,0,3,0,3,Sharks,3,0,1,0,4,20110520,3,3,1,1,7,1,2010,0,4,821,1
Bruins,3,0,0,0,3,Lightning,0,3,2,0,5,20110521,-3,0,2,2,8,2,2010,0,5,1183,1
Canucks,0,3,1,0,4,Sharks,0,0,2,0,2,20110522,0,3,2,2,6,-2,2010,0,6,821,1
Lightning,1,0,0,0,1,Bruins,0,2,1,0,3,20110523,-1,1,2,2,4,2,2010,0,0,1183,1
Sharks,0,1,1,0,2,Canucks,1,0,1,1,3,20110524,1,0,0,1,5,1,2010,1,1,821,1
Bruins,2,0,2,0,4,Lightning,1,2,2,0,5,20110525,-1,1,1,1,9,1,2010,0,2,1183,1
Lightning,0,0,0,0,0,Bruins,0,0,1,0,1,20110527,0,0,1,1,1,1,2010,0,4,1183,1
Bruins,0,0,0,0,0,Canucks,0,0,1,0,1,20110601,0,0,1,1,1,1,2010,0,2,2504,1
Bruins,0,2,0,0,2,Canucks,1,0,1,1,3,20110604,1,-1,0,1,5,1,2010,1,5,2504,1
Canucks,0,0,1,0,1,Bruins,0,4,4,0,8,20110606,0,4,7,7,9,7,2010,0,0,2504,1
Canucks,0,0,0,0,0,Bruins,1,2,1,0,4,20110608,1,3,4,4,4,4,2010,0,2,2504,1
Bruins,0,0,0,0,0,Canucks,0,0,1,0,1,20110610,0,0,1,1,1,1,2010,0,4,2504,1
Canucks,0,0,2,0,2,Bruins,4,0,1,0,5,20110613,4,4,3,3,7,3,2010,0,0,2504,1
Bruins,1,2,1,0,4,Canucks,0,0,0,0,0,20110615,1,3,4,4,4,-4,2010,0,2,2504,1
Penguins,2,1,0,1,4,Canucks,1,1,1,0,3,20111006,1,1,0,1,7,-1,2011,1,3,2168,0
Canadiens,0,0,0,0,0,Maple Leafs,0,1,1,0,2,20111006,0,1,2,2,2,2,2011,0,3,303,0
Flyers,2,0,0,0,2,Bruins,1,0,0,0,1,20111006,1,1,1,1,3,-1,2011,0,3,270,0
Ducks,0,1,0,0,1,Sabres,2,2,0,0,4,20111007,2,3,3,3,5,3,2011,0,4,2193,0
Rangers,1,0,1,0,2,Kings,1,0,1,1,3,20111007,0,0,0,1,5,1,2011,1,4,2445,0
Lightning,0,2,3,0,5,Hurricanes,1,0,0,0,1,20111007,-1,1,4,4,6,-4,2011,0,4,585,0
Senators,0,0,3,0,3,Red Wings,1,3,1,0,5,20111007,1,4,2,2,8,2,2011,0,4,406,0
Predators,0,2,1,0,3,Blue Jackets,0,1,1,0,2,20111007,0,1,1,1,5,-1,2011,0,4,333,0
Blackhawks,0,0,1,0,1,Stars,0,2,0,0,2,20111007,0,2,1,1,3,1,2011,0,4,802,0
Predators,1,0,3,0,4,Blues,1,0,1,0,2,20111008,0,0,2,2,6,-2,2011,0,5,253,0
Blue Jackets,0,1,1,0,2,Wild,2,2,0,0,4,20111008,2,3,2,2,6,2,2011,0,5,626,0
Red Wings,0,1,2,0,3,Avalanche,0,0,0,0,0,20111008,0,1,3,3,3,-3,2011,0,5,1154,0
Panthers,2,0,0,0,2,Islanders,0,0,0,0,0,20111008,2,2,2,2,2,-2,2011,0,5,1091,0
Stars,0,1,1,0,2,Blackhawks,1,2,2,0,5,20111008,1,2,3,3,7,3,2011,0,5,802,0
Hurricanes,0,1,2,0,3,Capitals,0,2,1,1,4,20111008,0,1,0,1,7,1,2011,1,5,233,0
Coyotes,0,1,2,0,3,Sharks,2,4,0,0,6,20111008,2,5,3,3,9,3,2011,0,5,614,0
Senators,0,0,5,0,5,Maple Leafs,2,2,2,0,6,20111008,2,4,1,1,11,1,2011,0,5,203,0
Lightning,0,1,0,0,1,Bruins,0,2,2,0,4,20111008,0,1,3,3,5,3,2011,0,5,1183,0
Sabres,0,3,1,0,4,Kings,0,1,1,0,2,20111008,0,2,2,2,6,-2,2011,0,5,2193,0
Rangers,0,0,1,0,1,Ducks,1,0,0,1,2,20111008,1,1,0,1,3,1,2011,1,5,2445,0
Penguins,0,4,1,0,5,Flames,1,0,2,0,3,20111008,-1,3,2,2,8,-2,2011,0,5,1777,0
Flyers,1,0,2,0,3,Devils,0,0,0,0,0,20111008,1,1,3,3,3,-3,2011,0,5,75,0
Canadiens,1,1,3,0,5,Jets,0,0,1,0,1,20111009,1,2,4,4,6,-4,2011,0,6,1115,0
Penguins,1,0,0,0,1,Oilers,0,0,1,1,2,20111009,-1,-1,0,1,3,1,2011,1,6,1797,0
Avalanche,0,0,1,0,1,Bruins,0,0,0,0,0,20111010,0,0,1,1,1,-1,2011,0,0,1765,0
Hurricanes,0,2,0,0,2,Devils,1,1,2,0,4,20111010,1,0,2,2,6,2,2011,0,0,419,0
Wild,0,0,1,0,1,Islanders,2,0,0,0,2,20111010,2,2,1,1,3,1,2011,0,0,1016,0
Flames,1,1,0,0,2,Blues,1,2,2,0,5,20111010,0,1,3,3,7,3,2011,0,0,1440,0
Coyotes,0,0,1,0,1,Stars,0,0,1,1,2,20111010,0,0,0,1,3,1,2011,1,0,884,0
Lightning,2,1,2,0,5,Capitals,2,1,2,1,6,20111010,0,0,0,1,11,1,2011,1,0,818,0
Canucks,1,0,2,0,3,Blue Jackets,1,1,0,0,2,20111010,0,-1,1,1,5,-1,2011,0,0,2050,0
Panthers,0,1,1,0,2,Penguins,1,2,1,0,4,20111011,1,2,2,2,6,2,2011,0,1,1013,0
Wild,2,0,1,0,3,Senators,0,1,2,1,4,20111011,-2,-1,0,1,7,1,2011,1,1,838,0
Avalanche,1,0,1,1,3,Blue Jackets,0,1,1,0,2,20111012,1,0,0,1,5,-1,2011,1,2,1163,0
Canucks,1,2,1,0,4,Flyers,3,1,1,0,5,20111012,2,1,1,1,9,1,2011,0,2,2404,0
Bruins,0,0,2,0,2,Hurricanes,0,1,2,0,3,20111012,0,1,1,1,5,1,2011,0,2,609,0
Oilers,1,0,0,0,1,Wild,0,1,0,1,2,20111013,-1,0,0,1,3,1,2011,1,3,1083,0
Jets,2,1,0,0,3,Blackhawks,2,2,0,0,4,20111013,0,1,1,1,7,1,2011,0,3,722,0
Capitals,0,1,1,1,3,Penguins,1,0,1,0,2,20111013,-1,0,0,1,5,-1,2011,1,3,190,0
Coyotes,3,1,1,0,5,Predators,0,1,1,0,2,20111013,3,3,3,3,7,-3,2011,0,3,1442,0
Blues,0,1,1,0,2,Stars,1,2,0,0,3,20111013,1,2,1,1,5,1,2011,0,3,547,0
Canucks,0,0,0,0,0,Red Wings,0,2,0,0,2,20111013,0,2,2,2,2,2,2011,0,3,1967,0
Kings,1,0,0,0,1,Devils,1,0,0,1,2,20111013,0,0,0,1,3,1,2011,1,3,2436,0
Flames,3,1,0,0,4,Canadiens,1,0,0,0,1,20111013,2,3,3,3,5,-3,2011,0,3,1852,0
Lightning,1,0,0,0,1,Islanders,4,1,0,0,5,20111013,3,4,4,4,6,4,2011,0,3,1004,0
Avalanche,2,1,4,0,7,Senators,1,0,0,0,1,20111013,1,2,6,6,8,-6,2011,0,3,1515,0
Hurricanes,2,1,1,0,4,Sabres,2,0,1,0,3,20111014,0,1,1,1,7,-1,2011,0,4,491,0
Sharks,0,0,0,0,0,Ducks,1,0,0,0,1,20111014,1,1,1,1,1,1,2011,0,4,305,0
Red Wings,0,1,1,1,3,Wild,1,1,0,0,2,20111015,-1,-1,0,1,5,-1,2011,1,5,542,0
Blue Jackets,1,1,0,0,2,Stars,1,1,2,0,4,20111015,0,0,2,2,6,2,2011,0,5,912,0
Bruins,0,1,1,1,3,Blackhawks,1,1,0,0,2,20111015,-1,-1,0,1,5,-1,2011,1,5,849,0
Kings,1,0,1,1,3,Flyers,1,0,1,0,2,20111015,0,0,0,1,5,-1,2011,1,5,2388,0
Blues,1,0,3,0,4,Sharks,1,1,0,0,2,20111015,0,-1,2,2,6,-2,2011,0,5,1719,0
Devils,0,0,2,1,3,Predators,2,0,0,0,2,20111015,-2,-2,0,1,5,-1,2011,1,5,750,0
Canucks,1,2,1,0,4,Oilers,2,1,0,0,3,20111015,-1,0,1,1,7,-1,2011,0,5,514,0
Lightning,0,0,2,0,2,Panthers,1,0,1,1,3,20111015,1,1,0,1,5,1,2011,1,5,205,0
Rangers,0,2,0,0,2,Islanders,1,1,2,0,4,20111015,1,0,2,2,6,2,2011,0,5,0,0
Senators,1,0,0,0,1,Capitals,2,0,0,0,2,20111015,1,1,1,1,3,1,2011,0,5,446,0
Sabres,2,0,1,0,3,Penguins,0,1,1,0,2,20111015,2,1,1,1,5,-1,2011,0,5,178,0
Jets,0,1,0,0,1,Coyotes,2,1,1,0,4,20111015,2,2,3,3,5,3,2011,0,5,1365,0
Avalanche,1,3,1,1,6,Canadiens,1,2,2,0,5,20111015,0,1,0,1,11,-1,2011,1,5,1618,0
Flames,2,0,0,0,2,Maple Leafs,0,2,1,0,3,20111015,-2,0,1,1,5,1,2011,0,5,1682,0
Blues,0,1,1,0,2,Ducks,1,0,3,0,4,20111016,1,0,2,2,6,2,2011,0,6,1586,0
Ducks,2,0,1,0,3,Sharks,0,1,1,0,2,20111017,2,1,1,1,5,-1,2011,0,0,305,0
Penguins,0,1,0,0,1,Jets,2,0,0,0,2,20111017,2,1,1,1,3,1,2011,0,0,1060,0
Predators,0,1,0,0,1,Oilers,0,0,3,0,3,20111017,0,-1,2,2,4,2,2011,0,0,1758,0
Avalanche,0,2,0,1,3,Maple Leafs,0,1,1,0,2,20111017,0,1,0,1,5,-1,2011,1,0,1341,0
Panthers,2,2,3,0,7,Lightning,2,1,1,0,4,20111017,0,1,3,3,11,-3,2011,0,0,205,0
Blackhawks,1,2,2,0,5,Coyotes,0,2,0,0,2,20111018,1,1,3,3,7,-3,2011,0,1,1450,0
Hurricanes,1,1,2,0,4,Bruins,0,0,1,0,1,20111018,1,2,3,3,5,-3,2011,0,1,609,0
Panthers,0,0,0,0,0,Capitals,1,0,2,0,3,20111018,1,1,3,3,3,3,2011,0,1,924,0
Stars,0,1,2,0,3,Blue Jackets,0,0,2,0,2,20111018,0,1,1,1,5,-1,2011,0,1,912,0
Sabres,0,2,1,0,3,Canadiens,0,1,0,0,1,20111018,0,1,2,2,4,-2,2011,0,1,311,0
Flyers,4,0,3,0,7,Senators,0,1,1,0,2,20111018,4,3,5,5,9,-5,2011,0,1,373,0
Penguins,0,2,2,0,4,Wild,0,1,1,0,2,20111018,0,1,2,2,6,-2,2011,0,1,741,0
Oilers,1,0,0,0,1,Flames,0,0,2,0,2,20111018,-1,-1,1,1,3,1,2011,0,1,171,0
Rangers,0,0,4,0,4,Canucks,0,0,0,0,0,20111018,0,0,4,4,4,-4,2011,0,1,2429,0
Blues,0,0,0,0,0,Kings,1,2,2,0,5,20111018,1,3,5,5,5,5,2011,0,1,1586,0
Jets,1,2,0,0,3,Maple Leafs,1,0,2,1,4,20111019,0,-2,0,1,7,1,2011,1,2,946,0
Wild,0,0,1,1,2,Oilers,1,0,0,0,1,20111020,-1,-1,0,1,3,-1,2011,1,3,1083,0
Predators,1,0,0,0,1,Canucks,4,0,1,0,5,20111020,3,3,4,4,6,4,2011,0,3,2030,0
Islanders,0,0,1,0,1,Lightning,1,1,2,0,4,20111020,1,2,3,3,5,3,2011,0,3,1004,0
Rangers,2,0,0,1,3,Flames,2,0,0,0,2,20111020,0,0,0,1,5,-1,2011,1,3,2023,0
Kings,0,2,0,0,2,Coyotes,0,0,0,0,0,20111020,0,2,2,2,2,-2,2011,0,3,356,0
Blackhawks,1,0,2,0,3,Avalanche,0,1,0,0,1,20111020,1,0,2,2,4,-2,2011,0,3,916,0
Jets,1,0,0,0,1,Senators,0,2,2,0,4,20111020,-1,1,3,3,5,3,2011,0,3,1033,0
Sabres,0,2,1,0,3,Panthers,0,0,0,0,0,20111020,0,2,3,3,3,-3,2011,0,3,1184,0
Canadiens,0,0,1,0,1,Penguins,1,1,1,0,3,20111020,1,2,2,2,4,2,2011,0,3,474,0
Capitals,2,0,3,0,5,Flyers,1,0,1,0,2,20111020,1,1,3,3,7,-3,2011,0,3,123,0
Maple Leafs,1,0,1,0,2,Bruins,3,0,3,0,6,20111020,2,2,4,4,8,4,2011,0,3,430,0
Sharks,0,2,1,1,4,Devils,1,1,1,0,3,20111021,-1,0,0,1,7,-1,2011,1,4,2540,0
Blue Jackets,1,0,1,0,2,Red Wings,2,1,2,0,5,20111021,1,2,3,3,7,3,2011,0,4,163,0
Hurricanes,1,1,0,0,2,Blues,0,2,0,1,3,20111021,-1,0,0,1,5,1,2011,1,4,665,0
Stars,2,0,1,0,3,Ducks,0,1,0,0,1,20111021,2,1,2,2,4,-2,2011,0,4,1237,0
Devils,0,0,1,0,1,Penguins,1,0,3,0,4,20111022,1,1,3,3,5,3,2011,0,5,306,0
Stars,0,0,0,0,0,Kings,0,0,1,0,1,20111022,0,0,1,1,1,1,2011,0,5,1237,0
Rangers,0,0,0,0,0,Oilers,0,1,1,0,2,20111022,0,1,2,2,2,2,2011,0,5,2024,0
Avalanche,1,2,1,1,5,Blackhawks,0,2,2,0,4,20111022,1,1,0,1,9,-1,2011,1,5,916,0
Islanders,1,1,0,0,2,Panthers,1,1,2,0,4,20111022,0,0,2,2,6,2,2011,0,5,1091,0
Sabres,0,0,0,0,0,Lightning,0,1,2,0,3,20111022,0,1,3,3,3,3,2011,0,5,1051,0
Hurricanes,2,0,1,0,3,Jets,2,3,0,0,5,20111022,0,3,2,2,8,2,2011,0,5,1350,0
Red Wings,0,1,0,0,1,Capitals,2,2,3,0,7,20111022,2,3,6,6,8,6,2011,0,5,394,0
Blue Jackets,1,1,1,0,3,Senators,1,1,2,0,4,20111022,0,0,1,1,7,1,2011,0,5,512,0
Blues,2,1,1,0,4,Flyers,0,1,1,0,2,20111022,2,2,2,2,6,-2,2011,0,5,808,0
Maple Leafs,1,2,1,1,5,Canadiens,1,1,2,0,4,20111022,0,1,0,1,9,-1,2011,1,5,303,0
Sharks,1,1,2,0,4,Bruins,0,0,2,0,2,20111022,1,2,2,2,6,-2,2011,0,5,2678,0
Wild,1,1,0,0,2,Canucks,0,1,1,1,3,20111022,-1,-1,0,1,5,1,2011,1,5,1427,0
Predators,0,1,1,0,2,Flames,0,0,0,0,0,20111022,0,1,2,2,2,-2,2011,0,5,1692,0
Coyotes,2,3,0,0,5,Ducks,2,1,1,0,4,20111023,0,2,1,1,9,-1,2011,0,6,356,0
Panthers,1,0,1,0,2,Canadiens,1,0,0,0,1,20111024,0,0,1,1,3,-1,2011,0,0,1418,0
Maple Leafs,1,0,1,0,2,Flyers,1,1,2,0,4,20111024,0,1,2,2,6,2,2011,0,0,334,0
Rangers,0,1,1,0,2,Jets,0,1,0,0,1,20111024,0,0,1,1,3,-1,2011,0,0,1287,0
Stars,1,0,1,1,3,Coyotes,1,0,1,0,2,20111025,0,0,0,1,5,-1,2011,1,1,884,0
Red Wings,1,0,0,0,1,Blue Jackets,2,1,1,0,4,20111025,1,2,3,3,5,3,2011,0,1,163,0
Canucks,0,1,1,0,2,Oilers,0,3,0,0,3,20111025,0,2,1,1,5,1,2011,0,1,514,0
Devils,0,3,0,0,3,Kings,0,0,0,0,0,20111025,0,3,3,3,3,-3,2011,0,1,2436,0
Ducks,0,2,0,0,2,Blackhawks,0,1,1,1,3,20111025,0,-1,0,1,5,1,2011,1,1,1741,0
Penguins,1,1,1,0,3,Islanders,0,0,0,0,0,20111025,1,2,3,3,3,-3,2011,0,1,314,0
Lightning,2,1,1,0,4,Sabres,2,0,1,0,3,20111025,0,1,1,1,7,-1,2011,0,1,1051,0
Senators,0,2,0,1,3,Hurricanes,0,0,2,0,2,20111025,0,2,0,1,5,-1,2011,1,1,673,0
Sharks,1,0,2,0,3,Predators,0,0,1,0,1,20111025,1,1,2,2,4,-2,2011,0,1,1934,0
Flyers,1,0,0,0,1,Canadiens,1,2,2,0,5,20111026,0,2,4,4,6,4,2011,0,2,400,0
Avalanche,1,0,1,0,2,Flames,1,2,1,0,4,20111026,0,2,2,2,6,2,2011,0,2,898,0
Blues,0,1,2,0,3,Canucks,0,0,0,0,0,20111026,0,1,3,3,3,-3,2011,0,2,1778,0
Devils,1,1,1,0,3,Coyotes,1,2,2,0,5,20111027,0,1,2,2,8,2,2011,0,3,2131,0
Capitals,1,0,0,0,1,Oilers,1,1,0,0,2,20111027,0,1,1,1,3,1,2011,0,3,1985,0
Kings,0,3,2,0,5,Stars,1,0,2,0,3,20111027,-1,2,2,2,8,-2,2011,0,3,1237,0
Ducks,1,1,1,0,3,Wild,0,1,1,0,2,20111027,1,1,1,1,5,-1,2011,0,3,1521,0
Lightning,2,0,1,0,3,Predators,2,3,0,0,5,20111027,0,3,2,2,8,2,2011,0,3,621,0
Panthers,1,1,1,0,3,Senators,0,2,2,0,4,20111027,-1,0,1,1,7,1,2011,0,3,1370,0
Islanders,1,0,1,0,2,Penguins,0,0,2,1,3,20111027,-1,-1,0,1,5,1,2011,1,3,314,0
Maple Leafs,0,1,3,0,4,Rangers,1,0,1,0,2,20111027,-1,0,2,2,6,-2,2011,0,3,341,0
Blue Jackets,0,1,1,0,2,Sabres,1,1,2,0,4,20111027,1,1,2,2,6,2,2011,0,3,293,0
Canadiens,0,1,1,0,2,Bruins,1,0,0,0,1,20111027,-1,0,1,1,3,-1,2011,0,3,270,0
Jets,3,3,3,0,9,Flyers,1,3,4,0,8,20111027,2,2,1,1,17,-1,2011,0,3,1273,0
Blues,0,0,1,0,1,Flames,0,1,2,0,3,20111028,0,1,2,2,4,2,2011,0,4,1440,0
Blackhawks,0,0,0,0,0,Hurricanes,1,0,2,0,3,20111028,1,1,3,3,3,3,2011,0,4,641,0
Sharks,0,3,1,0,4,Red Wings,1,1,0,0,2,20111028,-1,1,2,2,6,-2,2011,0,4,2071,0
Oilers,0,2,1,0,3,Avalanche,0,0,1,0,1,20111028,0,2,2,2,4,-2,2011,0,4,1036,0
Devils,0,1,0,0,1,Stars,1,0,2,0,3,20111029,1,0,2,2,4,2,2011,0,5,1362,0
Blue Jackets,1,1,0,0,2,Blackhawks,2,0,3,0,5,20111029,1,0,3,3,7,3,2011,0,5,275,0
Bruins,0,1,1,0,2,Canadiens,2,1,1,0,4,20111029,2,2,2,2,6,2,2011,0,5,270,0
Red Wings,0,0,0,0,0,Wild,1,0,0,0,1,20111029,1,1,1,1,1,1,2011,0,5,542,0
Capitals,1,3,0,0,4,Canucks,3,1,3,0,7,20111029,2,0,3,3,11,3,2011,0,5,2359,0
Kings,0,1,1,0,2,Coyotes,0,2,0,1,3,20111029,0,1,0,1,5,1,2011,1,5,356,0
Ducks,0,0,0,0,0,Predators,2,0,1,0,3,20111029,2,2,3,3,3,3,2011,0,5,1776,0
Penguins,0,2,1,0,3,Maple Leafs,1,1,2,0,4,20111029,1,0,1,1,7,1,2011,0,5,222,0
Hurricanes,0,1,0,0,1,Flyers,1,0,4,0,5,20111029,1,0,4,4,6,4,2011,0,5,345,0
Senators,1,0,3,1,5,Rangers,0,2,2,0,4,20111029,1,-1,0,1,9,-1,2011,1,5,334,0
Panthers,0,1,2,0,3,Sabres,0,1,1,0,2,20111029,0,0,1,1,5,-1,2011,0,5,1184,0
Jets,0,0,0,0,0,Lightning,0,1,0,0,1,20111029,0,1,1,1,1,1,2011,0,5,1705,0
Sharks,1,1,0,1,3,Islanders,0,2,0,0,2,20111029,1,0,0,1,5,-1,2011,1,5,2549,0
Ducks,1,0,0,0,1,Blue Jackets,1,2,0,0,3,20111030,0,2,2,2,4,2,2011,0,6,1973,0
Maple Leafs,1,0,1,0,2,Senators,1,1,1,0,3,20111030,0,1,1,1,5,1,2011,0,6,203,0
Kings,1,1,0,0,2,Avalanche,1,1,1,0,3,20111030,0,0,1,1,5,1,2011,0,6,830,0
Blues,0,1,1,0,2,Oilers,1,3,0,0,4,20111030,1,3,2,2,6,2,2011,0,6,1508,0
Jets,2,0,1,1,4,Panthers,1,0,2,0,3,20111031,1,1,0,1,7,-1,2011,1,0,1899,0
Predators,1,2,1,0,4,Blackhawks,1,1,2,1,5,20111031,0,-1,0,1,9,1,2011,1,0,395,0
Sharks,1,1,0,0,2,Rangers,2,3,0,0,5,20111031,1,3,3,3,7,3,2011,0,0,2549,0
Senators,2,0,1,0,3,Bruins,1,2,2,0,5,20111101,-1,1,2,2,8,2,2011,0,1,320,0
Ducks,2,1,1,0,4,Capitals,0,2,2,1,5,20111101,-2,-1,0,1,9,1,2011,1,1,2294,0
Wild,0,0,1,1,2,Red Wings,1,0,0,0,1,20111101,-1,-1,0,1,3,-1,2011,1,1,542,0
Canucks,3,2,0,0,5,Flames,0,0,1,0,1,20111101,3,5,4,4,6,-4,2011,0,1,426,0
Lightning,1,0,1,0,2,Hurricanes,1,2,1,0,4,20111101,0,2,2,2,6,2,2011,0,1,585,0
Flyers,3,0,0,0,3,Sabres,0,1,1,0,2,20111102,3,2,1,1,5,-1,2011,0,2,279,0
Maple Leafs,2,3,0,0,5,Devils,1,2,0,0,3,20111102,1,2,2,2,8,-2,2011,0,2,333,0
Coyotes,1,1,2,0,4,Avalanche,0,1,0,0,1,20111102,1,1,3,3,5,-3,2011,0,2,585,0
Oilers,0,2,1,0,3,Kings,0,0,0,0,0,20111103,0,2,3,3,3,-3,2011,0,3,1368,0
Flames,1,1,2,0,4,Red Wings,0,1,0,0,1,20111103,1,1,3,3,5,-3,2011,0,3,1573,0
Penguins,2,1,0,0,3,Sharks,0,1,2,1,4,20111103,-2,-2,0,1,7,1,2011,1,3,2242,0
Predators,0,2,1,0,3,Coyotes,0,0,0,0,0,20111103,0,2,3,3,3,-3,2011,0,3,1442,0
Canucks,1,0,0,0,1,Wild,0,3,2,0,5,20111103,-1,2,4,4,6,4,2011,0,3,1427,0
Blackhawks,1,1,0,1,3,Panthers,0,1,1,0,2,20111103,1,1,0,1,5,-1,2011,1,3,1189,0
Devils,0,2,1,1,4,Flyers,0,2,1,0,3,20111103,0,0,0,1,7,-1,2011,1,3,75,0
Ducks,0,1,0,0,1,Rangers,1,0,0,1,2,20111103,1,0,0,1,3,1,2011,1,3,2445,0
Jets,1,0,2,0,3,Islanders,0,0,0,0,0,20111103,1,1,3,3,3,-3,2011,0,3,1287,0
Maple Leafs,2,2,0,0,4,Blue Jackets,0,1,0,0,1,20111103,2,3,3,3,5,-3,2011,0,3,313,0
Capitals,0,2,3,0,5,Hurricanes,1,0,0,0,1,20111104,-1,1,4,4,6,-4,2011,0,4,233,0
Flames,0,0,1,0,1,Sabres,1,0,1,0,2,20111104,1,1,1,1,3,1,2011,0,4,1731,0
Canadiens,0,2,0,0,2,Senators,0,0,1,0,1,20111104,0,2,1,1,3,-1,2011,0,4,104,0
Blackhawks,0,4,0,0,4,Lightning,0,4,0,1,5,20111104,0,0,0,1,9,1,2011,1,4,1004,0
Canucks,1,0,1,0,2,Blues,1,1,1,0,3,20111104,0,1,1,1,5,1,2011,0,4,1778,0
Avalanche,2,2,2,0,6,Stars,0,4,2,1,7,20111104,-2,0,0,1,13,1,2011,1,4,661,0
Predators,0,1,2,1,4,Sharks,0,2,1,0,3,20111105,0,-1,0,1,7,-1,2011,1,5,1934,0
Penguins,1,0,1,1,3,Kings,0,1,1,0,2,20111105,1,0,0,1,5,-1,2011,1,5,2132,0
Oilers,0,0,2,0,2,Coyotes,0,2,2,0,4,20111105,0,2,2,2,6,2,2011,0,5,1392,0
Blues,0,0,1,0,1,Wild,0,2,0,0,2,20111105,0,2,1,1,3,1,2011,0,5,466,0
Ducks,0,0,0,0,0,Red Wings,1,2,2,0,5,20111105,1,3,5,5,5,5,2011,0,5,1979,0
Blue Jackets,0,0,2,0,2,Flyers,5,3,1,0,9,20111105,5,8,7,7,11,7,2011,0,5,414,0
Sabres,0,2,0,1,3,Senators,1,1,0,0,2,20111105,-1,0,0,1,5,-1,2011,1,5,219,0
Capitals,2,0,1,0,3,Islanders,0,2,3,0,5,20111105,-2,0,2,2,8,2,2011,0,5,204,0
Jets,0,0,2,0,2,Devils,0,2,0,1,3,20111105,0,2,0,1,5,1,2011,1,5,1280,0
Bruins,1,4,2,0,7,Maple Leafs,0,0,0,0,0,20111105,1,5,7,7,7,-7,2011,0,5,430,0
Canadiens,0,2,1,0,3,Rangers,3,1,1,0,5,20111105,3,2,2,2,8,2,2011,0,5,343,0
Jets,0,0,0,0,0,Rangers,0,1,2,0,3,20111106,0,1,3,3,3,3,2011,0,6,1287,0
Flames,1,1,0,0,2,Avalanche,1,0,0,0,1,20111106,0,1,1,1,3,-1,2011,0,6,898,0
Stars,3,2,0,0,5,Hurricanes,1,0,1,0,2,20111106,2,4,3,3,7,-3,2011,0,6,1055,0
Lightning,0,2,1,1,4,Panthers,3,0,0,0,3,20111106,-3,-1,0,1,7,-1,2011,1,6,205,0
Canucks,1,4,1,0,6,Blackhawks,1,1,0,0,2,20111106,0,3,4,4,8,-4,2011,0,6,1775,0
Kings,0,1,1,0,2,Sharks,0,3,1,0,4,20111107,0,2,2,2,6,2,2011,0,0,305,0
Islanders,2,0,0,0,2,Bruins,3,0,3,0,6,20111107,1,1,4,4,8,4,2011,0,0,190,0
Avalanche,0,1,1,0,2,Red Wings,1,2,2,0,5,20111108,1,2,3,3,7,3,2011,0,1,1154,0
Oilers,0,1,2,0,3,Canadiens,0,0,1,0,1,20111108,0,1,2,2,4,-2,2011,0,1,1826,0
Blackhawks,0,0,0,0,0,Blues,1,1,1,0,3,20111108,1,2,3,3,3,3,2011,0,1,260,0
Hurricanes,1,0,1,0,2,Devils,0,1,2,0,3,20111108,-1,0,1,1,5,1,2011,0,1,419,0
Wild,1,1,1,0,3,Flames,0,0,0,0,0,20111108,1,2,3,3,3,-3,2011,0,1,1043,0
Panthers,1,2,2,0,5,Maple Leafs,0,0,1,0,1,20111108,1,3,4,4,6,-4,2011,0,1,1234,0
Predators,2,0,1,0,3,Kings,2,2,0,0,4,20111108,0,2,1,1,7,1,2011,0,1,1776,0
Stars,2,0,3,0,5,Capitals,1,1,0,0,2,20111108,1,0,3,3,7,-3,2011,0,1,1181,0
Jets,3,1,1,0,5,Sabres,3,1,1,1,6,20111108,0,0,0,1,11,1,2011,1,1,996,0
Flyers,0,1,0,0,1,Lightning,0,0,1,1,2,20111109,0,-1,0,1,3,1,2011,1,2,928,0
Predators,2,1,1,0,4,Ducks,1,1,0,0,2,20111109,1,1,2,2,6,-2,2011,0,2,1776,0
Rangers,0,2,1,0,3,Senators,0,1,1,0,2,20111109,0,1,1,1,5,-1,2011,0,2,334,0
Oilers,2,0,1,0,3,Bruins,2,2,2,0,6,20111110,0,2,3,3,9,3,2011,0,3,2074,0
Blackhawks,2,3,1,0,6,Blue Jackets,1,0,2,0,3,20111110,1,4,3,3,9,-3,2011,0,3,275,0
Maple Leafs,2,0,0,1,3,Blues,0,1,1,0,2,20111110,2,1,0,1,5,-1,2011,1,3,659,0
Panthers,2,2,1,0,5,Jets,0,0,2,0,2,20111110,2,4,3,3,7,-3,2011,0,3,1899,0
Islanders,1,2,0,0,3,Avalanche,0,1,2,1,4,20111110,-1,-2,0,1,7,1,2011,1,3,1627,0
Canadiens,0,2,0,1,3,Coyotes,1,0,1,0,2,20111110,-1,1,0,1,5,-1,2011,1,3,2175,0
Canucks,3,0,0,0,3,Kings,0,1,1,0,2,20111110,3,2,1,1,5,-1,2011,0,3,1076,0
Wild,0,0,1,0,1,Sharks,0,3,0,0,3,20111110,0,3,2,2,4,2,2011,0,3,1570,0
Canucks,0,0,3,0,3,Ducks,0,4,0,0,4,20111111,0,4,1,1,7,1,2011,0,4,1076,0
Oilers,0,0,0,0,0,Red Wings,1,1,1,0,3,20111111,1,2,3,3,3,3,2011,0,4,1592,0
Flames,0,0,1,0,1,Blackhawks,1,1,2,0,4,20111111,1,2,3,3,5,3,2011,0,4,1397,0
Stars,1,0,0,0,1,Penguins,0,1,2,0,3,20111111,-1,0,2,2,4,2,2011,0,4,1069,0
Hurricanes,0,1,0,0,1,Rangers,1,0,4,0,5,20111111,1,0,4,4,6,4,2011,0,4,423,0
Capitals,0,1,2,0,3,Devils,1,0,0,0,1,20111111,-1,0,2,2,4,-2,2011,0,4,198,0
Senators,1,0,0,0,1,Sabres,3,0,2,0,5,20111111,2,2,4,4,6,4,2011,0,4,219,0
Sabres,1,0,1,0,2,Bruins,0,3,3,0,6,20111112,-1,2,4,4,8,4,2011,0,5,399,0
Senators,0,2,3,0,5,Maple Leafs,1,0,1,0,2,20111112,-1,1,3,3,7,-3,2011,0,5,203,0
Devils,0,2,0,1,3,Capitals,2,0,0,0,2,20111112,-2,0,0,1,5,-1,2011,1,5,198,0
Penguins,0,0,3,0,3,Hurricanes,1,2,2,0,5,20111112,1,3,2,2,8,2,2011,0,5,330,0
Stars,1,1,0,0,2,Red Wings,1,1,3,0,5,20111112,0,0,3,3,7,3,2011,0,5,999,0
Jets,0,0,1,0,1,Blue Jackets,1,0,1,0,2,20111112,1,1,1,1,3,1,2011,0,5,975,0
Canadiens,1,0,0,1,2,Predators,0,1,0,0,1,20111112,1,0,0,1,3,-1,2011,1,5,937,0
Lightning,0,0,0,0,0,Blues,1,1,1,0,3,20111112,1,2,3,3,3,3,2011,0,5,861,0
Flames,3,1,0,0,4,Avalanche,0,1,2,0,3,20111112,3,3,1,1,7,-1,2011,0,5,898,0
Wild,0,0,2,0,2,Kings,1,4,0,0,5,20111112,1,5,3,3,7,3,2011,0,5,1521,0
Coyotes,2,0,1,0,3,Sharks,0,0,0,0,0,20111112,2,2,3,3,3,-3,2011,0,5,614,0
Islanders,0,1,0,0,1,Canucks,1,1,2,0,4,20111113,1,1,3,3,5,3,2011,0,6,2429,0
Oilers,1,2,0,0,3,Blackhawks,3,2,1,0,6,20111113,2,2,3,3,9,3,2011,0,6,1437,0
Flyers,1,1,1,0,3,Panthers,0,1,1,0,2,20111113,1,1,1,1,5,-1,2011,0,6,1021,0
Wild,3,0,0,0,3,Ducks,0,1,1,0,2,20111113,3,2,1,1,5,-1,2011,0,6,1521,0
Flyers,2,2,1,0,5,Hurricanes,1,1,1,0,3,20111114,1,2,2,2,8,-2,2011,0,0,345,0
Lightning,0,1,1,0,2,Jets,2,2,1,0,5,20111114,2,3,3,3,7,3,2011,0,0,1705,0
Sabres,0,0,2,1,3,Canadiens,0,2,0,0,2,20111114,0,-2,0,1,5,-1,2011,1,0,311,0
Coyotes,2,0,0,1,3,Maple Leafs,0,0,2,0,2,20111115,2,2,0,1,5,-1,2011,1,1,1885,0
Rangers,1,1,2,0,4,Islanders,1,0,1,0,2,20111115,0,1,2,2,6,-2,2011,0,1,0,0
Wild,0,2,2,0,4,Blue Jackets,2,0,0,0,2,20111115,-2,0,2,2,6,-2,2011,0,1,626,0
Devils,0,1,2,0,3,Bruins,0,1,3,0,4,20111115,0,0,1,1,7,1,2011,0,1,196,0
Avalanche,3,0,0,0,3,Penguins,1,1,4,0,6,20111115,-2,-1,3,3,9,3,2011,0,1,1317,0
Red Wings,1,0,0,0,1,Blues,1,1,0,0,2,20111115,0,1,1,1,3,1,2011,0,1,454,0
Capitals,0,0,1,0,1,Predators,0,0,3,0,3,20111115,0,0,2,2,4,2,2011,0,1,566,0
Panthers,2,2,2,0,6,Stars,0,0,0,0,0,20111115,2,4,6,6,6,-6,2011,0,1,1110,0
Senators,0,1,2,0,3,Flames,0,1,0,0,1,20111115,0,0,2,2,4,-2,2011,0,1,1773,0
Ducks,0,0,1,0,1,Kings,0,1,0,1,2,20111116,0,1,0,1,3,1,2011,1,2,0,0
Hurricanes,0,0,0,0,0,Canadiens,2,2,0,0,4,20111116,2,4,4,4,4,4,2011,0,2,727,0
Blackhawks,0,2,3,0,5,Canucks,0,1,0,0,1,20111116,0,1,4,4,6,-4,2011,0,2,1775,0
Devils,2,1,2,0,5,Sabres,1,0,2,0,3,20111116,1,2,2,2,8,-2,2011,0,2,284,0
Blue Jackets,0,1,0,0,1,Bruins,0,1,0,1,2,20111117,0,0,0,1,3,1,2011,1,3,642,0
Canadiens,0,2,1,0,3,Islanders,0,4,0,0,4,20111117,0,2,1,1,7,1,2011,0,3,343,0
Coyotes,0,0,1,0,1,Flyers,0,1,1,0,2,20111117,0,1,1,1,3,1,2011,0,3,2078,0
Penguins,0,0,1,0,1,Lightning,1,1,2,0,4,20111117,1,2,3,3,5,3,2011,0,3,874,0
Panthers,1,0,0,0,1,Blues,1,1,2,0,4,20111117,0,1,3,3,5,3,2011,0,3,1061,0
Maple Leafs,0,1,0,0,1,Predators,1,1,2,0,4,20111117,1,1,3,3,5,3,2011,0,3,646,0
Avalanche,0,0,0,0,0,Wild,0,0,1,0,1,20111117,0,0,1,1,1,1,2011,0,3,698,0
Capitals,1,0,0,0,1,Jets,1,3,0,0,4,20111117,0,3,3,3,5,3,2011,0,3,1247,0
Red Wings,1,0,1,0,2,Sharks,1,3,1,0,5,20111117,0,3,3,3,7,3,2011,0,3,2071,0
Kings,0,2,3,0,5,Ducks,0,1,2,0,3,20111117,0,1,2,2,8,-2,2011,0,3,0,0
Senators,3,1,1,0,5,Oilers,0,1,1,0,2,20111117,3,3,3,3,7,-3,2011,0,3,1754,0
Sabres,1,0,0,0,1,Hurricanes,0,0,0,0,0,20111118,1,1,1,1,1,-1,2011,0,4,491,0
Stars,0,0,0,0,0,Avalanche,1,0,2,0,3,20111118,1,1,3,3,3,3,2011,0,4,661,0
Blackhawks,1,1,0,0,2,Flames,1,3,1,0,5,20111118,0,2,3,3,7,3,2011,0,4,1397,0
Devils,0,3,1,0,4,Lightning,0,0,2,0,2,20111119,0,3,2,2,6,-2,2011,0,5,1000,0
Sharks,1,2,1,0,4,Stars,0,0,1,0,1,20111119,1,3,3,3,5,-3,2011,0,5,1449,0
Blues,1,0,1,0,2,Wild,0,1,1,1,3,20111119,-1,0,0,1,5,1,2011,1,5,466,0
Blue Jackets,0,2,1,1,4,Predators,1,1,1,0,3,20111119,-1,0,0,1,7,-1,2011,1,5,333,0
Penguins,1,1,0,0,2,Panthers,1,1,1,0,3,20111119,0,0,1,1,5,1,2011,0,5,1013,0
Bruins,3,0,3,0,6,Islanders,0,0,0,0,0,20111119,3,3,6,6,6,-6,2011,0,5,190,0
Rangers,0,0,0,0,0,Canadiens,1,1,2,0,4,20111119,1,2,4,4,4,4,2011,0,5,343,0
Capitals,1,0,0,0,1,Maple Leafs,2,4,1,0,7,20111119,1,5,6,6,8,6,2011,0,5,349,0
Coyotes,1,2,1,0,4,Sabres,1,1,0,0,2,20111119,0,1,2,2,6,-2,2011,0,5,1902,0
Red Wings,1,2,1,0,4,Kings,1,0,0,0,1,20111119,0,2,3,3,5,-3,2011,0,5,1979,0
Flyers,1,1,2,0,4,Jets,3,2,1,0,6,20111119,2,3,2,2,10,2,2011,0,5,1273,0
Blackhawks,1,1,0,0,2,Oilers,5,3,1,0,9,20111119,4,6,7,7,11,7,2011,0,5,1437,0
Senators,0,0,1,0,1,Canucks,0,1,0,1,2,20111120,0,1,0,1,3,1,2011,1,6,2191,0
Red Wings,1,2,1,0,4,Ducks,0,2,0,0,2,20111120,1,1,2,2,6,-2,2011,0,6,1979,0
Sharks,1,2,1,0,4,Avalanche,1,0,0,0,1,20111120,0,2,3,3,5,-3,2011,0,6,927,0
Maple Leafs,0,0,2,0,2,Hurricanes,1,1,1,0,3,20111120,1,2,1,1,5,1,2011,0,6,544,0
Devils,3,0,0,0,3,Panthers,0,2,2,0,4,20111121,-3,-1,1,1,7,1,2011,0,0,1090,0
Oilers,0,1,0,0,1,Stars,1,2,1,0,4,20111121,1,2,3,3,5,3,2011,0,0,1655,0
Flames,0,1,0,0,1,Blue Jackets,2,1,1,0,4,20111121,2,2,3,3,5,3,2011,0,0,1670,0
Bruins,1,0,0,0,1,Canadiens,0,0,0,0,0,20111121,1,1,1,1,1,-1,2011,0,0,270,0
Islanders,0,0,0,0,0,Penguins,2,2,1,0,5,20111121,2,4,5,5,5,5,2011,0,0,314,0
Hurricanes,2,2,0,0,4,Flyers,0,2,0,0,2,20111121,2,2,2,2,6,-2,2011,0,0,345,0
Coyotes,1,1,1,0,3,Capitals,0,2,2,0,4,20111121,-1,0,1,1,7,1,2011,0,0,1977,0
Maple Leafs,3,1,3,0,7,Lightning,1,0,0,0,1,20111122,2,3,6,6,8,-6,2011,0,1,1096,0
Kings,0,1,2,0,3,Blues,1,0,1,0,2,20111122,-1,0,1,1,5,-1,2011,0,1,1586,0
Oilers,3,0,3,0,6,Predators,0,0,2,0,2,20111122,3,3,4,4,8,-4,2011,0,1,1758,0
Blackhawks,0,0,0,0,0,Sharks,0,1,0,0,1,20111123,0,1,1,1,1,1,2011,0,2,1837,0
Rangers,0,1,0,0,1,Panthers,1,1,0,0,2,20111123,1,1,1,1,3,1,2011,0,2,1091,0
Ducks,1,0,1,0,2,Coyotes,2,1,1,0,4,20111123,1,2,2,2,6,2,2011,0,2,356,0
Kings,0,2,0,0,2,Stars,0,0,2,1,3,20111123,0,-2,0,1,5,1,2011,1,2,1237,0
Predators,1,0,1,0,2,Wild,0,0,3,0,3,20111123,-1,-1,1,1,5,1,2011,0,2,696,0
Flames,0,2,1,0,3,Red Wings,1,1,3,0,5,20111123,1,0,2,2,8,2,2011,0,2,1573,0
Canucks,1,1,1,0,3,Avalanche,0,0,0,0,0,20111123,1,2,3,3,3,-3,2011,0,2,1105,0
Jets,2,0,1,0,3,Capitals,2,1,0,1,4,20111123,0,1,0,1,7,1,2011,1,2,1247,0
Blues,1,0,1,1,3,Penguins,0,0,2,0,2,20111123,1,1,0,1,5,-1,2011,1,2,557,0
Flyers,1,1,1,1,4,Islanders,3,0,0,0,3,20111123,-2,-1,0,1,7,-1,2011,1,2,80,0
Blue Jackets,0,0,1,0,1,Devils,0,1,0,1,2,20111123,0,1,0,1,3,1,2011,1,2,467,0
Bruins,0,2,1,1,4,Sabres,2,1,0,0,3,20111123,-2,-1,0,1,7,-1,2011,1,2,399,0
Canadiens,0,1,2,1,4,Hurricanes,2,0,1,0,3,20111123,-2,-1,0,1,7,-1,2011,1,2,727,0
Canucks,0,3,2,0,5,Coyotes,0,0,0,0,0,20111125,0,3,5,5,5,-5,2011,0,4,1228,0
Jets,1,1,1,0,3,Hurricanes,0,1,0,0,1,20111125,1,1,2,2,4,-2,2011,0,4,1350,0
Maple Leafs,2,0,1,1,4,Stars,1,1,1,0,3,20111125,1,0,0,1,7,-1,2011,1,4,1201,0
Flames,0,0,0,0,0,Blues,1,0,1,0,2,20111125,1,1,2,2,2,2,2011,0,4,1440,0
Lightning,0,0,1,1,2,Panthers,0,1,0,0,1,20111125,0,-1,0,1,3,-1,2011,1,4,205,0
Sabres,0,1,0,0,1,Blue Jackets,2,3,0,0,5,20111125,2,4,4,4,6,4,2011,0,4,293,0
Senators,1,1,1,0,3,Penguins,4,1,1,0,6,20111125,3,3,3,3,9,3,2011,0,4,392,0
Canadiens,1,0,0,0,1,Flyers,0,3,0,0,3,20111125,-1,2,2,2,4,2,2011,0,4,400,0
Rangers,0,4,2,0,6,Capitals,0,2,1,0,3,20111125,0,2,3,3,9,-3,2011,0,4,204,0
Oilers,2,1,2,0,5,Wild,1,1,0,0,2,20111125,1,1,3,3,7,-3,2011,0,4,1083,0
Blackhawks,2,0,4,0,6,Ducks,3,1,1,0,5,20111125,-1,-2,1,1,11,-1,2011,0,4,1741,0
Devils,0,1,0,0,1,Islanders,0,0,0,0,0,20111125,0,1,1,1,1,-1,2011,0,4,8,0
Red Wings,1,1,0,1,3,Bruins,0,1,1,0,2,20111125,1,1,0,1,5,-1,2011,1,4,611,0
Canucks,1,2,0,0,3,Sharks,1,0,1,0,2,20111126,0,2,1,1,5,-1,2011,0,5,821,0
Stars,0,0,0,0,0,Coyotes,1,1,1,0,3,20111126,1,2,3,3,3,3,2011,0,5,884,0
Predators,0,0,1,0,1,Red Wings,1,2,1,0,4,20111126,1,3,3,3,5,3,2011,0,5,470,0
Panthers,0,0,1,0,1,Lightning,1,3,1,0,5,20111126,1,4,4,4,6,4,2011,0,5,205,0
Penguins,1,1,1,1,4,Canadiens,2,1,0,0,3,20111126,-1,-1,0,1,7,-1,2011,1,5,474,0
Blackhawks,1,1,0,0,2,Kings,0,1,0,0,1,20111126,1,1,1,1,3,-1,2011,0,5,1741,0
Jets,2,0,0,0,2,Bruins,1,2,1,0,4,20111126,-1,1,2,2,6,2,2011,0,5,1349,0
Oilers,1,1,0,0,2,Avalanche,1,0,4,0,5,20111126,0,-1,3,3,7,3,2011,0,5,1036,0
Flyers,0,0,0,0,0,Rangers,0,1,1,0,2,20111126,0,1,2,2,2,2,2011,0,5,80,0
Islanders,1,1,1,0,3,Devils,0,1,1,0,2,20111126,1,1,1,1,5,-1,2011,0,5,8,0
Capitals,0,1,0,0,1,Sabres,2,1,2,0,5,20111126,2,2,4,4,6,4,2011,0,5,292,0
Hurricanes,1,0,2,0,3,Senators,2,1,1,0,4,20111127,1,2,1,1,7,1,2011,0,6,673,0
Blues,0,1,1,0,2,Blue Jackets,0,1,0,0,1,20111127,0,0,1,1,3,-1,2011,0,6,395,0
Flames,3,0,2,0,5,Wild,2,0,0,0,2,20111127,1,1,3,3,7,-3,2011,0,6,1043,0
Maple Leafs,2,1,2,0,5,Ducks,1,0,1,0,2,20111127,1,2,3,3,7,-3,2011,0,6,2170,0
Sharks,0,0,0,0,0,Kings,1,1,0,0,2,20111128,1,2,2,2,2,2,2011,0,0,305,0
Predators,0,1,1,0,2,Oilers,1,0,0,0,1,20111128,-1,0,1,1,3,-1,2011,0,0,1758,0
Stars,1,0,2,0,3,Avalanche,0,0,1,0,1,20111128,1,1,2,2,4,-2,2011,0,0,661,0
Lightning,0,1,0,0,1,Wild,0,2,1,0,3,20111128,0,1,2,2,4,2,2011,0,0,1318,0
Blue Jackets,0,0,1,0,1,Canucks,2,0,2,0,4,20111129,2,2,3,3,5,3,2011,0,1,2050,0
Islanders,1,0,1,0,2,Sabres,0,0,1,0,1,20111129,1,1,1,1,3,-1,2011,0,1,292,0
Blues,1,1,0,0,2,Capitals,1,0,0,0,1,20111129,0,1,1,1,3,-1,2011,0,1,708,0
Panthers,0,1,2,0,3,Hurricanes,0,1,0,0,1,20111129,0,0,2,2,4,-2,2011,0,1,696,0
Penguins,1,1,1,0,3,Rangers,0,4,0,0,4,20111129,-1,2,1,1,7,1,2011,0,1,314,0
Senators,1,2,3,0,6,Jets,0,2,2,0,4,20111129,1,1,2,2,10,-2,2011,0,1,1033,0
Coyotes,1,1,2,0,4,Blackhawks,0,0,1,0,1,20111129,1,2,3,3,5,-3,2011,0,1,1450,0
Predators,0,0,0,0,0,Flames,1,0,0,0,1,20111129,1,1,1,1,1,1,2011,0,1,1692,0
Canadiens,1,0,0,0,1,Ducks,1,1,2,0,4,20111130,0,1,3,3,5,3,2011,0,2,2448,0
Wild,0,2,0,1,3,Oilers,1,1,0,0,2,20111130,-1,0,0,1,5,-1,2011,1,2,1083,0
Devils,0,1,0,0,1,Avalanche,3,0,3,0,6,20111130,3,2,5,5,7,5,2011,0,2,1618,0
Bruins,1,2,3,0,6,Maple Leafs,1,1,1,0,3,20111130,0,1,3,3,9,-3,2011,0,2,430,0
Lightning,0,2,0,0,2,Red Wings,2,0,2,0,4,20111130,2,0,2,2,6,2,2011,0,2,994,0
Panthers,0,1,0,0,1,Kings,1,1,0,0,2,20111201,1,1,1,1,3,1,2011,0,3,2335,0
Blue Jackets,1,0,2,1,4,Flames,1,1,1,0,3,20111201,0,-1,0,1,7,-1,2011,1,3,1670,0
Predators,3,2,1,0,6,Canucks,1,4,0,0,5,20111201,2,0,1,1,11,-1,2011,0,3,2030,0
Senators,1,0,1,0,2,Stars,1,0,2,0,3,20111201,0,0,1,1,5,1,2011,0,3,1404,0
Canadiens,1,1,1,0,3,Sharks,1,1,1,1,4,20111201,0,0,0,1,7,1,2011,1,3,2508,0
Rangers,1,3,1,0,5,Hurricanes,2,1,0,0,3,20111201,-1,1,2,2,8,-2,2011,0,3,423,0
Penguins,1,0,1,0,2,Capitals,0,1,0,0,1,20111201,1,0,1,1,3,-1,2011,0,3,190,0
Coyotes,0,0,0,0,0,Jets,1,0,0,0,1,20111201,1,1,1,1,1,1,2011,0,3,1365,0
Red Wings,3,0,1,0,4,Sabres,0,0,1,0,1,20111202,3,3,3,3,5,-3,2011,0,4,215,0
Devils,2,0,0,0,2,Wild,3,0,1,0,4,20111202,1,1,2,2,6,2,2011,0,4,1007,0
Islanders,2,0,2,0,4,Blackhawks,1,2,1,1,5,20111202,-1,1,0,1,9,1,2011,1,4,711,0
Blues,1,1,0,0,2,Avalanche,1,0,1,1,3,20111202,0,-1,0,1,5,1,2011,1,4,794,0
Blue Jackets,1,1,1,0,3,Oilers,1,0,5,0,6,20111202,0,-1,3,3,9,3,2011,0,4,1703,0
Flyers,0,1,2,1,4,Ducks,2,1,0,0,3,20111202,-2,-2,0,1,7,-1,2011,1,4,2388,0
Panthers,1,3,1,0,5,Sharks,2,0,1,0,3,20111203,-1,2,2,2,8,-2,2011,0,5,2558,0
Flames,2,0,3,0,5,Oilers,2,0,1,0,3,20111203,0,0,2,2,8,-2,2011,0,5,171,0
Islanders,2,3,0,0,5,Stars,0,4,0,0,4,20111203,2,1,1,1,9,-1,2011,0,5,1370,0
Flyers,4,0,0,0,4,Coyotes,0,1,1,0,2,20111203,4,3,2,2,6,-2,2011,0,5,2078,0
Sabres,2,0,1,0,3,Predators,0,0,2,0,2,20111203,2,2,1,1,5,-1,2011,0,5,626,0
Rangers,0,1,3,0,4,Lightning,1,1,0,0,2,20111203,-1,-1,2,2,6,-2,2011,0,5,1004,0
Blackhawks,0,3,2,0,5,Blues,1,1,0,0,2,20111203,-1,1,3,3,7,-3,2011,0,5,260,0
Penguins,0,1,2,0,3,Hurricanes,0,1,1,0,2,20111203,0,0,1,1,5,-1,2011,0,5,330,0
Senators,0,1,1,0,2,Capitals,1,0,1,1,3,20111203,1,0,0,1,5,1,2011,1,5,446,0
Maple Leafs,0,1,0,0,1,Bruins,0,2,2,0,4,20111203,0,1,3,3,5,3,2011,0,5,430,0
Canadiens,1,1,0,0,2,Kings,0,1,0,0,1,20111203,1,1,1,1,3,-1,2011,0,5,2448,0
Devils,1,1,0,0,2,Jets,1,1,2,0,4,20111203,0,0,2,2,6,2,2011,0,5,1280,0
Flames,1,0,0,0,1,Canucks,0,2,3,0,5,20111204,-1,1,4,4,6,4,2011,0,6,426,0
Red Wings,1,0,1,0,2,Avalanche,0,2,2,0,4,20111204,-1,1,2,2,6,2,2011,0,6,1154,0
Wild,1,2,2,0,5,Ducks,2,0,1,0,3,20111204,-1,1,2,2,8,-2,2011,0,6,1521,0
Maple Leafs,1,2,1,0,4,Rangers,0,2,0,0,2,20111205,1,1,2,2,6,-2,2011,0,0,341,0
Bruins,0,2,1,0,3,Penguins,0,0,1,0,1,20111205,0,2,2,2,4,-2,2011,0,0,481,0
Lightning,0,1,1,0,2,Senators,0,1,3,0,4,20111205,0,0,2,2,6,2,2011,0,0,1251,0
Capitals,1,1,2,0,4,Panthers,3,2,0,0,5,20111205,2,3,1,1,9,1,2011,0,0,924,0
Coyotes,2,1,0,1,4,Blackhawks,0,3,0,0,3,20111205,2,0,0,1,7,-1,2011,1,0,1450,0
Hurricanes,0,2,4,0,6,Flames,2,2,3,0,7,20111206,2,2,1,1,13,1,2011,0,1,2038,0
Bruins,0,0,1,0,1,Jets,1,0,1,0,2,20111206,1,1,1,1,3,1,2011,0,1,1349,0
Kings,0,1,1,0,2,Ducks,2,0,1,0,3,20111206,2,1,1,1,5,1,2011,0,1,0,0
Avalanche,0,0,0,0,0,Canucks,1,1,4,0,6,20111206,1,2,6,6,6,6,2011,0,1,1105,0
Coyotes,1,0,2,0,3,Predators,1,0,1,0,2,20111206,0,0,1,1,5,-1,2011,0,1,1442,0
Wild,2,0,0,0,2,Sharks,1,0,0,0,1,20111206,1,1,1,1,3,-1,2011,0,1,1570,0
Blue Jackets,1,1,0,1,3,Canadiens,1,0,1,0,2,20111206,0,1,0,1,5,-1,2011,1,1,605,0
Devils,2,0,0,1,3,Maple Leafs,0,1,1,0,2,20111206,2,1,0,1,5,-1,2011,1,1,333,0
Red Wings,0,1,1,0,2,Blues,0,1,2,0,3,20111206,0,0,1,1,5,1,2011,0,1,454,0
Lightning,1,0,0,0,1,Islanders,3,0,2,0,5,20111206,2,2,4,4,6,4,2011,0,1,1004,0
Capitals,0,1,4,0,5,Senators,0,2,1,0,3,20111207,0,-1,2,2,8,-2,2011,0,2,446,0
Flyers,1,3,0,1,5,Sabres,3,0,1,0,4,20111207,-2,1,0,1,9,-1,2011,1,2,279,0
Hurricanes,1,3,1,0,5,Oilers,1,1,1,0,3,20111207,0,2,2,2,8,-2,2011,0,2,2076,0
Lightning,0,1,1,1,3,Rangers,1,1,0,0,2,20111208,-1,-1,0,1,5,-1,2011,1,3,1004,0
Wild,1,2,1,0,4,Kings,0,0,2,0,2,20111208,1,3,2,2,6,-2,2011,0,3,1521,0
Avalanche,0,1,1,0,2,Flames,0,0,3,0,3,20111208,0,-1,1,1,5,1,2011,0,3,898,0
Ducks,1,0,1,0,2,Blues,1,2,1,0,4,20111208,0,2,2,2,6,2,2011,0,3,1586,0
Coyotes,0,1,1,0,2,Red Wings,5,0,0,0,5,20111208,5,4,3,3,7,3,2011,0,3,1687,0
Canucks,0,1,2,1,4,Canadiens,2,1,0,0,3,20111208,-2,-2,0,1,7,-1,2011,1,3,2273,0
Blackhawks,1,1,0,1,3,Islanders,0,1,1,0,2,20111208,1,1,0,1,5,-1,2011,1,3,711,0
Penguins,0,1,1,0,2,Flyers,1,2,0,0,3,20111208,1,2,1,1,5,1,2011,0,3,257,0
Stars,1,1,0,0,2,Sharks,2,3,0,0,5,20111208,1,3,3,3,7,3,2011,0,3,1449,0
Senators,2,1,1,0,4,Devils,0,1,3,1,5,20111208,-2,-2,0,1,9,1,2011,1,3,330,0
Panthers,0,0,2,0,2,Bruins,0,0,0,0,0,20111208,0,0,2,2,2,-2,2011,0,3,1257,0
Predators,0,1,2,1,4,Blue Jackets,1,1,1,0,3,20111208,-1,-1,0,1,7,-1,2011,1,3,333,0
Hurricanes,0,0,2,0,2,Jets,2,2,0,0,4,20111209,2,4,2,2,6,2,2011,0,4,1350,0
Avalanche,0,1,0,0,1,Oilers,2,2,0,0,4,20111209,2,3,3,3,5,3,2011,0,4,1036,0
Panthers,0,1,0,0,1,Sabres,1,0,0,1,2,20111209,1,0,0,1,3,1,2011,1,4,1184,0
Maple Leafs,0,1,1,0,2,Capitals,1,2,1,0,4,20111209,1,2,2,2,6,2,2011,0,4,349,0
Ducks,0,1,1,0,2,Predators,0,1,2,0,3,20111210,0,0,1,1,5,1,2011,0,5,1776,0
Stars,1,1,0,0,2,Kings,0,1,0,0,1,20111210,1,1,1,1,3,-1,2011,0,5,1237,0
Oilers,0,0,0,0,0,Flames,0,2,1,0,3,20111210,0,2,3,3,3,3,2011,0,5,171,0
Wild,1,2,1,0,4,Coyotes,0,0,1,0,1,20111210,1,3,3,3,5,-3,2011,0,5,1278,0
Sharks,0,0,0,0,0,Blues,1,0,0,0,1,20111210,1,1,1,1,1,1,2011,0,5,1719,0
Jets,1,0,0,0,1,Red Wings,2,4,1,0,7,20111210,1,5,6,6,8,6,2011,0,5,855,0
Bruins,2,1,2,0,5,Blue Jackets,2,1,0,0,3,20111210,0,0,2,2,8,-2,2011,0,5,642,0
Penguins,2,2,2,0,6,Islanders,2,1,0,0,3,20111210,0,1,3,3,9,-3,2011,0,5,314,0
Canucks,2,1,1,0,4,Senators,0,1,0,0,1,20111210,2,2,3,3,5,-3,2011,0,5,2191,0
Rangers,0,2,2,0,4,Sabres,0,1,0,0,1,20111210,0,1,3,3,5,-3,2011,0,5,292,0
Canadiens,0,1,1,0,2,Devils,0,0,1,0,1,20111210,0,1,1,1,3,-1,2011,0,5,342,0
Lightning,1,0,1,0,2,Flyers,0,3,2,0,5,20111210,-1,2,3,3,7,3,2011,0,5,928,0
Sharks,1,1,0,0,2,Blackhawks,0,1,1,1,3,20111211,-1,-1,0,1,5,1,2011,1,6,1837,0
Panthers,1,0,0,0,1,Rangers,2,4,0,0,6,20111211,1,5,5,5,7,5,2011,0,6,1091,0
Devils,2,3,0,0,5,Lightning,2,0,2,0,4,20111212,0,3,1,1,9,-1,2011,0,0,1000,0
Islanders,1,0,2,0,3,Canadiens,2,0,3,0,5,20111213,1,1,2,2,8,2,2011,0,1,343,0
Devils,0,1,1,1,3,Panthers,1,1,0,0,2,20111213,-1,-1,0,1,5,-1,2011,1,1,1090,0
Canucks,0,0,1,0,1,Blue Jackets,1,0,0,1,2,20111213,1,1,0,1,3,1,2011,1,1,2050,0
Sharks,0,2,1,0,3,Avalanche,1,0,2,1,4,20111213,1,-1,0,1,7,1,2011,1,1,927,0
Wild,0,1,0,0,1,Jets,0,1,1,0,2,20111213,0,0,1,1,3,1,2011,0,1,388,0
Flyers,1,3,1,0,5,Capitals,0,0,1,0,1,20111213,1,4,4,4,6,-4,2011,0,1,123,0
Flames,0,1,0,0,1,Predators,1,0,1,0,2,20111213,1,0,1,1,3,1,2011,0,1,1692,0
Stars,0,0,1,0,1,Rangers,0,0,0,0,0,20111213,0,0,1,1,1,-1,2011,0,1,1370,0
Hurricanes,0,0,1,0,1,Maple Leafs,0,0,1,1,2,20111213,0,0,0,1,3,1,2011,1,1,544,0
Senators,1,0,1,1,3,Sabres,2,0,0,0,2,20111213,-1,-1,0,1,5,-1,2011,1,1,219,0
Kings,0,0,0,0,0,Bruins,1,1,1,0,3,20111213,1,2,3,3,3,3,2011,0,1,2590,0
Red Wings,0,1,3,0,4,Penguins,1,0,0,0,1,20111213,-1,0,3,3,5,-3,2011,0,1,205,0
Bruins,1,1,3,0,5,Senators,0,1,1,0,2,20111214,1,1,3,3,7,-3,2011,0,2,320,0
Blackhawks,0,2,1,1,4,Wild,0,2,1,0,3,20111214,0,0,0,1,7,-1,2011,1,2,355,0
Coyotes,0,1,0,0,1,Ducks,1,2,1,0,4,20111214,1,2,3,3,5,3,2011,0,2,356,0
Oilers,0,1,1,0,2,Coyotes,1,1,2,0,4,20111215,1,1,2,2,6,2,2011,0,3,1392,0
Capitals,0,0,1,0,1,Jets,0,0,0,0,0,20111215,0,0,1,1,1,-1,2011,0,3,1247,0
Red Wings,1,2,0,0,3,Predators,1,1,2,0,4,20111215,0,-1,1,1,7,1,2011,0,3,470,0
Rangers,0,1,0,0,1,Blues,2,0,2,0,4,20111215,2,1,3,3,5,3,2011,0,3,871,0
Flames,1,1,2,0,4,Lightning,1,3,0,1,5,20111215,0,2,0,1,9,1,2011,1,3,2289,0
Stars,1,0,2,0,3,Islanders,1,1,0,0,2,20111215,0,-1,1,1,5,-1,2011,0,3,1370,0
Kings,0,0,2,0,2,Blue Jackets,0,1,0,0,1,20111215,0,-1,1,1,3,-1,2011,0,3,1973,0
Canucks,1,1,1,0,3,Hurricanes,0,2,2,0,4,20111215,-1,0,1,1,7,1,2011,0,3,2409,0
Avalanche,2,2,0,0,4,Sharks,1,1,3,0,5,20111215,-1,-2,1,1,9,1,2011,0,3,927,0
Flyers,1,2,1,0,4,Canadiens,0,3,0,0,3,20111215,1,0,1,1,7,-1,2011,0,3,400,0
Ducks,0,0,1,0,1,Blackhawks,1,2,1,0,4,20111216,1,3,3,3,5,3,2011,0,4,1741,0
Stars,1,1,1,0,3,Devils,1,3,2,0,6,20111216,0,2,3,3,9,3,2011,0,4,1362,0
Flames,1,0,1,0,2,Panthers,1,0,1,1,3,20111216,0,0,0,1,5,1,2011,1,4,2493,0
Maple Leafs,0,2,2,0,4,Sabres,0,4,1,0,5,20111216,0,2,1,1,9,1,2011,0,4,57,0
Penguins,0,3,1,0,4,Senators,0,5,1,0,6,20111216,0,2,2,2,10,2,2011,0,4,392,0
Lightning,2,1,0,0,3,Blue Jackets,0,2,0,0,2,20111217,2,1,1,1,5,-1,2011,0,5,830,0
Bruins,4,1,1,0,6,Flyers,0,0,0,0,0,20111217,4,5,6,6,6,-6,2011,0,5,270,0
Canucks,1,2,2,0,5,Maple Leafs,1,1,1,0,3,20111217,0,1,2,2,8,-2,2011,0,5,2090,0
Devils,1,2,2,0,5,Canadiens,0,3,0,0,3,20111217,1,0,2,2,8,-2,2011,0,5,342,0
Sabres,1,0,2,0,3,Penguins,4,2,2,0,8,20111217,3,5,5,5,11,5,2011,0,5,178,0
Ducks,2,0,1,0,3,Jets,2,2,1,0,5,20111217,0,2,2,2,8,2,2011,0,5,1527,0
Kings,1,1,0,0,2,Red Wings,4,2,2,0,8,20111217,3,4,6,6,10,6,2011,0,5,1979,0
Blues,0,0,1,0,1,Predators,0,0,1,1,2,20111217,0,0,0,1,3,1,2011,1,5,253,0
Islanders,0,1,0,1,2,Wild,0,0,1,0,1,20111217,0,1,0,1,3,-1,2011,1,5,1016,0
Rangers,1,0,2,0,3,Coyotes,1,1,0,0,2,20111217,0,-1,1,1,5,-1,2011,0,5,2139,0
Capitals,0,1,0,0,1,Avalanche,1,1,0,0,2,20111217,1,1,1,1,3,1,2011,0,5,1489,0
Oilers,1,1,0,0,2,Sharks,1,1,1,0,3,20111217,0,0,1,1,5,1,2011,0,5,1190,0
Blue Jackets,1,2,1,0,4,Blues,2,0,4,0,6,20111218,1,-1,2,2,10,2,2011,0,6,395,0
Flames,0,0,2,0,2,Blackhawks,1,2,1,0,4,20111218,1,3,2,2,6,2,2011,0,6,1397,0
Hurricanes,1,1,0,0,2,Panthers,1,0,1,1,3,20111218,0,-1,0,1,5,1,2011,1,6,696,0
Wild,0,0,0,0,0,Canucks,1,2,1,0,4,20111219,1,3,4,4,4,4,2011,0,0,1427,0
Red Wings,1,1,1,0,3,Oilers,0,2,0,0,2,20111219,1,0,1,1,5,-1,2011,0,0,1592,0
Flyers,1,0,1,0,2,Avalanche,0,2,0,1,3,20111219,-1,1,0,1,5,1,2011,1,0,1574,0
Kings,1,1,0,1,3,Maple Leafs,1,0,1,0,2,20111219,0,1,0,1,5,-1,2011,1,0,2170,0
Canadiens,1,0,1,0,2,Bruins,1,1,1,0,3,20111219,0,1,1,1,5,1,2011,0,0,270,0
Ducks,0,3,0,0,3,Stars,1,2,2,0,5,20111219,1,0,2,2,8,2,2011,0,0,1237,0
Rangers,0,1,3,0,4,Devils,1,0,0,0,1,20111220,-1,0,3,3,5,-3,2011,0,1,8,0
Predators,0,0,1,0,1,Capitals,2,0,2,0,4,20111220,2,2,3,3,5,3,2011,0,1,566,0
Blackhawks,0,0,2,0,2,Penguins,1,2,0,0,3,20111220,1,3,1,1,5,1,2011,0,1,409,0
Sabres,0,1,0,0,1,Senators,1,0,3,0,4,20111220,1,0,3,3,5,3,2011,0,1,219,0
Coyotes,1,1,0,0,2,Panthers,0,1,0,0,1,20111220,1,1,1,1,3,-1,2011,0,1,1978,0
Islanders,1,1,0,1,3,Jets,1,1,0,0,2,20111220,0,0,0,1,5,-1,2011,1,1,1287,0
Wild,1,0,0,0,1,Flames,1,1,0,0,2,20111220,0,1,1,1,3,1,2011,0,1,1043,0
Lightning,1,0,1,0,2,Sharks,5,0,2,0,7,20111221,4,4,5,5,9,5,2011,0,2,2365,0
Blues,0,2,0,0,2,Avalanche,2,1,0,0,3,20111221,2,1,1,1,5,1,2011,0,2,794,0
Flyers,2,1,1,0,4,Stars,1,0,0,0,1,20111221,1,2,3,3,5,-3,2011,0,2,1297,0
Red Wings,1,1,0,0,2,Canucks,3,0,1,0,4,20111221,2,1,2,2,6,2,2011,0,2,1967,0
Coyotes,1,1,2,0,4,Hurricanes,1,2,0,0,3,20111221,0,-1,1,1,7,-1,2011,0,2,1898,0
Canadiens,0,1,0,0,1,Blackhawks,0,2,3,0,5,20111221,0,1,4,4,6,4,2011,0,2,732,0
Ducks,0,1,1,0,2,Kings,0,1,1,1,3,20111222,0,0,0,1,5,1,2011,1,3,0,0
Red Wings,0,0,2,0,2,Flames,1,2,0,0,3,20111222,1,3,1,1,5,1,2011,0,3,1573,0
Wild,0,0,1,0,1,Oilers,2,2,0,0,4,20111222,2,4,3,3,5,3,2011,0,3,1083,0
Canadiens,0,0,0,0,0,Jets,2,1,1,0,4,20111222,2,3,4,4,4,4,2011,0,3,1115,0
Sabres,0,1,1,0,2,Maple Leafs,0,2,1,0,3,20111222,0,1,1,1,5,1,2011,0,3,57,0
Panthers,0,1,2,0,3,Senators,1,0,2,1,4,20111222,1,0,0,1,7,1,2011,1,3,1370,0
Islanders,0,1,1,0,2,Rangers,1,2,1,0,4,20111222,1,2,2,2,6,2,2011,0,3,0,0
Blue Jackets,4,1,0,0,5,Predators,1,3,2,0,6,20111222,-3,-1,1,1,11,1,2011,0,3,333,0
Kings,0,1,0,0,1,Sharks,0,1,0,1,2,20111223,0,0,0,1,3,1,2011,1,4,305,0
Flames,0,0,3,0,3,Canucks,0,0,1,0,1,20111223,0,0,2,2,4,-2,2011,0,4,426,0
Blues,0,2,1,0,3,Coyotes,0,1,1,0,2,20111223,0,1,1,1,5,-1,2011,0,4,1270,0
Lightning,1,0,0,0,1,Avalanche,0,1,0,1,2,20111223,-1,0,0,1,3,1,2011,1,4,1521,0
Predators,0,2,1,0,3,Stars,3,1,2,0,6,20111223,3,2,3,3,9,3,2011,0,4,616,0
Penguins,1,0,3,0,4,Jets,0,1,0,0,1,20111223,1,0,3,3,5,-3,2011,0,4,1060,0
Flyers,0,0,2,0,2,Rangers,0,2,2,0,4,20111223,0,2,2,2,6,2,2011,0,4,80,0
Maple Leafs,3,1,1,0,5,Islanders,1,1,1,0,3,20111223,2,2,2,2,8,-2,2011,0,4,341,0
Capitals,0,0,3,0,3,Devils,0,3,0,1,4,20111223,0,3,0,1,7,1,2011,1,4,198,0
Panthers,0,0,0,0,0,Bruins,4,2,2,0,8,20111223,4,6,8,8,8,8,2011,0,4,1257,0
Senators,1,0,0,0,1,Hurricanes,1,0,0,1,2,20111223,0,0,0,1,3,1,2011,1,4,673,0
Blue Jackets,0,0,1,0,1,Blackhawks,0,3,1,0,4,20111226,0,3,3,3,5,3,2011,0,0,275,0
Coyotes,1,1,1,0,3,Kings,2,0,2,0,4,20111226,1,0,1,1,7,1,2011,0,0,356,0
Ducks,1,2,0,0,3,Sharks,1,1,0,0,2,20111226,0,1,1,1,5,-1,2011,0,0,305,0
Oilers,0,2,1,0,3,Canucks,3,1,1,0,5,20111226,3,2,2,2,8,2,2011,0,0,514,0
Red Wings,1,2,1,0,4,Predators,0,0,1,0,1,20111226,1,3,3,3,5,-3,2011,0,0,470,0
Avalanche,0,2,2,0,4,Wild,1,1,0,0,2,20111226,-1,0,2,2,6,-2,2011,0,0,698,0
Devils,0,0,2,0,2,Hurricanes,1,2,1,0,4,20111226,1,3,2,2,6,2,2011,0,0,419,0
Islanders,0,0,0,0,0,Rangers,0,1,2,0,3,20111226,0,1,3,3,3,3,2011,0,0,0,0
Capitals,0,1,1,0,2,Sabres,4,0,0,0,4,20111226,4,3,2,2,6,2,2011,0,0,292,0
Stars,0,1,2,0,3,Blues,1,2,2,0,5,20111226,1,2,2,2,8,2,2011,0,0,547,0
Maple Leafs,0,2,1,0,3,Panthers,1,3,1,0,5,20111227,1,2,2,2,8,2,2011,0,1,1234,0
Jets,1,2,1,0,4,Avalanche,0,0,1,0,1,20111227,1,3,3,3,5,-3,2011,0,1,797,0
Hurricanes,1,0,1,0,2,Penguins,0,1,3,0,4,20111227,-1,0,2,2,6,2,2011,0,1,330,0
Flames,0,0,1,1,2,Blue Jackets,0,1,0,0,1,20111227,0,-1,0,1,3,-1,2011,1,1,1670,0
Canadiens,3,2,1,0,6,Senators,1,1,0,0,2,20111227,2,3,4,4,8,-4,2011,0,1,104,0
Flyers,1,0,0,0,1,Lightning,1,3,1,0,5,20111227,0,3,4,4,6,4,2011,0,1,928,0
Blues,1,1,0,0,2,Red Wings,0,1,2,0,3,20111227,-1,-1,1,1,5,1,2011,0,1,454,0
Canucks,1,1,0,1,3,Sharks,0,2,0,0,2,20111228,1,0,0,1,5,-1,2011,1,2,821,0
Bruins,1,0,0,1,2,Coyotes,1,0,0,0,1,20111228,0,0,0,1,3,-1,2011,1,2,2295,0
Wild,0,0,1,0,1,Predators,0,0,1,1,2,20111228,0,0,0,1,3,1,2011,1,2,696,0
Kings,0,1,1,0,2,Blackhawks,0,0,0,0,0,20111228,0,1,2,2,2,-2,2011,0,2,1741,0
Rangers,1,0,0,0,1,Capitals,1,2,1,0,4,20111228,0,2,3,3,5,3,2011,0,2,204,0
Sabres,0,1,0,0,1,Devils,1,2,0,0,3,20111228,1,2,2,2,4,2,2011,0,2,284,0
Canucks,2,2,1,0,5,Ducks,0,0,2,0,2,20111229,2,4,3,3,7,-3,2011,0,3,1076,0
Blue Jackets,1,1,2,0,4,Stars,1,0,0,0,1,20111229,0,1,3,3,5,-3,2011,0,3,912,0
Kings,0,0,0,0,0,Jets,0,0,0,1,1,20111229,0,0,0,1,1,1,2011,1,3,1527,0
Oilers,1,1,1,0,3,Wild,1,3,0,0,4,20111229,0,2,1,1,7,1,2011,0,3,1083,0
Coyotes,1,1,0,0,2,Avalanche,2,0,1,0,3,20111229,1,0,1,1,5,1,2011,0,3,585,0
Maple Leafs,0,1,2,0,3,Hurricanes,1,0,2,1,4,20111229,1,0,0,1,7,1,2011,1,3,544,0
Flyers,1,2,1,0,4,Penguins,1,0,1,0,2,20111229,0,2,2,2,6,-2,2011,0,3,257,0
Flames,1,0,0,0,1,Islanders,0,1,2,0,3,20111229,-1,0,2,2,4,2,2011,0,3,2023,0
Canadiens,1,2,0,0,3,Lightning,1,1,2,0,4,20111229,0,-1,1,1,7,1,2011,0,3,1311,0
Sabres,0,1,0,0,1,Capitals,1,1,1,0,3,20111230,1,1,2,2,4,2,2011,0,4,292,0
Flames,3,0,0,0,3,Senators,0,2,1,1,4,20111230,-3,-1,0,1,7,1,2011,1,4,1773,0
Rangers,3,1,0,0,4,Panthers,0,1,0,0,1,20111230,3,3,3,3,5,-3,2011,0,4,1091,0
Predators,1,0,0,1,2,Blues,1,0,0,0,1,20111230,0,0,0,1,3,-1,2011,1,4,253,0
Red Wings,1,1,0,0,2,Blackhawks,1,1,1,0,3,20111230,0,0,1,1,5,1,2011,0,4,238,0
Blues,0,0,0,0,0,Red Wings,0,3,0,0,3,20111231,0,3,3,3,3,3,2011,0,5,454,0
Canucks,1,0,0,0,1,Kings,1,2,1,0,4,20111231,0,2,3,3,5,3,2011,0,5,1076,0
Avalanche,1,2,1,0,4,Ducks,0,1,1,0,2,20111231,1,2,2,2,6,-2,2011,0,5,830,0
Bruins,1,0,1,0,2,Stars,3,1,0,0,4,20111231,2,3,2,2,6,2,2011,0,5,1548,0
Capitals,0,0,4,0,4,Blue Jackets,0,2,0,0,2,20111231,0,-2,2,2,6,-2,2011,0,5,326,0
Maple Leafs,1,1,0,0,2,Jets,0,3,0,0,3,20111231,-1,1,1,1,5,1,2011,0,5,946,0
Penguins,0,0,1,0,1,Devils,2,0,1,0,3,20111231,2,2,2,2,4,2,2011,0,5,306,0
Canadiens,1,0,1,0,2,Panthers,0,1,2,0,3,20111231,-1,0,1,1,5,1,2011,0,5,1418,0
Coyotes,0,1,3,0,4,Wild,0,1,1,0,2,20111231,0,0,2,2,6,-2,2011,0,5,1278,0
Hurricanes,1,1,0,0,2,Lightning,1,1,3,0,5,20111231,0,0,3,3,7,3,2011,0,5,585,0
Oilers,1,0,0,0,1,Islanders,2,2,0,0,4,20111231,1,3,3,3,5,3,2011,0,5,2024,0
Senators,0,2,0,1,3,Sabres,1,1,0,0,2,20111231,-1,0,0,1,5,-1,2011,1,5,219,0
Flames,1,0,2,0,3,Predators,2,2,1,0,5,20120101,1,3,2,2,8,2,2011,0,6,1692,0
Rangers,0,1,2,0,3,Flyers,0,2,0,0,2,20120102,0,-1,1,1,5,-1,2011,0,0,80,0
Devils,0,2,0,0,2,Senators,0,0,2,1,3,20120102,0,-2,0,1,5,1,2011,1,0,330,0
Sharks,0,2,0,1,3,Canucks,1,0,1,0,2,20120102,-1,1,0,1,5,-1,2011,1,0,821,0
Oilers,0,3,1,0,4,Blackhawks,1,1,1,0,3,20120102,-1,1,1,1,7,-1,2011,0,0,1437,0
Avalanche,0,0,1,1,2,Kings,0,1,0,0,1,20120102,0,-1,0,1,3,-1,2011,1,0,830,0
Coyotes,1,0,0,0,1,Blues,2,1,1,0,4,20120103,1,2,3,3,5,3,2011,0,1,1270,0
Red Wings,3,2,0,0,5,Stars,1,2,1,0,4,20120103,2,2,1,1,9,-1,2011,0,1,999,0
Islanders,1,0,2,1,4,Hurricanes,1,1,1,0,3,20120103,0,-1,0,1,7,-1,2011,1,1,423,0
Flames,0,1,0,0,1,Capitals,1,2,0,0,3,20120103,1,2,2,2,4,2,2011,0,1,1967,0
Lightning,1,2,0,0,3,Maple Leafs,2,3,2,0,7,20120103,1,2,4,4,10,4,2011,0,1,1096,0
Oilers,1,1,1,0,3,Sabres,1,1,2,0,4,20120103,0,0,1,1,7,1,2011,0,1,1734,0
Jets,1,1,1,0,3,Canadiens,2,1,4,0,7,20120104,1,1,4,4,10,4,2011,0,2,1115,0
Bruins,2,1,3,0,6,Devils,1,0,0,0,1,20120104,1,2,5,5,7,-5,2011,0,2,196,0
Wild,0,0,0,0,0,Canucks,2,0,1,0,3,20120104,2,2,3,3,3,3,2011,0,2,1427,0
Sharks,0,2,1,0,3,Ducks,1,0,0,0,1,20120104,-1,1,2,2,4,-2,2011,0,2,305,0
Coyotes,0,0,0,0,0,Kings,0,0,0,1,1,20120105,0,0,0,1,1,1,2011,1,3,356,0
Stars,2,1,1,0,4,Predators,1,0,0,0,1,20120105,1,2,3,3,5,-3,2011,0,3,616,0
Oilers,0,3,0,0,3,Blues,1,0,3,0,4,20120105,1,-2,1,1,7,1,2011,0,3,1508,0
Lightning,0,0,1,0,1,Senators,1,1,2,0,4,20120105,1,2,3,3,5,3,2011,0,3,1251,0
Jets,0,0,0,0,0,Maple Leafs,1,1,2,0,4,20120105,1,2,4,4,4,4,2011,0,3,946,0
Panthers,1,0,1,0,2,Rangers,1,0,1,1,3,20120105,0,0,0,1,5,1,2011,1,3,1091,0
Blue Jackets,1,0,0,0,1,Sharks,1,1,0,0,2,20120105,0,1,1,1,3,1,2011,0,3,2090,0
Flames,0,0,0,0,0,Bruins,3,4,2,0,9,20120105,3,7,9,9,9,9,2011,0,3,2089,0
Blackhawks,1,1,2,0,4,Flyers,1,3,1,0,5,20120105,0,2,1,1,9,1,2011,0,3,664,0
Islanders,0,1,1,0,2,Ducks,0,1,3,0,4,20120106,0,0,2,2,6,2,2011,0,4,2445,0
Avalanche,1,2,1,0,4,Blackhawks,0,0,0,0,0,20120106,1,3,4,4,4,-4,2011,0,4,916,0
Sabres,0,1,1,0,2,Hurricanes,0,1,3,0,4,20120106,0,0,2,2,6,2,2011,0,4,491,0
Panthers,1,1,0,0,2,Devils,1,1,3,0,5,20120106,0,0,3,3,7,3,2011,0,4,1090,0
Rangers,1,1,1,0,3,Penguins,1,0,0,0,1,20120106,0,1,2,2,4,-2,2011,0,4,314,0
Lightning,1,0,0,0,1,Canadiens,0,2,1,0,3,20120107,-1,1,2,2,4,2,2011,0,5,1311,0
Canucks,1,2,1,0,4,Bruins,1,1,1,0,3,20120107,0,1,1,1,7,-1,2011,0,5,2504,0
Senators,0,1,1,0,2,Flyers,1,0,1,1,3,20120107,1,0,0,1,5,1,2011,1,5,373,0
Oilers,1,0,0,0,1,Stars,0,1,3,0,4,20120107,-1,0,3,3,5,3,2011,0,5,1655,0
Blue Jackets,0,1,0,0,1,Kings,0,0,0,0,0,20120107,0,1,1,1,1,-1,2011,0,5,1973,0
Jets,0,1,0,1,2,Sabres,0,1,0,0,1,20120107,0,0,0,1,3,-1,2011,1,5,996,0
Red Wings,0,2,1,0,3,Maple Leafs,3,0,1,0,4,20120107,3,1,1,1,7,1,2011,0,5,205,0
Devils,0,2,1,0,3,Penguins,1,0,0,0,1,20120107,-1,1,2,2,4,-2,2011,0,5,306,0
Avalanche,0,0,0,0,0,Blues,2,2,0,0,4,20120107,2,4,4,4,4,4,2011,0,5,794,0
Hurricanes,0,0,2,0,2,Predators,2,1,2,0,5,20120107,2,3,3,3,7,3,2011,0,5,456,0
Islanders,1,0,0,0,1,Coyotes,1,3,1,0,5,20120107,0,3,4,4,6,4,2011,0,5,2139,0
Wild,0,0,1,0,1,Flames,0,0,3,0,3,20120107,0,0,2,2,4,2,2011,0,5,1043,0
Capitals,0,1,1,0,2,Sharks,0,2,3,0,5,20120107,0,1,3,3,7,3,2011,0,5,2416,0
Flyers,3,1,0,0,4,Senators,2,0,4,0,6,20120108,-1,-2,2,2,10,2,2011,0,6,373,0
Red Wings,1,0,1,1,3,Blackhawks,2,0,0,0,2,20120108,-1,-1,0,1,5,-1,2011,1,6,238,0
Blue Jackets,1,1,2,0,4,Ducks,4,1,2,0,7,20120108,3,3,3,3,11,3,2011,0,6,1973,0
Canucks,1,0,0,0,1,Panthers,0,2,0,0,2,20120109,-1,1,1,1,3,1,2011,0,0,2803,0
Capitals,1,0,1,0,2,Kings,2,2,1,0,5,20120109,1,3,3,3,7,3,2011,0,0,2294,0
Sharks,1,0,3,0,4,Wild,1,1,2,1,5,20120110,0,1,0,1,9,1,2011,1,1,1570,0
Blue Jackets,0,1,1,0,2,Blackhawks,0,2,3,0,5,20120110,0,1,3,3,7,3,2011,0,1,275,0
Devils,0,2,1,0,3,Flames,4,1,1,0,6,20120110,4,3,3,3,9,3,2011,0,1,2015,0
Canucks,2,2,0,1,5,Lightning,0,2,2,0,4,20120110,2,2,0,1,9,-1,2011,1,1,2598,0
Predators,3,0,1,0,4,Avalanche,0,1,0,0,1,20120110,3,2,3,3,5,-3,2011,0,1,1019,0
Blues,0,2,1,0,3,Canadiens,0,0,0,0,0,20120110,0,2,3,3,3,-3,2011,0,1,962,0
Stars,0,0,2,0,2,Ducks,1,1,3,0,5,20120110,1,2,3,3,7,3,2011,0,1,1237,0
Senators,2,2,1,0,5,Penguins,0,1,0,0,1,20120110,2,3,4,4,6,-4,2011,0,1,392,0
Coyotes,0,0,1,0,1,Rangers,0,0,1,1,2,20120110,0,0,0,1,3,1,2011,1,1,2139,0
Red Wings,0,0,1,0,1,Islanders,1,3,1,0,5,20120110,1,4,4,4,6,4,2011,0,1,480,0
Sabres,0,0,0,0,0,Maple Leafs,2,0,0,0,2,20120110,2,2,2,2,2,2,2011,0,1,57,0
Jets,1,2,0,0,3,Bruins,1,1,3,0,5,20120110,0,-1,2,2,8,2,2011,0,1,1349,0
Flyers,0,1,1,0,2,Hurricanes,0,1,0,0,1,20120110,0,0,1,1,3,-1,2011,0,1,345,0
Penguins,0,0,0,0,0,Capitals,1,0,0,0,1,20120111,1,1,1,1,1,1,2011,0,2,190,0
Devils,0,1,0,1,2,Oilers,0,0,1,0,1,20120111,0,1,0,1,3,-1,2011,1,2,2016,0
Stars,2,1,1,1,5,Kings,0,2,2,0,4,20120112,2,1,0,1,9,-1,2011,1,3,1237,0
Wild,1,0,1,0,2,Blackhawks,1,3,1,0,5,20120112,0,3,3,3,7,3,2011,0,3,355,0
Sharks,0,1,1,0,2,Jets,0,0,0,0,0,20120112,0,1,2,2,2,-2,2011,0,3,1496,0
Avalanche,2,0,0,0,2,Predators,0,1,1,1,3,20120112,-2,-1,0,1,5,1,2011,1,3,1019,0
Canucks,1,1,0,1,3,Blues,1,1,0,0,2,20120112,0,0,0,1,5,-1,2011,1,3,1778,0
Ducks,0,0,0,0,0,Flames,0,0,0,1,1,20120112,0,0,0,1,1,1,2011,1,3,1197,0
Hurricanes,4,0,1,0,5,Lightning,1,1,0,0,2,20120112,3,2,3,3,7,-3,2011,0,3,585,0
Senators,0,1,2,0,3,Rangers,0,0,0,0,0,20120112,0,1,3,3,3,-3,2011,0,3,334,0
Flyers,1,1,1,0,3,Islanders,0,0,2,0,2,20120112,1,2,1,1,5,-1,2011,0,3,80,0
Canadiens,0,0,1,0,1,Bruins,1,0,1,0,2,20120112,1,1,1,1,3,1,2011,0,3,270,0
Coyotes,1,0,1,0,2,Red Wings,1,0,1,1,3,20120112,0,0,0,1,5,1,2011,1,3,1687,0
Lightning,0,1,2,0,3,Capitals,2,1,1,0,4,20120113,2,2,1,1,7,1,2011,0,4,818,0
Coyotes,1,1,1,0,3,Blue Jackets,2,2,0,0,4,20120113,1,2,1,1,7,1,2011,0,4,1664,0
Maple Leafs,2,0,0,0,2,Sabres,2,1,0,0,3,20120113,0,1,1,1,5,1,2011,0,4,57,0
Penguins,0,2,2,0,4,Panthers,0,0,1,0,1,20120113,0,2,3,3,5,-3,2011,0,4,1013,0
Ducks,1,3,1,0,5,Oilers,0,0,0,0,0,20120113,1,4,5,5,5,-5,2011,0,4,1368,0
Flyers,0,1,1,0,2,Predators,1,1,2,0,4,20120114,1,1,2,2,6,2,2011,0,5,683,0
Wild,1,1,0,0,2,Blues,0,2,0,1,3,20120114,-1,0,0,1,5,1,2011,1,5,466,0
Sharks,0,1,1,0,2,Blue Jackets,0,0,1,0,1,20120114,0,1,1,1,3,-1,2011,0,5,2090,0
Bruins,0,1,1,0,2,Hurricanes,0,1,3,0,4,20120114,0,0,2,2,6,2,2011,0,5,609,0
Sabres,0,2,0,0,2,Islanders,1,1,2,0,4,20120114,1,0,2,2,6,2,2011,0,5,292,0
Blackhawks,0,1,1,0,2,Red Wings,2,0,0,1,3,20120114,2,1,0,1,5,1,2011,1,5,238,0
Rangers,0,2,1,0,3,Maple Leafs,0,0,0,0,0,20120114,0,2,3,3,3,-3,2011,0,5,341,0
Devils,0,0,2,0,2,Jets,1,0,0,0,1,20120114,-1,-1,1,1,3,-1,2011,0,5,1280,0
Avalanche,1,0,1,0,2,Stars,0,0,1,0,1,20120114,1,1,1,1,3,-1,2011,0,5,661,0
Kings,0,3,1,0,4,Flames,0,1,0,0,1,20120114,0,2,3,3,5,-3,2011,0,5,1197,0
Senators,0,0,2,1,3,Canadiens,0,0,2,0,2,20120114,0,0,0,1,5,-1,2011,1,5,104,0
Penguins,2,0,4,0,6,Lightning,0,0,3,0,3,20120115,2,2,3,3,9,-3,2011,0,6,874,0
Rangers,1,0,0,0,1,Canadiens,1,3,0,0,4,20120115,0,3,3,3,5,3,2011,0,6,343,0
Hurricanes,0,1,0,0,1,Capitals,0,1,1,0,2,20120115,0,0,1,1,3,1,2011,0,6,233,0
Sharks,0,2,1,0,3,Blackhawks,2,1,1,0,4,20120115,2,1,1,1,7,1,2011,0,6,1837,0
Kings,0,0,1,0,1,Oilers,1,0,0,1,2,20120115,1,1,0,1,3,1,2011,1,6,1368,0
Ducks,1,2,1,0,4,Canucks,1,0,1,0,2,20120115,0,2,2,2,6,-2,2011,0,6,1076,0
Predators,3,0,0,0,3,Islanders,0,0,1,0,1,20120116,3,3,2,2,4,-2,2011,0,0,758,0
Avalanche,1,0,0,0,1,Coyotes,2,2,2,0,6,20120116,1,3,5,5,7,5,2011,0,0,585,0
Jets,1,1,0,0,2,Senators,0,0,0,0,0,20120116,1,2,2,2,2,-2,2011,0,0,1033,0
Bruins,1,1,0,1,3,Panthers,0,2,0,0,2,20120116,1,0,0,1,5,-1,2011,1,0,1257,0
Sabres,0,0,0,0,0,Red Wings,3,2,0,0,5,20120116,3,5,5,5,5,5,2011,0,0,215,0
Stars,0,0,0,0,0,Blues,0,0,1,0,1,20120116,0,0,1,1,1,1,2011,0,0,547,0
Flames,0,1,0,0,1,Sharks,0,0,1,1,2,20120117,0,-1,0,1,3,1,2011,1,1,1027,0
Kings,1,1,0,1,3,Canucks,0,1,1,0,2,20120117,1,1,0,1,5,-1,2011,1,1,1076,0
Red Wings,1,1,0,1,3,Stars,2,0,0,0,2,20120117,-1,0,0,1,5,-1,2011,1,1,999,0
Bruins,0,2,1,0,3,Lightning,1,1,3,0,5,20120117,1,0,2,2,8,2,2011,0,1,1183,0
Predators,0,0,0,0,0,Rangers,1,1,1,0,3,20120117,1,2,3,3,3,3,2011,0,1,758,0
Jets,0,0,1,0,1,Devils,1,3,1,0,5,20120117,1,4,4,4,6,4,2011,0,1,1280,0
Islanders,1,1,1,0,3,Capitals,0,0,0,0,0,20120117,1,2,3,3,3,-3,2011,0,1,204,0
Hurricanes,1,0,0,0,1,Penguins,1,0,0,1,2,20120117,0,0,0,1,3,1,2011,1,1,330,0
Wild,0,1,0,0,1,Flyers,1,3,1,0,5,20120117,1,3,4,4,6,4,2011,0,1,983,0
Senators,1,1,1,0,3,Maple Leafs,2,0,0,0,2,20120117,-1,0,1,1,5,-1,2011,0,1,203,0
Oilers,2,0,0,0,2,Blue Jackets,0,2,2,0,4,20120117,-2,0,2,2,6,2,2011,0,1,1703,0
Coyotes,1,1,0,0,2,Ducks,2,2,2,0,6,20120118,1,2,4,4,8,4,2011,0,2,356,0
Panthers,1,1,1,0,3,Avalanche,0,1,2,1,4,20120118,-1,-1,0,1,7,1,2011,1,2,1724,0
Sabres,1,1,0,0,2,Blackhawks,2,2,2,0,6,20120118,1,2,4,4,8,4,2011,0,2,453,0
Capitals,2,1,0,0,3,Canadiens,0,0,0,0,0,20120118,2,3,3,3,3,-3,2011,0,2,495,0
Senators,1,2,1,0,4,Sharks,1,0,0,0,1,20120119,0,2,3,3,5,-3,2011,0,3,2408,0
Red Wings,0,2,0,1,3,Coyotes,1,1,0,0,2,20120119,-1,0,0,1,5,-1,2011,1,3,1687,0
Sabres,0,1,0,0,1,Jets,1,1,2,0,4,20120119,1,1,3,3,5,3,2011,0,3,996,0
Oilers,0,0,0,0,0,Blues,0,0,1,0,1,20120119,0,0,1,1,1,1,2011,0,3,1508,0
Flames,0,1,0,1,2,Kings,1,0,0,0,1,20120119,-1,0,0,1,3,-1,2011,1,3,1197,0
Islanders,0,2,2,0,4,Flyers,0,0,1,0,1,20120119,0,2,3,3,5,-3,2011,0,3,80,0
Penguins,1,0,3,0,4,Rangers,0,1,0,0,1,20120119,1,0,3,3,5,-3,2011,0,3,314,0
Bruins,0,0,4,0,4,Devils,1,0,0,0,1,20120119,-1,-1,3,3,5,-3,2011,0,3,196,0
Wild,0,0,1,0,1,Maple Leafs,2,1,1,0,4,20120119,2,3,3,3,5,3,2011,0,3,691,0
Predators,0,2,1,0,3,Blue Jackets,0,0,0,0,0,20120119,0,2,3,3,3,-3,2011,0,3,333,0
Canadiens,2,2,0,0,4,Penguins,1,1,2,1,5,20120120,-1,-2,0,1,9,1,2011,1,4,474,0
Capitals,0,0,0,0,0,Hurricanes,1,1,1,0,3,20120120,1,2,3,3,3,3,2011,0,4,233,0
Lightning,1,0,1,0,2,Stars,0,0,1,0,1,20120120,1,1,1,1,3,-1,2011,0,4,916,0
Panthers,0,0,1,0,1,Blackhawks,2,1,0,0,3,20120120,2,3,2,2,4,2,2011,0,4,1189,0
Avalanche,0,2,1,0,3,Kings,0,1,0,0,1,20120121,0,1,2,2,4,-2,2011,0,5,830,0
Panthers,2,0,1,1,4,Jets,0,1,2,0,3,20120121,2,1,0,1,7,-1,2011,1,5,1899,0
Flames,3,1,2,0,6,Oilers,0,0,2,0,2,20120121,3,4,4,4,8,-4,2011,0,5,171,0
Stars,1,1,0,0,2,Wild,0,4,1,0,5,20120121,-1,2,3,3,7,3,2011,0,5,863,0
Lightning,2,2,0,0,4,Coyotes,0,1,2,0,3,20120121,2,3,1,1,7,-1,2011,0,5,1793,0
Blackhawks,1,0,1,0,2,Predators,1,3,1,0,5,20120121,0,3,3,3,7,3,2011,0,5,395,0
Blue Jackets,1,1,0,0,2,Red Wings,1,1,0,1,3,20120121,0,0,0,1,5,1,2011,1,5,163,0
Sabres,1,0,1,0,2,Blues,0,2,2,0,4,20120121,-1,1,2,2,6,2,2011,0,5,660,0
Canadiens,1,0,2,0,3,Maple Leafs,1,0,0,0,1,20120121,0,0,2,2,4,-2,2011,0,5,303,0
Hurricanes,1,0,0,0,1,Islanders,0,1,0,1,2,20120121,-1,0,0,1,3,1,2011,1,5,423,0
Senators,0,0,1,0,1,Ducks,0,2,0,0,2,20120121,0,2,1,1,3,1,2011,0,5,2345,0
Sharks,1,1,1,0,3,Canucks,1,1,2,0,4,20120121,0,0,1,1,7,1,2011,0,5,821,0
Flyers,0,2,2,0,4,Devils,0,1,0,0,1,20120121,0,1,3,3,5,-3,2011,0,5,75,0
Rangers,0,2,0,1,3,Bruins,0,2,0,0,2,20120121,0,0,0,1,5,-1,2011,1,5,190,0
Bruins,3,0,2,1,6,Flyers,1,3,1,0,5,20120122,2,-1,0,1,11,-1,2011,1,6,270,0
Avalanche,0,0,2,0,2,Ducks,1,0,2,0,3,20120122,1,1,1,1,5,1,2011,0,6,830,0
Capitals,0,2,1,0,3,Penguins,2,0,1,1,4,20120122,2,0,0,1,7,1,2011,1,6,190,0
Islanders,0,0,0,0,0,Maple Leafs,1,0,2,0,3,20120123,1,1,3,3,3,3,2011,0,0,341,0
Jets,0,1,0,0,1,Hurricanes,2,0,0,0,2,20120123,2,1,1,1,3,1,2011,0,0,1350,0
Blues,1,0,0,0,1,Red Wings,0,2,1,0,3,20120123,-1,1,2,2,4,2,2011,0,0,454,0
Blue Jackets,0,1,0,0,1,Predators,1,1,2,0,4,20120123,1,1,3,3,5,3,2011,0,0,333,0
Sharks,0,0,1,0,1,Oilers,0,1,0,1,2,20120123,0,1,0,1,3,1,2011,1,0,1190,0
Senators,0,0,1,0,1,Kings,1,3,0,0,4,20120123,1,4,3,3,5,3,2011,0,0,2345,0
Wild,2,0,1,0,3,Avalanche,1,1,0,0,2,20120124,1,0,1,1,5,-1,2011,0,1,698,0
Oilers,0,1,1,0,2,Canucks,1,0,1,1,3,20120124,1,0,0,1,5,1,2011,1,1,514,0
Ducks,0,0,0,0,0,Stars,1,0,0,0,1,20120124,1,1,1,1,1,1,2011,0,1,1237,0
Predators,2,0,1,0,3,Blackhawks,0,0,1,0,1,20120124,2,2,2,2,4,-2,2011,0,1,395,0
Penguins,0,2,0,1,3,Blues,0,1,1,0,2,20120124,0,1,0,1,5,-1,2011,1,1,557,0
Flyers,2,0,0,1,3,Panthers,1,1,0,0,2,20120124,1,0,0,1,5,-1,2011,1,1,1021,0
Maple Leafs,0,1,2,1,4,Islanders,1,1,1,0,3,20120124,-1,-1,0,1,7,-1,2011,1,1,341,0
Bruins,1,2,0,0,3,Capitals,0,3,2,0,5,20120124,-1,0,2,2,8,2,2011,0,1,394,0
Jets,0,0,0,0,0,Rangers,1,1,1,0,3,20120124,1,2,3,3,3,3,2011,0,1,1287,0
Sharks,0,0,1,0,1,Flames,0,0,0,0,0,20120124,0,0,1,1,1,-1,2011,0,1,1027,0
Sabres,1,0,0,1,2,Devils,0,1,0,0,1,20120124,1,0,0,1,3,-1,2011,1,1,284,0
Blue Jackets,1,0,1,0,2,Lightning,1,2,1,0,4,20120124,0,2,2,2,6,2,2011,0,1,830,0
Senators,0,1,1,0,2,Coyotes,1,1,1,0,3,20120124,1,1,1,1,5,1,2011,0,1,2071,0
Red Wings,0,0,2,0,2,Canadiens,4,2,1,0,7,20120125,4,6,5,5,9,5,2011,0,2,508,0
Ducks,0,3,1,0,4,Coyotes,1,0,0,0,1,20120131,-1,2,3,3,5,-3,2011,0,1,356,0
Blue Jackets,0,0,0,0,0,Sharks,2,2,2,0,6,20120131,2,4,6,6,6,6,2011,0,1,2090,0
Blackhawks,1,0,1,0,2,Canucks,1,0,1,1,3,20120131,0,0,0,1,5,1,2011,1,1,1775,0
Avalanche,0,1,1,0,2,Oilers,2,0,1,0,3,20120131,2,1,1,1,5,1,2011,0,1,1036,0
Predators,0,1,4,0,5,Wild,2,1,1,0,4,20120131,-2,-2,1,1,9,-1,2011,0,1,696,0
Capitals,1,1,1,0,3,Lightning,1,2,0,1,4,20120131,0,1,0,1,7,1,2011,1,1,818,0
Red Wings,1,0,2,0,3,Flames,0,1,0,0,1,20120131,1,0,2,2,4,-2,2011,0,1,1573,0
Islanders,1,1,3,0,5,Hurricanes,0,0,2,0,2,20120131,1,2,3,3,7,-3,2011,0,1,423,0
Maple Leafs,0,2,2,0,4,Penguins,0,1,3,1,5,20120131,0,-1,0,1,9,1,2011,1,1,222,0
Jets,0,1,0,1,2,Flyers,1,0,0,0,1,20120131,-1,0,0,1,3,-1,2011,1,1,1273,0
Rangers,1,0,2,0,3,Devils,0,1,2,1,4,20120131,-1,0,0,1,7,1,2011,1,1,8,0
Senators,1,2,0,0,3,Bruins,1,1,2,0,4,20120131,0,-1,1,1,7,1,2011,0,1,320,0
Sabres,0,1,2,0,3,Canadiens,1,0,0,0,1,20120131,-1,0,2,2,4,-2,2011,0,1,311,0
Stars,3,1,2,0,6,Ducks,1,1,0,0,2,20120201,2,2,4,4,8,-4,2011,0,2,1237,0
Rangers,0,0,0,1,1,Sabres,0,0,0,0,0,20120201,0,0,0,1,1,-1,2011,1,2,292,0
Penguins,0,0,0,0,0,Maple Leafs,0,0,1,0,1,20120201,0,0,1,1,1,1,2011,0,2,222,0
Capitals,0,1,1,0,2,Panthers,0,1,3,0,4,20120201,0,0,2,2,6,2,2011,0,2,924,0
Blue Jackets,0,1,1,0,2,Kings,1,1,1,0,3,20120201,1,1,1,1,5,1,2011,0,2,1973,0
Blackhawks,1,2,1,0,4,Oilers,0,3,5,0,8,20120202,-1,0,4,4,12,4,2011,0,3,1437,0
Red Wings,1,1,1,1,4,Canucks,1,0,2,0,3,20120202,0,1,0,1,7,-1,2011,1,3,1967,0
Wild,1,0,0,0,1,Avalanche,0,0,0,0,0,20120202,1,1,1,1,1,-1,2011,0,3,698,0
Stars,0,1,1,0,2,Sharks,2,2,1,0,5,20120202,2,3,3,3,7,3,2011,0,3,1449,0
Predators,0,0,1,0,1,Flyers,1,1,2,0,4,20120202,1,2,3,3,5,3,2011,0,3,683,0
Canadiens,2,1,0,0,3,Devils,1,1,3,0,5,20120202,-1,-1,2,2,8,2,2011,0,3,342,0
Hurricanes,1,1,1,0,3,Bruins,0,0,0,0,0,20120202,1,2,3,3,3,-3,2011,0,3,609,0
Jets,0,1,0,1,2,Lightning,0,0,1,0,1,20120202,0,1,0,1,3,-1,2011,1,3,1705,0
Islanders,0,0,1,1,2,Senators,0,1,0,0,1,20120203,0,-1,0,1,3,-1,2011,1,4,334,0
Jets,0,1,0,0,1,Panthers,1,1,0,0,2,20120203,1,1,1,1,3,1,2011,0,4,1899,0
Kings,0,0,0,0,0,Blues,0,1,0,0,1,20120203,0,1,1,1,1,1,2011,0,4,1586,0
Blackhawks,1,0,0,0,1,Flames,1,1,1,0,3,20120203,0,1,2,2,4,2,2011,0,4,1397,0
Blue Jackets,0,1,1,1,3,Ducks,1,1,0,0,2,20120203,-1,-1,0,1,5,-1,2011,1,4,1973,0
Panthers,1,2,0,0,3,Lightning,1,4,1,0,6,20120204,0,2,3,3,9,3,2011,0,5,205,0
Red Wings,1,0,3,0,4,Oilers,3,0,1,1,5,20120204,2,2,0,1,9,1,2011,1,5,1592,0
Sharks,0,2,1,0,3,Coyotes,0,3,2,0,5,20120204,0,1,2,2,8,2,2011,0,5,614,0
Wild,0,0,1,0,1,Stars,0,1,0,1,2,20120204,0,1,0,1,3,1,2011,1,5,863,0
Blues,0,0,1,0,1,Predators,2,0,1,0,3,20120204,2,2,2,2,4,2,2011,0,5,253,0
Kings,1,0,0,0,1,Hurricanes,0,1,1,0,2,20120204,-1,0,1,1,3,1,2011,0,5,2231,0
Canucks,1,0,1,1,3,Avalanche,1,1,0,0,2,20120204,0,-1,0,1,5,-1,2011,1,5,1105,0
Maple Leafs,2,1,2,0,5,Senators,0,0,0,0,0,20120204,2,3,5,5,5,-5,2011,0,5,203,0
Capitals,1,0,2,0,3,Canadiens,0,0,0,0,0,20120204,1,1,3,3,3,-3,2011,0,5,495,0
Devils,3,3,0,0,6,Flyers,0,0,4,0,4,20120204,3,6,2,2,10,-2,2011,0,5,75,0
Penguins,1,0,1,0,2,Bruins,0,0,1,0,1,20120204,1,1,1,1,3,-1,2011,0,5,481,0
Sabres,1,1,1,1,4,Islanders,3,0,0,0,3,20120204,-2,-1,0,1,7,-1,2011,1,5,292,0
Jets,0,0,0,0,0,Canadiens,1,2,0,0,3,20120205,1,3,3,3,3,3,2011,0,6,1115,0
Penguins,0,1,1,0,2,Devils,2,2,1,0,5,20120205,2,3,3,3,7,3,2011,0,6,306,0
Flyers,0,1,1,0,2,Rangers,1,1,3,0,5,20120205,1,1,3,3,7,3,2011,0,6,80,0
Bruins,2,0,2,0,4,Capitals,0,0,1,0,1,20120205,2,2,3,3,5,-3,2011,0,6,394,0
Oilers,2,1,0,0,3,Maple Leafs,2,3,1,0,6,20120206,0,2,3,3,9,3,2011,0,0,1683,0
Red Wings,0,1,0,0,1,Coyotes,1,1,1,0,3,20120206,1,1,2,2,4,2,2011,0,0,1687,0
Flames,0,1,1,0,2,Ducks,2,0,0,1,3,20120206,2,1,0,1,5,1,2011,1,0,1197,0
Canucks,3,0,0,1,4,Predators,1,2,0,0,3,20120207,2,0,0,1,7,-1,2011,1,1,2030,0
Blackhawks,0,2,0,0,2,Avalanche,0,2,3,0,5,20120207,0,0,3,3,7,3,2011,0,1,916,0
Coyotes,1,1,2,0,4,Stars,0,1,0,0,1,20120207,1,1,3,3,5,-3,2011,0,1,884,0
Maple Leafs,1,0,0,0,1,Jets,1,1,0,0,2,20120207,0,1,1,1,3,1,2011,0,1,946,0
Blues,2,1,0,0,3,Senators,0,1,0,0,1,20120207,2,2,2,2,4,-2,2011,0,1,860,0
Kings,1,2,0,0,3,Lightning,0,1,0,0,1,20120207,1,2,2,2,4,-2,2011,0,1,2149,0
Wild,1,0,0,0,1,Blue Jackets,1,1,1,0,3,20120207,0,1,2,2,4,2,2011,0,1,626,0
Panthers,0,0,0,0,0,Capitals,2,2,0,0,4,20120207,2,4,4,4,4,4,2011,0,1,924,0
Islanders,0,0,0,1,1,Flyers,0,0,0,0,0,20120207,0,0,0,1,1,-1,2011,1,1,80,0
Devils,1,0,0,0,1,Rangers,0,0,0,0,0,20120207,1,1,1,1,1,-1,2011,0,1,8,0
Penguins,0,0,2,0,2,Canadiens,0,1,1,1,3,20120207,0,1,0,1,5,1,2011,1,1,474,0
Bruins,0,0,0,0,0,Sabres,2,2,2,0,6,20120208,2,4,6,6,6,6,2011,0,2,399,0
Oilers,0,1,1,0,2,Red Wings,1,1,2,0,4,20120208,1,1,2,2,6,2,2011,0,2,1592,0
Hurricanes,1,0,1,0,2,Ducks,0,1,1,1,3,20120208,-1,0,0,1,5,1,2011,1,2,2231,0
Flames,1,2,1,0,4,Sharks,0,2,1,0,3,20120208,1,1,1,1,7,-1,2011,0,2,1027,0
Canucks,2,1,2,0,5,Wild,1,0,1,0,2,20120209,1,2,3,3,7,-3,2011,0,3,1427,0
Kings,0,0,1,0,1,Panthers,0,2,1,0,3,20120209,0,2,2,2,4,2,2011,0,3,2335,0
Predators,1,1,1,0,3,Senators,1,2,1,0,4,20120209,0,1,1,1,7,1,2011,0,3,845,0
Stars,2,1,1,0,4,Blue Jackets,0,2,0,0,2,20120209,2,1,2,2,6,-2,2011,0,3,912,0
Jets,0,0,2,1,3,Capitals,0,0,2,0,2,20120209,0,0,0,1,5,-1,2011,1,3,1247,0
Blues,1,1,1,1,4,Devils,1,2,0,0,3,20120209,0,-1,0,1,7,-1,2011,1,3,863,0
Lightning,1,2,0,0,3,Rangers,0,2,1,1,4,20120209,-1,-1,0,1,7,1,2011,1,3,1004,0
Canadiens,1,1,2,0,4,Islanders,0,0,2,0,2,20120209,1,2,2,2,6,-2,2011,0,3,343,0
Flames,0,0,1,0,1,Coyotes,1,0,0,1,2,20120209,1,1,0,1,3,1,2011,1,3,1224,0
Maple Leafs,0,3,0,0,3,Flyers,1,3,0,0,4,20120209,1,1,1,1,7,1,2011,0,3,334,0
Blackhawks,0,2,1,0,3,Sharks,2,1,2,0,5,20120210,2,1,2,2,8,2,2011,0,4,1837,0
Ducks,1,0,0,0,1,Red Wings,1,0,0,1,2,20120210,0,0,0,1,3,1,2011,1,4,1979,0
Hurricanes,2,1,0,0,3,Avalanche,1,2,0,1,4,20120210,-1,0,0,1,7,1,2011,1,4,1459,0
Stars,1,0,1,0,2,Sabres,0,0,2,1,3,20120210,-1,-1,0,1,5,1,2011,1,4,1197,0
Predators,0,1,2,0,3,Bruins,1,0,2,1,4,20120211,1,0,0,1,7,1,2011,1,5,941,0
Panthers,1,1,1,0,3,Devils,1,0,0,0,1,20120211,0,1,2,2,4,-2,2011,0,5,1090,0
Kings,0,1,0,0,1,Islanders,1,0,0,1,2,20120211,1,0,0,1,3,1,2011,1,5,2445,0
Rangers,2,1,2,0,5,Flyers,1,1,0,0,2,20120211,1,1,3,3,7,-3,2011,0,5,80,0
Jets,2,1,2,0,5,Penguins,2,3,3,0,8,20120211,0,2,3,3,13,3,2011,0,5,1060,0
Oilers,0,2,1,1,4,Senators,1,1,1,0,3,20120211,-1,0,0,1,7,-1,2011,1,5,1754,0
Lightning,0,2,0,0,2,Sabres,0,0,1,0,1,20120211,0,2,1,1,3,-1,2011,0,5,1051,0
Canadiens,0,4,1,0,5,Maple Leafs,0,0,0,0,0,20120211,0,4,5,5,5,-5,2011,0,5,303,0
Avalanche,2,0,0,0,2,Blues,2,0,0,1,3,20120211,0,0,0,1,5,1,2011,1,5,794,0
Blue Jackets,1,1,1,0,3,Wild,1,0,0,0,1,20120211,0,1,2,2,4,-2,2011,0,5,626,0
Blackhawks,0,0,0,0,0,Coyotes,2,1,0,0,3,20120211,2,3,3,3,3,3,2011,0,5,1450,0
Canucks,0,1,1,0,2,Flames,1,1,0,1,3,20120211,1,1,0,1,5,1,2011,1,5,426,0
Flyers,1,2,0,0,3,Red Wings,1,2,1,0,4,20120212,0,0,1,1,7,1,2011,0,6,441,0
Sharks,0,0,0,0,0,Blues,1,1,1,0,3,20120212,1,2,3,3,3,3,2011,0,6,1719,0
Kings,1,1,2,0,4,Stars,0,1,1,0,2,20120212,1,1,2,2,6,-2,2011,0,6,1237,0
Lightning,2,0,0,0,2,Penguins,1,3,0,0,4,20120212,-1,2,2,2,6,2,2011,0,6,874,0
Panthers,1,3,0,0,4,Islanders,1,0,0,0,1,20120212,0,3,3,3,5,-3,2011,0,6,1091,0
Capitals,0,1,1,0,2,Rangers,1,1,1,0,3,20120212,1,1,1,1,5,1,2011,0,6,204,0
Ducks,2,3,0,0,5,Blue Jackets,1,1,1,0,3,20120212,1,3,2,2,8,-2,2011,0,6,1973,0
Sharks,1,2,2,0,5,Capitals,0,1,2,0,3,20120213,1,2,2,2,8,-2,2011,0,0,2416,0
Hurricanes,1,1,3,0,5,Canadiens,0,3,0,0,3,20120213,1,-1,2,2,8,-2,2011,0,0,727,0
Coyotes,0,0,1,0,1,Canucks,0,1,0,1,2,20120213,0,1,0,1,3,1,2011,1,0,1228,0
Maple Leafs,1,0,0,0,1,Flames,2,1,2,0,5,20120214,1,2,4,4,6,4,2011,0,1,1682,0
Islanders,0,1,2,0,3,Jets,1,0,0,0,1,20120214,-1,0,2,2,4,-2,2011,0,1,1287,0
Blackhawks,1,0,1,0,2,Predators,1,1,1,0,3,20120214,0,1,1,1,5,1,2011,0,1,395,0
Ducks,0,0,2,0,2,Wild,1,0,0,0,1,20120214,-1,-1,1,1,3,-1,2011,0,1,1521,0
Stars,0,0,1,0,1,Red Wings,2,0,1,0,3,20120214,2,2,2,2,4,2,2011,0,1,999,0
Senators,1,1,2,0,4,Lightning,0,0,0,0,0,20120214,1,2,4,4,4,-4,2011,0,1,1251,0
Devils,1,0,3,0,4,Sabres,0,1,0,0,1,20120214,1,0,3,3,5,-3,2011,0,1,284,0
Rangers,2,0,1,0,3,Bruins,0,0,0,0,0,20120214,2,2,3,3,3,-3,2011,0,1,190,0
Blues,1,0,0,0,1,Blue Jackets,1,0,1,0,2,20120214,0,0,1,1,3,1,2011,0,1,395,0
Maple Leafs,2,0,1,1,4,Oilers,1,1,1,0,3,20120215,1,0,0,1,7,-1,2011,1,2,1683,0
Ducks,0,1,1,0,2,Penguins,1,0,0,0,1,20120215,-1,0,1,1,3,-1,2011,0,2,2132,0
Bruins,1,2,0,1,4,Canadiens,0,1,2,0,3,20120215,1,2,0,1,7,-1,2011,1,2,270,0
Senators,1,3,2,0,6,Panthers,1,0,1,0,2,20120215,0,3,4,4,8,-4,2011,0,2,1370,0
Avalanche,0,1,0,0,1,Canucks,1,0,2,0,3,20120215,1,0,2,2,4,2,2011,0,2,1105,0
Jets,1,1,1,1,4,Wild,1,1,1,0,3,20120216,0,0,0,1,7,-1,2011,1,3,388,0
Coyotes,0,1,0,0,1,Kings,0,0,0,0,0,20120216,0,1,1,1,1,-1,2011,0,3,356,0
Flames,1,0,1,0,2,Stars,1,1,0,1,3,20120216,0,1,0,1,5,1,2011,1,3,1536,0
Islanders,1,0,0,0,1,Blues,2,3,0,0,5,20120216,1,4,4,4,6,4,2011,0,3,871,0
Sabres,2,0,0,0,2,Flyers,0,4,3,0,7,20120216,-2,2,5,5,9,5,2011,0,3,279,0
Blackhawks,4,0,0,0,4,Rangers,0,1,1,0,2,20120216,4,3,2,2,6,-2,2011,0,3,711,0
Sharks,1,3,1,0,5,Lightning,2,1,2,1,6,20120216,1,-1,0,1,11,1,2011,1,3,2365,0
Ducks,0,1,1,0,2,Devils,0,2,0,1,3,20120217,0,1,0,1,5,1,2011,1,4,2436,0
Sharks,0,0,2,0,2,Hurricanes,2,0,1,0,3,20120217,2,2,1,1,5,1,2011,0,4,2382,0
Canadiens,2,1,0,1,4,Sabres,2,0,1,0,3,20120217,0,1,0,1,7,-1,2011,1,4,311,0
Capitals,0,0,2,0,2,Panthers,1,0,0,0,1,20120217,-1,-1,1,1,3,-1,2011,0,4,924,0
Predators,0,1,0,0,1,Red Wings,1,0,1,0,2,20120217,1,0,1,1,3,1,2011,0,4,470,0
Bruins,0,1,1,0,2,Jets,0,2,2,0,4,20120217,0,1,2,2,6,2,2011,0,4,1349,0
Avalanche,1,2,0,0,3,Oilers,0,1,0,0,1,20120217,1,2,2,2,4,-2,2011,0,4,1036,0
Flames,0,0,1,0,1,Kings,0,0,0,0,0,20120218,0,0,1,1,1,-1,2011,0,5,1197,0
Stars,0,1,0,0,1,Coyotes,1,0,0,1,2,20120218,1,0,0,1,3,1,2011,1,5,884,0
Maple Leafs,0,1,1,0,2,Canucks,2,3,1,0,6,20120218,2,4,4,4,8,4,2011,0,5,2090,0
Capitals,0,1,0,0,1,Lightning,1,1,0,0,2,20120218,1,1,1,1,3,1,2011,0,5,818,0
Hurricanes,1,2,0,0,3,Islanders,1,2,1,0,4,20120218,0,0,1,1,7,1,2011,0,5,423,0
Blackhawks,2,2,2,0,6,Blue Jackets,1,0,0,0,1,20120218,1,3,5,5,7,-5,2011,0,5,275,0
Penguins,1,2,3,0,6,Flyers,2,1,1,0,4,20120218,-1,0,2,2,10,-2,2011,0,5,257,0
Wild,0,0,0,0,0,Blues,1,2,1,0,4,20120218,1,3,4,4,4,4,2011,0,5,466,0
Avalanche,0,1,0,0,1,Jets,0,3,2,0,5,20120219,0,2,4,4,6,4,2011,0,6,797,0
Penguins,0,1,1,0,2,Sabres,2,1,3,0,6,20120219,2,2,4,4,8,4,2011,0,6,178,0
Sharks,0,1,1,0,2,Red Wings,1,1,1,0,3,20120219,1,1,1,1,5,1,2011,0,6,2071,0
Blues,1,0,0,0,1,Blackhawks,0,0,3,0,3,20120219,-1,-1,2,2,4,2,2011,0,6,260,0
Bruins,0,0,0,0,0,Wild,0,2,0,0,2,20120219,0,2,2,2,2,2,2011,0,6,1120,0
Devils,1,1,1,0,3,Canadiens,0,0,1,0,1,20120219,1,2,2,2,4,-2,2011,0,6,342,0
Ducks,1,0,1,0,2,Panthers,0,0,0,0,0,20120219,1,1,2,2,2,-2,2011,0,6,2335,0
Predators,2,1,0,0,3,Stars,1,0,1,0,2,20120219,1,2,1,1,5,-1,2011,0,6,616,0
Blue Jackets,0,1,1,0,2,Rangers,1,1,0,1,3,20120219,1,1,0,1,5,1,2011,1,6,476,0
Canucks,2,2,1,0,5,Oilers,0,2,0,0,2,20120219,2,2,3,3,7,-3,2011,0,6,514,0
Capitals,0,0,0,0,0,Hurricanes,3,1,1,0,5,20120220,3,4,5,5,5,5,2011,0,0,233,0
Senators,3,1,2,0,6,Islanders,0,0,0,0,0,20120220,3,4,6,6,6,-6,2011,0,0,334,0
Red Wings,1,0,0,0,1,Blackhawks,0,1,1,0,2,20120221,-1,0,1,1,3,1,2011,0,1,238,0
Islanders,0,0,1,0,1,Sabres,1,1,0,0,2,20120221,1,2,1,1,3,1,2011,0,1,292,0
Devils,2,1,0,1,4,Maple Leafs,1,1,1,0,3,20120221,1,1,0,1,7,-1,2011,1,1,333,0
Rangers,0,0,0,0,0,Penguins,0,2,0,0,2,20120221,0,2,2,2,2,2,2011,0,1,314,0
Sharks,0,2,1,0,3,Blue Jackets,4,1,1,0,6,20120221,4,3,3,3,9,3,2011,0,1,2090,0
Flyers,1,2,1,1,5,Jets,1,2,1,0,4,20120221,0,0,0,1,9,-1,2011,1,1,1273,0
Stars,1,0,2,0,3,Canadiens,0,0,0,0,0,20120221,1,1,3,3,3,-3,2011,0,1,1505,0
Ducks,0,2,0,0,2,Lightning,2,1,0,0,3,20120221,2,1,1,1,5,1,2011,0,1,2149,0
Canucks,0,1,0,0,1,Predators,0,2,1,0,3,20120221,0,1,2,2,4,2,2011,0,1,2030,0
Oilers,1,4,1,0,6,Flames,1,0,0,0,1,20120221,0,4,5,5,7,-5,2011,0,1,171,0
Kings,3,1,0,0,4,Coyotes,0,3,1,1,5,20120221,-3,-1,0,1,9,1,2011,1,1,356,0
Capitals,0,0,2,0,2,Senators,2,2,1,0,5,20120222,2,4,3,3,7,3,2011,0,2,446,0
Bruins,3,0,1,0,4,Blues,2,0,0,0,2,20120222,1,1,2,2,6,-2,2011,0,2,1035,0
Kings,0,0,1,0,1,Avalanche,3,1,0,0,4,20120222,3,4,3,3,5,3,2011,0,2,830,0
Coyotes,0,2,1,1,4,Flames,2,0,1,0,3,20120223,-2,0,0,1,7,-1,2011,1,3,1224,0
Stars,0,0,3,0,3,Blackhawks,0,1,0,0,1,20120223,0,-1,2,2,4,-2,2011,0,3,802,0
Lightning,0,0,3,0,3,Jets,2,2,0,0,4,20120223,2,4,1,1,7,1,2011,0,3,1705,0
Flyers,0,0,0,0,0,Oilers,0,2,0,0,2,20120223,0,2,2,2,2,2,2011,0,3,2011,0
Blues,1,1,0,1,3,Predators,0,2,0,0,2,20120223,1,0,0,1,5,-1,2011,1,3,253,0
Ducks,1,0,1,1,3,Hurricanes,1,1,0,0,2,20120223,0,-1,0,1,5,-1,2011,1,3,2231,0
Wild,0,1,1,1,3,Panthers,0,1,1,0,2,20120223,0,0,0,1,5,-1,2011,1,3,1513,0
Sharks,0,2,0,0,2,Maple Leafs,0,0,1,0,1,20120223,0,2,1,1,3,-1,2011,0,3,2249,0
Canucks,0,1,2,1,4,Red Wings,1,0,2,0,3,20120223,-1,0,0,1,7,-1,2011,1,3,1967,0
Canucks,1,1,0,0,2,Devils,0,1,0,0,1,20120224,1,1,1,1,3,-1,2011,0,4,2421,0
Rangers,1,2,0,0,3,Islanders,2,1,0,1,4,20120224,1,0,0,1,7,1,2011,1,4,0,0
Canadiens,0,0,1,0,1,Capitals,1,2,1,0,4,20120224,1,3,3,3,5,3,2011,0,4,495,0
Avalanche,1,1,3,0,5,Blue Jackets,0,0,0,0,0,20120224,1,2,5,5,5,-5,2011,0,4,1163,0
Bruins,0,0,1,0,1,Sabres,0,1,0,1,2,20120224,0,1,0,1,3,1,2011,1,4,399,0
Wild,0,0,1,0,1,Stars,2,1,1,0,4,20120224,2,3,3,3,5,3,2011,0,4,863,0
Flyers,0,2,2,1,5,Flames,2,1,1,0,4,20120225,-2,-1,0,1,9,-1,2011,1,5,2003,0
Panthers,0,0,2,1,3,Hurricanes,1,1,0,0,2,20120225,-1,-2,0,1,5,-1,2011,1,5,696,0
Sharks,1,1,0,0,2,Predators,3,1,2,0,6,20120225,2,2,4,4,8,4,2011,0,5,1934,0
Avalanche,2,1,1,0,4,Red Wings,0,0,3,0,3,20120225,2,3,1,1,7,-1,2011,0,5,1154,0
Sabres,1,0,1,0,2,Rangers,0,1,1,1,3,20120225,-1,0,0,1,5,1,2011,1,5,292,0
Blackhawks,0,0,0,0,0,Kings,2,2,0,0,4,20120225,2,4,4,4,4,4,2011,0,5,1741,0
Capitals,2,2,0,0,4,Maple Leafs,0,0,2,0,2,20120225,2,4,2,2,6,-2,2011,0,5,349,0
Coyotes,2,0,1,0,3,Oilers,0,0,1,0,1,20120225,2,2,2,2,4,-2,2011,0,5,1392,0
Blues,2,0,0,1,3,Jets,0,2,0,0,2,20120225,2,0,0,1,5,-1,2011,1,5,853,0
Lightning,0,1,0,0,1,Penguins,3,2,3,0,8,20120225,3,4,7,7,9,7,2011,0,5,874,0
Bruins,2,1,2,0,5,Senators,1,0,2,0,3,20120225,1,2,2,2,8,-2,2011,0,5,320,0
Blackhawks,1,0,0,0,1,Ducks,1,1,1,0,3,20120226,0,1,2,2,4,2,2011,0,6,1741,0
Canadiens,2,0,0,0,2,Panthers,1,2,1,0,4,20120226,-1,1,2,2,6,2,2011,0,6,1418,0
Sharks,2,0,1,0,3,Wild,1,1,2,0,4,20120226,-1,0,1,1,7,1,2011,0,6,1570,0
Islanders,1,0,1,0,2,Senators,0,2,3,0,5,20120226,-1,1,3,3,7,3,2011,0,6,334,0
Blue Jackets,0,1,1,0,2,Penguins,0,1,3,0,4,20120226,0,0,2,2,6,2,2011,0,6,161,0
Lightning,0,2,2,0,4,Devils,1,0,2,0,3,20120226,-1,1,1,1,7,-1,2011,0,6,1000,0
Canucks,0,2,0,0,2,Stars,0,1,1,1,3,20120226,0,-1,0,1,5,1,2011,1,6,1766,0
Devils,0,0,0,0,0,Rangers,1,0,1,0,2,20120227,1,1,2,2,2,2,2011,0,0,8,0
Kings,0,0,1,0,1,Predators,1,1,0,0,2,20120227,1,2,1,1,3,1,2011,0,0,1776,0
Oilers,0,1,4,0,5,Jets,0,2,1,0,3,20120227,0,-1,2,2,8,-2,2011,0,0,738,0
Ducks,0,1,0,0,1,Avalanche,1,0,3,0,4,20120227,1,0,3,3,5,3,2011,0,0,830,0
Blues,2,1,0,0,3,Flames,1,0,0,0,1,20120227,1,2,2,2,4,-2,2011,0,0,1440,0
Canucks,1,0,0,0,1,Coyotes,0,0,1,1,2,20120228,-1,-1,0,1,3,1,2011,1,1,1228,0
Flyers,0,0,0,0,0,Sharks,1,0,0,0,1,20120228,1,1,1,1,1,1,2011,0,1,2499,0
Canadiens,1,0,0,0,1,Lightning,1,1,0,0,2,20120228,0,1,1,1,3,1,2011,0,1,1311,0
Red Wings,1,0,4,0,5,Blue Jackets,1,0,1,0,2,20120228,0,0,3,3,7,-3,2011,0,1,163,0
Kings,3,1,0,0,4,Wild,0,0,0,0,0,20120228,3,4,4,4,4,-4,2011,0,1,1521,0
Islanders,1,0,1,0,2,Capitals,0,0,2,1,3,20120228,-1,-1,0,1,5,1,2011,1,1,204,0
Panthers,2,1,2,0,5,Maple Leafs,0,1,2,0,3,20120228,2,2,2,2,8,-2,2011,0,1,1234,0
Predators,1,1,1,0,3,Hurricanes,0,3,1,0,4,20120228,-1,1,1,1,7,1,2011,0,1,456,0
Senators,1,0,0,0,1,Bruins,0,0,0,0,0,20120228,1,1,1,1,1,-1,2011,0,1,320,0
Blues,1,2,2,0,5,Oilers,0,2,0,0,2,20120229,1,1,3,3,7,-3,2011,0,2,1508,0
Maple Leafs,3,0,1,0,4,Blackhawks,2,2,1,0,5,20120229,-1,1,1,1,9,1,2011,0,2,436,0
Sabres,1,1,0,0,2,Ducks,0,0,0,0,0,20120229,1,2,2,2,2,-2,2011,0,2,2193,0
Penguins,1,0,2,1,4,Stars,1,1,1,0,3,20120229,0,-1,0,1,7,-1,2011,1,2,1069,0
Sabres,1,0,0,0,1,Sharks,0,0,0,0,0,20120301,1,1,1,1,1,-1,2011,0,3,2279,0
Flames,3,0,1,0,4,Coyotes,0,2,0,0,2,20120301,3,1,2,2,6,-2,2011,0,3,1224,0
Devils,0,3,0,0,3,Bruins,2,0,1,1,4,20120301,2,-1,0,1,7,1,2011,1,3,196,0
Wild,1,0,3,0,4,Canadiens,2,1,1,1,5,20120301,1,2,0,1,9,1,2011,1,3,938,0
Islanders,1,1,1,0,3,Flyers,2,2,2,0,6,20120301,1,2,3,3,9,3,2011,0,3,80,0
Rangers,0,2,1,0,3,Hurricanes,0,1,1,0,2,20120301,0,1,1,1,5,-1,2011,0,3,423,0
Panthers,0,0,0,0,0,Jets,2,0,5,0,7,20120301,2,2,7,7,7,7,2011,0,3,1899,0
Blue Jackets,1,1,0,0,2,Avalanche,0,0,0,0,0,20120301,1,2,2,2,2,-2,2011,0,3,1163,0
Blues,0,0,0,0,0,Canucks,0,0,2,0,2,20120301,0,0,2,2,2,2,2011,0,3,1778,0
Stars,0,2,1,0,3,Oilers,0,0,1,0,1,20120302,0,2,2,2,4,-2,2011,0,4,1655,0
Wild,0,0,0,0,0,Red Wings,2,3,1,0,6,20120302,2,5,6,6,6,6,2011,0,4,542,0
Rangers,1,1,1,0,3,Lightning,0,1,2,1,4,20120302,-1,-1,0,1,7,1,2011,1,4,1004,0
Flames,1,0,1,0,2,Ducks,1,1,1,0,3,20120302,0,1,1,1,5,1,2011,0,4,1197,0
Devils,3,2,0,0,5,Capitals,0,0,0,0,0,20120302,3,5,5,5,5,-5,2011,0,4,198,0
Blackhawks,0,2,0,0,2,Senators,1,0,0,0,1,20120302,-1,1,1,1,3,-1,2011,0,4,628,0
Penguins,2,2,1,0,5,Avalanche,0,0,1,0,1,20120303,2,4,4,4,6,-4,2011,0,5,1317,0
Blues,2,1,0,0,3,Sharks,1,0,0,0,1,20120303,1,2,2,2,4,-2,2011,0,5,1719,0
Ducks,1,1,0,0,2,Kings,1,2,1,0,4,20120303,0,1,2,2,6,2,2011,0,5,0,0
Sabres,3,0,2,0,5,Canucks,0,1,2,0,3,20120303,3,2,2,2,8,-2,2011,0,5,2137,0
Blue Jackets,1,1,3,0,5,Coyotes,0,2,0,0,2,20120303,1,0,3,3,7,-3,2011,0,5,1664,0
Islanders,1,1,1,0,3,Bruins,1,0,1,0,2,20120303,0,1,1,1,5,-1,2011,0,5,190,0
Lightning,1,1,1,1,4,Hurricanes,0,3,0,0,3,20120303,1,-1,0,1,7,-1,2011,1,5,585,0
Maple Leafs,0,1,2,0,3,Canadiens,1,0,0,0,1,20120303,-1,0,2,2,4,-2,2011,0,5,303,0
Predators,1,1,1,0,3,Panthers,0,1,0,0,1,20120303,1,1,2,2,4,-2,2011,0,5,816,0
Avalanche,2,0,0,0,2,Wild,0,0,0,0,0,20120304,2,2,2,2,2,-2,2011,0,6,698,0
Stars,0,2,0,1,3,Flames,0,1,1,0,2,20120304,0,1,0,1,5,-1,2011,1,6,1536,0
Senators,2,0,0,0,2,Panthers,0,3,1,0,4,20120304,-2,1,2,2,6,2,2011,0,6,1370,0
Flyers,0,1,0,0,1,Capitals,0,0,0,0,0,20120304,0,1,1,1,1,-1,2011,0,6,123,0
Devils,0,0,0,0,0,Islanders,0,1,0,0,1,20120304,0,1,1,1,1,1,2011,0,6,8,0
Bruins,1,1,1,0,3,Rangers,2,0,2,0,4,20120304,1,0,1,1,7,1,2011,0,6,190,0
Blackhawks,1,1,0,0,2,Red Wings,1,0,0,0,1,20120304,0,1,1,1,3,-1,2011,0,6,238,0
Coyotes,0,0,1,0,1,Penguins,2,0,0,0,2,20120305,2,2,1,1,3,1,2011,0,0,1824,0
Sabres,0,1,0,0,1,Jets,1,0,2,0,3,20120305,1,0,2,2,4,2,2011,0,0,996,0
Oilers,0,1,1,0,2,Ducks,1,0,3,0,4,20120305,1,0,2,2,6,2,2011,0,0,1368,0
Kings,2,1,2,0,5,Predators,1,2,1,0,4,20120306,1,0,1,1,9,-1,2011,0,1,1776,0
Oilers,1,1,0,1,3,Sharks,1,1,0,0,2,20120306,0,0,0,1,5,-1,2011,1,1,1190,0
Stars,0,2,3,0,5,Canucks,0,1,1,0,2,20120306,0,1,3,3,7,-3,2011,0,1,1766,0
Canadiens,1,1,2,0,4,Flames,2,2,1,0,5,20120306,1,2,1,1,9,1,2011,0,1,1852,0
Wild,0,0,1,0,1,Avalanche,1,4,2,0,7,20120306,1,5,6,6,8,6,2011,0,1,698,0
Blackhawks,0,0,1,0,1,Blues,2,1,2,0,5,20120306,2,3,4,4,6,4,2011,0,1,260,0
Red Wings,1,0,1,0,2,Flyers,2,1,0,0,3,20120306,1,2,1,1,5,1,2011,0,1,441,0
Coyotes,1,1,0,0,2,Blue Jackets,2,1,0,0,3,20120306,1,1,1,1,5,1,2011,0,1,1664,0
Hurricanes,0,2,1,1,4,Capitals,1,1,1,0,3,20120306,-1,0,0,1,7,-1,2011,1,1,233,0
Rangers,0,1,0,0,1,Devils,1,0,3,0,4,20120306,1,0,3,3,5,3,2011,0,1,8,0
Bruins,1,4,0,0,5,Maple Leafs,1,2,1,0,4,20120306,0,2,1,1,9,-1,2011,0,1,430,0
Senators,3,1,3,0,7,Lightning,0,2,1,0,3,20120306,3,2,4,4,10,-4,2011,0,1,1251,0
Hurricanes,1,1,0,0,2,Sabres,0,2,0,1,3,20120307,-1,0,0,1,5,1,2011,1,2,491,0
Maple Leafs,0,2,0,0,2,Penguins,0,1,2,0,3,20120307,0,-1,1,1,5,1,2011,0,2,222,0
Ducks,0,1,0,0,1,Blues,0,1,2,0,3,20120308,0,0,2,2,4,2,2011,0,3,1586,0
Canadiens,1,1,3,0,5,Oilers,1,1,1,0,3,20120308,0,0,2,2,8,-2,2011,0,3,1826,0
Jets,0,1,1,0,2,Canucks,0,1,2,0,3,20120308,0,0,1,1,5,1,2011,0,3,1157,0
Sharks,0,1,2,0,3,Stars,0,1,2,1,4,20120308,0,0,0,1,7,1,2011,1,3,1449,0
Avalanche,1,0,1,0,2,Predators,2,1,1,0,4,20120308,1,2,2,2,6,2,2011,0,3,1019,0
Rangers,1,0,0,0,1,Senators,2,0,2,0,4,20120308,1,1,3,3,5,3,2011,0,3,334,0
Wild,2,0,0,1,3,Coyotes,0,0,2,0,2,20120308,2,2,0,1,5,-1,2011,1,3,1278,0
Lightning,0,2,0,0,2,Capitals,1,0,1,1,3,20120308,1,-1,0,1,5,1,2011,1,3,818,0
Panthers,0,0,0,0,0,Flyers,1,2,2,0,5,20120308,1,3,5,5,5,5,2011,0,3,1021,0
Islanders,0,1,0,0,1,Devils,1,1,3,0,5,20120308,1,1,4,4,6,4,2011,0,3,8,0
Sabres,1,0,0,0,1,Bruins,0,1,2,0,3,20120308,-1,0,2,2,4,2,2011,0,3,399,0
Kings,1,0,0,0,1,Blue Jackets,2,1,0,0,3,20120308,1,2,2,2,4,2,2011,0,3,1973,0
Panthers,0,1,0,0,1,Penguins,0,0,1,1,2,20120309,0,-1,0,1,3,1,2011,1,4,1013,0
Kings,2,0,1,0,3,Red Wings,1,1,2,0,4,20120309,-1,0,1,1,7,1,2011,0,4,1979,0
Rangers,1,0,2,0,3,Blackhawks,0,1,3,0,4,20120309,-1,0,1,1,7,1,2011,0,4,711,0
Jets,2,0,1,0,3,Flames,3,1,1,0,5,20120309,1,2,2,2,8,2,2011,0,4,740,0
Sharks,0,0,0,0,0,Coyotes,0,2,1,0,3,20120310,0,2,3,3,3,3,2011,0,5,614,0
Ducks,0,0,0,0,0,Stars,0,1,1,0,2,20120310,0,1,2,2,2,2,2011,0,5,1237,0
Red Wings,1,0,1,0,2,Predators,2,0,1,0,3,20120310,1,1,1,1,5,1,2011,0,5,470,0
Blue Jackets,0,1,0,0,1,Blues,1,2,1,0,4,20120310,1,2,3,3,5,3,2011,0,5,395,0
Hurricanes,2,0,2,0,4,Lightning,2,0,0,0,2,20120310,0,0,2,2,6,-2,2011,0,5,585,0
Canadiens,0,1,3,0,4,Canucks,0,1,0,0,1,20120310,0,0,3,3,5,-3,2011,0,5,2273,0
Sabres,0,2,1,1,4,Senators,1,1,1,0,3,20120310,-1,0,0,1,7,-1,2011,1,5,219,0
Flyers,0,0,0,1,1,Maple Leafs,0,0,0,0,0,20120310,0,0,0,1,1,-1,2011,1,5,334,0
Oilers,1,0,1,0,2,Avalanche,0,2,0,1,3,20120310,-1,1,0,1,5,1,2011,1,5,1036,0
Capitals,2,2,0,0,4,Bruins,1,1,1,0,3,20120310,1,2,1,1,7,-1,2011,0,5,394,0
Devils,0,0,2,0,2,Islanders,0,0,1,0,1,20120310,0,0,1,1,3,-1,2011,0,5,8,0
Kings,1,1,0,1,3,Blackhawks,0,1,1,0,2,20120311,1,1,0,1,5,-1,2011,1,6,1741,0
Flyers,0,0,1,0,1,Devils,1,0,3,0,4,20120311,1,1,3,3,5,3,2011,0,6,75,0
Flames,1,0,3,0,4,Wild,0,0,3,0,3,20120311,1,1,1,1,7,-1,2011,0,6,1043,0
Blues,0,1,1,0,2,Blue Jackets,0,1,0,0,1,20120311,0,0,1,1,3,-1,2011,0,6,395,0
Islanders,1,2,0,0,3,Rangers,1,1,1,1,4,20120311,0,-1,0,1,7,1,2011,1,6,0,0
Maple Leafs,0,0,0,0,0,Capitals,1,0,1,0,2,20120311,1,1,2,2,2,2,2011,0,6,349,0
Bruins,0,2,0,0,2,Penguins,3,1,1,0,5,20120311,3,2,3,3,7,3,2011,0,6,481,0
Hurricanes,0,0,0,0,0,Panthers,0,1,1,0,2,20120311,0,1,2,2,2,2,2011,0,6,696,0
Canadiens,1,0,1,0,2,Sabres,0,1,1,1,3,20120312,-1,0,0,1,5,1,2011,1,0,311,0
Ducks,0,1,1,0,2,Avalanche,1,0,1,1,3,20120312,1,0,0,1,5,1,2011,1,0,830,0
Sharks,1,1,1,0,3,Oilers,1,1,0,0,2,20120312,0,0,1,1,5,-1,2011,0,0,1190,0
Predators,1,2,1,1,5,Coyotes,0,2,2,0,4,20120312,1,1,0,1,9,-1,2011,1,0,1442,0
Blues,3,0,0,0,3,Blackhawks,1,1,1,1,4,20120313,-2,-1,0,1,7,1,2011,1,1,260,0
Red Wings,0,1,1,0,2,Kings,2,1,2,0,5,20120313,2,2,3,3,7,3,2011,0,1,1979,0
Capitals,0,2,2,1,5,Islanders,2,2,0,0,4,20120313,-2,-2,0,1,9,-1,2011,1,1,204,0
Devils,0,0,0,0,0,Flyers,0,1,2,0,3,20120313,0,1,3,3,3,3,2011,0,1,75,0
Hurricanes,0,2,0,0,2,Rangers,1,2,1,0,4,20120313,1,1,2,2,6,2,2011,0,1,423,0
Bruins,0,0,1,0,1,Lightning,4,1,1,0,6,20120313,4,5,5,5,7,5,2011,0,1,1183,0
Maple Leafs,0,1,1,0,2,Panthers,1,1,3,0,5,20120313,1,1,3,3,7,3,2011,0,1,1234,0
Stars,0,0,1,0,1,Wild,0,0,0,0,0,20120313,0,0,1,1,1,-1,2011,0,1,863,0
Sharks,1,0,1,0,2,Flames,0,2,0,1,3,20120313,-1,1,0,1,5,1,2011,1,1,1027,0
Red Wings,0,0,0,0,0,Ducks,0,3,1,0,4,20120314,0,3,4,4,4,4,2011,0,2,1979,0
Coyotes,2,2,1,0,5,Canucks,2,1,1,0,4,20120314,0,1,1,1,9,-1,2011,0,2,1228,0
Blue Jackets,0,0,0,0,0,Oilers,0,2,1,0,3,20120314,0,2,3,3,3,3,2011,0,2,1703,0
Stars,0,1,1,0,2,Jets,1,4,0,0,5,20120314,1,4,3,3,7,3,2011,0,2,1183,0
Avalanche,2,1,1,1,5,Sabres,2,1,1,0,4,20120314,0,0,0,1,9,-1,2011,1,2,1366,0
Senators,1,0,1,0,2,Canadiens,1,0,1,1,3,20120314,0,0,0,1,5,1,2011,1,2,104,0
Penguins,1,2,2,0,5,Rangers,1,1,0,0,2,20120315,0,1,3,3,7,-3,2011,0,3,314,0
Blues,0,0,0,0,0,Hurricanes,0,0,2,0,2,20120315,0,0,2,2,2,2,2011,0,3,665,0
Maple Leafs,1,2,0,0,3,Lightning,0,0,1,0,1,20120315,1,3,2,2,4,-2,2011,0,3,1096,0
Bruins,0,1,1,0,2,Panthers,1,3,2,0,6,20120315,1,3,4,4,8,4,2011,0,3,1257,0
Coyotes,0,1,0,0,1,Flames,1,2,1,0,4,20120315,1,2,3,3,5,3,2011,0,3,1224,0
Predators,1,0,0,0,1,Sharks,0,0,1,1,2,20120315,-1,-1,0,1,3,1,2011,1,3,1934,0
Avalanche,0,0,0,0,0,Devils,0,0,0,1,1,20120315,0,0,0,1,1,1,2011,1,3,1618,0
Flyers,2,1,0,0,3,Islanders,0,0,2,0,2,20120315,2,3,1,1,5,-1,2011,0,3,80,0
Kings,3,0,1,0,4,Ducks,0,1,1,0,2,20120316,3,2,2,2,6,-2,2011,0,4,0,0
Blackhawks,2,0,2,0,4,Stars,0,0,1,0,1,20120316,2,2,3,3,5,-3,2011,0,4,802,0
Capitals,1,0,1,0,2,Jets,1,1,1,0,3,20120316,0,1,1,1,5,1,2011,0,4,1247,0
Canadiens,1,0,0,0,1,Senators,0,0,1,1,2,20120316,-1,-1,0,1,3,1,2011,1,4,104,0
Flames,0,1,0,0,1,Oilers,2,0,1,0,3,20120316,2,1,2,2,4,2,2011,0,4,171,0
Blue Jackets,1,1,1,0,3,Canucks,2,1,1,0,4,20120317,1,1,1,1,7,1,2011,0,5,2050,0
Red Wings,1,0,1,0,2,Sharks,2,0,0,1,3,20120317,1,1,0,1,5,1,2011,1,5,2071,0
Predators,0,1,1,0,2,Kings,1,0,3,0,4,20120317,1,0,2,2,6,2,2011,0,5,1776,0
Sabres,1,1,0,0,2,Panthers,2,0,0,1,3,20120317,1,0,0,1,5,1,2011,1,5,1184,0
Penguins,1,3,1,0,5,Devils,1,0,1,0,2,20120317,0,3,3,3,7,-3,2011,0,5,306,0
Avalanche,1,1,1,0,3,Rangers,1,0,0,0,1,20120317,0,1,2,2,4,-2,2011,0,5,1627,0
Maple Leafs,0,1,2,0,3,Senators,0,0,1,0,1,20120317,0,1,2,2,4,-2,2011,0,5,203,0
Islanders,0,2,0,1,3,Canadiens,1,0,1,0,2,20120317,-1,1,0,1,5,-1,2011,1,5,343,0
Hurricanes,1,1,3,0,5,Wild,1,2,0,0,3,20120317,0,-1,2,2,8,-2,2011,0,5,995,0
Flyers,0,1,1,0,2,Bruins,2,0,0,1,3,20120317,2,1,0,1,5,1,2011,1,5,270,0
Blues,2,1,0,0,3,Lightning,0,0,1,0,1,20120317,2,3,2,2,4,-2,2011,0,5,861,0
Predators,0,0,3,0,3,Ducks,1,0,0,0,1,20120318,-1,-1,2,2,4,-2,2011,0,6,1776,0
Hurricanes,1,1,2,0,4,Jets,1,2,0,0,3,20120318,0,-1,1,1,7,-1,2011,0,6,1350,0
Blue Jackets,1,0,0,1,2,Flames,0,0,1,0,1,20120318,1,1,0,1,3,-1,2011,1,6,1670,0
Capitals,0,2,0,0,2,Blackhawks,2,2,1,0,5,20120318,2,2,3,3,7,3,2011,0,6,594,0
Penguins,1,1,0,0,2,Flyers,0,0,2,1,3,20120318,-1,-2,0,1,5,1,2011,1,6,257,0
Coyotes,0,0,2,1,3,Oilers,0,2,0,0,2,20120318,0,-2,0,1,5,-1,2011,1,6,1392,0
Ducks,2,3,0,0,5,Sharks,2,1,0,0,3,20120319,0,2,2,2,8,-2,2011,0,0,305,0
Canucks,0,0,0,0,0,Wild,1,0,1,0,2,20120319,1,1,2,2,2,2,2011,0,0,1427,0
Maple Leafs,0,0,0,0,0,Bruins,4,3,1,0,8,20120319,4,7,8,8,8,8,2011,0,0,430,0
Sabres,2,4,1,0,7,Lightning,0,2,1,0,3,20120319,2,4,4,4,10,-4,2011,0,0,1051,0
Capitals,3,1,1,0,5,Red Wings,0,1,2,0,3,20120319,3,3,2,2,8,-2,2011,0,0,394,0
Devils,0,2,0,0,2,Rangers,1,2,1,0,4,20120319,1,1,2,2,6,2,2011,0,0,8,0
Sharks,1,0,1,0,2,Kings,1,1,3,0,5,20120320,0,1,3,3,7,3,2011,0,1,305,0
Coyotes,1,0,2,0,3,Stars,1,2,0,1,4,20120320,0,2,0,1,7,1,2011,1,1,884,0
Oilers,2,3,1,0,6,Predators,1,1,1,0,3,20120320,1,3,3,3,9,-3,2011,0,1,1758,0
Flames,1,0,0,0,1,Avalanche,1,0,0,1,2,20120320,0,0,0,1,3,1,2011,1,1,898,0
Blackhawks,3,0,2,0,5,Blue Jackets,0,0,1,0,1,20120320,3,3,4,4,6,-4,2011,0,1,275,0
Jets,2,2,0,0,4,Penguins,2,4,2,0,8,20120320,0,2,4,4,12,4,2011,0,1,1060,0
Panthers,1,1,0,0,2,Flyers,0,1,0,0,1,20120320,1,1,1,1,3,-1,2011,0,1,1021,0
Devils,0,1,0,0,1,Senators,0,0,0,0,0,20120320,0,1,1,1,1,-1,2011,0,1,330,0
Islanders,1,1,3,0,5,Maple Leafs,1,1,0,0,2,20120320,0,0,3,3,7,-3,2011,0,1,341,0
Blues,2,0,1,0,3,Ducks,1,1,2,0,4,20120321,-1,0,1,1,7,1,2011,0,2,1586,0
Red Wings,1,0,0,0,1,Rangers,1,0,0,1,2,20120321,0,0,0,1,3,1,2011,1,2,480,0
Panthers,0,1,0,0,1,Hurricanes,1,1,1,0,3,20120321,1,1,2,2,4,2,2011,0,2,696,0
Canadiens,0,0,0,0,0,Sabres,1,1,1,0,3,20120321,1,2,3,3,3,3,2011,0,2,311,0
Canucks,1,0,0,0,1,Blackhawks,0,1,0,1,2,20120321,-1,0,0,1,3,1,2011,1,2,1775,0
Predators,0,1,0,0,1,Penguins,2,2,1,0,5,20120322,2,3,4,4,6,4,2011,0,3,471,0
Oilers,0,1,1,0,2,Lightning,0,2,0,1,3,20120322,0,1,0,1,5,1,2011,1,3,2367,0
Flames,1,1,0,0,2,Wild,0,1,1,1,3,20120322,-1,-1,0,1,5,1,2011,1,3,1043,0
Canucks,1,0,1,0,2,Stars,0,0,1,0,1,20120322,1,1,1,1,3,-1,2011,0,3,1766,0
Avalanche,0,0,2,0,2,Coyotes,2,1,0,0,3,20120322,2,3,1,1,5,1,2011,0,3,585,0
Blues,0,0,0,0,0,Kings,0,0,0,1,1,20120322,0,0,0,1,1,1,2011,1,3,1586,0
Bruins,0,0,1,0,1,Sharks,1,0,1,0,2,20120322,1,1,1,1,3,1,2011,0,3,2678,0
Capitals,1,0,0,0,1,Flyers,0,1,0,1,2,20120322,-1,0,0,1,3,1,2011,1,3,123,0
Hurricanes,0,1,0,0,1,Blue Jackets,1,2,2,0,5,20120323,1,2,4,4,6,4,2011,0,4,374,0
Maple Leafs,0,2,1,1,4,Devils,0,1,2,0,3,20120323,0,1,0,1,7,-1,2011,1,4,333,0
Sabres,0,2,2,0,4,Rangers,0,1,0,0,1,20120323,0,1,3,3,5,-3,2011,0,4,292,0
Jets,0,2,1,1,4,Capitals,1,2,0,0,3,20120323,-1,-1,0,1,7,-1,2011,1,4,1247,0
Senators,1,0,0,0,1,Canadiens,4,0,1,0,5,20120323,3,3,4,4,6,4,2011,0,4,104,0
Oilers,0,1,0,1,2,Panthers,0,1,0,0,1,20120323,0,0,0,1,3,-1,2011,1,4,2569,0
Canucks,0,2,0,1,3,Avalanche,1,1,0,0,2,20120324,-1,0,0,1,5,-1,2011,1,5,1105,0
Bruins,0,1,3,0,4,Kings,0,1,1,0,2,20120324,0,0,2,2,6,-2,2011,0,5,2590,0
Jets,0,0,1,0,1,Predators,0,2,1,0,3,20120324,0,2,2,2,4,2,2011,0,5,1084,0
Hurricanes,1,3,0,0,4,Red Wings,0,3,2,0,5,20120324,-1,-1,1,1,9,1,2011,0,5,511,0
Islanders,0,2,1,0,3,Lightning,1,1,2,0,4,20120324,1,0,1,1,7,1,2011,0,5,1004,0
Coyotes,2,1,0,0,3,Sharks,2,1,0,1,4,20120324,0,0,0,1,7,1,2011,1,5,614,0
Penguins,2,1,1,0,4,Senators,1,4,3,0,8,20120324,-1,2,4,4,12,4,2011,0,5,392,0
Rangers,1,1,1,1,4,Maple Leafs,1,1,1,0,3,20120324,0,0,0,1,7,-1,2011,1,5,341,0
Wild,1,0,0,0,1,Sabres,0,1,2,0,3,20120324,-1,0,2,2,4,2,2011,0,5,729,0
Flames,1,0,0,0,1,Stars,2,0,2,0,4,20120324,1,1,3,3,5,3,2011,0,5,1536,0
Canadiens,0,1,0,0,1,Flyers,1,2,1,0,4,20120324,1,2,3,3,5,3,2011,0,5,400,0
Blues,0,1,3,0,4,Coyotes,0,0,0,0,0,20120325,0,1,4,4,4,-4,2011,0,6,1270,0
Bruins,0,2,1,0,3,Ducks,0,1,1,0,2,20120325,0,1,1,1,5,-1,2011,0,6,2590,0
Devils,1,0,1,0,2,Penguins,2,1,2,0,5,20120325,1,2,3,3,7,3,2011,0,6,306,0
Predators,2,1,3,0,6,Blackhawks,0,0,1,0,1,20120325,2,3,5,5,7,-5,2011,0,6,395,0
Wild,0,0,0,0,0,Capitals,0,2,1,0,3,20120325,0,2,3,3,3,3,2011,0,6,931,0
Oilers,0,5,1,0,6,Blue Jackets,1,1,1,0,3,20120325,-1,3,3,3,9,-3,2011,0,6,1703,0
Islanders,0,1,1,1,3,Panthers,1,0,1,0,2,20120325,-1,0,0,1,5,-1,2011,1,6,1091,0
Lightning,2,0,3,0,5,Flyers,0,2,1,0,3,20120326,2,0,2,2,8,-2,2011,0,0,928,0
Blue Jackets,0,0,2,0,2,Red Wings,4,2,1,0,7,20120326,4,6,5,5,9,5,2011,0,0,163,0
Senators,1,2,3,0,6,Jets,0,3,1,0,4,20120326,1,0,2,2,10,-2,2011,0,0,1033,0
Stars,1,2,1,0,4,Flames,1,4,0,0,5,20120326,0,2,1,1,9,1,2011,0,0,1536,0
Kings,0,0,0,0,0,Canucks,1,0,0,0,1,20120326,1,1,1,1,1,1,2011,0,0,1076,0
Avalanche,0,1,0,0,1,Sharks,0,3,2,0,5,20120326,0,2,4,4,6,4,2011,0,0,927,0
Lightning,1,0,1,0,2,Bruins,1,1,3,0,5,20120327,0,1,3,3,7,3,2011,0,1,1183,0
Rangers,1,1,1,0,3,Wild,0,2,0,0,2,20120327,1,0,1,1,5,-1,2011,0,1,1016,0
Panthers,1,0,1,1,3,Canadiens,1,1,0,0,2,20120327,0,-1,0,1,5,-1,2011,1,1,1418,0
Sabres,2,2,1,0,5,Capitals,0,1,0,0,1,20120327,2,3,4,4,6,-4,2011,0,1,292,0
Predators,0,0,0,0,0,Blues,0,1,2,0,3,20120327,0,1,3,3,3,3,2011,0,1,253,0
Blackhawks,0,0,1,0,1,Devils,1,0,0,1,2,20120327,1,1,0,1,3,1,2011,1,1,703,0
Islanders,2,3,0,0,5,Penguins,0,2,1,0,3,20120327,2,3,2,2,8,-2,2011,0,1,314,0
Hurricanes,2,1,0,0,3,Maple Leafs,0,0,0,0,0,20120327,2,3,3,3,3,-3,2011,0,1,544,0
Sharks,0,1,0,0,1,Ducks,0,1,2,0,3,20120328,0,0,2,2,4,2,2011,0,2,305,0
Rangers,0,2,2,0,4,Jets,0,2,0,0,2,20120328,0,0,2,2,6,-2,2011,0,2,1287,0
Red Wings,1,0,1,0,2,Blue Jackets,2,2,0,0,4,20120328,1,3,2,2,6,2,2011,0,2,163,0
Kings,1,1,1,0,3,Flames,0,0,0,0,0,20120328,1,2,3,3,3,-3,2011,0,2,1197,0
Stars,1,1,1,0,3,Oilers,0,0,1,0,1,20120328,1,2,2,2,4,-2,2011,0,2,1655,0
Avalanche,0,0,0,0,0,Canucks,1,0,0,0,1,20120328,1,1,1,1,1,1,2011,0,2,1105,0
Sharks,0,0,0,0,0,Coyotes,0,1,1,0,2,20120329,0,1,2,2,2,2,2011,0,3,614,0
Blues,1,0,2,0,3,Blackhawks,1,0,2,1,4,20120329,0,0,0,1,7,1,2011,1,3,260,0
Panthers,0,1,1,0,2,Wild,0,0,2,1,3,20120329,0,-1,0,1,5,1,2011,1,3,1513,0
Penguins,0,1,2,0,3,Islanders,1,2,2,0,5,20120329,1,2,2,2,8,2,2011,0,3,314,0
Capitals,0,0,2,1,3,Bruins,0,0,2,0,2,20120329,0,0,0,1,5,-1,2011,1,3,394,0
Flyers,2,2,3,0,7,Maple Leafs,1,0,0,0,1,20120329,1,3,6,6,8,-6,2011,0,3,334,0
Lightning,1,2,1,0,4,Devils,0,4,2,0,6,20120329,-1,1,2,2,10,2,2011,0,3,1000,0
Predators,0,2,2,0,4,Red Wings,0,0,1,0,1,20120330,0,2,3,3,5,-3,2011,0,4,470,0
Kings,2,1,1,0,4,Oilers,1,0,0,0,1,20120330,1,2,3,3,5,-3,2011,0,4,1368,0
Avalanche,2,1,1,0,4,Flames,0,0,1,0,1,20120330,2,3,3,3,5,-3,2011,0,4,898,0
Stars,0,1,1,0,2,Canucks,1,2,2,0,5,20120330,1,2,3,3,7,3,2011,0,4,1766,0
Canadiens,0,0,1,0,1,Rangers,1,1,2,0,4,20120330,1,2,3,3,5,3,2011,0,4,343,0
Panthers,0,0,1,0,1,Blue Jackets,1,1,2,0,4,20120330,1,2,3,3,5,3,2011,0,4,993,0
Jets,1,1,1,1,4,Hurricanes,2,1,0,0,3,20120330,-1,-1,0,1,7,-1,2011,1,4,1350,0
Penguins,2,2,1,0,5,Sabres,2,1,0,0,3,20120330,0,1,2,2,8,-2,2011,0,4,178,0
Stars,0,0,0,0,0,Sharks,2,1,0,0,3,20120331,2,3,3,3,3,3,2011,0,5,1449,0
Flames,0,1,1,0,2,Canucks,1,0,1,1,3,20120331,1,0,0,1,5,1,2011,1,5,426,0
Ducks,0,0,0,0,0,Coyotes,1,3,0,0,4,20120331,1,4,4,4,4,4,2011,0,5,356,0
Kings,2,1,0,0,3,Wild,2,0,1,1,4,20120331,0,-1,0,1,7,1,2011,1,5,1521,0
Blackhawks,1,3,1,0,5,Predators,0,2,2,0,4,20120331,1,2,1,1,9,-1,2011,0,5,395,0
Blue Jackets,2,1,2,0,5,Blues,1,1,0,0,2,20120331,1,1,3,3,7,-3,2011,0,5,395,0
Devils,1,3,1,0,5,Hurricanes,0,0,0,0,0,20120331,1,4,5,5,5,-5,2011,0,5,419,0
Canadiens,1,1,0,0,2,Capitals,2,0,0,1,3,20120331,1,0,0,1,5,1,2011,1,5,495,0
Sabres,0,1,2,0,3,Maple Leafs,1,2,1,0,4,20120331,1,2,1,1,7,1,2011,0,5,57,0
Senators,3,0,0,1,4,Flyers,0,3,0,0,3,20120331,3,0,0,1,7,-1,2011,1,5,373,0
Bruins,1,1,4,0,6,Islanders,1,1,1,0,3,20120331,0,0,3,3,9,-3,2011,0,5,190,0
Jets,0,2,0,0,2,Lightning,1,0,1,1,3,20120331,1,-1,0,1,5,1,2011,1,5,1705,0
Wild,2,2,0,1,5,Blackhawks,1,2,1,0,4,20120401,1,1,0,1,9,-1,2011,1,6,355,0
Oilers,2,0,0,0,2,Ducks,1,0,0,0,1,20120401,1,1,1,1,3,-1,2011,0,6,1368,0
Panthers,1,0,0,0,1,Red Wings,0,0,1,1,2,20120401,-1,-1,0,1,3,1,2011,1,6,1155,0
Bruins,0,2,0,0,2,Rangers,1,0,0,0,1,20120401,-1,1,1,1,3,-1,2011,0,6,190,0
Flyers,1,1,4,0,6,Penguins,2,0,2,0,4,20120401,-1,0,2,2,10,-2,2011,0,6,257,0
Senators,1,3,1,0,5,Islanders,1,0,0,0,1,20120401,0,3,4,4,6,-4,2011,0,6,334,0
Capitals,0,1,1,0,2,Lightning,0,2,2,0,4,20120402,0,1,2,2,6,2,2011,0,0,818,0
Oilers,0,0,0,0,0,Kings,0,0,2,0,2,20120402,0,0,2,2,2,2,2011,0,0,1368,0
Wild,0,1,0,0,1,Predators,0,1,0,1,2,20120403,0,0,0,1,3,1,2011,1,1,696,0
Maple Leafs,3,0,2,0,5,Sabres,0,2,3,1,6,20120403,-3,-1,0,1,11,1,2011,1,1,57,0
Islanders,1,0,0,0,1,Devils,1,1,1,0,3,20120403,0,1,2,2,4,2,2011,0,1,8,0
Rangers,4,1,0,0,5,Flyers,0,2,1,0,3,20120403,4,3,2,2,8,-2,2011,0,1,80,0
Penguins,2,2,1,0,5,Bruins,1,1,1,0,3,20120403,1,2,2,2,8,-2,2011,0,1,481,0
Hurricanes,0,2,0,0,2,Senators,0,0,1,0,1,20120403,0,2,1,1,3,-1,2011,0,1,673,0
Jets,0,2,2,1,5,Panthers,2,1,1,0,4,20120403,-2,-1,0,1,9,-1,2011,1,1,1899,0
Sharks,1,2,2,0,5,Stars,1,1,0,0,2,20120403,0,1,3,3,7,-3,2011,0,1,1449,0
Ducks,2,2,0,0,4,Canucks,2,2,0,1,5,20120403,0,0,0,1,9,1,2011,1,1,1076,0
Blue Jackets,0,0,0,0,0,Coyotes,0,2,0,0,2,20120403,0,2,2,2,2,2,2011,0,1,1664,0
Lightning,1,0,1,0,2,Canadiens,1,2,2,0,5,20120404,0,2,3,3,7,3,2011,0,2,1311,0
Red Wings,0,0,2,1,3,Blues,0,0,2,0,2,20120404,0,0,0,1,5,-1,2011,1,2,454,0
Ducks,0,2,0,1,3,Oilers,0,1,1,0,2,20120405,0,1,0,1,5,-1,2011,1,3,1368,0
Canucks,1,0,1,0,2,Flames,0,0,3,0,3,20120405,-1,-1,1,1,5,1,2011,0,3,426,0
Blue Jackets,2,2,1,0,5,Avalanche,1,1,0,0,2,20120405,1,2,3,3,7,-3,2011,0,3,1163,0
Sharks,1,1,3,1,6,Kings,1,2,2,0,5,20120405,0,-1,0,1,11,-1,2011,1,3,305,0
Blackhawks,1,0,0,0,1,Wild,0,0,1,1,2,20120405,-1,-1,0,1,3,1,2011,1,3,355,0
Stars,0,0,0,0,0,Predators,0,0,2,0,2,20120405,0,0,2,2,2,2,2011,0,3,616,0
Devils,1,0,1,0,2,Red Wings,0,1,0,0,1,20120405,1,0,1,1,3,-1,2011,0,3,471,0
Sabres,0,1,0,0,1,Flyers,0,0,2,0,2,20120405,0,-1,1,1,3,1,2011,0,3,279,0
Canadiens,0,1,0,0,1,Hurricanes,0,1,0,1,2,20120405,0,0,0,1,3,1,2011,1,3,727,0
Panthers,0,1,1,0,2,Capitals,1,2,1,0,4,20120405,1,2,2,2,6,2,2011,0,3,924,0
Rangers,1,0,1,0,2,Penguins,2,1,2,0,5,20120405,1,2,3,3,7,3,2011,0,3,314,0
Jets,2,0,2,0,4,Islanders,2,1,2,0,5,20120405,0,1,1,1,9,1,2011,0,3,1287,0
Lightning,1,0,1,0,2,Maple Leafs,1,0,1,1,3,20120405,0,0,0,1,5,1,2011,1,3,1096,0
Bruins,1,1,1,0,3,Senators,0,1,0,0,1,20120405,1,1,2,2,4,-2,2011,0,3,320,0
Coyotes,1,2,1,0,4,Blues,1,0,0,0,1,20120406,0,2,3,3,5,-3,2011,0,4,1270,0
Coyotes,2,1,1,0,4,Wild,0,1,0,0,1,20120407,2,2,3,3,5,-3,2011,0,5,1278,0
Hurricanes,0,0,1,0,1,Panthers,2,1,1,0,4,20120407,2,3,3,3,5,3,2011,0,5,696,0
Blues,0,1,2,0,3,Stars,0,0,2,0,2,20120407,0,1,1,1,5,-1,2011,0,5,547,0
Capitals,3,1,0,0,4,Rangers,0,1,0,0,1,20120407,3,3,3,3,5,-3,2011,0,5,204,0
Oilers,0,0,0,0,0,Canucks,0,1,2,0,3,20120407,0,1,3,3,3,3,2011,0,5,514,0
Kings,1,1,0,0,2,Sharks,0,0,2,1,3,20120407,-1,-2,0,1,5,1,2011,1,5,305,0
Predators,3,1,2,0,6,Avalanche,1,0,0,0,1,20120407,2,3,5,5,7,-5,2011,0,5,1019,0
Islanders,0,2,1,0,3,Blue Jackets,1,4,2,0,7,20120407,1,3,4,4,10,4,2011,0,5,476,0
Flyers,1,1,0,0,2,Penguins,1,3,0,0,4,20120407,0,2,2,2,6,2,2011,0,5,257,0
Maple Leafs,0,0,1,0,1,Canadiens,1,1,2,0,4,20120407,1,2,3,3,5,3,2011,0,5,303,0
Ducks,0,1,1,0,2,Flames,1,2,2,0,5,20120407,1,2,3,3,7,3,2011,0,5,1197,0
Sabres,0,1,2,0,3,Bruins,0,1,2,1,4,20120407,0,0,0,1,7,1,2011,1,5,399,0
Senators,1,1,0,0,2,Devils,1,1,2,0,4,20120407,0,0,2,2,6,2,2011,0,5,330,0
Blackhawks,1,1,0,1,3,Red Wings,0,0,2,0,2,20120407,1,2,0,1,5,-1,2011,1,5,238,0
Lightning,1,1,1,1,4,Jets,0,1,2,0,3,20120407,1,1,0,1,7,-1,2011,1,5,1705,0
Flyers,0,1,2,1,4,Penguins,3,0,0,0,3,20120411,-3,-2,0,1,7,-1,2011,1,2,257,1
Red Wings,0,1,1,0,2,Predators,1,1,1,0,3,20120411,1,1,1,1,5,1,2011,0,2,470,1
Kings,1,1,2,0,4,Canucks,1,1,0,0,2,20120411,0,0,2,2,6,-2,2011,0,2,1076,1
Senators,0,0,2,0,2,Rangers,1,2,1,0,4,20120412,1,3,2,2,6,2,2011,0,3,334,1
Capitals,0,0,0,0,0,Bruins,0,0,0,1,1,20120412,0,0,0,1,1,1,2011,1,3,394,1
Sharks,0,1,1,1,3,Blues,0,0,2,0,2,20120412,0,1,0,1,5,-1,2011,1,3,1719,1
Blackhawks,1,0,1,0,2,Coyotes,0,2,0,1,3,20120412,-1,1,0,1,5,1,2011,1,3,1450,1
Kings,1,1,2,0,4,Canucks,0,1,1,0,2,20120413,1,1,2,2,6,-2,2011,0,4,1076,1
Red Wings,2,1,0,0,3,Predators,0,1,1,0,2,20120413,2,2,1,1,5,-1,2011,0,4,470,1
Flyers,1,3,4,0,8,Penguins,3,1,1,0,5,20120413,-2,0,3,3,13,-3,2011,0,4,257,1
Devils,3,0,0,0,3,Panthers,0,2,0,0,2,20120413,3,1,1,1,5,-1,2011,0,4,1090,1
Capitals,0,1,0,1,2,Bruins,0,0,1,0,1,20120414,0,1,0,1,3,-1,2011,1,5,394,1
Senators,0,1,1,1,3,Rangers,1,0,1,0,2,20120414,-1,0,0,1,5,-1,2011,1,5,334,1
Sharks,0,0,0,0,0,Blues,1,1,1,0,3,20120414,1,2,3,3,3,3,2011,0,5,1719,1
Blackhawks,1,1,1,1,4,Coyotes,2,1,0,0,3,20120414,-1,-1,0,1,7,-1,2011,1,5,1450,1
Predators,1,1,1,0,3,Red Wings,0,1,1,0,2,20120415,1,1,1,1,5,-1,2011,0,6,470,1
Penguins,2,2,0,0,4,Flyers,4,2,2,0,8,20120415,2,2,4,4,12,4,2011,0,6,257,1
Devils,0,0,2,0,2,Panthers,1,2,1,0,4,20120415,1,3,2,2,6,2,2011,0,6,1090,1
Canucks,0,0,0,0,0,Kings,0,0,1,0,1,20120415,0,0,1,1,1,1,2011,0,6,1076,1
Rangers,0,0,1,0,1,Senators,0,0,0,0,0,20120416,0,0,1,1,1,-1,2011,0,0,334,1
Bruins,0,2,2,0,4,Capitals,1,1,1,0,3,20120416,-1,0,1,1,7,-1,2011,0,0,394,1
Blues,1,2,1,0,4,Sharks,1,0,2,0,3,20120416,0,2,1,1,7,-1,2011,0,0,1719,1
Predators,0,0,3,0,3,Red Wings,0,0,1,0,1,20120417,0,0,2,2,4,-2,2011,0,1,470,1
Panthers,2,2,0,0,4,Devils,3,0,0,0,3,20120417,-1,1,1,1,7,-1,2011,0,1,1090,1
Coyotes,0,0,2,1,3,Blackhawks,1,0,1,0,2,20120417,-1,-1,0,1,5,-1,2011,1,1,1450,1
Penguins,4,5,1,0,10,Flyers,3,0,0,0,3,20120418,1,6,7,7,13,-7,2011,0,2,257,1
Canucks,0,2,1,0,3,Kings,1,0,0,0,1,20120418,-1,1,2,2,4,-2,2011,0,2,1076,1
Rangers,2,0,0,0,2,Senators,0,2,0,1,3,20120418,-2,0,0,1,5,1,2011,1,2,334,1
Coyotes,0,0,2,1,3,Blackhawks,0,0,2,0,2,20120419,0,0,0,1,5,-1,2011,1,3,1450,1
Bruins,1,0,0,0,1,Capitals,1,1,0,0,2,20120419,0,1,1,1,3,1,2011,0,3,394,1
Blues,1,0,1,0,2,Sharks,0,0,1,0,1,20120419,1,1,1,1,3,-1,2011,0,3,1719,1
Panthers,0,0,0,0,0,Devils,0,1,3,0,4,20120419,0,1,4,4,4,4,2011,0,3,1090,1
Flyers,2,0,0,0,2,Penguins,1,2,0,0,3,20120420,-1,1,1,1,5,1,2011,0,4,257,1
Red Wings,0,1,0,0,1,Predators,1,0,1,0,2,20120420,1,0,1,1,3,1,2011,0,4,470,1
Sharks,0,1,0,0,1,Blues,0,0,3,0,3,20120421,0,-1,2,2,4,2,2011,0,5,1719,1
Senators,1,0,1,0,2,Rangers,0,0,0,0,0,20120421,1,1,2,2,2,-2,2011,0,5,334,1
Blackhawks,0,0,1,1,2,Coyotes,0,1,0,0,1,20120421,0,-1,0,1,3,-1,2011,1,5,1450,1
Capitals,0,2,2,0,4,Bruins,0,2,1,0,3,20120421,0,0,1,1,7,-1,2011,0,5,394,1
Devils,0,0,0,0,0,Panthers,0,1,2,0,3,20120421,0,1,3,3,3,3,2011,0,5,1090,1
Penguins,0,1,0,0,1,Flyers,2,2,1,0,5,20120422,2,3,4,4,6,4,2011,0,6,257,1
Bruins,2,0,1,1,4,Capitals,1,1,1,0,3,20120422,1,0,0,1,7,-1,2011,1,6,394,1
Kings,0,0,1,1,2,Canucks,1,0,0,0,1,20120422,-1,-1,0,1,3,-1,2011,1,6,1076,1
Rangers,0,3,0,0,3,Senators,1,0,1,0,2,20120423,-1,2,1,1,5,-1,2011,0,0,334,1
Coyotes,0,1,3,0,4,Blackhawks,0,0,0,0,0,20120423,0,1,4,4,4,-4,2011,0,0,1450,1
Panthers,0,2,0,0,2,Devils,1,1,0,1,3,20120424,1,0,0,1,5,1,2011,1,1,1090,1
Capitals,1,0,0,1,2,Bruins,0,1,0,0,1,20120425,1,0,0,1,3,-1,2011,1,2,394,1
Devils,1,1,0,1,3,Panthers,0,0,2,0,2,20120426,1,2,0,1,5,-1,2011,1,3,1090,1
Senators,0,1,0,0,1,Rangers,0,2,0,0,2,20120426,0,1,1,1,3,1,2011,0,3,334,1
Predators,1,1,1,0,3,Coyotes,1,2,0,1,4,20120427,0,1,0,1,7,1,2011,1,4,1442,1
Capitals,0,1,0,0,1,Rangers,0,1,2,0,3,20120428,0,0,2,2,4,2,2011,0,5,204,1
Kings,1,1,1,0,3,Blues,1,0,0,0,1,20120428,0,1,2,2,4,-2,2011,0,5,1586,1
Devils,1,1,1,0,3,Flyers,0,2,1,1,4,20120429,-1,0,0,1,7,1,2011,1,6,75,1
Predators,1,1,1,0,3,Coyotes,1,3,1,0,5,20120429,0,2,2,2,8,2,2011,0,6,1442,1
Capitals,2,0,1,0,3,Rangers,1,0,1,0,2,20120430,1,1,1,1,5,-1,2011,0,0,204,1
Kings,4,1,0,0,5,Blues,0,1,1,0,2,20120430,4,4,3,3,7,-3,2011,0,0,1586,1
Devils,0,0,4,0,4,Flyers,1,0,0,0,1,20120501,-1,-1,3,3,5,-3,2011,0,1,75,1
Coyotes,0,0,0,0,0,Predators,2,0,0,0,2,20120502,2,2,2,2,2,2,2011,0,2,1442,1
Rangers,0,1,0,1,2,Capitals,0,1,0,0,1,20120502,0,0,0,1,3,-1,2011,1,2,204,1
Flyers,1,1,1,0,3,Devils,2,0,1,1,4,20120503,1,0,0,1,7,1,2011,1,3,75,1
Blues,0,1,1,0,2,Kings,1,2,1,0,4,20120503,1,2,2,2,6,2,2011,0,3,1586,1
Coyotes,1,0,0,0,1,Predators,0,0,0,0,0,20120504,1,1,1,1,1,-1,2011,0,4,1442,1
Rangers,0,2,0,0,2,Capitals,1,1,1,0,3,20120505,1,0,1,1,5,1,2011,0,5,204,1
Blues,1,0,0,0,1,Kings,2,0,1,0,3,20120506,1,1,2,2,4,2,2011,0,6,1586,1
Flyers,2,0,0,0,2,Devils,2,1,1,0,4,20120506,0,1,2,2,6,2,2011,0,6,75,1
Capitals,0,1,1,0,2,Rangers,1,0,1,1,3,20120507,1,0,0,1,5,1,2011,1,0,204,1
Predators,0,0,1,0,1,Coyotes,0,2,0,0,2,20120507,0,2,1,1,3,1,2011,0,0,1442,1
Devils,2,0,1,0,3,Flyers,1,0,0,0,1,20120508,1,1,2,2,4,-2,2011,0,1,75,1
Rangers,0,0,1,0,1,Capitals,1,1,0,0,2,20120509,1,2,1,1,3,1,2011,0,2,204,1
Capitals,0,0,1,0,1,Rangers,1,0,1,0,2,20120512,1,1,1,1,3,1,2011,0,5,204,1
Kings,1,1,2,0,4,Coyotes,1,1,0,0,2,20120513,0,0,2,2,6,-2,2011,0,6,356,1
Devils,0,0,0,0,0,Rangers,0,0,3,0,3,20120514,0,0,3,3,3,3,2011,0,0,8,1
Kings,1,2,1,0,4,Coyotes,0,0,0,0,0,20120515,1,3,4,4,4,-4,2011,0,1,356,1
Devils,1,1,1,0,3,Rangers,0,2,0,0,2,20120516,1,0,1,1,5,-1,2011,0,2,8,1
Coyotes,0,1,0,0,1,Kings,0,1,1,0,2,20120517,0,0,1,1,3,1,2011,0,3,356,1
Rangers,0,0,3,0,3,Devils,0,0,0,0,0,20120519,0,0,3,3,3,-3,2011,0,5,8,1
Coyotes,1,1,0,0,2,Kings,0,0,0,0,0,20120520,1,2,2,2,2,-2,2011,0,6,356,1
Rangers,0,0,1,0,1,Devils,2,0,2,0,4,20120521,2,2,3,3,5,3,2011,0,0,8,1
Kings,1,2,0,1,4,Coyotes,1,2,0,0,3,20120522,0,0,0,1,7,-1,2011,1,1,356,1
Devils,3,0,2,0,5,Rangers,1,1,1,0,3,20120523,2,1,2,2,8,-2,2011,0,2,8,1
Rangers,0,2,0,0,2,Devils,2,0,0,1,3,20120525,2,0,0,1,5,1,2011,1,4,8,1
Kings,1,0,0,1,2,Devils,0,1,0,0,1,20120530,1,0,0,1,3,-1,2011,1,2,2436,1
Kings,1,0,0,1,2,Devils,0,0,1,0,1,20120602,1,1,0,1,3,-1,2011,1,5,2436,1
Devils,0,0,0,0,0,Kings,0,2,2,0,4,20120604,0,2,4,4,4,4,2011,0,0,2436,1
Devils,0,0,3,0,3,Kings,0,0,1,0,1,20120606,0,0,2,2,4,-2,2011,0,2,2436,1
Kings,0,1,0,0,1,Devils,1,1,0,0,2,20120609,1,1,1,1,3,1,2011,0,5,2436,1
Devils,0,1,0,0,1,Kings,3,1,2,0,6,20120611,3,3,5,5,7,5,2011,0,0,2436,1
Capitals,1,2,0,0,3,Lightning,2,1,3,0,6,20130119,1,0,3,3,9,3,2012,0,5,818,0
Penguins,2,0,1,0,3,Flyers,0,1,0,0,1,20130119,2,1,2,2,4,-2,2012,0,5,257,0
Senators,1,1,2,0,4,Jets,1,0,0,0,1,20130119,0,1,3,3,5,-3,2012,0,5,1033,0
Blackhawks,3,1,1,0,5,Kings,0,1,1,0,2,20130119,3,3,3,3,7,-3,2012,0,5,1741,0
Rangers,0,1,0,0,1,Bruins,1,1,1,0,3,20130119,1,1,2,2,4,2,2012,0,5,190,0
Maple Leafs,1,1,0,0,2,Canadiens,0,0,1,0,1,20130119,1,2,1,1,3,-1,2012,0,5,303,0
Devils,0,1,1,0,2,Islanders,0,0,1,0,1,20130119,0,1,1,1,3,-1,2012,0,5,8,0
Avalanche,1,0,1,0,2,Wild,0,3,1,0,4,20130119,-1,2,2,2,6,2,2012,0,5,698,0
Red Wings,0,0,0,0,0,Blues,2,2,2,0,6,20130119,2,4,6,6,6,6,2012,0,5,454,0
Blue Jackets,1,1,0,1,3,Predators,2,0,0,0,2,20130119,-1,0,0,1,5,-1,2012,1,5,333,0
Coyotes,0,2,1,0,3,Stars,1,1,2,0,4,20130119,1,0,1,1,7,1,2012,0,5,884,0
Ducks,2,4,1,0,7,Canucks,2,0,1,0,3,20130119,0,4,4,4,10,-4,2012,0,5,1076,0
Hurricanes,0,1,0,0,1,Panthers,4,1,0,0,5,20130119,4,4,4,4,6,4,2012,0,5,696,0
Blackhawks,1,3,2,0,6,Coyotes,1,1,2,0,4,20130120,0,2,2,2,10,-2,2012,0,6,1450,0
Oilers,0,1,1,1,3,Canucks,1,1,0,0,2,20130120,-1,-1,0,1,5,-1,2012,1,6,514,0
Stars,0,0,0,0,0,Wild,1,0,0,0,1,20130120,1,1,1,1,1,1,2012,0,6,863,0
Flyers,0,2,0,0,2,Sabres,1,1,3,0,5,20130120,1,0,3,3,7,3,2012,0,6,279,0
Sharks,0,3,1,0,4,Flames,1,0,0,0,1,20130120,-1,2,3,3,5,-3,2012,0,6,1027,0
Penguins,3,1,2,0,6,Rangers,1,0,2,0,3,20130120,2,3,3,3,9,-3,2012,0,6,314,0
Ducks,3,0,2,0,5,Flames,2,1,1,0,4,20130121,1,0,1,1,9,-1,2012,0,0,1197,0
Red Wings,0,2,1,1,4,Blue Jackets,0,1,2,0,3,20130121,0,1,0,1,7,-1,2012,1,0,163,0
Panthers,0,0,0,0,0,Senators,1,1,2,0,4,20130121,1,2,4,4,4,4,2012,0,0,1370,0
Sabres,1,1,0,0,2,Maple Leafs,0,0,1,0,1,20130121,1,2,1,1,3,-1,2012,0,0,57,0
Lightning,0,0,3,0,3,Islanders,0,3,1,0,4,20130121,0,3,1,1,7,1,2012,0,0,1004,0
Jets,1,0,0,0,1,Bruins,1,0,0,1,2,20130121,0,0,0,1,3,1,2012,1,0,1349,0
Blues,2,0,1,1,4,Predators,2,1,0,0,3,20130121,0,-1,0,1,7,-1,2012,1,0,253,0
Maple Leafs,0,3,2,0,5,Penguins,1,1,0,0,2,20130123,-1,1,3,3,7,-3,2012,0,2,222,0
Bruins,0,2,1,0,3,Rangers,2,1,0,1,4,20130123,2,1,0,1,7,1,2012,1,2,190,0
Flames,0,2,0,0,2,Canucks,0,2,0,1,3,20130123,0,0,0,1,5,1,2012,1,2,426,0
Blue Jackets,0,1,0,0,1,Coyotes,0,2,3,0,5,20130123,0,1,4,4,6,4,2012,0,2,1664,0
Kings,0,1,0,0,1,Oilers,0,0,1,1,2,20130124,0,-1,0,1,3,1,2012,1,3,1368,0
Blue Jackets,0,0,0,0,0,Avalanche,2,0,2,0,4,20130124,2,2,4,4,4,4,2012,0,3,1163,0
Blackhawks,0,1,1,1,3,Stars,1,1,0,0,2,20130124,-1,-1,0,1,5,-1,2012,1,3,802,0
Predators,0,0,0,0,0,Blues,1,1,1,0,3,20130124,1,2,3,3,3,3,2012,0,3,253,0
Coyotes,0,1,2,0,3,Sharks,1,0,4,0,5,20130124,1,0,2,2,8,2,2012,0,3,614,0
Sabres,0,2,1,0,3,Hurricanes,0,4,2,0,6,20130124,0,2,3,3,9,3,2012,0,3,491,0
Canadiens,0,4,0,0,4,Capitals,0,0,1,0,1,20130124,0,4,3,3,5,-3,2012,0,3,495,0
Rangers,0,0,1,0,1,Flyers,0,2,0,0,2,20130124,0,2,1,1,3,1,2012,0,3,80,0
Islanders,1,2,4,0,7,Maple Leafs,3,0,1,0,4,20130124,-2,0,3,3,11,-3,2012,0,3,341,0
Senators,1,1,1,0,3,Panthers,1,0,0,0,1,20130124,0,1,2,2,4,-2,2012,0,3,1370,0
Canucks,0,1,0,0,1,Sharks,2,1,1,0,4,20130127,2,2,3,3,5,3,2012,0,6,821,0
Islanders,1,0,3,0,4,Jets,1,1,2,1,5,20130127,0,1,0,1,9,1,2012,1,6,1287,0
Red Wings,0,0,1,0,1,Blackhawks,1,0,0,1,2,20130127,1,1,0,1,3,1,2012,1,6,238,0
Wild,0,3,1,0,4,Blues,1,1,2,1,5,20130127,1,-1,0,1,9,1,2012,1,6,466,0
Devils,0,1,2,0,3,Canadiens,2,0,1,1,4,20130127,2,1,0,1,7,1,2012,1,6,342,0
Penguins,1,0,0,1,2,Senators,0,1,0,0,1,20130127,1,0,0,1,3,-1,2012,1,6,392,0
Sabres,1,0,1,0,2,Capitals,1,1,1,0,3,20130127,0,1,1,1,5,1,2012,0,6,292,0
Flyers,1,0,0,0,1,Lightning,3,0,2,0,5,20130127,2,2,4,4,6,4,2012,0,6,928,0
Bruins,2,1,2,0,5,Hurricanes,1,2,0,0,3,20130128,1,0,2,2,8,-2,2012,0,0,609,0
Stars,0,1,0,0,1,Blue Jackets,0,1,1,0,2,20130128,0,0,1,1,3,1,2012,0,0,912,0
Predators,0,0,0,0,0,Coyotes,1,1,2,0,4,20130128,1,2,4,4,4,4,2012,0,0,1442,0
Avalanche,0,0,1,0,1,Oilers,2,1,1,0,4,20130128,2,3,3,3,5,3,2012,0,0,1036,0
Canucks,1,1,0,0,2,Kings,0,1,1,1,3,20130128,-1,-1,0,1,5,1,2012,1,0,1076,0
Panthers,1,0,1,0,2,Lightning,2,2,1,0,5,20130129,1,3,3,3,7,3,2012,0,1,205,0
Ducks,0,2,0,0,2,Sharks,1,0,1,1,3,20130129,1,-1,0,1,5,1,2012,1,1,305,0
Stars,0,1,0,0,1,Red Wings,0,2,2,0,4,20130129,0,1,3,3,5,3,2012,0,1,999,0
Islanders,1,3,0,0,4,Penguins,0,0,1,0,1,20130129,1,4,3,3,5,-3,2012,0,1,314,0
Blue Jackets,0,1,1,0,2,Wild,2,0,1,0,3,20130129,2,1,1,1,5,1,2012,0,1,626,0
Jets,1,2,0,0,3,Canadiens,2,1,1,0,4,20130129,1,0,1,1,7,1,2012,0,1,1115,0
Devils,0,1,0,0,1,Bruins,0,0,1,1,2,20130129,0,-1,0,1,3,1,2012,1,1,196,0
Capitals,2,0,0,0,2,Senators,0,1,2,0,3,20130129,-2,-1,1,1,5,1,2012,0,1,446,0
Flyers,0,0,1,0,1,Rangers,1,1,0,0,2,20130129,1,2,1,1,3,1,2012,0,1,80,0
Maple Leafs,1,2,0,1,4,Sabres,1,1,1,0,3,20130129,0,1,0,1,7,-1,2012,1,1,57,0
Canadiens,1,0,0,0,1,Senators,1,3,1,0,5,20130130,0,3,4,4,6,4,2012,0,2,104,0
Blackhawks,2,0,0,0,2,Wild,1,1,0,1,3,20130130,-1,0,0,1,5,1,2012,1,2,355,0
Oilers,1,0,0,1,2,Coyotes,0,0,1,0,1,20130130,1,1,0,1,3,-1,2012,1,2,1392,0
Avalanche,0,0,0,0,0,Canucks,1,1,1,0,3,20130130,1,2,3,3,3,3,2012,0,2,1105,0
Oilers,0,1,1,0,2,Sharks,0,2,0,1,3,20130131,0,1,0,1,5,1,2012,1,3,1190,0
Predators,1,0,0,1,2,Kings,1,0,0,0,1,20130131,0,0,0,1,3,-1,2012,1,3,1776,0
Avalanche,1,2,3,0,6,Flames,1,2,0,0,3,20130131,0,0,3,3,9,-3,2012,0,3,898,0
Jets,0,1,2,0,3,Panthers,0,1,5,0,6,20130131,0,0,3,3,9,3,2012,0,3,1899,0
Islanders,1,2,1,1,5,Devils,0,3,1,0,4,20130131,1,0,0,1,9,-1,2012,1,3,8,0
Penguins,1,0,2,0,3,Rangers,0,0,0,0,0,20130131,1,1,3,3,3,-3,2012,0,3,314,0
Sabres,0,3,4,0,7,Bruins,0,3,1,0,4,20130131,0,0,3,3,11,-3,2012,0,3,399,0
Blues,3,0,1,0,4,Blue Jackets,0,1,0,0,1,20130131,3,2,3,3,5,-3,2012,0,3,395,0
Capitals,1,1,0,0,2,Maple Leafs,1,0,2,0,3,20130131,0,-1,1,1,5,1,2012,0,3,349,0
Coyotes,1,2,0,0,3,Stars,2,1,0,1,4,20130201,1,0,0,1,7,1,2012,1,4,884,0
Wild,1,0,0,0,1,Ducks,0,1,2,0,3,20130201,-1,0,2,2,4,2,2012,0,4,1521,0
Blackhawks,0,0,1,0,1,Canucks,1,0,0,1,2,20130201,1,1,0,1,3,1,2012,1,4,1775,0
Jets,0,0,3,0,3,Lightning,3,3,2,0,8,20130201,3,6,5,5,11,5,2012,0,4,1705,0
Senators,0,0,0,0,0,Hurricanes,1,0,0,0,1,20130201,1,1,1,1,1,1,2012,0,4,673,0
Flyers,0,1,1,0,2,Capitals,0,1,2,0,3,20130201,0,0,1,1,5,1,2012,0,4,123,0
Blues,2,1,0,0,3,Red Wings,2,0,3,0,5,20130201,0,-1,2,2,8,2,2012,0,4,454,0
Predators,0,0,1,1,2,Sharks,0,0,1,0,1,20130202,0,0,0,1,3,-1,2012,1,5,1934,0
Kings,2,2,0,0,4,Ducks,3,2,2,0,7,20130202,1,1,3,3,11,3,2012,0,5,0,0
Blackhawks,0,0,2,1,3,Flames,0,0,2,0,2,20130202,0,0,0,1,5,-1,2012,1,5,1397,0
Stars,0,0,0,0,0,Coyotes,0,1,1,0,2,20130202,0,1,2,2,2,2,2012,0,5,884,0
Rangers,0,1,2,0,3,Lightning,0,1,1,0,2,20130202,0,0,1,1,5,-1,2012,0,5,1004,0
Red Wings,1,0,1,0,2,Blue Jackets,1,2,1,0,4,20130202,0,2,2,2,6,2,2012,0,5,163,0
Bruins,1,0,0,0,1,Maple Leafs,0,0,0,0,0,20130202,1,1,1,1,1,-1,2012,0,5,430,0
Oilers,1,0,0,0,1,Avalanche,0,2,1,0,3,20130202,-1,1,2,2,4,2,2012,0,5,1036,0
Sabres,0,0,1,0,1,Canadiens,1,3,2,0,6,20130202,1,4,5,5,7,5,2012,0,5,311,0
Devils,0,1,0,0,1,Penguins,0,2,3,0,5,20130202,0,1,4,4,6,4,2012,0,5,306,0
Hurricanes,2,0,1,0,3,Flyers,3,2,0,0,5,20130202,1,3,2,2,8,2,2012,0,5,345,0
Penguins,2,3,1,0,6,Capitals,1,1,1,0,3,20130203,1,3,3,3,9,-3,2012,0,6,190,0
Senators,1,0,0,0,1,Canadiens,2,0,0,0,2,20130203,1,1,1,1,3,1,2012,0,6,104,0
Panthers,1,2,1,0,4,Sabres,2,1,0,0,3,20130203,-1,0,1,1,7,-1,2012,0,6,1184,0
Devils,0,0,3,0,3,Islanders,0,0,0,0,0,20130203,0,0,3,3,3,-3,2012,0,6,8,0
Canucks,0,1,1,1,3,Oilers,1,1,0,0,2,20130204,-1,-1,0,1,5,-1,2012,1,0,514,0
Wild,0,1,0,0,1,Coyotes,1,1,0,0,2,20130204,1,1,1,1,3,1,2012,0,0,1278,0
Sharks,1,0,0,0,1,Ducks,0,0,2,0,2,20130204,-1,-1,1,1,3,1,2012,0,0,305,0
Hurricanes,0,2,2,0,4,Maple Leafs,1,0,0,0,1,20130204,-1,1,3,3,5,-3,2012,0,0,544,0
Stars,2,1,0,0,3,Avalanche,1,1,0,0,2,20130204,1,1,1,1,5,-1,2012,0,0,661,0
Blackhawks,3,1,1,0,5,Sharks,3,0,0,0,3,20130205,0,1,2,2,8,-2,2012,0,1,1837,0
Panthers,1,1,0,0,2,Jets,0,2,0,1,3,20130205,-1,0,0,1,5,1,2012,1,1,1899,0
Flames,2,1,1,0,4,Red Wings,0,1,0,0,1,20130205,2,2,3,3,5,-3,2012,0,1,1573,0
Lightning,0,0,1,0,1,Flyers,0,1,1,0,2,20130205,0,1,1,1,3,1,2012,0,1,928,0
Predators,3,2,1,0,6,Blues,0,1,0,0,1,20130205,3,4,5,5,7,-5,2012,0,1,253,0
Kings,0,3,1,0,4,Blue Jackets,1,1,0,0,2,20130205,-1,1,2,2,6,-2,2012,0,1,1973,0
Maple Leafs,2,1,0,0,3,Capitals,1,0,1,0,2,20130205,1,2,1,1,5,-1,2012,0,1,349,0
Penguins,1,1,2,0,4,Islanders,0,0,2,0,2,20130205,1,2,2,2,6,-2,2012,0,1,314,0
Rangers,0,0,1,0,1,Devils,2,0,1,0,3,20130205,2,2,2,2,4,2,2012,0,1,8,0
Sabres,1,1,1,0,3,Senators,3,1,0,0,4,20130205,2,2,1,1,7,1,2012,0,1,219,0
Bruins,0,0,2,0,2,Canadiens,0,1,0,0,1,20130206,0,-1,1,1,3,-1,2012,0,2,270,0
Ducks,2,1,0,0,3,Avalanche,0,0,0,0,0,20130206,2,3,3,3,3,-3,2012,0,2,830,0
Stars,0,2,0,1,3,Oilers,0,1,1,0,2,20130206,0,1,0,1,5,-1,2012,1,2,1655,0
Maple Leafs,0,1,2,0,3,Jets,0,1,1,0,2,20130207,0,0,1,1,5,-1,2012,0,3,946,0
Blackhawks,4,2,0,0,6,Coyotes,0,1,1,0,2,20130207,4,5,4,4,8,-4,2012,0,3,1450,0
Canucks,2,2,0,0,4,Wild,0,0,1,0,1,20130207,2,4,3,3,5,-3,2012,0,3,1427,0
Kings,0,0,0,0,0,Predators,1,2,0,0,3,20130207,1,3,3,3,3,3,2012,0,3,1776,0
Red Wings,2,2,1,0,5,Blues,0,1,0,0,1,20130207,2,3,4,4,6,-4,2012,0,3,454,0
Hurricanes,0,1,1,1,3,Senators,1,1,0,0,2,20130207,-1,-1,0,1,5,-1,2012,1,3,673,0
Lightning,0,1,1,0,2,Devils,0,2,2,0,4,20130207,0,1,2,2,6,2,2012,0,3,1000,0
Capitals,1,0,1,0,2,Penguins,0,5,0,0,5,20130207,-1,4,3,3,7,3,2012,0,3,190,0
Panthers,1,0,1,1,3,Flyers,1,1,0,0,2,20130207,0,-1,0,1,5,-1,2012,1,3,1021,0
Islanders,0,1,0,0,1,Rangers,2,1,1,0,4,20130207,2,2,3,3,5,3,2012,0,3,0,0
Canadiens,1,2,1,0,4,Sabres,1,1,2,1,5,20130207,0,-1,0,1,9,1,2012,1,3,311,0
Flames,1,1,1,1,4,Blue Jackets,2,0,1,0,3,20130207,-1,0,0,1,7,-1,2012,1,3,1670,0
Ducks,0,1,0,0,1,Stars,2,0,1,0,3,20130208,2,1,2,2,4,2,2012,0,4,1237,0
Sabres,1,1,1,0,3,Islanders,1,1,0,0,2,20130209,0,0,1,1,5,-1,2012,0,5,292,0
Flames,1,0,0,0,1,Canucks,0,3,2,0,5,20130209,-1,2,4,4,6,4,2012,0,5,426,0
Predators,1,0,0,0,1,Wild,0,1,0,1,2,20130209,-1,0,0,1,3,1,2012,1,5,696,0
Panthers,0,0,0,0,0,Capitals,1,2,2,0,5,20130209,1,3,5,5,5,5,2012,0,5,924,0
Maple Leafs,2,2,2,0,6,Canadiens,0,0,0,0,0,20130209,2,4,6,6,6,-6,2012,0,5,303,0
Ducks,1,3,1,1,6,Blues,3,0,2,0,5,20130209,-2,1,0,1,11,-1,2012,1,5,1586,0
Oilers,0,1,0,0,1,Red Wings,0,1,1,0,2,20130209,0,0,1,1,3,1,2012,0,5,1592,0
Jets,0,0,1,0,1,Senators,0,0,0,0,0,20130209,0,0,1,1,1,-1,2012,0,5,1033,0
Coyotes,0,0,0,1,1,Sharks,0,0,0,0,0,20130209,0,0,0,1,1,-1,2012,1,5,614,0
Hurricanes,1,1,1,0,3,Flyers,1,2,0,1,4,20130209,0,1,0,1,7,1,2012,1,5,345,0
Penguins,1,0,0,0,1,Devils,0,1,2,0,3,20130209,-1,0,2,2,4,2,2012,0,5,306,0
Devils,1,2,0,0,3,Penguins,0,0,1,0,1,20130210,1,3,2,2,4,-2,2012,0,6,306,0
Lightning,0,1,0,0,1,Rangers,2,1,2,0,5,20130210,2,2,4,4,6,4,2012,0,6,1004,0
Blackhawks,0,2,1,0,3,Predators,0,0,0,0,0,20130210,0,2,3,3,3,-3,2012,0,6,395,0
Oilers,1,0,2,0,3,Blue Jackets,0,0,1,0,1,20130210,1,1,2,2,4,-2,2012,0,6,1703,0
Kings,1,0,1,0,2,Red Wings,2,0,1,0,3,20130210,1,1,1,1,5,1,2012,0,6,1979,0
Bruins,0,1,2,0,3,Sabres,0,1,0,0,1,20130210,0,0,2,2,4,-2,2012,0,6,399,0
Flyers,1,0,1,0,2,Maple Leafs,1,3,1,0,5,20130211,0,3,3,3,7,3,2012,0,0,334,0
Hurricanes,1,1,4,0,6,Islanders,1,2,1,0,4,20130211,0,-1,2,2,10,-2,2012,0,0,423,0
Sharks,0,1,1,0,2,Blue Jackets,1,2,3,0,6,20130211,1,2,4,4,8,4,2012,0,0,2090,0
Kings,1,2,1,0,4,Blues,0,1,0,0,1,20130211,1,2,3,3,5,-3,2012,0,0,1586,0
Coyotes,1,0,1,1,3,Avalanche,0,2,0,0,2,20130211,1,-1,0,1,5,-1,2012,1,0,585,0
Wild,0,1,0,1,2,Flames,0,0,1,0,1,20130211,0,1,0,1,3,-1,2012,1,0,1043,0
Sharks,0,0,0,0,0,Predators,0,0,0,1,1,20130212,0,0,0,1,1,1,2012,1,1,1934,0
Stars,0,1,3,0,4,Oilers,1,0,0,0,1,20130212,-1,0,3,3,5,-3,2012,0,1,1655,0
Ducks,0,1,1,1,3,Blackhawks,0,2,0,0,2,20130212,0,-1,0,1,5,-1,2012,1,1,1741,0
Wild,0,1,0,0,1,Canucks,1,1,0,0,2,20130212,1,1,1,1,3,1,2012,0,1,1427,0
Flyers,2,0,1,0,3,Jets,1,0,1,0,2,20130212,1,1,1,1,5,-1,2012,0,1,1273,0
Sabres,0,0,0,0,0,Senators,0,2,0,0,2,20130212,0,2,2,2,2,2,2012,0,1,219,0
Canadiens,1,2,0,1,4,Lightning,0,0,3,0,3,20130212,1,3,0,1,7,-1,2012,1,1,1311,0
Rangers,1,1,1,1,4,Bruins,0,0,3,0,3,20130212,1,2,0,1,7,-1,2012,1,1,190,0
Hurricanes,0,2,2,0,4,Devils,1,0,1,0,2,20130212,-1,1,2,2,6,-2,2012,0,1,419,0
Capitals,1,2,2,1,6,Panthers,2,2,1,0,5,20130212,-1,-1,0,1,11,-1,2012,1,1,924,0
Senators,0,2,0,0,2,Penguins,1,1,2,0,4,20130213,1,0,2,2,6,2,2012,0,2,392,0
Blues,1,2,0,1,4,Red Wings,2,1,0,0,3,20130213,-1,0,0,1,7,-1,2012,1,2,454,0
Stars,1,2,1,0,4,Flames,4,2,1,0,7,20130213,3,3,3,3,11,3,2012,0,2,1536,0
Islanders,0,3,0,1,4,Rangers,2,1,0,0,3,20130214,-2,0,0,1,7,-1,2012,1,3,0,0
Maple Leafs,0,1,0,0,1,Hurricanes,0,3,0,0,3,20130214,0,2,2,2,4,2,2012,0,3,544,0
Capitals,1,1,2,0,4,Lightning,1,0,2,0,3,20130214,0,1,1,1,7,-1,2012,0,3,818,0
Canadiens,0,0,0,1,1,Panthers,0,0,0,0,0,20130214,0,0,0,1,1,-1,2012,1,3,1418,0
Coyotes,0,0,0,0,0,Predators,0,0,3,0,3,20130214,0,0,3,3,3,3,2012,0,3,1442,0
Avalanche,0,2,1,1,4,Wild,0,1,2,0,3,20130214,0,1,0,1,7,-1,2012,1,3,698,0
Stars,1,1,2,0,4,Canucks,0,3,0,0,3,20130215,1,-1,1,1,7,-1,2012,0,4,1766,0
Blue Jackets,0,0,1,0,1,Kings,0,1,1,0,2,20130215,0,1,1,1,3,1,2012,0,4,1973,0
Sharks,0,1,0,0,1,Blackhawks,1,2,1,0,4,20130215,1,2,3,3,5,3,2012,0,4,1837,0
Blues,4,0,1,0,5,Flames,0,1,1,0,2,20130215,4,3,3,3,7,-3,2012,0,4,1440,0
Penguins,1,0,2,0,3,Jets,0,0,1,0,1,20130215,1,1,2,2,4,-2,2012,0,4,1060,0
Ducks,0,2,3,0,5,Red Wings,0,2,0,0,2,20130215,0,0,3,3,7,-3,2012,0,4,1979,0
Flyers,3,0,0,0,3,Devils,1,2,2,0,5,20130215,-2,0,2,2,8,2,2012,0,4,75,0
Bruins,1,1,0,0,2,Sabres,1,0,3,0,4,20130215,0,-1,2,2,6,2,2012,0,4,399,0
Blue Jackets,2,1,0,0,3,Coyotes,3,0,2,0,5,20130216,1,0,2,2,8,2,2012,0,5,1664,0
Ducks,1,1,0,1,3,Predators,1,1,0,0,2,20130216,0,0,0,1,5,-1,2012,1,5,1776,0
Devils,0,0,1,0,1,Islanders,0,3,2,0,5,20130216,0,3,4,4,6,4,2012,0,5,8,0
Avalanche,3,1,0,0,4,Oilers,1,2,3,0,6,20130216,-2,-1,2,2,10,2,2012,0,5,1036,0
Senators,0,0,0,0,0,Maple Leafs,1,0,2,0,3,20130216,1,1,3,3,3,3,2012,0,5,203,0
Lightning,2,1,2,1,6,Panthers,1,2,2,0,5,20130216,1,0,0,1,11,-1,2012,1,5,205,0
Flyers,0,1,0,0,1,Canadiens,1,1,2,0,4,20130216,1,1,3,3,5,3,2012,0,5,400,0
Penguins,2,0,2,0,4,Sabres,1,1,1,0,3,20130217,1,0,1,1,7,-1,2012,0,6,178,0
Kings,0,0,2,0,2,Blackhawks,2,1,0,0,3,20130217,2,3,1,1,5,1,2012,0,6,1741,0
Bruins,0,2,1,0,3,Jets,0,2,0,0,2,20130217,0,0,1,1,5,-1,2012,0,6,1349,0
Flames,1,0,3,0,4,Stars,0,3,0,0,3,20130217,1,-2,1,1,7,-1,2012,0,6,1536,0
Red Wings,1,1,0,0,2,Wild,0,3,0,0,3,20130217,-1,1,1,1,5,1,2012,0,6,542,0
Capitals,1,0,0,0,1,Rangers,0,1,1,0,2,20130217,-1,0,1,1,3,1,2012,0,6,204,0
Blues,1,1,1,1,4,Canucks,2,0,1,0,3,20130217,-1,0,0,1,7,-1,2012,1,6,1778,0
Flames,0,0,0,0,0,Coyotes,1,0,3,0,4,20130218,1,1,4,4,4,4,2012,0,0,1224,0
Blue Jackets,1,0,1,0,2,Ducks,2,0,1,0,3,20130218,1,1,1,1,5,1,2012,0,0,1973,0
Maple Leafs,1,2,0,0,3,Panthers,0,0,0,0,0,20130218,1,3,3,3,3,-3,2012,0,0,1234,0
Predators,1,3,1,0,5,Avalanche,2,4,0,0,6,20130218,1,2,1,1,11,1,2012,0,0,1019,0
Flyers,1,3,3,0,7,Islanders,0,0,0,0,0,20130218,1,4,7,7,7,-7,2012,0,0,80,0
Senators,0,0,1,1,2,Devils,1,0,0,0,1,20130218,-1,-1,0,1,3,-1,2012,1,0,330,0
Hurricanes,0,0,0,0,0,Canadiens,0,0,3,0,3,20130218,0,0,3,3,3,3,2012,0,0,727,0
Canucks,1,0,2,0,3,Blackhawks,0,3,0,1,4,20130219,-1,2,0,1,7,1,2012,1,1,1775,0
Jets,1,1,0,0,2,Sabres,0,1,0,0,1,20130219,1,1,1,1,3,-1,2012,0,1,996,0
Canadiens,0,1,2,0,3,Rangers,0,1,0,0,1,20130219,0,0,2,2,4,-2,2012,0,1,343,0
Islanders,0,0,1,0,1,Senators,0,2,1,0,3,20130219,0,2,2,2,4,2,2012,0,1,334,0
Maple Leafs,1,0,1,0,2,Lightning,1,1,2,0,4,20130219,0,1,2,2,6,2,2012,0,1,1096,0
Sharks,0,1,1,0,2,Blues,1,0,0,0,1,20130219,-1,0,1,1,3,-1,2012,0,1,1719,0
Red Wings,1,0,2,0,3,Predators,2,0,1,1,4,20130219,1,1,0,1,7,1,2012,1,1,470,0
Kings,0,1,2,0,3,Oilers,0,1,0,0,1,20130219,0,0,2,2,4,-2,2012,0,1,1368,0
Flyers,2,1,3,0,6,Penguins,2,0,3,0,5,20130220,0,1,1,1,11,-1,2012,0,2,257,0
Blues,0,0,0,0,0,Avalanche,0,0,0,1,1,20130220,0,0,0,1,1,1,2012,1,2,794,0
Kings,2,0,1,0,3,Flames,1,0,0,0,1,20130220,1,1,2,2,4,-2,2012,0,2,1197,0
Wild,0,1,2,0,3,Oilers,0,1,0,0,1,20130221,0,0,2,2,4,-2,2012,0,3,1083,0
Bruins,2,1,1,0,4,Lightning,1,1,0,0,2,20130221,1,1,2,2,6,-2,2012,0,3,1183,0
Canucks,1,1,2,0,4,Stars,1,1,1,0,3,20130221,0,0,1,1,7,-1,2012,0,3,1766,0
Blue Jackets,1,0,2,0,3,Red Wings,2,0,0,0,2,20130221,-1,-1,1,1,5,-1,2012,0,3,163,0
Rangers,0,0,2,0,2,Senators,1,0,1,1,3,20130221,1,1,0,1,5,1,2012,1,3,334,0
Devils,0,1,2,0,3,Capitals,0,2,0,0,2,20130221,0,-1,1,1,5,-1,2012,0,3,198,0
Jets,1,0,3,0,4,Hurricanes,1,0,2,0,3,20130221,0,0,1,1,7,-1,2012,0,3,1350,0
Panthers,3,1,1,0,5,Flyers,0,0,2,0,2,20130221,3,4,3,3,7,-3,2012,0,3,1021,0
Sabres,1,0,0,0,1,Maple Leafs,0,2,1,0,3,20130221,-1,1,2,2,4,2,2012,0,3,57,0
Islanders,0,2,1,1,4,Canadiens,2,1,0,0,3,20130221,-2,-1,0,1,7,-1,2012,1,3,343,0
Panthers,0,1,0,0,1,Penguins,0,1,2,0,3,20130222,0,0,2,2,4,2,2012,0,4,1013,0
Canucks,0,0,1,0,1,Predators,0,0,0,0,0,20130222,0,0,1,1,1,-1,2012,0,4,2030,0
Sharks,1,0,0,0,1,Blackhawks,0,1,1,0,2,20130222,-1,0,1,1,3,1,2012,0,4,1837,0
Wild,1,0,0,0,1,Flames,1,0,2,0,3,20130223,0,0,2,2,4,2,2012,0,5,1043,0
Blue Jackets,0,1,0,0,1,Blues,1,0,1,0,2,20130223,1,0,1,1,3,1,2012,0,5,395,0
Predators,0,0,0,0,0,Red Wings,1,2,1,0,4,20130223,1,3,4,4,4,4,2012,0,5,470,0
Lightning,1,0,4,0,5,Hurricanes,0,0,2,0,2,20130223,1,1,3,3,7,-3,2012,0,5,585,0
Maple Leafs,1,0,1,0,2,Senators,1,1,1,0,3,20130223,0,1,1,1,5,1,2012,0,5,203,0
Sharks,0,0,1,0,1,Stars,0,1,2,0,3,20130223,0,1,2,2,4,2,2012,0,5,1449,0
Islanders,0,2,2,0,4,Sabres,0,0,0,0,0,20130223,0,2,4,4,4,-4,2012,0,5,292,0
Avalanche,0,1,0,0,1,Kings,2,2,0,0,4,20130223,2,3,3,3,5,3,2012,0,5,830,0
Coyotes,1,1,0,0,2,Oilers,0,1,1,1,3,20130223,-1,-1,0,1,5,1,2012,1,5,1392,0
Jets,1,2,0,0,3,Flyers,1,1,3,0,5,20130223,0,-1,2,2,8,2,2012,0,5,1273,0
Devils,0,1,0,0,1,Capitals,0,1,4,0,5,20130223,0,0,4,4,6,4,2012,0,5,198,0
Rangers,0,0,0,0,0,Canadiens,0,3,0,0,3,20130223,0,3,3,3,3,3,2012,0,5,343,0
Avalanche,2,1,0,0,3,Ducks,0,2,1,1,4,20130224,-2,-1,0,1,7,1,2012,1,6,830,0
Coyotes,0,2,2,0,4,Flames,1,2,2,0,5,20130224,1,1,1,1,9,1,2012,0,6,1224,0
Blue Jackets,0,0,0,0,0,Blackhawks,0,1,0,0,1,20130224,0,1,1,1,1,1,2012,0,6,275,0
Lightning,0,2,1,0,3,Penguins,3,1,1,0,5,20130224,3,2,2,2,8,2,2012,0,6,874,0
Canucks,3,0,0,0,3,Red Wings,2,3,3,0,8,20130224,-1,2,5,5,11,5,2012,0,6,1967,0
Jets,1,2,1,0,4,Devils,2,0,0,0,2,20130224,-1,1,2,2,6,-2,2012,0,6,1280,0
Bruins,2,1,1,0,4,Panthers,1,0,0,0,1,20130224,1,2,3,3,5,-3,2012,0,6,1257,0
Hurricanes,0,2,2,0,4,Islanders,2,0,0,0,2,20130224,-2,0,2,2,6,-2,2012,0,6,423,0
Maple Leafs,1,1,2,0,4,Flyers,0,1,1,0,2,20130225,1,1,2,2,6,-2,2012,0,0,334,0
Canadiens,0,1,0,0,1,Senators,0,1,0,1,2,20130225,0,0,0,1,3,1,2012,1,0,104,0
Stars,0,4,0,0,4,Predators,1,2,1,1,5,20130225,1,-1,0,1,9,1,2012,1,0,616,0
Oilers,1,1,0,0,2,Blackhawks,1,0,1,1,3,20130225,0,-1,0,1,5,1,2012,1,0,1437,0
Ducks,0,2,0,0,2,Kings,0,2,3,0,5,20130225,0,0,3,3,7,3,2012,0,0,0,0
Penguins,0,4,0,0,4,Panthers,1,3,2,0,6,20130226,1,0,2,2,10,2,2012,0,1,1013,0
Avalanche,1,0,1,0,2,Sharks,1,1,0,1,3,20130226,0,1,0,1,5,1,2012,1,1,927,0
Flames,1,0,0,0,1,Wild,0,0,1,1,2,20130226,-1,-1,0,1,3,1,2012,1,1,1043,0
Sabres,1,0,1,0,2,Lightning,1,0,0,0,1,20130226,0,0,1,1,3,-1,2012,0,1,1051,0
Coyotes,1,1,2,0,4,Canucks,0,1,1,0,2,20130226,1,1,2,2,6,-2,2012,0,1,1228,0
Stars,1,2,1,1,5,Blue Jackets,0,2,2,0,4,20130226,1,1,0,1,9,-1,2012,1,1,912,0
Hurricanes,0,0,0,0,0,Capitals,1,1,1,0,3,20130226,1,2,3,3,3,3,2012,0,1,233,0
Jets,0,3,1,0,4,Rangers,0,1,2,0,3,20130226,0,2,1,1,7,-1,2012,0,1,1287,0
Bruins,1,2,1,0,4,Islanders,1,0,0,0,1,20130226,0,2,3,3,5,-3,2012,0,1,190,0
Canadiens,1,1,3,0,5,Maple Leafs,1,1,0,0,2,20130227,0,0,3,3,7,-3,2012,0,2,303,0
Capitals,0,0,1,0,1,Flyers,2,2,0,0,4,20130227,2,4,3,3,5,3,2012,0,2,123,0
Predators,0,1,0,0,1,Ducks,3,2,0,0,5,20130227,3,4,4,4,6,4,2012,0,2,1776,0
Red Wings,1,0,0,0,1,Kings,0,0,2,0,2,20130227,-1,-1,1,1,3,1,2012,0,2,1979,0
Red Wings,0,0,1,1,2,Sharks,0,0,1,0,1,20130228,0,0,0,1,3,-1,2012,1,3,2071,0
Flames,3,1,0,0,4,Avalanche,0,2,3,0,5,20130228,-3,-2,1,1,9,1,2012,0,3,898,0
Oilers,2,1,2,0,5,Stars,0,0,1,0,1,20130228,2,3,4,4,6,-4,2012,0,3,1655,0
Blackhawks,1,0,2,0,3,Blues,0,0,0,0,0,20130228,1,1,3,3,3,-3,2012,0,3,260,0
Devils,0,1,0,0,1,Jets,1,0,2,0,3,20130228,1,0,2,2,4,2,2012,0,3,1280,0
Wild,2,2,0,0,4,Coyotes,0,1,2,0,3,20130228,2,3,1,1,7,-1,2012,0,3,1278,0
Penguins,1,0,0,0,1,Hurricanes,1,3,0,0,4,20130228,0,3,3,3,5,3,2012,0,3,330,0
Lightning,1,0,0,0,1,Rangers,2,1,1,0,4,20130228,1,2,3,3,5,3,2012,0,3,1004,0
Maple Leafs,1,3,0,1,5,Islanders,1,1,2,0,4,20130228,0,2,0,1,9,-1,2012,1,3,341,0
Senators,0,1,0,0,1,Bruins,0,1,0,1,2,20130228,0,0,0,1,3,1,2012,1,3,320,0
Sabres,3,0,0,1,4,Panthers,2,0,1,0,3,20130228,1,1,0,1,7,-1,2012,1,3,1184,0
Oilers,2,0,0,0,2,Blues,0,2,2,0,4,20130301,-2,0,2,2,6,2,2012,0,4,1508,0
Blue Jackets,1,1,1,0,3,Blackhawks,1,2,0,1,4,20130301,0,1,0,1,7,1,2012,1,4,275,0
Wild,0,0,2,0,2,Ducks,2,1,0,0,3,20130301,2,3,1,1,5,1,2012,0,4,1521,0
Predators,0,0,1,0,1,Sharks,1,1,0,0,2,20130302,1,2,1,1,3,1,2012,0,5,1934,0
Kings,0,2,0,0,2,Canucks,1,3,1,0,5,20130302,1,2,3,3,7,3,2012,0,5,1076,0
Ducks,1,2,1,0,4,Coyotes,1,1,2,1,5,20130302,0,-1,0,1,9,1,2012,1,5,356,0
Panthers,1,1,0,0,2,Hurricanes,3,2,1,0,6,20130302,2,3,4,4,8,4,2012,0,5,696,0
Devils,0,1,2,0,3,Sabres,0,1,2,1,4,20130302,0,0,0,1,7,1,2012,1,5,284,0
Capitals,0,1,2,0,3,Jets,0,0,0,0,0,20130302,0,1,3,3,3,-3,2012,0,5,1247,0
Lightning,2,0,0,0,2,Bruins,0,2,1,0,3,20130302,-2,0,1,1,5,1,2012,0,5,1183,0
Senators,0,1,0,0,1,Flyers,0,2,0,0,2,20130302,0,1,1,1,3,1,2012,0,5,373,0
Penguins,1,3,2,1,7,Canadiens,1,3,2,0,6,20130302,0,0,0,1,13,-1,2012,1,5,474,0
Canadiens,2,0,2,0,4,Bruins,1,2,0,0,3,20130303,1,-1,1,1,7,-1,2012,0,6,270,0
Oilers,1,0,1,0,2,Wild,1,0,3,0,4,20130303,0,0,2,2,6,2,2012,0,6,1083,0
Sabres,0,1,1,0,2,Rangers,0,0,2,1,3,20130303,0,-1,0,1,5,1,2012,1,6,292,0
Hurricanes,2,1,0,0,3,Panthers,0,1,1,0,2,20130303,2,2,1,1,5,-1,2012,0,6,696,0
Canucks,1,1,0,0,2,Flames,1,1,2,0,4,20130303,0,0,2,2,6,2,2012,0,6,426,0
Avalanche,0,1,0,0,1,Blue Jackets,0,0,1,1,2,20130303,0,-1,0,1,3,1,2012,1,6,1163,0
Blackhawks,0,0,1,1,2,Red Wings,0,0,1,0,1,20130303,0,0,0,1,3,-1,2012,1,6,238,0
Blues,1,0,0,0,1,Stars,2,0,2,0,4,20130303,1,1,3,3,5,3,2012,0,6,547,0
Senators,0,1,1,0,2,Islanders,1,0,1,1,3,20130303,1,0,0,1,5,1,2012,1,6,334,0
Devils,0,2,0,0,2,Maple Leafs,1,0,3,0,4,20130304,1,-1,2,2,6,2,2012,0,0,333,0
Lightning,0,2,1,0,3,Penguins,1,0,3,0,4,20130304,1,-1,1,1,7,1,2012,0,0,874,0
Ducks,1,1,2,0,4,Coyotes,0,2,2,1,5,20130304,-1,0,0,1,9,1,2012,1,0,356,0
Predators,0,0,1,0,1,Kings,0,1,4,0,5,20130304,0,1,4,4,6,4,2012,0,0,1776,0
Sabres,0,0,3,0,3,Hurricanes,1,1,2,0,4,20130305,1,2,1,1,7,1,2012,0,1,491,0
Sharks,1,1,0,1,3,Canucks,0,2,0,0,2,20130305,1,0,0,1,5,-1,2012,1,1,821,0
Wild,1,0,2,0,3,Blackhawks,4,0,1,0,5,20130305,3,3,2,2,8,2,2012,0,1,355,0
Avalanche,0,0,1,0,1,Red Wings,0,2,0,0,2,20130305,0,2,1,1,3,1,2012,0,1,1154,0
Jets,0,1,0,0,1,Panthers,1,2,1,0,4,20130305,1,2,3,3,5,3,2012,0,1,1899,0
Canadiens,1,1,1,0,3,Islanders,0,3,3,0,6,20130305,-1,1,3,3,9,3,2012,0,1,343,0
Oilers,2,1,0,0,3,Blue Jackets,2,1,0,1,4,20130305,0,0,0,1,7,1,2012,1,1,1703,0
Bruins,3,0,0,0,3,Capitals,0,2,1,1,4,20130305,-3,-1,0,1,7,1,2012,1,1,394,0
Blues,2,2,0,0,4,Kings,1,1,4,0,6,20130305,-1,-2,2,2,10,2,2012,0,1,1586,0
Lightning,1,2,2,0,5,Devils,0,0,2,0,2,20130305,1,3,3,3,7,-3,2012,0,1,1000,0
Flyers,2,0,0,0,2,Rangers,2,0,2,0,4,20130305,0,0,2,2,6,2,2012,0,1,80,0
Coyotes,0,0,0,0,0,Ducks,1,0,1,0,2,20130306,1,1,2,2,2,2,2012,0,2,356,0
Sharks,0,1,0,0,1,Flames,1,0,3,0,4,20130306,1,0,3,3,5,3,2012,0,2,1027,0
Senators,0,1,3,0,4,Maple Leafs,2,1,2,0,5,20130306,2,2,1,1,9,1,2012,0,2,203,0
Avalanche,1,1,0,0,2,Blackhawks,1,0,2,0,3,20130306,0,-1,1,1,5,1,2012,0,2,916,0
Stars,1,1,3,0,5,Kings,1,1,0,0,2,20130307,0,0,3,3,7,-3,2012,0,3,1237,0
Oilers,0,0,0,0,0,Red Wings,0,2,1,0,3,20130307,0,2,3,3,3,3,2012,0,3,1592,0
Jets,1,0,1,0,2,Lightning,0,0,1,0,1,20130307,1,1,1,1,3,-1,2012,0,3,1705,0
Canucks,0,0,1,0,1,Blue Jackets,1,0,0,1,2,20130307,1,1,0,1,3,1,2012,1,3,2050,0
Canadiens,2,0,2,0,4,Hurricanes,0,2,0,0,2,20130307,2,0,2,2,6,-2,2012,0,3,727,0
Blues,1,3,2,0,6,Coyotes,1,1,1,0,3,20130307,0,2,3,3,9,-3,2012,0,3,1270,0
Penguins,1,3,1,0,5,Flyers,4,0,0,0,4,20130307,-3,0,1,1,9,-1,2012,0,3,257,0
Rangers,0,0,1,1,2,Islanders,1,0,0,0,1,20130307,-1,-1,0,1,3,-1,2012,1,3,0,0
Sabres,0,1,1,0,2,Devils,0,0,2,1,3,20130307,0,-1,0,1,5,1,2012,1,3,284,0
Maple Leafs,0,1,1,0,2,Bruins,1,2,1,0,4,20130307,1,2,2,2,6,2,2012,0,3,430,0
Panthers,0,0,1,0,1,Capitals,4,1,2,0,7,20130307,4,5,6,6,8,6,2012,0,3,924,0
Senators,2,0,1,0,3,Rangers,2,0,0,0,2,20130308,0,0,1,1,5,-1,2012,0,4,334,0
Jets,2,0,0,1,3,Panthers,1,0,1,0,2,20130308,1,1,0,1,5,-1,2012,1,4,1899,0
Oilers,0,0,0,0,0,Predators,2,2,2,0,6,20130308,2,4,6,6,6,6,2012,0,4,1758,0
Blackhawks,1,0,1,0,2,Avalanche,1,4,1,0,6,20130308,0,4,4,4,8,4,2012,0,4,916,0
Flames,0,0,0,0,0,Ducks,1,2,1,0,4,20130308,1,3,4,4,4,4,2012,0,4,1197,0
Flames,2,0,0,0,2,Kings,3,1,2,0,6,20130309,1,2,4,4,8,4,2012,0,5,1197,0
Stars,0,1,0,0,1,Coyotes,1,1,0,0,2,20130309,1,1,1,1,3,1,2012,0,5,884,0
Wild,0,1,0,1,2,Predators,0,0,1,0,1,20130309,0,1,0,1,3,-1,2012,1,5,696,0
Canadiens,0,1,3,0,4,Lightning,0,3,0,0,3,20130309,0,-2,1,1,7,-1,2012,0,5,1311,0
Devils,1,0,2,0,3,Hurricanes,2,3,1,0,6,20130309,1,4,3,3,9,3,2012,0,5,419,0
Blues,1,0,2,1,4,Sharks,1,2,0,0,3,20130309,0,-2,0,1,7,-1,2012,1,5,1719,0
Red Wings,0,0,0,0,0,Blue Jackets,1,2,0,0,3,20130309,1,3,3,3,3,3,2012,0,5,163,0
Capitals,0,1,1,0,2,Islanders,1,1,3,0,5,20130309,1,1,3,3,7,3,2012,0,5,204,0
Flyers,0,0,0,0,0,Bruins,3,0,0,0,3,20130309,3,3,3,3,3,3,2012,0,5,270,0
Penguins,3,1,0,1,5,Maple Leafs,1,2,1,0,4,20130309,2,1,0,1,9,-1,2012,1,5,222,0
Blues,1,0,1,0,2,Ducks,0,1,3,0,4,20130310,-1,0,2,2,6,2,2012,0,6,1586,0
Sharks,0,1,1,0,2,Avalanche,1,1,0,1,3,20130310,1,1,0,1,5,1,2012,1,6,927,0
Canucks,0,1,1,0,2,Wild,2,1,1,0,4,20130310,2,2,2,2,6,2,2012,0,6,1427,0
Oilers,4,2,0,0,6,Blackhawks,0,4,1,0,5,20130310,4,2,1,1,11,-1,2012,0,6,1437,0
Sabres,1,0,1,0,2,Flyers,2,1,0,0,3,20130310,1,2,1,1,5,1,2012,0,6,279,0
Jets,1,1,0,0,2,Devils,2,0,0,1,3,20130310,1,0,0,1,5,1,2012,1,6,1280,0
Canadiens,2,2,1,0,5,Panthers,0,0,2,0,2,20130310,2,4,3,3,7,-3,2012,0,6,1418,0
Blue Jackets,0,2,0,1,3,Red Wings,0,1,1,0,2,20130310,0,1,0,1,5,-1,2012,1,6,163,0
Rangers,1,2,1,0,4,Capitals,1,0,0,0,1,20130310,0,2,3,3,5,-3,2012,0,6,204,0
Islanders,0,1,0,0,1,Penguins,3,2,1,0,6,20130310,3,4,5,5,7,5,2012,0,6,314,0
Bruins,1,1,0,1,3,Senators,2,0,0,0,2,20130311,-1,0,0,1,5,-1,2012,1,0,320,0
Flames,0,0,1,0,1,Kings,2,0,1,0,3,20130311,2,2,2,2,4,2,2012,0,0,1197,0
Ducks,0,0,2,0,2,Wild,1,0,0,0,1,20130312,-1,-1,1,1,3,-1,2012,0,1,1521,0
Kings,0,1,1,0,2,Coyotes,2,2,1,0,5,20130312,2,3,3,3,7,3,2012,0,1,356,0
Oilers,2,1,1,0,4,Avalanche,0,0,0,0,0,20130312,2,3,4,4,4,-4,2012,0,1,1036,0
Predators,1,2,1,0,4,Stars,0,0,0,0,0,20130312,1,3,4,4,4,-4,2012,0,1,616,0
Sharks,0,1,1,0,2,Blues,1,2,1,0,4,20130312,1,2,2,2,6,2,2012,0,1,1719,0
Hurricanes,1,2,1,0,4,Capitals,0,0,0,0,0,20130312,1,3,4,4,4,-4,2012,0,1,233,0
Lightning,2,0,1,0,3,Panthers,0,2,0,0,2,20130312,2,0,1,1,5,-1,2012,0,1,205,0
Bruins,2,0,0,0,2,Penguins,0,0,3,0,3,20130312,-2,-2,1,1,5,1,2012,0,1,481,0
Canucks,0,1,0,1,2,Blue Jackets,0,1,0,0,1,20130312,0,0,0,1,3,-1,2012,1,1,2050,0
Rangers,0,1,0,0,1,Sabres,0,2,1,0,3,20130312,0,1,2,2,4,2,2012,0,1,292,0
Maple Leafs,0,1,1,0,2,Jets,1,2,2,0,5,20130312,1,2,3,3,7,3,2012,0,1,946,0
Senators,1,1,1,0,3,Canadiens,1,2,0,1,4,20130313,0,1,0,1,7,1,2012,1,2,104,0
Flyers,1,0,1,0,2,Devils,3,1,1,0,5,20130313,2,3,3,3,7,3,2012,0,2,75,0
Red Wings,1,1,0,0,2,Flames,2,0,3,0,5,20130313,1,0,3,3,7,3,2012,0,2,1573,0
Coyotes,0,0,0,0,0,Blues,0,1,2,0,3,20130314,0,1,3,3,3,3,2012,0,3,1270,0
Predators,1,1,2,0,4,Canucks,3,2,2,0,7,20130314,2,3,3,3,11,3,2012,0,3,2030,0
Kings,0,1,2,0,3,Sharks,1,2,1,0,4,20130314,1,2,1,1,7,1,2012,0,3,305,0
Avalanche,1,1,1,0,3,Wild,1,3,1,0,5,20130314,0,2,2,2,8,2,2012,0,3,698,0
Rangers,0,1,0,0,1,Jets,1,1,1,0,3,20130314,1,1,2,2,4,2,2012,0,3,1287,0
Ducks,0,1,0,1,2,Stars,1,0,0,0,1,20130314,-1,0,0,1,3,-1,2012,1,3,1237,0
Blackhawks,0,1,0,1,2,Blue Jackets,0,1,0,0,1,20130314,0,0,0,1,3,-1,2012,1,3,275,0
Capitals,0,1,2,0,3,Hurricanes,2,0,0,0,2,20130314,-2,-1,1,1,5,-1,2012,0,3,233,0
Penguins,0,0,3,0,3,Maple Leafs,0,1,0,0,1,20130314,0,-1,2,2,4,-2,2012,0,3,222,0
Panthers,0,1,0,0,1,Bruins,2,0,2,0,4,20130314,2,1,3,3,5,3,2012,0,3,1257,0
Islanders,0,1,1,0,2,Lightning,0,0,0,0,0,20130314,0,1,2,2,2,-2,2012,0,3,1004,0
Devils,0,1,0,0,1,Flyers,1,0,0,1,2,20130315,1,0,0,1,3,1,2012,1,4,75,0
Predators,0,1,2,0,3,Flames,2,1,3,0,6,20130315,2,2,3,3,9,3,2012,0,4,1692,0
Red Wings,0,0,2,1,3,Oilers,1,1,0,0,2,20130315,-1,-2,0,1,5,-1,2012,1,4,1592,0
Coyotes,0,0,0,0,0,Blue Jackets,0,0,0,1,1,20130316,0,0,0,1,1,1,2012,1,5,1664,0
Islanders,2,1,1,0,4,Panthers,0,0,3,0,3,20130316,2,3,1,1,7,-1,2012,0,5,1091,0
Ducks,1,0,0,0,1,Blues,0,1,0,1,2,20130316,-1,0,0,1,3,1,2012,1,5,1586,0
Blackhawks,3,3,2,0,8,Stars,0,0,1,0,1,20130316,3,6,7,7,9,-7,2012,0,5,802,0
Red Wings,1,1,3,0,5,Canucks,1,0,1,0,2,20130316,0,1,3,3,7,-3,2012,0,5,1967,0
Sharks,0,1,1,0,2,Kings,2,3,0,0,5,20130316,2,4,3,3,7,3,2012,0,5,305,0
Canadiens,1,0,1,0,2,Devils,0,1,0,0,1,20130316,1,0,1,1,3,-1,2012,0,5,342,0
Hurricanes,0,0,1,0,1,Lightning,1,2,1,0,4,20130316,1,3,3,3,5,3,2012,0,5,585,0
Capitals,0,1,0,0,1,Bruins,2,1,1,0,4,20130316,2,2,3,3,5,3,2012,0,5,394,0
Rangers,0,0,0,0,0,Penguins,1,0,2,0,3,20130316,1,1,3,3,3,3,2012,0,5,314,0
Senators,0,3,0,1,4,Sabres,2,0,1,0,3,20130316,-2,1,0,1,7,-1,2012,1,5,219,0
Wild,4,1,1,0,6,Avalanche,1,2,1,0,4,20130316,3,2,2,2,10,-2,2012,0,5,698,0
Jets,0,4,0,1,5,Maple Leafs,1,2,1,0,4,20130316,-1,1,0,1,9,-1,2012,1,5,946,0
Jets,0,0,1,0,1,Senators,2,0,2,0,4,20130317,2,2,3,3,5,3,2012,0,6,1033,0
Predators,0,1,1,0,2,Oilers,0,1,2,0,3,20130317,0,0,1,1,5,1,2012,0,6,1758,0
Sabres,0,2,1,0,3,Capitals,1,3,1,0,5,20130317,1,2,2,2,8,2,2012,0,6,292,0
Bruins,1,0,0,0,1,Penguins,2,0,0,0,2,20130317,1,1,1,1,3,1,2012,0,6,481,0
Hurricanes,1,0,0,0,1,Rangers,0,1,0,1,2,20130318,-1,0,0,1,3,1,2012,1,0,423,0
Flyers,1,1,0,0,2,Lightning,2,0,2,0,4,20130318,1,0,2,2,6,2,2012,0,0,928,0
Blackhawks,2,2,1,0,5,Avalanche,1,1,0,0,2,20130318,1,2,3,3,7,-3,2012,0,0,916,0
Wild,0,1,2,0,3,Canucks,0,1,0,0,1,20130318,0,0,2,2,4,-2,2012,0,0,1427,0
Coyotes,0,0,0,0,0,Kings,1,1,2,0,4,20130318,1,2,4,4,4,4,2012,0,0,356,0
Flames,0,2,1,0,3,Stars,3,0,1,0,4,20130318,3,1,1,1,7,1,2012,0,0,1536,0
Sharks,1,1,1,0,3,Ducks,1,3,1,0,5,20130318,0,2,2,2,8,2,2012,0,0,305,0
Bruins,0,1,0,0,1,Jets,0,0,3,0,3,20130319,0,-1,2,2,4,2,2012,0,1,1349,0
Rangers,2,1,0,0,3,Devils,2,0,0,0,2,20130319,0,1,1,1,5,-1,2012,0,1,8,0
Coyotes,0,0,2,0,2,Kings,1,1,1,0,3,20130319,1,2,1,1,5,1,2012,0,1,356,0
Panthers,0,0,4,0,4,Hurricanes,0,0,1,0,1,20130319,0,0,3,3,5,-3,2012,0,1,696,0
Predators,0,1,2,0,3,Blue Jackets,0,2,2,0,4,20130319,0,1,1,1,7,1,2012,0,1,333,0
Sabres,2,0,0,1,3,Canadiens,0,0,2,0,2,20130319,2,2,0,1,5,-1,2012,1,1,311,0
Capitals,0,1,0,0,1,Penguins,0,1,1,0,2,20130319,0,0,1,1,3,1,2012,0,1,190,0
Blues,0,0,2,0,2,Canucks,0,3,0,0,3,20130319,0,3,1,1,5,1,2012,0,1,1778,0
Senators,1,0,4,0,5,Islanders,1,2,0,0,3,20130319,0,-2,2,2,8,-2,2012,0,1,334,0
Wild,1,3,0,0,4,Red Wings,0,1,1,0,2,20130320,1,3,2,2,6,-2,2012,0,2,542,0
Lightning,0,0,2,0,2,Maple Leafs,1,3,0,0,4,20130320,1,4,2,2,6,2,2012,0,2,1096,0
Stars,2,1,0,0,3,Avalanche,0,2,2,0,4,20130320,-2,-1,1,1,7,1,2012,0,2,661,0
Sharks,1,0,2,1,4,Oilers,1,1,1,0,3,20130320,0,-1,0,1,7,-1,2012,1,2,1190,0
Blackhawks,1,1,0,0,2,Ducks,1,0,3,0,4,20130320,0,-1,2,2,6,2,2012,0,2,1741,0
Stars,0,0,2,0,2,Kings,0,0,0,0,0,20130321,0,0,2,2,2,-2,2012,0,3,1237,0
Canucks,1,0,1,0,2,Coyotes,0,0,1,0,1,20130321,1,1,1,1,3,-1,2012,0,3,1228,0
Capitals,2,0,2,0,4,Jets,0,0,0,0,0,20130321,2,2,4,4,4,-4,2012,0,3,1247,0
Bruins,0,1,1,0,2,Senators,0,1,0,0,1,20130321,0,0,1,1,3,-1,2012,0,3,320,0
Flames,2,0,1,0,3,Predators,2,2,1,0,5,20130321,0,2,2,2,8,2,2012,0,3,1692,0
Panthers,1,1,1,0,3,Rangers,0,0,1,0,1,20130321,1,2,2,2,4,-2,2012,0,3,1091,0
Canadiens,1,1,3,0,5,Islanders,1,1,0,0,2,20130321,0,0,3,3,7,-3,2012,0,3,343,0
Maple Leafs,2,1,1,0,4,Sabres,1,2,1,1,5,20130321,-1,0,0,1,9,1,2012,1,3,57,0
Devils,1,2,1,0,4,Hurricanes,0,0,1,0,1,20130321,1,3,3,3,5,-3,2012,0,3,419,0
Penguins,0,2,2,0,4,Islanders,1,1,0,0,2,20130322,-1,0,2,2,6,-2,2012,0,4,314,0
Flames,0,1,0,0,1,Blue Jackets,1,3,1,0,5,20130322,1,3,4,4,6,4,2012,0,4,1670,0
Capitals,2,2,2,0,6,Jets,0,0,1,0,1,20130322,2,4,5,5,7,-5,2012,0,4,1247,0
Red Wings,2,2,1,0,5,Ducks,1,0,0,0,1,20130322,1,3,4,4,6,-4,2012,0,4,1979,0
Blue Jackets,1,1,0,0,2,Predators,4,0,1,0,5,20130323,3,2,3,3,7,3,2012,0,5,333,0
Blues,1,0,2,0,3,Oilers,0,0,0,0,0,20130323,1,1,3,3,3,-3,2012,0,5,1508,0
Avalanche,0,1,1,0,2,Stars,2,2,1,0,5,20130323,2,3,3,3,7,3,2012,0,5,661,0
Panthers,0,1,0,0,1,Devils,0,2,0,0,2,20130323,0,1,1,1,3,1,2012,0,5,1090,0
Sabres,0,2,0,0,2,Canadiens,0,0,1,0,1,20130323,0,2,1,1,3,-1,2012,0,5,311,0
Bruins,0,0,2,0,2,Maple Leafs,1,1,1,0,3,20130323,1,2,1,1,5,1,2012,0,5,430,0
Canucks,1,0,0,0,1,Kings,0,0,0,0,0,20130323,1,1,1,1,1,-1,2012,0,5,1076,0
Sharks,0,0,0,0,0,Wild,0,1,1,0,2,20130323,0,1,2,2,2,2,2012,0,5,1570,0
Lightning,0,0,3,0,3,Senators,4,0,1,0,5,20130323,4,4,2,2,8,2,2012,0,5,1251,0
Blues,0,1,1,0,2,Flames,1,1,1,0,3,20130324,1,1,1,1,5,1,2012,0,6,1440,0
Canucks,1,2,0,0,3,Avalanche,1,0,1,0,2,20130324,0,2,1,1,5,-1,2012,0,6,1105,0
Lightning,0,1,1,0,2,Jets,1,2,0,0,3,20130324,1,2,1,1,5,1,2012,0,6,1705,0
Red Wings,2,0,0,0,2,Ducks,0,1,0,0,1,20130324,2,1,1,1,3,-1,2012,0,6,1979,0
Capitals,2,0,0,1,3,Rangers,2,0,0,0,2,20130324,0,0,0,1,5,-1,2012,1,6,204,0
Panthers,0,0,0,0,0,Islanders,1,0,2,0,3,20130324,1,1,3,3,3,3,2012,0,6,1091,0
Flyers,0,1,0,0,1,Penguins,0,0,1,1,2,20130324,0,-1,0,1,3,1,2012,1,6,257,0
Maple Leafs,0,2,0,0,2,Bruins,0,1,1,1,3,20130325,0,-1,0,1,5,1,2012,1,0,430,0
Devils,0,1,1,0,2,Senators,1,1,0,1,3,20130325,1,1,0,1,5,1,2012,1,0,330,0
Kings,0,3,2,0,5,Blackhawks,1,2,1,0,4,20130325,-1,0,1,1,9,-1,2012,0,0,1741,0
Oilers,1,0,1,0,2,Predators,1,2,0,0,3,20130325,0,2,1,1,5,1,2012,0,0,1758,0
Wild,1,3,3,0,7,Stars,2,1,1,0,4,20130325,-1,1,3,3,11,-3,2012,0,0,863,0
Red Wings,1,1,1,0,3,Coyotes,2,0,0,0,2,20130325,-1,0,1,1,5,-1,2012,0,0,1687,0
Sharks,2,1,2,0,5,Ducks,0,1,2,0,3,20130325,2,2,2,2,8,-2,2012,0,0,305,0
Oilers,1,2,0,0,3,Blues,0,0,0,0,0,20130326,1,3,3,3,3,-3,2012,0,1,1508,0
Blue Jackets,0,0,0,0,0,Canucks,0,0,0,1,1,20130326,0,0,0,1,1,1,2012,1,1,2050,0
Flames,0,0,0,0,0,Blackhawks,1,1,0,0,2,20130326,1,2,2,2,2,2,2012,0,1,1397,0
Sabres,0,0,1,0,1,Lightning,1,1,0,0,2,20130326,1,2,1,1,3,1,2012,0,1,1051,0
Jets,1,2,1,0,4,Hurricanes,1,0,0,0,1,20130326,0,2,3,3,5,-3,2012,0,1,1350,0
Rangers,1,2,2,0,5,Flyers,0,1,1,0,2,20130326,1,2,3,3,7,-3,2012,0,1,80,0
Islanders,2,0,1,0,3,Capitals,0,2,0,0,2,20130326,2,0,1,1,5,-1,2012,0,1,204,0
Canadiens,0,0,0,0,0,Penguins,0,1,0,0,1,20130326,0,1,1,1,1,1,2012,0,1,474,0
Panthers,1,0,1,0,2,Maple Leafs,0,1,2,0,3,20130326,-1,0,1,1,5,1,2012,0,1,1234,0
Canadiens,1,1,3,1,6,Bruins,0,4,1,0,5,20130327,1,-2,0,1,11,-1,2012,1,2,270,0
Coyotes,0,2,1,0,3,Wild,1,1,1,1,4,20130327,1,0,0,1,7,1,2012,1,2,1278,0
Avalanche,0,2,1,0,3,Flames,2,2,0,0,4,20130327,2,2,1,1,7,1,2012,0,2,898,0
Ducks,0,0,0,0,0,Sharks,3,0,1,0,4,20130327,3,3,4,4,4,4,2012,0,2,305,0
Red Wings,0,0,0,0,0,Sharks,1,0,1,0,2,20130328,1,1,2,2,2,2,2012,0,3,2071,0
Avalanche,0,0,1,0,1,Canucks,1,0,3,0,4,20130328,1,1,3,3,5,3,2012,0,3,1105,0
Blue Jackets,2,1,1,0,4,Oilers,1,2,3,0,6,20130328,-1,0,2,2,10,2,2012,0,3,1703,0
Coyotes,6,1,0,0,7,Predators,3,0,1,0,4,20130328,3,4,3,3,11,-3,2012,0,3,1442,0
Kings,0,2,2,0,4,Blues,0,1,1,0,2,20130328,0,1,2,2,6,-2,2012,0,3,1586,0
Islanders,0,1,2,1,4,Flyers,2,0,1,0,3,20130328,-2,-1,0,1,7,-1,2012,1,3,80,0
Rangers,0,0,0,0,0,Senators,0,1,2,0,3,20130328,0,1,3,3,3,3,2012,0,3,334,0
Jets,0,0,0,0,0,Penguins,2,2,0,0,4,20130328,2,4,4,4,4,4,2012,0,3,1060,0
Hurricanes,0,2,1,0,3,Maple Leafs,1,1,4,0,6,20130328,1,0,3,3,9,3,2012,0,3,544,0
Sabres,0,3,1,0,4,Panthers,1,1,2,1,5,20130328,1,-1,0,1,9,1,2012,1,3,1184,0
Blue Jackets,1,4,1,0,6,Flames,0,3,1,0,4,20130329,1,2,2,2,10,-2,2012,0,4,1670,0
Wild,1,1,1,0,3,Stars,2,0,3,0,5,20130329,1,0,2,2,8,2,2012,0,4,863,0
Ducks,0,1,1,0,2,Blackhawks,0,0,1,0,1,20130329,0,1,1,1,3,-1,2012,0,4,1741,0
Devils,0,3,1,0,4,Lightning,0,2,2,1,5,20130329,0,-1,0,1,9,1,2012,1,4,1000,0
Coyotes,1,0,1,0,2,Sharks,0,1,1,1,3,20130330,-1,0,0,1,5,1,2012,1,5,614,0
Canucks,0,0,0,0,0,Oilers,4,0,0,0,4,20130330,4,4,4,4,4,4,2012,0,5,514,0
Kings,1,2,0,0,3,Wild,1,1,1,1,4,20130330,0,-1,0,1,7,1,2012,1,5,1521,0
Maple Leafs,1,1,2,0,4,Senators,0,0,0,0,0,20130330,1,2,4,4,4,-4,2012,0,5,203,0
Rangers,0,0,0,0,0,Canadiens,2,1,0,0,3,20130330,2,3,3,3,3,3,2012,0,5,343,0
Devils,1,0,1,0,2,Panthers,1,0,1,1,3,20130330,0,0,0,1,5,1,2012,1,5,1090,0
Predators,0,0,0,0,0,Avalanche,0,0,0,1,1,20130330,0,0,0,1,1,1,2012,1,5,1019,0
Hurricanes,2,0,1,0,3,Jets,0,1,0,0,1,20130330,2,1,2,2,4,-2,2012,0,5,1350,0
Islanders,0,0,0,0,0,Penguins,0,0,2,0,2,20130330,0,0,2,2,2,2,2012,0,5,314,0
Bruins,0,0,1,0,1,Flyers,1,1,1,0,3,20130330,1,2,2,2,4,2,2012,0,5,270,0
Capitals,0,1,2,1,4,Sabres,1,2,0,0,3,20130330,-1,-2,0,1,7,-1,2012,1,5,292,0
Bruins,0,0,2,0,2,Sabres,0,0,0,0,0,20130331,0,0,2,2,2,-2,2012,0,6,399,0
Blackhawks,3,2,2,0,7,Red Wings,0,0,1,0,1,20130331,3,5,6,6,8,-6,2012,0,6,238,0
Ducks,0,0,1,0,1,Blue Jackets,0,1,0,1,2,20130331,0,1,0,1,3,1,2012,1,6,1973,0
Kings,1,0,2,0,3,Stars,0,1,1,0,2,20130331,1,0,1,1,5,-1,2012,0,6,1237,0
Capitals,1,1,2,0,4,Flyers,2,0,2,1,5,20130331,1,0,0,1,9,1,2012,1,6,123,0
Ducks,0,3,1,0,4,Stars,0,0,0,0,0,20130401,0,3,4,4,4,-4,2012,0,0,1237,0
Predators,0,0,2,0,2,Blackhawks,1,1,0,1,3,20130401,1,2,0,1,5,1,2012,1,0,395,0
Flames,0,0,1,0,1,Oilers,3,0,1,0,4,20130401,3,3,3,3,5,3,2012,0,0,171,0
Blues,1,2,1,0,4,Wild,0,1,0,0,1,20130401,1,2,3,3,5,-3,2012,0,0,466,0
Canucks,0,1,1,0,2,Sharks,0,3,0,0,3,20130401,0,2,1,1,5,1,2012,0,0,821,0
Hurricanes,1,0,0,0,1,Canadiens,1,1,2,0,4,20130401,0,1,3,3,5,3,2012,0,0,727,0
Jets,2,0,0,0,2,Rangers,1,1,2,0,4,20130401,-1,0,2,2,6,2,2012,0,0,1287,0
Islanders,2,0,1,0,3,Devils,0,1,0,0,1,20130401,2,1,2,2,4,-2,2012,0,0,8,0
Avalanche,0,0,2,0,2,Red Wings,1,2,0,0,3,20130401,1,3,1,1,5,1,2012,0,0,1154,0
Kings,1,0,0,0,1,Coyotes,1,1,1,0,3,20130402,0,1,2,2,4,2,2012,0,1,356,0
Panthers,1,1,0,1,3,Lightning,0,0,2,0,2,20130402,1,2,0,1,5,-1,2012,1,1,205,0
Sabres,2,2,0,0,4,Penguins,1,0,0,0,1,20130402,1,3,3,3,5,-3,2012,0,1,178,0
Avalanche,0,0,1,0,1,Predators,0,0,3,0,3,20130402,0,0,2,2,4,2,2012,0,1,1019,0
Jets,1,1,0,0,2,Islanders,1,2,2,0,5,20130402,0,1,3,3,7,3,2012,0,1,1287,0
Senators,1,0,1,0,2,Bruins,2,0,1,0,3,20130402,1,1,1,1,5,1,2012,0,1,320,0
Capitals,1,4,0,0,5,Hurricanes,2,1,0,0,3,20130402,-1,2,2,2,8,-2,2012,0,1,233,0
Penguins,0,1,0,0,1,Rangers,3,2,1,0,6,20130403,3,4,5,5,7,5,2012,0,2,314,0
Canadiens,1,2,0,0,3,Flyers,0,2,3,0,5,20130403,-1,-1,2,2,8,2,2012,0,2,400,0
Oilers,2,3,3,0,8,Flames,2,0,0,0,2,20130403,0,3,6,6,10,-6,2012,0,2,171,0
Stars,0,0,2,0,2,Ducks,1,2,2,0,5,20130403,1,3,3,3,7,3,2012,0,2,1237,0
Wild,0,2,0,0,2,Sharks,2,1,1,0,4,20130403,2,1,2,2,6,2,2012,0,2,1570,0
Wild,0,0,0,0,0,Kings,2,1,0,0,3,20130404,2,3,3,3,3,3,2012,0,3,1521,0
Oilers,0,0,0,0,0,Canucks,1,1,2,0,4,20130404,1,2,4,4,4,4,2012,0,3,514,0
Red Wings,1,0,1,0,2,Coyotes,0,3,1,0,4,20130404,-1,2,2,2,6,2,2012,0,3,1687,0
Blue Jackets,0,1,2,0,3,Predators,0,1,0,0,1,20130404,0,0,2,2,4,-2,2012,0,3,333,0
Blues,1,0,2,1,4,Blackhawks,0,2,1,0,3,20130404,1,-1,0,1,7,-1,2012,1,3,260,0
Lightning,0,3,2,0,5,Hurricanes,0,0,0,0,0,20130404,0,3,5,5,5,-5,2012,0,3,585,0
Islanders,0,0,1,0,1,Capitals,1,0,0,1,2,20130404,1,1,0,1,3,1,2012,1,3,204,0
Flyers,2,2,1,0,5,Maple Leafs,2,0,1,0,3,20130404,0,2,2,2,8,-2,2012,0,3,334,0
Devils,0,0,0,0,0,Bruins,0,1,0,0,1,20130404,0,1,1,1,1,1,2012,0,3,196,0
Jets,1,0,0,0,1,Canadiens,1,2,1,0,4,20130404,0,2,3,3,5,3,2012,0,3,1115,0
Senators,1,0,1,0,2,Sabres,1,0,3,0,4,20130405,0,0,2,2,6,2,2012,0,4,219,0
Rangers,0,0,1,0,1,Penguins,0,0,1,1,2,20130405,0,0,0,1,3,1,2012,1,4,314,0
Blue Jackets,0,1,0,0,1,Blues,0,2,1,0,3,20130405,0,1,2,2,4,2,2012,0,4,395,0
Red Wings,2,0,0,1,3,Avalanche,1,0,1,0,2,20130405,1,1,0,1,5,-1,2012,1,4,1154,0
Stars,3,0,0,0,3,Ducks,1,0,0,0,1,20130405,2,2,2,2,4,-2,2012,0,4,1237,0
Flames,1,0,0,0,1,Sharks,0,0,2,0,2,20130405,-1,-1,1,1,3,1,2012,0,4,1027,0
Flames,1,0,1,0,2,Canucks,2,2,1,0,5,20130406,1,3,3,3,7,3,2012,0,5,426,0
Avalanche,0,0,0,0,0,Coyotes,1,3,0,0,4,20130406,1,4,4,4,4,4,2012,0,5,585,0
Capitals,1,3,0,0,4,Panthers,0,0,3,0,3,20130406,1,4,1,1,7,-1,2012,0,5,924,0
Rangers,0,3,1,0,4,Hurricanes,0,0,1,0,1,20130406,0,3,3,3,5,-3,2012,0,5,423,0
Lightning,0,1,1,0,2,Islanders,1,1,2,0,4,20130406,1,1,2,2,6,2,2012,0,5,1004,0
Flyers,1,0,0,0,1,Jets,0,4,0,0,4,20130406,-1,3,3,3,5,3,2012,0,5,1273,0
Bruins,0,1,0,0,1,Canadiens,1,1,0,0,2,20130406,1,1,1,1,3,1,2012,0,5,270,0
Oilers,0,1,0,0,1,Kings,2,1,1,0,4,20130406,2,2,3,3,5,3,2012,0,5,1368,0
Blackhawks,1,0,0,0,1,Predators,0,0,0,0,0,20130406,1,1,1,1,1,-1,2012,0,5,395,0
Maple Leafs,1,0,1,0,2,Devils,0,0,1,0,1,20130406,1,1,1,1,3,-1,2012,0,5,333,0
Kings,0,2,1,0,3,Ducks,1,1,1,1,4,20130407,1,0,0,1,7,1,2012,1,6,0,0
Devils,1,0,1,0,2,Sabres,1,1,0,1,3,20130407,0,1,0,1,5,1,2012,1,6,284,0
Lightning,1,1,0,0,2,Capitals,0,3,1,0,4,20130407,-1,1,2,2,6,2,2012,0,6,818,0
Predators,1,1,1,0,3,Blackhawks,1,1,3,0,5,20130407,0,0,2,2,8,2,2012,0,6,395,0
Senators,1,0,0,0,1,Panthers,0,1,1,0,2,20130407,-1,0,1,1,3,1,2012,0,6,1370,0
Stars,0,2,2,1,5,Sharks,1,3,0,0,4,20130407,-1,-2,0,1,9,-1,2012,1,6,1449,0
Blues,0,1,0,0,1,Red Wings,0,0,0,0,0,20130407,0,1,1,1,1,-1,2012,0,6,454,0
Wild,0,2,1,0,3,Blue Jackets,0,0,0,0,0,20130407,0,2,3,3,3,-3,2012,0,6,626,0
Hurricanes,0,0,2,0,2,Bruins,3,2,1,0,6,20130408,3,5,4,4,8,4,2012,0,0,609,0
Rangers,0,1,2,0,3,Maple Leafs,1,2,1,0,4,20130408,1,2,1,1,7,1,2012,0,0,341,0
Flames,0,2,1,0,3,Avalanche,0,1,0,0,1,20130408,0,1,2,2,4,-2,2012,0,0,898,0
Coyotes,0,0,0,0,0,Canucks,1,0,1,0,2,20130408,1,1,2,2,2,2,2012,0,0,1228,0
Oilers,0,0,1,0,1,Ducks,1,0,1,0,2,20130408,1,1,1,1,3,1,2012,0,0,1368,0
Kings,1,0,0,0,1,Stars,1,0,4,0,5,20130409,0,0,4,4,6,4,2012,0,1,1237,0
Blackhawks,0,1,0,0,1,Wild,0,0,0,0,0,20130409,0,1,1,1,1,-1,2012,0,1,355,0
Blues,0,1,0,0,1,Predators,0,0,0,0,0,20130409,0,1,1,1,1,-1,2012,0,1,253,0
Sabres,0,0,1,0,1,Jets,0,3,1,0,4,20130409,0,3,3,3,5,3,2012,0,1,996,0
Senators,1,0,1,0,2,Lightning,0,2,1,0,3,20130409,-1,1,1,1,5,1,2012,0,1,1251,0
Capitals,0,2,1,0,3,Canadiens,1,0,1,0,2,20130409,-1,1,1,1,5,-1,2012,0,1,495,0
Sharks,0,0,0,0,0,Blue Jackets,1,2,1,0,4,20130409,1,3,4,4,4,4,2012,0,1,2090,0
Penguins,2,0,3,0,5,Hurricanes,2,0,1,0,3,20130409,0,0,2,2,8,-2,2012,0,1,330,0
Flyers,1,0,0,0,1,Islanders,1,1,2,0,4,20130409,0,1,3,3,5,3,2012,0,1,80,0
Maple Leafs,0,1,1,0,2,Rangers,0,2,0,1,3,20130410,0,1,0,1,5,1,2012,1,2,341,0
Bruins,3,1,1,0,5,Devils,0,2,2,0,4,20130410,3,2,1,1,9,-1,2012,0,2,196,0
Canucks,1,0,3,0,4,Flames,1,0,0,0,1,20130410,0,0,3,3,5,-3,2012,0,2,426,0
Coyotes,0,2,1,0,3,Oilers,0,0,1,0,1,20130410,0,2,2,2,4,-2,2012,0,2,1392,0
Avalanche,1,3,0,0,4,Ducks,0,1,0,0,1,20130410,1,3,3,3,5,-3,2012,0,2,830,0
Blues,1,0,1,0,2,Wild,0,0,0,0,0,20130411,1,1,2,2,2,-2,2012,0,3,466,0
Avalanche,0,1,1,0,2,Kings,2,0,0,1,3,20130411,2,1,0,1,5,1,2012,1,3,830,0
Panthers,2,0,0,0,2,Jets,3,3,1,0,7,20130411,1,4,5,5,9,5,2012,0,3,1899,0
Sharks,1,0,1,1,3,Red Wings,0,1,1,0,2,20130411,1,0,0,1,5,-1,2012,1,3,2071,0
Senators,1,0,2,0,3,Flyers,1,0,0,0,1,20130411,0,0,2,2,4,-2,2012,0,3,373,0
Canadiens,2,2,1,0,5,Sabres,0,0,1,0,1,20130411,2,4,4,4,6,-4,2012,0,3,311,0
Hurricanes,1,0,0,0,1,Capitals,0,2,1,0,3,20130411,-1,1,2,2,4,2,2012,0,3,233,0
Islanders,1,1,0,0,2,Bruins,0,1,0,0,1,20130411,1,1,1,1,3,-1,2012,0,3,190,0
Penguins,2,1,3,0,6,Lightning,1,1,1,0,3,20130411,1,1,3,3,9,-3,2012,0,3,874,0
Senators,0,2,0,0,2,Devils,0,0,0,0,0,20130412,0,2,2,2,2,-2,2012,0,4,330,0
Blues,1,0,0,0,1,Blue Jackets,1,2,1,0,4,20130412,0,2,3,3,5,3,2012,0,4,395,0
Stars,2,2,1,0,5,Predators,1,0,1,0,2,20130412,1,3,3,3,7,-3,2012,0,4,616,0
Red Wings,0,2,0,0,2,Blackhawks,0,1,1,1,3,20130412,0,-1,0,1,5,1,2012,1,4,238,0
Coyotes,1,0,1,0,2,Flames,1,1,0,1,3,20130412,0,1,0,1,5,1,2012,1,4,1224,0
Flames,1,2,1,0,4,Oilers,1,0,0,0,1,20130413,0,2,3,3,5,-3,2012,0,5,171,0
Sharks,0,0,1,0,1,Stars,2,0,0,0,2,20130413,2,2,1,1,3,1,2012,0,5,1449,0
Blue Jackets,0,2,0,1,3,Wild,1,0,1,0,2,20130413,-1,1,0,1,5,-1,2012,1,5,626,0
Penguins,2,0,1,0,3,Panthers,0,1,0,0,1,20130413,2,1,2,2,4,-2,2012,0,5,1013,0
Bruins,1,1,0,0,2,Hurricanes,1,1,2,0,4,20130413,0,0,2,2,6,2,2012,0,5,609,0
Canucks,0,2,1,0,3,Avalanche,1,0,3,0,4,20130413,1,-1,1,1,7,1,2012,0,5,1105,0
Rangers,0,0,0,1,1,Islanders,0,0,0,0,0,20130413,0,0,0,1,1,-1,2012,1,5,0,0
Canadiens,1,0,0,0,1,Maple Leafs,4,1,0,0,5,20130413,3,4,4,4,6,4,2012,0,5,303,0
Flyers,0,0,0,0,0,Sabres,0,0,1,0,1,20130413,0,0,1,1,1,1,2012,0,5,279,0
Ducks,0,1,0,0,1,Kings,1,1,0,0,2,20130413,1,1,1,1,3,1,2012,0,5,0,0
Lightning,0,2,3,0,5,Capitals,3,2,0,1,6,20130413,3,3,0,1,11,1,2012,1,5,818,0
Lightning,0,1,0,0,1,Sabres,1,2,0,0,3,20130414,1,2,2,2,4,2,2012,0,6,1051,0
Red Wings,0,1,2,0,3,Predators,0,0,0,0,0,20130414,0,1,3,3,3,-3,2012,0,6,470,0
Blackhawks,0,1,1,0,2,Blues,0,0,0,0,0,20130414,0,1,2,2,2,-2,2012,0,6,260,0
Devils,0,0,0,0,0,Maple Leafs,0,0,2,0,2,20130415,0,0,2,2,2,2,2012,0,0,333,0
Flyers,2,4,1,0,7,Canadiens,1,2,0,0,3,20130415,1,3,4,4,10,-4,2012,0,0,400,0
Stars,0,1,1,0,2,Blackhawks,1,1,3,0,5,20130415,1,1,3,3,7,3,2012,0,0,802,0
Canucks,2,1,2,0,5,Predators,0,2,0,0,2,20130415,2,1,3,3,7,-3,2012,0,0,2030,0
Blue Jackets,0,1,2,1,4,Avalanche,0,1,2,0,3,20130415,0,0,0,1,7,-1,2012,1,0,1163,0
Wild,1,1,2,0,4,Flames,0,0,3,0,3,20130415,1,2,1,1,7,-1,2012,0,0,1043,0
Sharks,0,3,1,0,4,Coyotes,0,0,0,0,0,20130415,0,3,4,4,4,-4,2012,0,0,614,0
Kings,0,2,0,0,2,Sharks,0,2,0,1,3,20130416,0,0,0,1,5,1,2012,1,1,305,0
Wild,1,2,2,0,5,Oilers,1,0,2,0,3,20130416,0,2,2,2,8,-2,2012,0,1,1083,0
Canucks,0,1,0,0,1,Blues,0,0,1,1,2,20130416,0,-1,0,1,3,1,2012,1,1,1778,0
Lightning,1,0,2,0,3,Jets,1,2,0,1,4,20130416,0,2,0,1,7,1,2012,1,1,1705,0
Hurricanes,0,1,1,0,2,Senators,1,2,0,0,3,20130416,1,2,1,1,5,1,2012,0,1,673,0
Maple Leafs,0,0,1,0,1,Capitals,1,3,1,0,5,20130416,1,4,4,4,6,4,2012,0,1,349,0
Panthers,1,1,0,0,2,Islanders,3,2,0,0,5,20130416,2,3,3,3,7,3,2012,0,1,1091,0
Rangers,0,1,1,0,2,Flyers,2,1,1,0,4,20130416,2,2,2,2,6,2,2012,0,1,80,0
Canadiens,0,2,2,0,4,Penguins,3,2,1,0,6,20130417,3,3,2,2,10,2,2012,0,2,474,0
Sabres,1,0,1,1,3,Bruins,1,1,0,0,2,20130417,0,-1,0,1,5,-1,2012,1,2,399,0
Red Wings,0,1,1,0,2,Flames,1,0,2,0,3,20130417,1,0,1,1,5,1,2012,0,2,1573,0
Blue Jackets,0,1,1,1,3,Ducks,1,0,1,0,2,20130417,-1,0,0,1,5,-1,2012,1,2,1973,0
Wild,0,1,0,0,1,Sharks,1,2,3,0,6,20130418,1,2,5,5,7,5,2012,0,3,1570,0
Blue Jackets,0,1,0,0,1,Kings,1,1,0,0,2,20130418,1,1,1,1,3,1,2012,0,3,1973,0
Canucks,0,1,0,0,1,Stars,0,1,4,0,5,20130418,0,0,4,4,6,4,2012,0,3,1766,0
Coyotes,0,0,1,0,1,Blues,1,0,0,1,2,20130418,1,1,0,1,3,1,2012,1,3,1270,0
Hurricanes,0,1,2,0,3,Jets,1,1,1,1,4,20130418,1,1,0,1,7,1,2012,1,3,1350,0
Capitals,0,1,0,0,1,Senators,0,2,1,0,3,20130418,0,1,2,2,4,2,2012,0,3,446,0
Lightning,0,1,1,0,2,Canadiens,0,2,1,0,3,20130418,0,1,1,1,5,1,2012,0,3,1311,0
Panthers,1,0,0,0,1,Rangers,2,1,3,0,6,20130418,1,2,5,5,7,5,2012,0,3,1091,0
Islanders,3,1,1,0,5,Maple Leafs,2,0,1,0,3,20130418,1,2,2,2,8,-2,2012,0,3,341,0
Devils,0,1,2,0,3,Flyers,0,0,0,0,0,20130418,0,1,3,3,3,-3,2012,0,3,75,0
Ducks,0,0,1,0,1,Flames,0,1,2,0,3,20130419,0,1,2,2,4,2,2012,0,4,1197,0
Oilers,2,2,0,0,4,Avalanche,1,0,0,0,1,20130419,1,3,3,3,5,-3,2012,0,4,1036,0
Rangers,3,4,1,0,8,Sabres,0,3,1,0,4,20130419,3,4,4,4,12,-4,2012,0,4,292,0
Stars,0,0,1,0,1,Blues,1,1,0,0,2,20130419,1,2,1,1,3,1,2012,0,4,547,0
Predators,2,1,1,0,4,Blackhawks,2,1,1,1,5,20130419,0,0,0,1,9,1,2012,1,4,395,0
Penguins,0,1,2,0,3,Bruins,1,0,1,0,2,20130420,-1,0,1,1,5,-1,2012,0,5,481,0
Panthers,2,0,0,0,2,Devils,1,4,1,0,6,20130420,-1,3,4,4,8,4,2012,0,5,1090,0
Islanders,2,1,1,1,5,Jets,1,2,1,0,4,20130420,1,0,0,1,9,-1,2012,1,5,1287,0
Capitals,2,2,1,0,5,Canadiens,0,0,1,0,1,20130420,2,4,4,4,6,-4,2012,0,5,495,0
Maple Leafs,0,2,2,0,4,Senators,0,1,0,0,1,20130420,0,1,3,3,5,-3,2012,0,5,203,0
Flyers,1,2,2,0,5,Hurricanes,1,1,1,0,3,20130420,0,1,2,2,8,-2,2012,0,5,345,0
Coyotes,2,0,0,1,3,Blackhawks,1,1,0,0,2,20130420,1,0,0,1,5,-1,2012,1,5,1450,0
Red Wings,1,0,0,0,1,Canucks,1,0,0,1,2,20130420,0,0,0,1,3,1,2012,1,5,1967,0
Stars,0,2,1,0,3,Kings,1,1,1,1,4,20130421,1,0,0,1,7,1,2012,1,6,1237,0
Ducks,1,1,1,0,3,Oilers,1,0,0,0,1,20130421,0,1,2,2,4,-2,2012,0,6,1368,0
Blue Jackets,1,2,1,0,4,Sharks,0,1,2,0,3,20130421,1,2,1,1,7,-1,2012,0,6,2090,0
Blues,1,1,1,0,3,Avalanche,2,2,1,0,5,20130421,1,2,2,2,8,2,2012,0,6,794,0
Hurricanes,3,0,0,0,3,Lightning,0,1,1,0,2,20130421,3,2,1,1,5,-1,2012,0,6,585,0
Devils,0,0,1,0,1,Rangers,2,1,1,0,4,20130421,2,3,3,3,5,3,2012,0,6,8,0
Panthers,0,0,0,0,0,Bruins,1,1,1,0,3,20130421,1,2,3,3,3,3,2012,0,6,1257,0
Flames,1,1,2,0,4,Wild,1,0,0,0,1,20130421,0,1,3,3,5,-3,2012,0,6,1043,0
Jets,0,1,1,0,2,Sabres,0,1,0,0,1,20130422,0,0,1,1,3,-1,2012,0,0,996,0
Penguins,2,0,1,0,3,Senators,0,0,1,0,1,20130422,2,2,2,2,4,-2,2012,0,0,392,0
Coyotes,0,0,0,0,0,Red Wings,2,1,1,0,4,20130422,2,3,4,4,4,4,2012,0,0,1687,0
Ducks,2,0,1,0,3,Oilers,0,0,0,0,0,20130422,2,2,3,3,3,-3,2012,0,0,1368,0
Blackhawks,0,0,1,0,1,Canucks,1,2,0,0,3,20130422,1,3,2,2,4,2,2012,0,0,1775,0
Avalanche,0,1,0,0,1,Blues,1,2,0,0,3,20130423,1,2,2,2,4,2,2012,0,1,794,0
Stars,1,1,0,0,2,Sharks,1,0,2,0,3,20130423,0,-1,1,1,5,1,2012,0,1,1449,0
Kings,0,1,0,0,1,Wild,2,0,0,0,2,20130423,2,1,1,1,3,1,2012,0,1,1521,0
Flames,1,1,1,0,3,Predators,1,1,2,0,4,20130423,0,0,1,1,7,1,2012,0,1,1692,0
Rangers,0,0,2,0,2,Panthers,0,1,2,0,3,20130423,0,1,1,1,5,1,2012,0,1,1091,0
Canadiens,0,2,0,0,2,Devils,2,1,0,0,3,20130423,2,1,1,1,5,1,2012,0,1,342,0
Sabres,1,0,3,0,4,Penguins,1,0,1,0,2,20130423,0,0,2,2,6,-2,2012,0,1,178,0
Islanders,1,1,1,0,3,Hurricanes,2,1,0,1,4,20130423,1,1,0,1,7,1,2012,1,1,423,0
Jets,0,2,1,0,3,Capitals,2,2,1,0,5,20130423,2,2,2,2,8,2,2012,0,1,1247,0
Bruins,1,0,1,0,2,Flyers,1,2,2,0,5,20130423,0,2,3,3,7,3,2012,0,1,270,0
Maple Leafs,1,1,0,0,2,Lightning,0,2,3,0,5,20130424,-1,0,3,3,7,3,2012,0,2,1096,0
Kings,0,1,0,0,1,Red Wings,0,1,2,0,3,20130424,0,0,2,2,4,2,2012,0,2,1979,0
Blackhawks,2,0,2,0,4,Oilers,1,0,0,0,1,20130424,1,1,3,3,5,-3,2012,0,2,1437,0
Sharks,0,1,0,0,1,Coyotes,2,0,0,0,2,20130424,2,1,1,1,3,1,2012,0,2,614,0
Ducks,0,2,1,0,3,Canucks,0,0,1,0,1,20130425,0,2,2,2,4,-2,2012,0,3,1076,0
Blue Jackets,1,0,2,0,3,Stars,0,1,0,0,1,20130425,1,0,2,2,4,-2,2012,0,3,912,0
Flames,0,1,0,0,1,Blues,0,3,1,0,4,20130425,0,2,3,3,5,3,2012,0,3,1440,0
Canadiens,0,1,3,0,4,Jets,1,1,0,0,2,20130425,-1,-1,2,2,6,-2,2012,0,3,1115,0
Predators,2,0,0,0,2,Red Wings,1,3,1,0,5,20130425,-1,2,3,3,7,3,2012,0,3,470,0
Lightning,0,0,0,0,0,Bruins,0,2,0,0,2,20130425,0,2,2,2,2,2,2012,0,3,1183,0
Penguins,1,1,0,0,2,Devils,0,1,2,0,3,20130425,-1,-1,1,1,5,1,2012,0,3,306,0
Rangers,2,0,1,1,4,Hurricanes,0,2,1,0,3,20130425,2,0,0,1,7,-1,2012,1,3,423,0
Senators,0,1,0,1,2,Capitals,0,0,1,0,1,20130425,0,1,0,1,3,-1,2012,1,3,446,0
Islanders,0,1,0,0,1,Flyers,1,0,1,0,2,20130425,1,0,1,1,3,1,2012,0,3,80,0
Maple Leafs,2,2,0,0,4,Panthers,0,0,0,0,0,20130425,2,4,4,4,4,-4,2012,0,3,1234,0
Islanders,0,0,1,0,1,Sabres,0,1,0,1,2,20130426,0,1,0,1,3,1,2012,1,4,292,0
Oilers,3,3,0,0,6,Wild,0,0,1,0,1,20130426,3,6,5,5,7,-5,2012,0,4,1083,0
Flames,0,1,0,0,1,Blackhawks,2,0,1,0,3,20130426,2,1,2,2,4,2,2012,0,4,1397,0
Avalanche,3,1,0,1,5,Coyotes,2,1,1,0,4,20130426,1,1,0,1,9,-1,2012,1,4,585,0
Sharks,0,1,1,0,2,Kings,0,2,1,0,3,20130427,0,1,1,1,5,1,2012,0,5,305,0
Coyotes,2,1,2,0,5,Ducks,1,1,1,0,3,20130427,1,1,2,2,8,-2,2012,0,5,356,0
Canucks,1,0,1,0,2,Oilers,0,1,6,0,7,20130427,-1,0,5,5,9,5,2012,0,5,514,0
Blackhawks,0,0,1,0,1,Blues,2,1,0,0,3,20130427,2,3,2,2,4,2,2012,0,5,260,0
Wild,1,1,1,0,3,Avalanche,1,0,0,0,1,20130427,0,1,2,2,4,-2,2012,0,5,698,0
Red Wings,1,0,2,0,3,Stars,0,0,0,0,0,20130427,1,1,3,3,3,-3,2012,0,5,999,0
Hurricanes,0,3,0,0,3,Penguins,1,2,5,0,8,20130427,1,0,5,5,11,5,2012,0,5,330,0
Panthers,1,1,3,0,5,Lightning,2,1,0,0,3,20130427,-1,-1,2,2,8,-2,2012,0,5,205,0
Bruins,1,1,0,0,2,Capitals,0,0,2,1,3,20130427,-1,-2,0,1,5,1,2012,1,5,394,0
Flyers,1,0,1,0,2,Senators,0,1,0,0,1,20130427,1,0,1,1,3,-1,2012,0,5,373,0
Canadiens,1,2,1,0,4,Maple Leafs,1,0,0,0,1,20130427,0,2,3,3,5,-3,2012,0,5,303,0
Devils,0,0,0,0,0,Rangers,2,1,1,0,4,20130427,2,3,4,4,4,4,2012,0,5,8,0
Predators,0,1,0,0,1,Blue Jackets,0,0,3,0,3,20130427,0,-1,2,2,4,2,2012,0,5,333,0
Senators,1,1,2,0,4,Bruins,0,1,1,0,2,20130428,1,1,2,2,6,-2,2012,0,6,320,0
Wild,1,0,0,0,1,Blackhawks,0,1,0,1,2,20130430,-1,0,0,1,3,1,2012,1,1,355,1
Kings,0,0,1,0,1,Blues,1,0,0,1,2,20130430,1,1,0,1,3,1,2012,1,1,1586,1
Red Wings,1,0,0,0,1,Ducks,1,0,2,0,3,20130430,0,0,2,2,4,2,2012,0,1,1979,1
Sharks,0,1,2,0,3,Canucks,0,1,0,0,1,20130501,0,0,2,2,4,-2,2012,0,2,821,1
Maple Leafs,1,0,0,0,1,Bruins,2,2,0,0,4,20130501,1,3,3,3,5,3,2012,0,2,430,1
Islanders,0,0,0,0,0,Penguins,2,3,0,0,5,20130501,2,5,5,5,5,5,2012,0,2,314,1
Senators,1,0,3,0,4,Canadiens,0,2,0,0,2,20130502,1,-1,2,2,6,-2,2012,0,3,104,1
Rangers,1,0,0,0,1,Capitals,0,3,0,0,3,20130502,-1,2,2,2,4,2,2012,0,3,204,1
Kings,1,0,0,0,1,Blues,0,0,2,0,2,20130502,-1,-1,1,1,3,1,2012,0,3,1586,1
Red Wings,2,1,1,1,5,Ducks,0,1,3,0,4,20130502,2,2,0,1,9,-1,2012,1,3,1979,1
Sharks,1,0,1,1,3,Canucks,0,0,2,0,2,20130503,1,1,0,1,5,-1,2012,1,4,821,1
Senators,0,1,0,0,1,Canadiens,0,3,0,0,3,20130503,0,2,2,2,4,2,2012,0,4,104,1
Islanders,1,2,1,0,4,Penguins,3,0,0,0,3,20130503,-2,0,1,1,7,-1,2012,0,4,314,1
Wild,0,1,1,0,2,Blackhawks,1,1,3,0,5,20130503,1,1,3,3,7,3,2012,0,4,355,1
Ducks,0,1,3,0,4,Red Wings,0,0,0,0,0,20130504,0,1,4,4,4,-4,2012,0,5,1979,1
Blues,0,0,0,0,0,Kings,0,1,0,0,1,20130504,0,1,1,1,1,1,2012,0,5,1586,1
Rangers,0,0,0,0,0,Capitals,0,0,0,1,1,20130504,0,0,0,1,1,1,2012,1,5,204,1
Maple Leafs,0,2,2,0,4,Bruins,0,1,1,0,2,20130504,0,1,2,2,6,-2,2012,0,5,430,1
Penguins,3,1,0,1,5,Islanders,2,0,2,0,4,20130505,1,2,0,1,9,-1,2012,1,6,314,1
Blackhawks,1,0,1,0,2,Wild,1,0,1,1,3,20130505,0,0,0,1,5,1,2012,1,6,355,1
Canadiens,1,0,0,0,1,Senators,1,1,4,0,6,20130505,0,1,5,5,7,5,2012,0,6,104,1
Canucks,0,1,1,0,2,Sharks,1,1,3,0,5,20130505,1,1,3,3,7,3,2012,0,6,821,1
Bruins,1,3,1,0,5,Maple Leafs,0,1,1,0,2,20130506,1,3,3,3,7,-3,2012,0,0,430,1
Capitals,1,1,1,0,3,Rangers,1,1,2,0,4,20130506,0,0,1,1,7,1,2012,0,0,204,1
Ducks,1,0,1,0,2,Red Wings,0,0,2,1,3,20130506,-1,-1,0,1,5,1,2012,1,0,1979,1
Blues,2,1,0,0,3,Kings,2,0,2,0,4,20130506,0,-1,1,1,7,1,2012,0,0,1586,1
Canadiens,0,2,0,0,2,Senators,0,0,2,1,3,20130507,0,-2,0,1,5,1,2012,1,1,104,1
Penguins,1,2,1,0,4,Islanders,1,2,3,0,6,20130507,0,0,2,2,10,2,2012,0,1,314,1
Blackhawks,1,1,1,0,3,Wild,0,0,0,0,0,20130507,1,2,3,3,3,-3,2012,0,1,355,1
Canucks,1,0,2,0,3,Sharks,2,0,1,1,4,20130507,1,1,0,1,7,1,2012,1,1,821,1
Red Wings,1,1,0,0,2,Ducks,1,1,0,1,3,20130508,0,0,0,1,5,1,2012,1,2,1979,1
Kings,0,1,1,1,3,Blues,0,1,1,0,2,20130508,0,0,0,1,5,-1,2012,1,2,1586,1
Bruins,0,3,0,1,4,Maple Leafs,2,1,0,0,3,20130508,-2,0,0,1,7,-1,2012,1,2,430,1
Capitals,0,2,1,0,3,Rangers,1,1,2,0,4,20130508,1,0,1,1,7,1,2012,0,2,204,1
Senators,2,1,3,0,6,Canadiens,1,0,0,0,1,20130509,1,2,5,5,7,-5,2012,0,3,104,1
Islanders,0,0,0,0,0,Penguins,0,3,1,0,4,20130509,0,3,4,4,4,4,2012,0,3,314,1
Wild,0,1,0,0,1,Blackhawks,1,3,1,0,5,20130509,1,3,4,4,6,4,2012,0,3,355,1
Blues,0,1,0,0,1,Kings,1,1,0,0,2,20130510,1,1,1,1,3,1,2012,0,4,1586,1
Maple Leafs,0,1,1,0,2,Bruins,0,0,1,0,1,20130510,0,1,1,1,3,-1,2012,0,4,430,1
Rangers,1,0,0,0,1,Capitals,0,1,0,1,2,20130510,-1,0,0,1,3,1,2012,1,4,204,1
Ducks,0,1,2,0,3,Red Wings,1,0,2,1,4,20130510,1,0,0,1,7,1,2012,1,4,1979,1
Penguins,1,1,1,1,4,Islanders,2,0,1,0,3,20130511,-1,0,0,1,7,-1,2012,1,5,314,1
Capitals,0,0,0,0,0,Rangers,0,1,0,0,1,20130512,0,1,1,1,1,1,2012,0,6,204,1
Bruins,0,0,1,0,1,Maple Leafs,0,0,2,0,2,20130512,0,0,1,1,3,1,2012,0,6,430,1
Red Wings,2,1,0,0,3,Ducks,1,0,1,0,2,20130512,1,2,1,1,5,-1,2012,0,6,1979,1
Maple Leafs,1,1,2,0,4,Bruins,1,0,3,1,5,20130513,0,-1,0,1,9,1,2012,1,0,430,1
Rangers,1,2,2,0,5,Capitals,0,0,0,0,0,20130513,1,3,5,5,5,-5,2012,0,0,204,1
Sharks,0,0,0,0,0,Kings,1,1,0,0,2,20130514,1,2,2,2,2,2,2012,0,1,305,1
Senators,1,0,0,0,1,Penguins,2,1,1,0,4,20130514,1,2,3,3,5,3,2012,0,1,392,1
Red Wings,1,0,0,0,1,Blackhawks,1,0,3,0,4,20130515,0,0,3,3,5,3,2012,0,2,238,1
Sharks,0,2,1,0,3,Kings,1,1,2,0,4,20130516,1,0,1,1,7,1,2012,0,3,305,1
Rangers,0,1,1,0,2,Bruins,0,1,1,1,3,20130516,0,0,0,1,5,1,2012,1,3,190,1
Senators,1,1,1,0,3,Penguins,2,2,0,0,4,20130517,1,2,1,1,7,1,2012,0,4,392,1
Red Wings,0,2,2,0,4,Blackhawks,1,0,0,0,1,20130518,-1,1,3,3,5,-3,2012,0,5,238,1
Kings,1,0,0,0,1,Sharks,1,0,0,1,2,20130518,0,0,0,1,3,1,2012,1,5,305,1
Rangers,1,1,0,0,2,Bruins,1,2,2,0,5,20130519,0,1,3,3,7,3,2012,0,6,190,1
Penguins,0,1,0,0,1,Senators,0,0,1,1,2,20130519,0,-1,0,1,3,1,2012,1,6,392,1
Blackhawks,0,0,1,0,1,Red Wings,0,2,1,0,3,20130520,0,2,2,2,4,2,2012,0,0,238,1
Kings,0,0,1,0,1,Sharks,1,1,0,0,2,20130521,1,2,1,1,3,1,2012,0,1,305,1
Bruins,0,0,2,0,2,Rangers,0,1,0,0,1,20130521,0,-1,1,1,3,-1,2012,0,1,190,1
Penguins,1,2,4,0,7,Senators,2,0,1,0,3,20130522,-1,1,4,4,10,-4,2012,0,2,392,1
Bruins,0,2,1,0,3,Rangers,0,1,2,1,4,20130523,0,-1,0,1,7,1,2012,1,3,190,1
Blackhawks,0,0,0,0,0,Red Wings,0,1,1,0,2,20130523,0,1,2,2,2,2,2012,0,3,238,1
Sharks,0,0,0,0,0,Kings,0,1,2,0,3,20130523,0,1,3,3,3,3,2012,0,3,305,1
Senators,0,1,1,0,2,Penguins,1,3,2,0,6,20130524,1,3,4,4,8,4,2012,0,4,392,1
Red Wings,0,1,0,0,1,Blackhawks,1,2,1,0,4,20130525,1,2,3,3,5,3,2012,0,5,238,1
Rangers,1,0,0,0,1,Bruins,0,2,1,0,3,20130525,-1,1,2,2,4,2,2012,0,5,190,1
Kings,0,1,0,0,1,Sharks,1,1,0,0,2,20130526,1,1,1,1,3,1,2012,0,6,305,1
Blackhawks,1,0,3,0,4,Red Wings,1,1,1,0,3,20130527,0,-1,1,1,7,-1,2012,0,0,238,1
Sharks,0,0,1,0,1,Kings,0,2,0,0,2,20130528,0,2,1,1,3,1,2012,0,1,305,1
Red Wings,0,0,1,0,1,Blackhawks,0,1,0,1,2,20130529,0,1,0,1,3,1,2012,1,2,238,1
Kings,1,0,0,0,1,Blackhawks,0,2,0,0,2,20130601,-1,1,1,1,3,1,2012,0,5,1741,1
Bruins,1,0,2,0,3,Penguins,0,0,0,0,0,20130601,1,1,3,3,3,-3,2012,0,5,481,1
Kings,0,1,1,0,2,Blackhawks,2,2,0,0,4,20130602,2,3,2,2,6,2,2012,0,6,1741,1
Bruins,4,0,2,0,6,Penguins,1,0,0,0,1,20130603,3,3,5,5,7,-5,2012,0,0,481,1
Blackhawks,0,1,0,0,1,Kings,1,1,1,0,3,20130604,1,1,2,2,4,2,2012,0,1,1741,1
Penguins,0,1,0,0,1,Bruins,1,0,0,1,2,20130605,1,0,0,1,3,1,2012,1,2,481,1
Blackhawks,1,1,1,0,3,Kings,1,1,0,0,2,20130606,0,0,1,1,5,-1,2012,0,3,1741,1
Penguins,0,0,0,0,0,Bruins,0,0,1,0,1,20130607,0,0,1,1,1,1,2012,0,4,481,1
Kings,0,1,2,0,3,Blackhawks,2,0,1,1,4,20130608,2,1,0,1,7,1,2012,1,5,1741,1
Bruins,1,1,1,0,3,Blackhawks,0,1,2,1,4,20130612,-1,-1,0,1,7,1,2012,1,2,849,1
Bruins,0,1,0,1,2,Blackhawks,1,0,0,0,1,20130615,-1,0,0,1,3,-1,2012,1,5,849,1
Blackhawks,0,0,0,0,0,Bruins,0,2,0,0,2,20130617,0,2,2,2,2,2,2012,0,0,849,1
Blackhawks,1,3,1,1,6,Bruins,1,2,2,0,5,20130619,0,1,0,1,11,-1,2012,1,2,849,1
Bruins,0,0,1,0,1,Blackhawks,1,1,1,0,3,20130622,1,2,2,2,4,2,2012,0,5,849,1
Blackhawks,0,1,2,0,3,Bruins,1,0,1,0,2,20130624,-1,0,1,1,5,-1,2012,0,0,849,1
Jets,2,1,2,0,5,Oilers,2,2,0,0,4,20131001,0,-1,1,1,9,-1,2013,0,1,738,0
Capitals,1,1,2,0,4,Blackhawks,2,1,3,0,6,20131001,1,1,2,2,10,2,2013,0,1,594,0
Maple Leafs,1,2,1,0,4,Canadiens,2,0,1,0,3,20131001,-1,1,1,1,7,-1,2013,0,1,303,0
Sabres,0,0,1,0,1,Red Wings,2,0,0,0,2,20131002,2,2,1,1,3,1,2013,0,2,215,0
Maple Leafs,0,1,2,0,3,Flyers,1,0,0,0,1,20131002,-1,0,2,2,4,-2,2013,0,2,334,0
Ducks,0,0,1,0,1,Avalanche,1,3,2,0,6,20131002,1,4,5,5,7,5,2013,0,2,830,0
Devils,0,0,0,0,0,Penguins,2,0,1,0,3,20131003,2,2,3,3,3,3,2013,0,3,306,0
Flames,3,1,0,0,4,Capitals,0,3,1,1,5,20131003,-3,-1,0,1,9,1,2013,1,3,1967,0
Kings,1,0,1,1,3,Wild,2,0,0,0,2,20131003,-1,-1,0,1,5,-1,2013,1,3,1521,0
Predators,1,1,0,0,2,Blues,3,1,0,0,4,20131003,2,2,2,2,6,2,2013,0,3,253,0
Panthers,1,0,3,0,4,Stars,0,1,1,0,2,20131003,1,0,2,2,6,-2,2013,0,3,1110,0
Rangers,0,1,0,0,1,Coyotes,1,1,2,0,4,20131003,1,1,3,3,5,3,2013,0,3,2139,0
Canucks,1,0,0,0,1,Sharks,0,2,2,0,4,20131003,-1,1,3,3,5,3,2013,0,3,821,0
Lightning,0,1,0,0,1,Bruins,1,1,1,0,3,20131003,1,1,2,2,4,2,2013,0,3,1183,0
Flames,2,0,2,0,4,Blue Jackets,2,0,1,0,3,20131004,0,0,1,1,7,-1,2013,0,4,1670,0
Predators,0,1,0,0,1,Avalanche,1,1,1,0,3,20131004,1,1,2,2,4,2,2013,0,4,1019,0
Islanders,1,1,1,1,4,Devils,1,1,1,0,3,20131004,0,0,0,1,7,-1,2013,1,4,8,0
Senators,0,0,1,0,1,Sabres,0,0,0,0,0,20131004,0,0,1,1,1,-1,2013,0,4,219,0
Red Wings,0,0,2,1,3,Hurricanes,1,1,0,0,2,20131004,-1,-2,0,1,5,-1,2013,1,4,511,0
Kings,1,0,2,0,3,Jets,1,1,3,0,5,20131004,0,1,2,2,8,2,2013,0,4,1527,0
Red Wings,1,0,0,0,1,Bruins,1,2,1,0,4,20131005,0,2,3,3,5,3,2013,0,5,611,0
Senators,2,2,0,0,4,Maple Leafs,2,1,1,1,5,20131005,0,-1,0,1,9,1,2013,1,5,203,0
Flyers,0,0,1,0,1,Canadiens,1,0,3,0,4,20131005,1,1,3,3,5,3,2013,0,5,400,0
Blue Jackets,0,0,2,1,3,Islanders,0,2,0,0,2,20131005,0,-2,0,1,5,-1,2013,1,5,476,0
Sabres,0,0,1,0,1,Penguins,2,0,2,0,4,20131005,2,2,3,3,5,3,2013,0,5,178,0
Lightning,0,0,2,1,3,Blackhawks,0,2,0,0,2,20131005,0,-2,0,1,5,-1,2013,1,5,1004,0
Panthers,0,0,0,0,0,Blues,1,4,2,0,7,20131005,1,5,7,7,7,7,2013,0,5,1061,0
Capitals,1,0,0,0,1,Stars,1,1,0,0,2,20131005,0,1,1,1,3,1,2013,0,5,1181,0
Ducks,2,1,0,1,4,Wild,1,1,1,0,3,20131005,1,1,0,1,7,-1,2013,1,5,1521,0
Oilers,1,1,0,0,2,Canucks,3,2,1,0,6,20131005,2,3,4,4,8,4,2013,0,5,514,0
Coyotes,0,1,0,0,1,Sharks,3,0,1,0,4,20131005,3,2,3,3,5,3,2013,0,5,614,0
Ducks,1,1,1,0,3,Jets,2,0,0,0,2,20131006,-1,0,1,1,5,-1,2013,0,6,1527,0
Flyers,0,1,0,0,1,Hurricanes,1,1,0,0,2,20131006,1,1,1,1,3,1,2013,0,6,345,0
Canucks,1,0,3,1,5,Flames,1,1,2,0,4,20131006,0,-1,0,1,9,-1,2013,1,6,426,0
Devils,2,1,1,0,4,Oilers,0,0,4,1,5,20131007,-2,-3,0,1,9,1,2013,1,0,2016,0
Rangers,1,1,1,0,3,Kings,0,1,0,0,1,20131007,1,1,2,2,4,-2,2013,0,0,2445,0
Devils,1,1,0,0,2,Canucks,0,2,0,1,3,20131008,-1,0,0,1,5,1,2013,1,1,2421,0
Wild,1,1,0,0,2,Predators,3,0,0,0,3,20131008,2,1,1,1,5,1,2013,0,1,696,0
Rangers,1,0,1,0,2,Sharks,2,4,3,0,9,20131008,1,5,7,7,11,7,2013,0,1,2549,0
Hurricanes,0,1,1,0,2,Penguins,1,1,3,0,5,20131008,1,1,3,3,7,3,2013,0,1,330,0
Panthers,0,1,0,0,1,Flyers,2,0,0,0,2,20131008,2,1,1,1,3,1,2013,0,1,1021,0
Coyotes,0,1,0,0,1,Islanders,2,3,1,0,6,20131008,2,4,5,5,7,5,2013,0,1,2139,0
Avalanche,0,1,1,0,2,Maple Leafs,0,1,0,0,1,20131008,0,0,1,1,3,-1,2013,0,1,1341,0
Lightning,0,1,1,1,3,Sabres,0,2,0,0,2,20131008,0,-1,0,1,5,-1,2013,1,1,1051,0
Blackhawks,1,1,0,0,2,Blues,1,1,1,0,3,20131009,0,0,1,1,5,1,2013,0,2,260,0
Canadiens,0,1,1,0,2,Flames,2,1,0,0,3,20131009,2,2,1,1,5,1,2013,0,2,1852,0
Senators,0,1,2,0,3,Kings,3,0,0,1,4,20131009,3,2,0,1,7,1,2013,1,2,2345,0
Canadiens,0,2,2,0,4,Oilers,0,1,0,0,1,20131010,0,1,3,3,5,-3,2013,0,3,1826,0
Rangers,0,0,0,0,0,Ducks,3,3,0,0,6,20131010,3,6,6,6,6,6,2013,0,3,2445,0
Sharks,2,1,1,0,4,Canucks,0,1,0,0,1,20131010,2,2,3,3,5,-3,2013,0,3,821,0
Jets,1,0,0,0,1,Wild,1,1,0,0,2,20131010,0,1,1,1,3,1,2013,0,3,388,0
Avalanche,1,0,1,0,2,Bruins,0,0,0,0,0,20131010,1,1,2,2,2,-2,2013,0,3,1765,0
Panthers,0,1,1,0,2,Lightning,2,2,3,0,7,20131010,2,3,5,5,9,5,2013,0,3,205,0
Coyotes,1,1,2,0,4,Red Wings,0,2,0,0,2,20131010,1,0,2,2,6,-2,2013,0,3,1687,0
Hurricanes,0,2,1,0,3,Capitals,1,1,0,0,2,20131010,-1,0,1,1,5,-1,2013,0,3,233,0
Blue Jackets,3,1,0,0,4,Sabres,1,0,0,0,1,20131010,2,3,3,3,5,-3,2013,0,3,293,0
Maple Leafs,0,2,2,0,4,Predators,0,0,0,0,0,20131010,0,2,4,4,4,-4,2013,0,3,646,0
Devils,1,1,0,0,2,Flames,0,2,1,0,3,20131011,-1,0,1,1,5,1,2013,0,4,2015,0
Stars,3,1,0,0,4,Jets,0,0,1,0,1,20131011,3,4,3,3,5,-3,2013,0,4,1183,0
Penguins,2,1,0,0,3,Panthers,2,2,2,0,6,20131011,0,1,3,3,9,3,2013,0,4,1013,0
Coyotes,1,1,0,0,2,Flyers,0,1,0,0,1,20131011,1,1,1,1,3,-1,2013,0,4,2078,0
Kings,0,0,1,1,2,Hurricanes,0,0,1,0,1,20131011,0,0,0,1,3,-1,2013,1,4,2231,0
Islanders,2,0,0,0,2,Blackhawks,2,1,0,0,3,20131011,0,1,1,1,5,1,2013,0,4,711,0
Flyers,0,1,1,0,2,Red Wings,1,1,3,0,5,20131012,1,1,3,3,7,3,2013,0,5,441,0
Penguins,0,2,3,0,5,Lightning,1,2,1,0,4,20131012,-1,-1,1,1,9,-1,2013,0,5,874,0
Avalanche,2,1,2,0,5,Capitals,0,0,1,0,1,20131012,2,3,4,4,6,-4,2013,0,5,1489,0
Sabres,0,0,1,0,1,Blackhawks,1,1,0,0,2,20131012,1,2,1,1,3,1,2013,0,5,453,0
Rangers,1,1,1,0,3,Blues,1,3,1,0,5,20131012,0,2,2,2,8,2,2013,0,5,871,0
Islanders,0,2,0,0,2,Predators,0,2,1,0,3,20131012,0,0,1,1,5,1,2013,0,5,758,0
Stars,0,1,0,0,1,Wild,2,2,1,0,5,20131012,2,3,4,4,6,4,2013,0,5,863,0
Canadiens,1,1,2,0,4,Canucks,0,1,0,0,1,20131012,1,1,3,3,5,-3,2013,0,5,2273,0
Senators,2,0,0,0,2,Sharks,1,1,1,0,3,20131012,-1,0,1,1,5,1,2013,0,5,2408,0
Bruins,0,1,2,0,3,Blue Jackets,1,0,0,0,1,20131012,-1,0,2,2,4,-2,2013,0,5,642,0
Oilers,2,1,2,0,5,Maple Leafs,2,1,2,1,6,20131012,0,0,0,1,11,1,2013,1,5,1683,0
Senators,1,0,0,0,1,Ducks,2,2,0,0,4,20131013,1,3,3,3,5,3,2013,0,6,2345,0
Kings,0,2,1,0,3,Panthers,0,0,0,0,0,20131013,0,2,3,3,3,-3,2013,0,6,2335,0
Devils,0,0,0,0,0,Jets,0,1,2,0,3,20131013,0,1,3,3,3,3,2013,0,6,1280,0
Coyotes,1,2,2,0,5,Hurricanes,1,2,0,0,3,20131013,0,0,2,2,8,-2,2013,0,6,1898,0
Red Wings,1,2,0,0,3,Bruins,1,0,1,0,2,20131014,0,2,1,1,5,-1,2013,0,0,611,0
Oilers,1,0,1,0,2,Capitals,1,3,0,0,4,20131014,0,3,2,2,6,2,2013,0,0,1985,0
Wild,1,1,0,0,2,Sabres,0,1,0,0,1,20131014,1,1,1,1,3,-1,2013,0,0,729,0
Panthers,0,2,1,0,3,Predators,1,1,2,0,4,20131015,1,0,1,1,7,1,2013,0,1,816,0
Senators,0,1,2,1,4,Coyotes,0,2,1,0,3,20131015,0,-1,0,1,7,-1,2013,1,1,2071,0
Stars,1,1,0,0,2,Avalanche,2,1,0,0,3,20131015,1,1,1,1,5,1,2013,0,1,661,0
Canadiens,2,0,1,0,3,Jets,0,0,0,0,0,20131015,2,2,3,3,3,-3,2013,0,1,1115,0
Sharks,2,2,2,0,6,Blues,0,0,2,0,2,20131015,2,4,4,4,8,-4,2013,0,1,1719,0
Kings,0,0,1,0,1,Lightning,2,1,2,0,5,20131015,2,3,4,4,6,4,2013,0,1,2149,0
Blackhawks,2,0,0,1,3,Hurricanes,0,0,2,0,2,20131015,2,2,0,1,5,-1,2013,1,1,641,0
Oilers,0,2,0,0,2,Penguins,1,1,1,0,3,20131015,1,0,1,1,5,1,2013,0,1,1797,0
Canucks,1,0,2,0,3,Flyers,1,1,0,0,2,20131015,0,-1,1,1,5,-1,2013,0,1,2404,0
Sabres,0,2,1,1,4,Islanders,1,1,1,0,3,20131015,-1,0,0,1,7,-1,2013,1,1,292,0
Wild,1,0,0,0,1,Maple Leafs,2,1,1,0,4,20131015,1,2,3,3,5,3,2013,0,1,691,0
Blue Jackets,0,1,0,0,1,Red Wings,1,1,0,0,2,20131015,1,1,1,1,3,1,2013,0,1,163,0
Rangers,0,2,0,0,2,Capitals,0,0,0,0,0,20131016,0,2,2,2,2,-2,2013,0,2,204,0
Flames,1,0,1,0,2,Ducks,2,1,0,0,3,20131016,1,2,1,1,5,1,2013,0,2,1197,0
Red Wings,2,0,2,0,4,Avalanche,0,2,0,0,2,20131017,2,0,2,2,6,-2,2013,0,3,1154,0
Sharks,2,1,0,0,3,Stars,1,2,0,1,4,20131017,-1,0,0,1,7,1,2013,1,3,1449,0
Kings,1,0,0,1,2,Predators,1,0,0,0,1,20131017,0,0,0,1,3,-1,2013,1,3,1776,0
Blues,1,1,0,1,3,Blackhawks,1,1,0,0,2,20131017,0,0,0,1,5,-1,2013,1,3,260,0
Bruins,2,0,1,0,3,Panthers,0,1,1,0,2,20131017,2,1,1,1,5,-1,2013,0,3,1257,0
Blue Jackets,0,2,1,0,3,Canadiens,2,1,2,0,5,20131017,2,1,2,2,8,2,2013,0,3,605,0
Devils,0,0,2,0,2,Senators,2,1,2,0,5,20131017,2,3,3,3,7,3,2013,0,3,330,0
Penguins,0,2,2,0,4,Flyers,0,1,0,0,1,20131017,0,1,3,3,5,-3,2013,0,3,257,0
Oilers,2,0,0,0,2,Islanders,1,2,0,0,3,20131017,-1,1,1,1,5,1,2013,0,3,2024,0
Hurricanes,0,0,3,0,3,Maple Leafs,0,2,0,0,2,20131017,0,-2,1,1,5,-1,2013,0,3,544,0
Canucks,1,1,1,0,3,Sabres,0,0,0,0,0,20131017,1,2,3,3,3,-3,2013,0,3,2137,0
Wild,0,0,1,0,1,Lightning,1,0,2,0,3,20131017,1,1,2,2,4,2,2013,0,3,1318,0
Blues,2,0,1,0,3,Jets,1,0,2,1,4,20131018,-1,-1,0,1,7,1,2013,1,4,853,0
Coyotes,0,1,1,0,2,Ducks,1,0,1,1,3,20131018,1,0,0,1,5,1,2013,1,4,356,0
Maple Leafs,0,1,0,0,1,Blackhawks,0,3,0,0,3,20131019,0,2,2,2,4,2,2013,0,5,436,0
Blue Jackets,0,0,1,0,1,Capitals,0,2,2,0,4,20131019,0,2,3,3,5,3,2013,0,5,326,0
Stars,1,1,0,0,2,Kings,2,0,3,0,5,20131019,1,0,3,3,7,3,2013,0,5,1237,0
Flames,0,1,2,0,3,Sharks,2,2,2,0,6,20131019,2,3,3,3,9,3,2013,0,5,1027,0
Hurricanes,0,3,1,0,4,Islanders,0,1,2,0,3,20131019,0,2,1,1,7,-1,2013,0,5,423,0
Red Wings,2,0,0,0,2,Coyotes,0,1,4,0,5,20131019,-2,-1,3,3,7,3,2013,0,5,1687,0
Wild,0,1,0,0,1,Panthers,0,0,1,1,2,20131019,0,-1,0,1,3,1,2013,1,5,1513,0
Bruins,1,3,1,0,5,Lightning,0,0,0,0,0,20131019,1,4,5,5,5,-5,2013,0,5,1183,0
Predators,1,0,1,0,2,Canadiens,0,1,0,0,1,20131019,1,0,1,1,3,-1,2013,0,5,937,0
Avalanche,2,2,0,0,4,Sabres,0,1,1,0,2,20131019,2,3,2,2,6,-2,2013,0,5,1366,0
Oilers,2,0,1,0,3,Senators,0,0,1,0,1,20131019,2,2,2,2,4,-2,2013,0,5,1754,0
Rangers,0,0,0,0,0,Devils,2,2,0,0,4,20131019,2,4,4,4,4,4,2013,0,5,8,0
Canucks,1,1,1,0,3,Penguins,1,1,1,1,4,20131019,0,0,0,1,7,1,2013,1,5,2168,0
Canucks,0,1,0,0,1,Blue Jackets,1,0,2,0,3,20131020,1,0,2,2,4,2,2013,0,6,2050,0
Predators,0,3,0,0,3,Jets,0,0,1,0,1,20131020,0,3,2,2,4,-2,2013,0,6,1084,0
Stars,3,0,0,0,3,Ducks,1,3,2,0,6,20131020,-2,1,3,3,9,3,2013,0,6,1237,0
Sharks,0,0,0,1,1,Red Wings,0,0,0,0,0,20131021,0,0,0,1,1,-1,2013,1,0,2071,0
Avalanche,0,1,0,0,1,Penguins,0,0,0,0,0,20131021,0,1,1,1,1,-1,2013,0,0,1317,0
Flames,0,2,1,0,3,Kings,1,1,0,0,2,20131021,-1,0,1,1,5,-1,2013,0,0,1197,0
Flames,0,1,1,0,2,Coyotes,1,1,2,0,4,20131022,1,1,2,2,6,2,2013,0,1,1224,0
Predators,0,0,0,0,0,Wild,0,1,1,0,2,20131022,0,1,2,2,2,2,2013,0,1,696,0
Capitals,0,3,1,1,5,Jets,0,3,1,0,4,20131022,0,0,0,1,9,-1,2013,1,1,1247,0
Oilers,0,2,2,0,4,Canadiens,2,0,1,0,3,20131022,-2,0,1,1,7,-1,2013,0,1,1826,0
Ducks,1,1,0,0,2,Maple Leafs,0,3,1,0,4,20131022,-1,1,2,2,6,2,2013,0,1,2170,0
Devils,0,1,0,0,1,Blue Jackets,0,2,2,0,4,20131022,0,1,3,3,5,3,2013,0,1,467,0
Canucks,2,2,0,1,5,Islanders,2,1,1,0,4,20131022,0,1,0,1,9,-1,2013,1,1,2429,0
Blackhawks,0,2,0,1,3,Panthers,0,0,2,0,2,20131022,0,2,0,1,5,-1,2013,1,1,1189,0
Senators,3,1,2,0,6,Red Wings,1,0,0,0,1,20131023,2,3,5,5,7,-5,2013,0,2,406,0
Bruins,1,2,2,0,5,Sabres,0,2,0,0,2,20131023,1,1,3,3,7,-3,2013,0,2,399,0
Coyotes,0,2,2,0,4,Kings,4,0,3,0,7,20131024,4,2,3,3,11,3,2013,0,3,356,0
Capitals,1,1,2,0,4,Oilers,0,0,1,0,1,20131024,1,2,3,3,5,-3,2013,0,3,1985,0
Flames,0,1,0,0,1,Stars,1,3,1,0,5,20131024,1,3,4,4,6,4,2013,0,3,1536,0
Hurricanes,0,1,0,0,1,Wild,2,0,1,0,3,20131024,2,1,2,2,4,2,2013,0,3,995,0
Blackhawks,0,3,2,0,5,Lightning,1,2,2,1,6,20131024,1,0,0,1,11,1,2013,1,3,1004,0
Ducks,0,0,1,0,1,Canadiens,2,1,1,0,4,20131024,2,3,3,3,5,3,2013,0,3,2448,0
Rangers,1,0,0,0,1,Flyers,1,0,1,0,2,20131024,0,0,1,1,3,1,2013,0,3,80,0
Canucks,1,1,0,1,3,Devils,2,0,0,0,2,20131024,-1,0,0,1,5,-1,2013,1,3,2421,0
Sharks,0,0,1,0,1,Bruins,0,1,1,0,2,20131024,0,1,1,1,3,1,2013,0,3,2678,0
Jets,0,1,1,0,2,Predators,1,0,1,1,3,20131024,1,0,0,1,5,1,2013,1,3,1084,0
Hurricanes,0,1,1,0,2,Avalanche,2,1,1,0,4,20131025,2,2,2,2,6,2,2013,0,4,1459,0
Canucks,1,1,0,1,3,Blues,0,1,1,0,2,20131025,1,1,0,1,5,-1,2013,1,4,1778,0
Islanders,1,0,3,0,4,Penguins,1,1,1,0,3,20131025,0,-1,1,1,7,-1,2013,0,4,314,0
Ducks,2,0,0,0,2,Senators,0,1,0,0,1,20131025,2,1,1,1,3,-1,2013,0,4,2345,0
Maple Leafs,0,1,1,0,2,Blue Jackets,1,0,4,0,5,20131025,1,0,3,3,7,3,2013,0,4,313,0
Sabres,0,1,2,0,3,Panthers,1,0,0,0,1,20131025,-1,0,2,2,4,-2,2013,0,4,1184,0
Oilers,1,2,1,0,4,Coyotes,0,3,2,0,5,20131026,-1,0,1,1,9,1,2013,0,5,1392,0
Devils,1,1,2,0,4,Bruins,3,0,0,0,3,20131026,-2,-1,1,1,7,-1,2013,0,5,196,0
Penguins,1,0,0,0,1,Maple Leafs,1,0,3,0,4,20131026,0,0,3,3,5,3,2013,0,5,222,0
Sharks,0,1,1,0,2,Canadiens,0,0,0,0,0,20131026,0,1,2,2,2,-2,2013,0,5,2508,0
Rangers,0,1,1,1,3,Red Wings,1,1,0,0,2,20131026,-1,-1,0,1,5,-1,2013,1,5,480,0
Sabres,0,1,1,0,2,Lightning,1,0,2,0,3,20131026,1,0,1,1,5,1,2013,0,5,1051,0
Flyers,3,0,2,0,5,Islanders,1,1,0,0,2,20131026,2,1,3,3,7,-3,2013,0,5,80,0
Jets,0,1,0,1,2,Stars,0,0,1,0,1,20131026,0,1,0,1,3,-1,2013,1,5,1183,0
Wild,1,2,2,0,5,Blackhawks,0,1,2,0,3,20131026,1,2,2,2,8,-2,2013,0,5,355,0
Blues,1,2,3,0,6,Predators,0,0,1,0,1,20131026,1,3,5,5,7,-5,2013,0,5,253,0
Capitals,1,1,0,0,2,Flames,3,0,2,0,5,20131026,2,1,3,3,7,3,2013,0,5,1967,0
Oilers,0,1,0,0,1,Kings,0,1,0,1,2,20131027,0,0,0,1,3,1,2013,1,6,1368,0
Lightning,2,1,0,1,4,Panthers,1,0,2,0,3,20131027,1,2,0,1,7,-1,2013,1,6,205,0
Ducks,0,2,2,0,4,Blue Jackets,1,1,1,0,3,20131027,-1,0,1,1,7,-1,2013,0,6,1973,0
Sharks,3,0,2,0,5,Senators,1,1,0,0,2,20131027,2,1,3,3,7,-3,2013,0,6,2408,0
Jets,1,1,0,0,2,Avalanche,1,0,2,0,3,20131027,0,-1,1,1,5,1,2013,0,6,797,0
Stars,3,1,0,0,4,Sabres,1,2,0,0,3,20131028,2,1,1,1,7,-1,2013,0,0,1197,0
Penguins,1,1,1,0,3,Hurricanes,1,0,0,0,1,20131028,0,1,2,2,4,-2,2013,0,0,330,0
Canadiens,0,1,1,0,2,Rangers,0,0,0,0,0,20131028,0,1,2,2,2,-2,2013,0,0,343,0
Blackhawks,1,2,2,0,5,Wild,0,1,0,0,1,20131028,1,2,4,4,6,-4,2013,0,0,355,0
Capitals,1,0,1,0,2,Canucks,1,0,2,0,3,20131028,0,0,1,1,5,1,2013,0,0,2359,0
Maple Leafs,1,2,1,0,4,Oilers,0,0,0,0,0,20131029,1,3,4,4,4,-4,2013,0,1,1683,0
Kings,0,0,1,0,1,Coyotes,0,2,1,0,3,20131029,0,2,2,2,4,2,2013,0,1,356,0
Jets,1,0,1,0,2,Blues,1,0,2,0,3,20131029,0,0,1,1,5,1,2013,0,1,853,0
Rangers,1,0,2,0,3,Islanders,0,2,0,0,2,20131029,1,-1,1,1,5,-1,2013,0,1,0,0
Lightning,0,1,0,0,1,Devils,0,2,0,0,2,20131029,0,1,1,1,3,1,2013,0,1,1000,0
Stars,0,1,0,0,1,Canadiens,1,1,0,0,2,20131029,1,1,1,1,3,1,2013,0,1,1505,0
Senators,1,3,1,0,5,Blackhawks,1,2,3,0,6,20131029,0,-1,1,1,11,1,2013,0,1,628,0
Ducks,0,1,2,0,3,Flyers,2,0,0,0,2,20131029,-2,-1,1,1,5,-1,2013,0,1,2388,0
Bruins,0,0,2,0,2,Penguins,0,1,2,0,3,20131030,0,1,1,1,5,1,2013,0,2,481,0
Maple Leafs,2,0,2,0,4,Flames,0,1,1,0,2,20131030,2,1,2,2,6,-2,2013,0,2,1682,0
Red Wings,0,2,0,0,2,Canucks,1,0,0,0,1,20131030,-1,1,1,1,3,-1,2013,0,2,1967,0
Sharks,2,1,0,0,3,Kings,1,1,1,1,4,20131030,-1,-1,0,1,7,1,2013,1,2,305,0
Ducks,1,1,0,0,2,Bruins,0,1,1,1,3,20131031,-1,-1,0,1,5,1,2013,1,3,2590,0
Sabres,0,0,0,0,0,Rangers,1,1,0,0,2,20131031,1,2,2,2,2,2,2013,0,3,292,0
Predators,3,0,1,0,4,Coyotes,0,2,2,1,5,20131031,-3,-1,0,1,9,1,2013,1,3,1442,0
Red Wings,2,0,2,0,4,Flames,0,2,1,0,3,20131101,2,0,1,1,7,-1,2013,0,4,1573,0
Avalanche,1,1,0,1,3,Stars,0,0,2,0,2,20131101,1,2,0,1,5,-1,2013,1,4,661,0
Canadiens,1,0,2,0,3,Wild,1,1,2,0,4,20131101,0,1,1,1,7,1,2013,0,4,938,0
Lightning,0,1,2,0,3,Hurricanes,0,0,0,0,0,20131101,0,1,3,3,3,-3,2013,0,4,585,0
Islanders,0,3,1,1,5,Senators,2,2,0,0,4,20131101,-2,-1,0,1,9,-1,2013,1,4,334,0
Blue Jackets,0,1,1,0,2,Penguins,1,3,0,0,4,20131101,1,3,2,2,6,2,2013,0,4,161,0
Capitals,1,5,1,0,7,Flyers,0,0,0,0,0,20131101,1,6,7,7,7,-7,2013,0,4,123,0
Blues,1,3,0,0,4,Panthers,0,0,0,0,0,20131101,1,4,4,4,4,-4,2013,0,4,1061,0
Maple Leafs,0,0,0,0,0,Canucks,1,2,1,0,4,20131102,1,3,4,4,4,4,2013,0,5,2090,0
Coyotes,1,1,0,1,3,Sharks,0,2,0,0,2,20131102,1,0,0,1,5,-1,2013,1,5,614,0
Predators,2,1,1,0,4,Kings,1,0,2,0,3,20131102,1,2,1,1,7,-1,2013,0,5,1776,0
Red Wings,2,1,2,0,5,Oilers,0,0,0,0,0,20131102,2,3,5,5,5,-5,2013,0,5,1592,0
Penguins,0,1,2,0,3,Blue Jackets,0,0,0,0,0,20131102,0,1,3,3,3,-3,2013,0,5,161,0
Canadiens,0,0,1,0,1,Avalanche,0,1,3,0,4,20131102,0,1,3,3,5,3,2013,0,5,1618,0
Hurricanes,0,1,0,0,1,Rangers,1,2,2,0,5,20131102,1,2,4,4,6,4,2013,0,5,423,0
Bruins,0,1,0,0,1,Islanders,0,3,0,0,3,20131102,0,2,2,2,4,2,2013,0,5,190,0
Flyers,1,0,0,0,1,Devils,0,0,0,0,0,20131102,1,1,1,1,1,-1,2013,0,5,75,0
Blues,1,1,0,0,2,Lightning,1,1,2,0,4,20131102,0,0,2,2,6,2,2013,0,5,861,0
Ducks,0,3,3,0,6,Sabres,0,1,2,0,3,20131102,0,2,3,3,9,-3,2013,0,5,2193,0
Blackhawks,1,3,1,0,5,Jets,1,0,0,0,1,20131102,0,3,4,4,6,-4,2013,0,5,722,0
Panthers,0,1,1,0,2,Capitals,1,1,0,1,3,20131102,1,1,0,1,5,1,2013,1,5,924,0
Stars,1,1,1,1,4,Senators,0,2,1,0,3,20131103,1,0,0,1,7,-1,2013,1,6,1404,0
Flames,0,1,1,1,3,Blackhawks,0,1,1,0,2,20131103,0,0,0,1,5,-1,2013,1,6,1397,0
Devils,0,0,0,0,0,Wild,1,1,2,0,4,20131103,1,2,4,4,4,4,2013,0,6,1007,0
Ducks,2,0,0,0,2,Rangers,0,1,0,0,1,20131104,2,1,1,1,3,-1,2013,0,0,2445,0
Red Wings,0,2,0,0,2,Jets,1,1,2,0,4,20131104,1,0,2,2,6,2,2013,0,0,855,0
Sabres,0,2,2,1,5,Sharks,1,0,3,0,4,20131105,-1,1,0,1,9,-1,2013,1,1,2279,0
Canucks,0,2,0,0,2,Coyotes,1,1,0,1,3,20131105,1,0,0,1,5,1,2013,1,1,1228,0
Flames,1,0,0,0,1,Wild,1,1,3,0,5,20131105,0,1,4,4,6,4,2013,0,1,1043,0
Oilers,1,2,0,1,4,Panthers,1,0,2,0,3,20131105,0,2,0,1,7,-1,2013,1,1,2569,0
Blues,1,0,1,1,3,Canadiens,0,2,0,0,2,20131105,1,-1,0,1,5,-1,2013,1,1,962,0
Senators,2,0,2,0,4,Blue Jackets,0,0,1,0,1,20131105,2,2,3,3,5,-3,2013,0,1,512,0
Islanders,1,1,0,0,2,Capitals,0,5,1,0,6,20131105,-1,3,4,4,8,4,2013,0,1,204,0
Stars,1,0,1,1,3,Bruins,1,0,1,0,2,20131105,0,0,0,1,5,-1,2013,1,1,1548,0
Flyers,0,0,1,0,1,Hurricanes,0,0,1,1,2,20131105,0,0,0,1,3,1,2013,1,1,345,0
Penguins,0,1,0,0,1,Rangers,2,2,1,0,5,20131106,2,3,4,4,6,4,2013,0,2,314,0
Jets,0,0,1,0,1,Blackhawks,2,1,1,0,4,20131106,2,3,3,3,5,3,2013,0,2,722,0
Predators,2,2,2,0,6,Avalanche,1,2,1,0,4,20131106,1,1,2,2,10,-2,2013,0,2,1019,0
Coyotes,1,1,0,0,2,Ducks,1,2,2,0,5,20131106,0,1,3,3,7,3,2013,0,2,356,0
Flames,0,0,2,0,2,Blues,2,1,0,0,3,20131107,2,3,1,1,5,1,2013,0,3,1440,0
Canucks,3,1,0,0,4,Sharks,2,0,0,0,2,20131107,1,2,2,2,6,-2,2013,0,3,821,0
Sabres,0,0,0,0,0,Kings,1,1,0,0,2,20131107,1,2,2,2,2,2,2013,0,3,2193,0
Stars,0,1,2,1,4,Red Wings,0,2,1,0,3,20131107,0,-1,0,1,7,-1,2013,1,3,999,0
Oilers,1,0,1,0,2,Lightning,2,1,1,0,4,20131107,1,2,2,2,6,2,2013,0,3,2367,0
Rangers,1,2,1,0,4,Blue Jackets,1,1,0,0,2,20131107,0,1,2,2,6,-2,2013,0,3,476,0
Islanders,0,0,0,0,0,Hurricanes,1,0,0,0,1,20131107,1,1,1,1,1,1,2013,0,3,423,0
Wild,1,1,0,0,2,Capitals,1,0,1,1,3,20131107,0,-1,0,1,5,1,2013,1,3,931,0
Devils,1,0,2,0,3,Flyers,0,0,0,0,0,20131107,1,1,3,3,3,-3,2013,0,3,75,0
Canadiens,1,0,0,0,1,Senators,1,2,1,0,4,20131107,0,2,3,3,5,3,2013,0,3,104,0
Panthers,0,0,1,0,1,Bruins,0,1,3,0,4,20131107,0,1,3,3,5,3,2013,0,3,1257,0
Devils,0,0,1,0,1,Maple Leafs,0,0,1,1,2,20131108,0,0,0,1,3,1,2013,1,4,333,0
Predators,0,0,0,0,0,Jets,4,0,1,0,5,20131108,4,4,5,5,5,5,2013,0,4,1084,0
Flames,0,2,0,0,2,Avalanche,1,2,1,0,4,20131108,1,1,2,2,6,2,2013,0,4,898,0
Sabres,1,1,0,0,2,Ducks,4,2,0,0,6,20131108,3,4,4,4,8,4,2013,0,4,2193,0
Canucks,0,1,0,0,1,Kings,2,3,0,0,5,20131109,2,4,4,4,6,4,2013,0,5,1076,0
Capitals,0,3,0,0,3,Coyotes,1,0,2,1,4,20131109,1,-2,0,1,7,1,2013,1,5,1977,0
Penguins,0,1,0,0,1,Blues,0,1,1,0,2,20131109,0,0,1,1,3,1,2013,0,5,557,0
Blackhawks,1,2,2,0,5,Stars,1,1,0,0,2,20131109,0,1,3,3,7,-3,2013,0,5,802,0
Wild,1,1,0,1,3,Hurricanes,1,1,0,0,2,20131109,0,0,0,1,5,-1,2013,1,5,995,0
Oilers,0,1,1,0,2,Flyers,2,0,2,0,4,20131109,2,1,2,2,6,2,2013,0,5,2011,0
Lightning,1,1,0,1,3,Red Wings,1,0,1,0,2,20131109,0,1,0,1,5,-1,2013,1,5,994,0
Maple Leafs,0,1,0,0,1,Bruins,1,0,2,0,3,20131109,1,0,2,2,4,2,2013,0,5,430,0
Panthers,1,0,1,0,2,Senators,2,1,0,0,3,20131109,1,2,1,1,5,1,2013,0,5,1370,0
Islanders,1,1,0,0,2,Blue Jackets,1,1,3,0,5,20131109,0,0,3,3,7,3,2013,0,5,476,0
Canucks,0,1,0,0,1,Ducks,0,2,1,0,3,20131110,0,1,2,2,4,2,2013,0,6,1076,0
Capitals,0,1,0,0,1,Avalanche,1,1,2,0,4,20131110,1,1,3,3,5,3,2013,0,6,1489,0
Sharks,2,1,1,0,4,Jets,0,3,1,1,5,20131110,-2,0,0,1,9,1,2013,1,6,1496,0
Panthers,1,1,1,0,3,Rangers,1,1,2,0,4,20131110,0,0,1,1,7,1,2013,0,6,1091,0
Predators,0,0,0,0,0,Devils,1,2,2,0,5,20131110,1,3,5,5,5,5,2013,0,6,750,0
Islanders,0,1,1,0,2,Canadiens,0,3,1,0,4,20131110,0,2,2,2,6,2,2013,0,6,343,0
Oilers,0,2,2,0,4,Blackhawks,1,1,3,0,5,20131110,1,0,1,1,9,1,2013,0,6,1437,0
Lightning,0,0,0,0,0,Bruins,0,2,1,0,3,20131111,0,2,3,3,3,3,2013,0,0,1183,0
Ducks,2,0,0,0,2,Panthers,0,2,1,0,3,20131112,-2,0,1,1,5,1,2013,0,1,2335,0
Sharks,2,0,0,1,3,Flames,0,0,2,0,2,20131112,2,2,0,1,5,-1,2013,1,1,1027,0
Coyotes,2,0,0,1,3,Blues,1,0,1,0,2,20131112,1,1,0,1,5,-1,2013,1,1,1270,0
Jets,1,0,1,1,3,Red Wings,1,0,1,0,2,20131112,0,0,0,1,5,-1,2013,1,1,855,0
Avalanche,0,1,0,0,1,Hurricanes,1,1,0,0,2,20131112,1,1,1,1,3,1,2013,0,1,1459,0
Lightning,1,0,0,1,2,Canadiens,0,0,1,0,1,20131112,1,1,0,1,3,-1,2013,1,1,1311,0
Kings,1,0,1,0,2,Sabres,0,1,1,1,3,20131112,-1,0,0,1,5,1,2013,1,1,2193,0
Blue Jackets,0,1,2,0,3,Capitals,0,1,2,1,4,20131112,0,0,0,1,7,1,2013,1,1,326,0
Devils,0,2,1,0,3,Rangers,0,1,1,0,2,20131112,0,1,1,1,5,-1,2013,0,1,8,0
Predators,0,0,1,0,1,Islanders,2,1,0,0,3,20131112,2,3,2,2,4,2,2013,0,1,758,0
Flyers,1,2,2,0,5,Senators,0,0,0,0,0,20131112,1,3,5,5,5,-5,2013,0,1,373,0
Maple Leafs,0,1,0,0,1,Wild,0,0,1,1,2,20131113,0,-1,0,1,3,1,2013,1,2,691,0
Flyers,1,1,0,0,2,Penguins,0,1,0,0,1,20131113,1,1,1,1,3,-1,2013,0,2,257,0
Stars,0,1,2,0,3,Oilers,0,0,0,0,0,20131113,0,1,3,3,3,-3,2013,0,2,1655,0
Sharks,0,0,1,1,2,Canucks,0,1,0,0,1,20131114,0,-1,0,1,3,-1,2013,1,3,821,0
Stars,1,4,2,0,7,Flames,0,1,2,0,3,20131114,1,4,4,4,10,-4,2013,0,3,1536,0
Ducks,0,1,0,0,1,Lightning,2,2,1,0,5,20131114,2,3,4,4,6,4,2013,0,3,2149,0
Coyotes,2,2,0,0,4,Blackhawks,2,1,1,1,5,20131114,0,-1,0,1,9,1,2013,1,3,1450,0
Kings,0,0,3,0,3,Islanders,0,2,0,0,2,20131114,0,-2,1,1,5,-1,2013,0,3,2445,0
Blue Jackets,1,1,0,0,2,Bruins,1,1,0,1,3,20131114,0,0,0,1,5,1,2013,1,3,642,0
Avalanche,1,0,2,0,3,Blues,1,4,2,0,7,20131114,0,4,4,4,10,4,2013,0,3,794,0
Panthers,0,0,2,0,2,Wild,2,0,1,0,3,20131115,2,2,1,1,5,1,2013,0,4,1513,0
Sharks,2,1,0,0,3,Oilers,0,1,0,0,1,20131115,2,2,2,2,4,-2,2013,0,4,1190,0
Flyers,2,0,0,0,2,Jets,1,0,1,1,3,20131115,-1,-1,0,1,5,1,2013,1,4,1273,0
Capitals,1,0,2,1,4,Red Wings,2,1,0,0,3,20131115,-1,-2,0,1,7,-1,2013,1,4,394,0
Maple Leafs,0,1,0,0,1,Sabres,0,2,1,0,3,20131115,0,1,2,2,4,2,2013,0,4,57,0
Canadiens,1,1,0,1,3,Blue Jackets,2,0,0,0,2,20131115,-1,0,0,1,5,-1,2013,1,4,605,0
Ducks,0,1,1,0,2,Hurricanes,0,1,1,1,3,20131115,0,0,0,1,5,1,2013,1,4,2231,0
Predators,1,0,0,0,1,Penguins,2,2,0,0,4,20131115,1,3,3,3,5,3,2013,0,4,471,0
Kings,0,0,2,0,2,Devils,0,0,0,0,0,20131115,0,0,2,2,2,-2,2013,0,4,2436,0
Bruins,2,0,0,0,2,Senators,1,0,3,0,4,20131115,-1,-1,2,2,6,2,2013,0,4,320,0
Panthers,1,2,1,0,4,Avalanche,0,1,0,0,1,20131116,1,2,3,3,5,-3,2013,0,5,1724,0
Oilers,0,0,4,0,4,Flames,1,1,0,0,2,20131116,-1,-2,2,2,6,-2,2013,0,5,171,0
Lightning,0,2,1,0,3,Coyotes,2,2,2,0,6,20131116,2,2,3,3,9,3,2013,0,5,1793,0
Hurricanes,0,2,0,0,2,Blues,0,2,2,0,4,20131116,0,0,2,2,6,2,2013,0,5,665,0
Sabres,0,0,2,0,2,Maple Leafs,2,1,1,0,4,20131116,2,3,2,2,6,2,2013,0,5,57,0
Red Wings,2,1,1,0,4,Islanders,1,2,1,1,5,20131116,-1,0,0,1,9,1,2013,1,5,480,0
Penguins,0,1,0,0,1,Devils,1,1,2,0,4,20131116,1,1,3,3,5,3,2013,0,5,306,0
Rangers,0,1,0,0,1,Canadiens,0,0,0,0,0,20131116,0,1,1,1,1,-1,2013,0,5,343,0
Blackhawks,0,1,1,0,2,Predators,2,2,3,0,7,20131116,2,3,5,5,9,5,2013,0,5,395,0
Jets,0,0,1,0,1,Wild,1,0,1,0,2,20131117,1,1,1,1,3,1,2013,0,6,388,0
Stars,1,0,1,0,2,Canucks,0,0,1,0,1,20131117,1,1,1,1,3,-1,2013,0,6,1766,0
Kings,0,1,0,0,1,Rangers,0,0,0,0,0,20131117,0,1,1,1,1,-1,2013,0,6,2445,0
Blues,0,1,0,0,1,Capitals,3,1,0,0,4,20131117,3,3,3,3,5,3,2013,0,6,708,0
Blue Jackets,1,2,1,0,4,Senators,0,0,1,0,1,20131117,1,3,3,3,5,-3,2013,0,6,512,0
Sharks,0,1,0,0,1,Blackhawks,1,1,3,0,5,20131117,1,1,4,4,6,4,2013,0,6,1837,0
Bruins,2,0,2,0,4,Hurricanes,1,0,0,0,1,20131118,1,1,3,3,5,-3,2013,0,0,609,0
Ducks,0,0,1,0,1,Penguins,0,0,3,0,3,20131118,0,0,2,2,4,2,2013,0,0,2132,0
Flames,0,2,2,1,5,Jets,0,1,3,0,4,20131118,0,1,0,1,9,-1,2013,1,0,740,0
Blue Jackets,0,0,0,0,0,Oilers,3,3,1,0,7,20131119,3,6,7,7,7,7,2013,0,1,1703,0
Lightning,0,1,1,0,2,Kings,2,3,0,0,5,20131119,2,4,3,3,7,3,2013,0,1,2149,0
Panthers,1,0,1,1,3,Canucks,0,1,1,0,2,20131119,1,0,0,1,5,-1,2013,1,1,2803,0
Blackhawks,0,0,1,0,1,Avalanche,3,1,1,0,5,20131119,3,4,4,4,6,4,2013,0,1,916,0
Wild,0,0,2,0,2,Canadiens,0,4,2,0,6,20131119,0,4,4,4,8,4,2013,0,1,938,0
Predators,0,1,1,0,2,Red Wings,0,0,0,0,0,20131119,0,1,2,2,2,-2,2013,0,1,470,0
Senators,0,1,1,0,2,Flyers,1,1,3,0,5,20131119,1,1,3,3,7,3,2013,0,1,373,0
Islanders,0,1,1,0,2,Maple Leafs,1,1,3,0,5,20131119,1,1,3,3,7,3,2013,0,1,341,0
Blues,2,1,1,0,4,Sabres,1,0,0,0,1,20131119,1,2,3,3,5,-3,2013,0,1,660,0
Bruins,0,2,0,0,2,Rangers,0,1,0,0,1,20131119,0,1,1,1,3,-1,2013,0,1,190,0
Wild,1,2,1,0,4,Senators,2,0,1,0,3,20131120,-1,1,1,1,7,-1,2013,0,2,838,0
Penguins,2,1,1,0,4,Capitals,0,0,0,0,0,20131120,2,3,4,4,4,-4,2013,0,2,190,0
Blue Jackets,1,0,0,1,2,Flames,0,0,1,0,1,20131120,1,1,0,1,3,-1,2013,1,2,1670,0
Devils,2,0,1,1,4,Ducks,1,2,0,0,3,20131120,1,-1,0,1,7,-1,2013,1,2,2436,0
Panthers,0,1,0,0,1,Oilers,1,2,1,0,4,20131121,1,2,3,3,5,3,2013,0,3,2569,0
Lightning,0,0,1,0,1,Sharks,2,1,2,0,5,20131121,2,3,4,4,6,4,2013,0,3,2365,0
Devils,0,0,1,1,2,Kings,0,0,1,0,1,20131121,0,0,0,1,3,-1,2013,1,3,2436,0
Avalanche,0,2,1,1,4,Coyotes,0,1,2,0,3,20131121,0,1,0,1,7,-1,2013,1,3,585,0
Hurricanes,0,2,1,0,3,Red Wings,1,1,2,0,4,20131121,1,0,1,1,7,1,2013,0,3,511,0
Blackhawks,1,2,3,0,6,Jets,0,3,0,0,3,20131121,1,0,3,3,9,-3,2013,0,3,722,0
Rangers,1,0,2,0,3,Stars,0,1,1,0,2,20131121,1,0,1,1,5,-1,2013,0,3,1370,0
Sabres,1,0,0,0,1,Flyers,0,2,2,0,4,20131121,-1,1,3,3,5,3,2013,0,3,279,0
Predators,0,3,1,0,4,Maple Leafs,1,0,1,0,2,20131121,-1,2,2,2,6,-2,2013,0,3,646,0
Blues,1,1,0,1,3,Bruins,1,1,0,0,2,20131121,0,0,0,1,5,-1,2013,1,3,1035,0
Islanders,0,3,0,0,3,Penguins,2,1,1,0,4,20131122,2,0,1,1,7,1,2013,0,4,314,0
Canadiens,3,0,0,0,3,Capitals,1,0,1,0,2,20131122,2,2,1,1,5,-1,2013,0,4,495,0
Panthers,1,0,2,0,3,Flames,0,2,1,1,4,20131122,-1,1,0,1,7,1,2013,1,4,2493,0
Blue Jackets,1,0,1,0,2,Canucks,1,3,2,0,6,20131122,0,3,4,4,8,4,2013,0,4,2050,0
Lightning,0,0,0,0,0,Ducks,0,0,0,1,1,20131122,0,0,0,1,1,1,2013,1,4,2149,0
Devils,0,0,1,0,1,Sharks,2,0,0,0,2,20131123,2,2,1,1,3,1,2013,0,5,2540,0
Avalanche,0,0,0,1,1,Kings,0,0,0,0,0,20131123,0,0,0,1,1,-1,2013,1,5,830,0
Blackhawks,0,0,2,0,2,Canucks,1,0,0,0,1,20131123,-1,-1,1,1,3,-1,2013,0,5,1775,0
Ducks,1,3,0,0,4,Coyotes,0,1,1,0,2,20131123,1,3,2,2,6,-2,2013,0,5,356,0
Rangers,0,1,1,0,2,Predators,0,0,0,0,0,20131123,0,1,2,2,2,-2,2013,0,5,758,0
Islanders,0,1,1,0,2,Flyers,0,3,2,0,5,20131123,0,2,3,3,7,3,2013,0,5,80,0
Senators,2,0,2,0,4,Red Wings,1,0,1,0,2,20131123,1,1,2,2,6,-2,2013,0,5,406,0
Capitals,0,0,1,0,1,Maple Leafs,0,1,0,1,2,20131123,0,1,0,1,3,1,2013,1,5,349,0
Wild,0,0,2,1,3,Jets,0,1,1,0,2,20131123,0,-1,0,1,5,-1,2013,1,5,388,0
Hurricanes,1,0,1,0,2,Bruins,1,1,0,1,3,20131123,0,1,0,1,5,1,2013,1,5,609,0
Stars,1,0,0,0,1,Blues,2,1,3,0,6,20131123,1,2,5,5,7,5,2013,0,5,547,0
Penguins,0,0,2,0,2,Canadiens,0,1,2,0,3,20131123,0,1,1,1,5,1,2013,0,5,474,0
Red Wings,0,1,2,0,3,Sabres,1,0,0,0,1,20131124,-1,0,2,2,4,-2,2013,0,6,215,0
Senators,1,0,0,0,1,Hurricanes,0,3,1,0,4,20131124,-1,2,3,3,5,3,2013,0,6,673,0
Coyotes,0,2,0,0,2,Predators,3,0,1,0,4,20131125,3,1,2,2,6,2,2013,0,0,1442,0
Kings,1,0,1,1,3,Canucks,0,1,1,0,2,20131125,1,0,0,1,5,-1,2013,1,0,1076,0
Wild,0,0,0,0,0,Blues,2,0,1,0,3,20131125,2,2,3,3,3,3,2013,0,0,466,0
Blackhawks,2,2,1,0,5,Oilers,0,1,0,0,1,20131125,2,3,4,4,6,-4,2013,0,0,1437,0
Rangers,0,0,0,0,0,Lightning,2,2,1,0,5,20131125,2,4,5,5,5,5,2013,0,0,1004,0
Blue Jackets,2,2,2,0,6,Maple Leafs,0,0,0,0,0,20131125,2,4,6,6,6,-6,2013,0,0,313,0
Flyers,0,0,1,0,1,Panthers,0,2,1,0,3,20131125,0,2,2,2,4,2,2013,0,0,1021,0
Penguins,0,1,2,0,3,Bruins,2,0,1,1,4,20131125,2,1,0,1,7,1,2013,1,0,481,0
Jets,1,1,1,0,3,Devils,0,0,1,0,1,20131125,1,2,2,2,4,-2,2013,0,0,1280,0
Ducks,1,1,1,0,3,Stars,0,1,5,0,6,20131126,-1,-1,3,3,9,3,2013,0,1,1237,0
Canadiens,1,1,1,0,3,Sabres,0,1,0,0,1,20131127,1,1,2,2,4,-2,2013,0,2,311,0
Hurricanes,1,3,0,0,4,Devils,0,1,2,0,3,20131127,1,3,1,1,7,-1,2013,0,2,419,0
Jets,0,3,0,0,3,Islanders,0,1,1,0,2,20131127,0,2,1,1,5,-1,2013,0,2,1287,0
Senators,1,2,3,0,6,Capitals,3,0,1,0,4,20131127,-2,0,2,2,10,-2,2013,0,2,446,0
Predators,1,2,1,0,4,Blue Jackets,0,0,0,0,0,20131127,1,3,4,4,4,-4,2013,0,2,333,0
Flyers,0,0,2,0,2,Lightning,0,2,2,0,4,20131127,0,2,2,2,6,2,2013,0,2,928,0
Rangers,1,1,3,0,5,Panthers,0,0,2,0,2,20131127,1,2,3,3,7,-3,2013,0,2,1091,0
Maple Leafs,2,3,0,0,5,Penguins,1,2,2,1,6,20131127,-1,-2,0,1,11,1,2013,1,2,222,0
Coyotes,1,1,1,0,3,Wild,0,0,1,0,1,20131127,1,2,2,2,4,-2,2013,0,2,1278,0
Blues,3,0,1,0,4,Avalanche,1,0,0,0,1,20131127,2,2,3,3,5,-3,2013,0,2,794,0
Blackhawks,0,0,3,0,3,Flames,0,1,1,0,2,20131127,0,-1,1,1,5,-1,2013,0,2,1397,0
Kings,1,0,1,0,2,Sharks,0,2,0,1,3,20131127,-1,1,0,1,5,1,2013,1,2,305,0
Bruins,0,0,1,0,1,Red Wings,1,3,2,0,6,20131127,1,4,5,5,7,5,2013,0,2,611,0
Oilers,0,2,1,0,3,Predators,0,0,0,0,0,20131128,0,2,3,3,3,-3,2013,0,3,1758,0
Canucks,0,4,1,0,5,Senators,1,1,0,0,2,20131128,-1,2,3,3,7,-3,2013,0,3,2191,0
Rangers,2,0,0,0,2,Bruins,1,0,2,0,3,20131129,-1,-1,1,1,5,1,2013,0,4,190,0
Blackhawks,0,0,1,1,2,Stars,1,0,0,0,1,20131129,-1,-1,0,1,3,-1,2013,1,4,802,0
Maple Leafs,1,1,0,0,2,Sabres,0,2,0,1,3,20131129,-1,0,0,1,5,1,2013,1,4,57,0
Jets,0,0,1,0,1,Flyers,1,1,0,0,2,20131129,1,2,1,1,3,1,2013,0,4,1273,0
Devils,1,0,4,0,5,Hurricanes,0,2,0,0,2,20131129,1,-1,3,3,7,-3,2013,0,4,419,0
Oilers,0,0,2,0,2,Blue Jackets,1,3,0,0,4,20131129,1,4,2,2,6,2,2013,0,4,1703,0
Canadiens,1,1,0,0,2,Capitals,0,1,1,1,3,20131129,-1,-1,0,1,5,1,2013,1,4,495,0
Blues,0,1,2,0,3,Sharks,4,0,2,0,6,20131129,4,3,3,3,9,3,2013,0,4,1719,0
Flames,0,2,0,0,2,Ducks,2,2,1,0,5,20131129,2,2,3,3,7,3,2013,0,4,1197,0
Red Wings,1,1,3,0,5,Islanders,0,0,0,0,0,20131129,1,2,5,5,5,-5,2013,0,4,480,0
Penguins,1,0,2,0,3,Lightning,0,0,0,0,0,20131129,1,1,3,3,3,-3,2013,0,4,874,0
Avalanche,1,1,1,0,3,Wild,0,1,0,0,1,20131129,1,1,2,2,4,-2,2013,0,4,698,0
Wild,0,0,2,0,2,Avalanche,1,1,0,1,3,20131130,1,2,0,1,5,1,2013,1,5,698,0
Ducks,1,0,2,0,3,Sharks,0,3,0,1,4,20131130,-1,2,0,1,7,1,2013,1,5,305,0
Flames,0,1,1,0,2,Kings,0,0,1,0,1,20131130,0,1,1,1,3,-1,2013,0,5,1197,0
Blackhawks,3,0,2,0,5,Coyotes,0,2,0,0,2,20131130,3,1,3,3,7,-3,2013,0,5,1450,0
Maple Leafs,0,2,0,0,2,Canadiens,2,2,0,0,4,20131130,2,2,2,2,6,2,2013,0,5,303,0
Capitals,0,1,1,1,3,Islanders,0,0,2,0,2,20131130,0,1,0,1,5,-1,2013,1,5,204,0
Sabres,0,0,0,0,0,Devils,0,0,0,1,1,20131130,0,0,0,1,1,1,2013,1,5,284,0
Penguins,2,2,1,0,5,Panthers,0,1,0,0,1,20131130,2,3,4,4,6,-4,2013,0,5,1013,0
Canucks,0,1,1,0,2,Rangers,2,2,1,0,5,20131130,2,3,3,3,7,3,2013,0,5,2429,0
Blue Jackets,0,0,1,0,1,Bruins,2,0,1,0,3,20131130,2,2,2,2,4,2,2013,0,5,642,0
Flyers,1,0,1,1,3,Predators,1,0,1,0,2,20131130,0,0,0,1,5,-1,2013,1,5,683,0
Canucks,2,1,0,0,3,Hurricanes,0,2,0,0,2,20131201,2,1,1,1,5,-1,2013,0,6,2409,0
Red Wings,0,2,2,0,4,Senators,0,1,1,0,2,20131201,0,1,2,2,6,-2,2013,0,6,406,0
Oilers,0,1,1,1,3,Stars,0,1,1,0,2,20131201,0,0,0,1,5,-1,2013,1,6,1655,0
Jets,0,2,3,0,5,Rangers,1,1,0,0,2,20131202,-1,0,3,3,7,-3,2013,0,0,1287,0
Devils,1,0,1,0,2,Canadiens,0,2,1,0,3,20131202,-1,1,1,1,5,1,2013,0,0,342,0
Flyers,0,0,0,0,0,Wild,0,0,2,0,2,20131202,0,0,2,2,2,2,2013,0,0,983,0
Blues,0,0,2,0,2,Kings,2,1,0,0,3,20131202,2,3,1,1,5,1,2013,0,0,1586,0
Kings,0,1,1,1,3,Ducks,0,1,1,0,2,20131203,0,0,0,1,5,-1,2013,1,1,0,0
Coyotes,1,2,3,0,6,Oilers,1,1,0,0,2,20131203,0,1,4,4,8,-4,2013,0,1,1392,0
Canucks,0,1,2,0,3,Predators,0,1,0,0,1,20131203,0,0,2,2,4,-2,2013,0,1,2030,0
Lightning,0,0,0,0,0,Blue Jackets,0,1,0,0,1,20131203,0,1,1,1,1,1,2013,0,1,830,0
Senators,2,1,1,0,4,Panthers,2,0,0,0,2,20131203,0,1,2,2,6,-2,2013,0,1,1370,0
Hurricanes,1,3,0,0,4,Capitals,0,0,1,0,1,20131203,1,4,3,3,5,-3,2013,0,1,233,0
Penguins,0,1,1,1,3,Islanders,2,0,0,0,2,20131203,-2,-1,0,1,5,-1,2013,1,1,314,0
Sharks,2,1,1,0,4,Maple Leafs,0,2,0,0,2,20131203,2,1,2,2,6,-2,2013,0,1,2249,0
Stars,2,1,1,0,4,Blackhawks,0,3,0,0,3,20131203,2,0,1,1,7,-1,2013,0,1,802,0
Canadiens,1,0,2,1,4,Devils,0,0,3,0,3,20131204,1,1,0,1,7,-1,2013,1,2,342,0
Flyers,1,1,4,0,6,Red Wings,1,2,0,0,3,20131204,0,-1,3,3,9,-3,2013,0,2,441,0
Coyotes,1,0,0,0,1,Flames,1,2,1,0,4,20131204,0,2,3,3,5,3,2013,0,2,1224,0
Avalanche,0,2,0,0,2,Oilers,3,1,4,0,8,20131205,3,2,6,6,10,6,2013,0,3,1036,0
Hurricanes,1,3,1,0,5,Predators,0,2,0,0,2,20131205,1,2,3,3,7,-3,2013,0,3,456,0
Blackhawks,0,1,2,0,3,Wild,1,1,2,0,4,20131205,1,1,1,1,7,1,2013,0,3,355,0
Islanders,0,1,0,0,1,Blues,1,3,1,0,5,20131205,1,3,4,4,6,4,2013,0,3,871,0
Sharks,0,1,0,0,1,Penguins,0,4,1,0,5,20131205,0,3,4,4,6,4,2013,0,3,2242,0
Senators,0,1,0,0,1,Lightning,1,1,1,0,3,20131205,1,1,2,2,4,2,2013,0,3,1251,0
Bruins,1,0,0,0,1,Canadiens,0,2,0,0,2,20131205,-1,1,1,1,3,1,2013,0,3,270,0
Stars,0,0,2,0,2,Maple Leafs,0,1,1,1,3,20131205,0,1,0,1,5,1,2013,1,3,1201,0
Rangers,1,0,2,0,3,Sabres,0,0,1,0,1,20131205,1,1,2,2,4,-2,2013,0,3,292,0
Jets,1,0,1,0,2,Panthers,1,2,2,0,5,20131205,0,2,3,3,7,3,2013,0,3,1899,0
Red Wings,0,1,2,0,3,Devils,1,0,0,0,1,20131206,-1,0,2,2,4,-2,2013,0,4,471,0
Sharks,2,0,1,0,3,Hurricanes,0,1,4,0,5,20131206,-2,-1,2,2,8,2,2013,0,4,2382,0
Wild,0,0,0,0,0,Blue Jackets,0,2,2,0,4,20131206,0,2,4,4,4,4,2013,0,4,626,0
Ducks,1,1,0,1,3,Blackhawks,1,1,0,0,2,20131206,0,0,0,1,5,-1,2013,1,4,1741,0
Avalanche,0,2,1,0,3,Flames,1,0,1,0,2,20131206,-1,1,1,1,5,-1,2013,0,4,898,0
Coyotes,0,0,2,0,2,Canucks,0,2,0,1,3,20131206,0,2,0,1,5,1,2013,1,4,1228,0
Islanders,0,0,0,0,0,Kings,0,1,2,0,3,20131207,0,1,3,3,3,3,2013,0,5,2445,0
Flames,1,0,0,1,2,Oilers,0,0,1,0,1,20131207,1,1,0,1,3,-1,2013,1,5,171,0
Devils,0,1,2,1,4,Rangers,1,1,1,0,3,20131207,-1,-1,0,1,7,-1,2013,1,5,8,0
Predators,1,0,1,0,2,Capitals,3,0,2,0,5,20131207,2,2,3,3,7,3,2013,0,5,566,0
Ducks,3,1,1,0,5,Blues,0,0,2,0,2,20131207,3,4,3,3,7,-3,2013,0,5,1586,0
Panthers,0,1,1,0,2,Red Wings,1,0,0,0,1,20131207,-1,0,1,1,3,-1,2013,0,5,1155,0
Flyers,1,0,0,0,1,Stars,0,4,1,0,5,20131207,-1,3,4,4,6,4,2013,0,5,1297,0
Maple Leafs,1,2,0,1,4,Senators,1,0,2,0,3,20131207,0,2,0,1,7,-1,2013,1,5,203,0
Sabres,0,1,1,0,2,Canadiens,0,3,0,0,3,20131207,0,2,1,1,5,1,2013,0,5,311,0
Jets,1,0,0,1,2,Lightning,0,1,0,0,1,20131207,1,0,0,1,3,-1,2013,1,5,1705,0
Penguins,2,0,0,0,2,Bruins,1,0,2,0,3,20131207,-1,-1,1,1,5,1,2013,0,5,481,0
Sharks,0,0,1,0,1,Wild,0,2,1,0,3,20131208,0,2,2,2,4,2,2013,0,6,1570,0
Bruins,0,3,2,0,5,Maple Leafs,1,0,1,0,2,20131208,-1,2,3,3,7,-3,2013,0,6,430,0
Capitals,0,3,1,0,4,Rangers,0,0,1,0,1,20131208,0,3,3,3,5,-3,2013,0,6,204,0
Panthers,0,2,0,0,2,Blackhawks,2,2,2,0,6,20131208,2,2,4,4,8,4,2013,0,6,1189,0
Avalanche,0,0,1,0,1,Canucks,1,0,2,0,3,20131208,1,1,2,2,4,2,2013,0,6,1105,0
Islanders,1,1,0,0,2,Ducks,1,3,1,0,5,20131209,0,2,3,3,7,3,2013,0,0,2445,0
Flyers,1,2,1,0,4,Senators,1,1,2,1,5,20131209,0,-1,0,1,9,1,2013,1,0,373,0
Blue Jackets,0,0,1,0,1,Penguins,0,1,1,0,2,20131209,0,1,1,1,3,1,2013,0,0,161,0
Hurricanes,0,0,0,0,0,Canucks,1,0,1,0,2,20131209,1,1,2,2,2,2,2013,0,0,2409,0
Coyotes,0,3,0,0,3,Avalanche,0,1,0,0,1,20131210,0,2,2,2,4,-2,2013,0,1,585,0
Islanders,0,0,2,1,3,Sharks,0,2,0,0,2,20131210,0,-2,0,1,5,-1,2013,1,1,2549,0
Hurricanes,1,1,2,0,4,Oilers,3,1,0,1,5,20131210,2,2,0,1,9,1,2013,1,1,2076,0
Bruins,0,0,2,0,2,Flames,0,1,0,0,1,20131210,0,-1,1,1,3,-1,2013,0,1,2089,0
Blackhawks,2,4,0,0,6,Stars,0,1,1,0,2,20131210,2,5,4,4,8,-4,2013,0,1,802,0
Senators,1,0,0,0,1,Sabres,0,1,0,1,2,20131210,-1,0,0,1,3,1,2013,1,1,219,0
Predators,2,0,2,0,4,Rangers,0,1,0,0,1,20131210,2,1,3,3,5,-3,2013,0,1,758,0
Red Wings,1,1,0,0,2,Panthers,0,0,2,1,3,20131210,-1,-2,0,1,5,1,2013,1,1,1155,0
Kings,2,4,0,0,6,Canadiens,0,0,0,0,0,20131210,2,6,6,6,6,-6,2013,0,1,2448,0
Devils,2,1,1,0,4,Blue Jackets,1,2,2,0,5,20131210,-1,0,1,1,9,1,2013,0,1,467,0
Blues,0,1,1,0,2,Jets,0,0,1,0,1,20131210,0,1,1,1,3,-1,2013,0,1,853,0
Lightning,3,1,1,0,5,Capitals,1,3,1,1,6,20131210,-2,0,0,1,11,1,2013,1,1,818,0
Kings,1,0,2,0,3,Maple Leafs,0,1,0,0,1,20131211,1,0,2,2,4,-2,2013,0,2,2170,0
Flyers,1,1,0,0,2,Blackhawks,0,5,2,0,7,20131211,-1,3,5,5,9,5,2013,0,2,664,0
Wild,0,0,1,0,1,Ducks,0,2,0,0,2,20131211,0,2,1,1,3,1,2013,0,2,1521,0
Bruins,3,0,1,0,4,Oilers,0,2,0,0,2,20131212,3,1,2,2,6,-2,2013,0,3,2074,0
Islanders,1,2,0,0,3,Coyotes,1,4,1,0,6,20131212,0,2,3,3,9,3,2013,0,3,2139,0
Hurricanes,0,0,1,0,1,Flames,0,1,0,1,2,20131212,0,1,0,1,3,1,2013,1,3,2038,0
Avalanche,1,2,0,1,4,Jets,2,0,1,0,3,20131212,-1,1,0,1,7,-1,2013,1,3,797,0
Stars,1,0,0,0,1,Predators,2,1,0,0,3,20131212,1,2,2,2,4,2,2013,0,3,616,0
Red Wings,1,0,0,0,1,Lightning,0,1,0,1,2,20131212,-1,0,0,1,3,1,2013,1,3,994,0
Sabres,1,0,0,0,1,Senators,1,1,0,0,2,20131212,0,1,1,1,3,1,2013,0,3,219,0
Canadiens,0,0,1,0,1,Flyers,1,1,0,0,2,20131212,1,2,1,1,3,1,2013,0,3,400,0
Blue Jackets,3,0,1,0,4,Rangers,1,0,1,0,2,20131212,2,2,2,2,6,-2,2013,0,3,476,0
Maple Leafs,0,1,2,0,3,Blues,3,1,2,0,6,20131212,3,3,3,3,9,3,2013,0,3,659,0
Wild,0,0,1,0,1,Sharks,2,1,0,0,3,20131212,2,3,2,2,4,2,2013,0,3,1570,0
Oilers,0,0,0,0,0,Canucks,0,1,3,0,4,20131213,0,1,4,4,4,4,2013,0,4,514,0
Capitals,0,2,0,0,2,Panthers,0,2,0,1,3,20131213,0,0,0,1,5,1,2013,1,4,924,0
Devils,0,2,0,0,2,Penguins,3,0,0,0,3,20131213,3,1,1,1,5,1,2013,0,4,306,0
Wild,0,0,1,1,2,Avalanche,0,1,0,0,1,20131214,0,-1,0,1,3,-1,2013,1,5,698,0
Bruins,0,1,1,0,2,Canucks,1,2,3,0,6,20131214,1,2,4,4,8,4,2013,0,5,2504,0
Hurricanes,0,1,2,0,3,Coyotes,1,0,0,0,1,20131214,-1,0,2,2,4,-2,2013,0,5,1898,0
Blues,1,1,1,1,4,Blue Jackets,3,0,0,0,3,20131214,-2,-1,0,1,7,-1,2013,1,5,395,0
Canadiens,0,0,0,1,1,Islanders,0,0,0,0,0,20131214,0,0,0,1,1,-1,2013,1,5,343,0
Lightning,0,0,0,0,0,Devils,0,1,2,0,3,20131214,0,1,3,3,3,3,2013,0,5,1000,0
Sharks,0,0,2,0,2,Predators,1,1,1,0,3,20131214,1,2,1,1,5,1,2013,0,5,1934,0
Blackhawks,1,1,1,0,3,Maple Leafs,1,4,2,0,7,20131214,0,3,4,4,10,4,2013,0,5,436,0
Stars,2,3,1,0,6,Jets,1,2,1,0,4,20131214,1,2,2,2,10,-2,2013,0,5,1183,0
Kings,3,0,2,0,5,Senators,0,1,1,0,2,20131214,3,2,3,3,7,-3,2013,0,5,2345,0
Flames,0,0,1,1,2,Sabres,0,0,1,0,1,20131214,0,0,0,1,3,-1,2013,1,5,1731,0
Penguins,2,1,1,0,4,Red Wings,1,0,0,0,1,20131214,1,2,3,3,5,-3,2013,0,5,205,0
Oilers,1,0,1,0,2,Ducks,1,1,1,0,3,20131215,0,1,1,1,5,1,2013,0,6,1368,0
Flyers,1,1,2,0,4,Capitals,1,0,3,1,5,20131215,0,-1,0,1,9,1,2013,1,6,123,0
Lightning,0,0,3,0,3,Red Wings,0,0,0,0,0,20131215,0,0,3,3,3,-3,2013,0,6,994,0
Panthers,0,2,0,0,2,Canadiens,0,0,1,0,1,20131215,0,2,1,1,3,-1,2013,0,6,1418,0
Flames,2,0,1,0,3,Rangers,1,1,1,1,4,20131215,-1,0,0,1,7,1,2013,1,6,2023,0
Kings,0,0,1,0,1,Blackhawks,3,0,0,0,3,20131215,3,3,2,2,4,2,2013,0,6,1741,0
Canucks,1,1,0,0,2,Wild,1,0,1,1,3,20131217,0,-1,0,1,5,1,2013,1,1,1427,0
Avalanche,1,1,0,0,2,Stars,1,1,1,0,3,20131217,0,0,1,1,5,1,2013,0,1,661,0
Sharks,2,1,1,0,4,Blues,0,2,0,0,2,20131217,2,1,2,2,6,-2,2013,0,1,1719,0
Blackhawks,2,1,0,0,3,Predators,1,0,0,0,1,20131217,1,2,2,2,4,-2,2013,0,1,395,0
Oilers,0,0,0,0,0,Kings,1,0,2,0,3,20131217,1,1,3,3,3,3,2013,0,1,1368,0
Capitals,0,2,0,0,2,Flyers,0,4,1,0,5,20131217,0,2,3,3,7,3,2013,0,1,123,0
Lightning,0,0,2,1,3,Islanders,0,1,1,0,2,20131217,0,-1,0,1,5,-1,2013,1,1,1004,0
Coyotes,1,0,0,0,1,Canadiens,0,0,3,0,3,20131217,-1,-1,2,2,4,2,2013,0,1,2175,0
Panthers,1,2,0,0,3,Maple Leafs,0,0,1,0,1,20131217,1,3,2,2,4,-2,2013,0,1,1234,0
Jets,0,2,0,0,2,Sabres,0,1,3,0,4,20131217,0,-1,2,2,6,2,2013,0,1,996,0
Flames,0,0,0,0,0,Bruins,0,1,1,0,2,20131217,0,1,2,2,2,2,2013,0,1,2089,0
Ducks,4,1,0,0,5,Red Wings,1,0,1,0,2,20131217,3,4,3,3,7,-3,2013,0,1,1979,0
Senators,0,1,1,0,2,Devils,2,2,1,0,5,20131218,2,3,3,3,7,3,2013,0,2,330,0
Penguins,0,1,2,1,4,Rangers,0,1,2,0,3,20131218,0,0,0,1,7,-1,2013,1,2,314,0
Sharks,0,0,1,0,1,Kings,0,2,2,0,4,20131219,0,2,3,3,5,3,2013,0,3,305,0
Oilers,1,1,0,0,2,Avalanche,0,3,1,0,4,20131219,-1,1,2,2,6,2,2013,0,3,1036,0
Canucks,1,0,0,0,1,Stars,2,1,1,0,4,20131219,1,2,3,3,5,3,2013,0,3,1766,0
Canadiens,0,1,0,0,1,Blues,3,0,2,0,5,20131219,3,2,4,4,6,4,2013,0,3,962,0
Predators,0,2,0,0,2,Lightning,2,2,0,0,4,20131219,2,2,2,2,6,2,2013,0,3,621,0
Flames,1,1,0,0,2,Red Wings,1,1,0,1,3,20131219,0,0,0,1,5,1,2013,1,3,1573,0
Blue Jackets,1,2,1,0,4,Flyers,0,0,5,0,5,20131219,-1,-3,1,1,9,1,2013,0,3,414,0
Wild,0,1,1,0,2,Penguins,1,3,1,0,5,20131219,1,3,3,3,7,3,2013,0,3,741,0
Coyotes,0,0,1,0,1,Maple Leafs,1,0,0,1,2,20131219,1,1,0,1,3,1,2013,1,3,1885,0
Bruins,0,2,0,0,2,Sabres,1,1,2,0,4,20131219,1,0,2,2,6,2,2013,0,3,399,0
Panthers,1,1,2,0,4,Senators,2,0,0,0,2,20131219,-1,0,2,2,6,-2,2013,0,3,1370,0
Canucks,0,1,1,1,3,Blackhawks,1,1,0,0,2,20131220,-1,-1,0,1,5,-1,2013,1,4,1775,0
Panthers,1,1,0,0,2,Jets,3,2,0,0,5,20131220,2,3,3,3,7,3,2013,0,4,1899,0
Capitals,0,3,1,0,4,Hurricanes,1,1,0,0,2,20131220,-1,1,2,2,6,-2,2013,0,4,233,0
Ducks,0,1,1,1,3,Devils,0,1,1,0,2,20131220,0,0,0,1,5,-1,2013,1,4,2436,0
Islanders,2,1,2,0,5,Rangers,1,2,0,0,3,20131220,1,0,2,2,8,-2,2013,0,4,0,0
Avalanche,0,1,1,0,2,Kings,1,1,0,1,3,20131221,1,1,0,1,5,1,2013,1,5,830,0
Canadiens,3,0,0,1,4,Predators,0,2,1,0,3,20131221,3,1,0,1,7,-1,2013,1,5,937,0
Red Wings,3,0,1,1,5,Maple Leafs,1,2,1,0,4,20131221,2,0,0,1,9,-1,2013,1,5,205,0
Stars,1,1,0,0,2,Sharks,0,1,1,1,3,20131221,-1,-1,0,1,5,1,2013,1,5,1449,0
Blues,1,1,4,0,6,Oilers,0,0,0,0,0,20131221,1,2,6,6,6,-6,2013,0,5,1508,0
Flyers,0,2,1,0,3,Blue Jackets,1,1,4,0,6,20131221,1,0,3,3,9,3,2013,0,5,414,0
Sabres,1,0,0,0,1,Bruins,1,1,2,0,4,20131221,0,1,3,3,5,3,2013,0,5,399,0
Ducks,0,1,4,0,5,Islanders,1,2,0,0,3,20131221,-1,-2,2,2,8,-2,2013,0,5,2445,0
Hurricanes,1,1,0,0,2,Lightning,1,0,1,1,3,20131221,0,-1,0,1,5,1,2013,1,5,585,0
Coyotes,0,2,1,1,4,Senators,1,2,0,0,3,20131221,-1,-1,0,1,7,-1,2013,1,5,2071,0
Flames,0,2,1,0,3,Penguins,2,2,0,0,4,20131221,2,2,1,1,7,1,2013,0,5,1777,0
Devils,1,0,3,1,5,Capitals,0,3,1,0,4,20131221,1,-2,0,1,9,-1,2013,1,5,198,0
Wild,1,0,0,0,1,Rangers,1,2,1,0,4,20131222,0,2,3,3,5,3,2013,0,6,1016,0
Jets,0,1,0,0,1,Canucks,1,0,1,0,2,20131222,1,0,1,1,3,1,2013,0,6,1157,0
Avalanche,2,0,2,0,4,Sharks,1,2,1,1,5,20131223,-1,1,0,1,9,1,2013,1,0,927,0
Stars,2,1,2,0,5,Kings,2,0,0,0,2,20131223,0,1,3,3,7,-3,2013,0,0,1237,0
Blues,1,2,0,0,3,Flames,0,1,2,1,4,20131223,-1,-2,0,1,7,1,2013,1,0,1440,0
Bruins,3,0,3,0,6,Predators,0,1,1,0,2,20131223,3,2,4,4,8,-4,2013,0,0,941,0
Devils,0,1,1,0,2,Blackhawks,1,2,2,0,5,20131223,1,2,3,3,7,3,2013,0,0,703,0
Jets,1,1,0,0,2,Oilers,2,1,3,0,6,20131223,1,1,4,4,8,4,2013,0,0,738,0
Lightning,1,3,2,0,6,Panthers,1,0,0,0,1,20131223,0,3,5,5,7,-5,2013,0,0,205,0
Islanders,3,0,0,0,3,Red Wings,0,0,0,0,0,20131223,3,3,3,3,3,-3,2013,0,0,480,0
Penguins,0,0,0,0,0,Senators,1,1,3,0,5,20131223,1,2,5,5,5,5,2013,0,0,392,0
Blue Jackets,1,1,2,0,4,Hurricanes,1,1,1,0,3,20131223,0,0,1,1,7,-1,2013,0,0,374,0
Ducks,1,1,1,0,3,Capitals,2,0,0,0,2,20131223,-1,0,1,1,5,-1,2013,0,0,2294,0
Maple Leafs,0,0,1,0,1,Rangers,0,0,1,1,2,20131223,0,0,0,1,3,1,2013,1,0,341,0
Coyotes,0,1,0,0,1,Sabres,0,0,1,1,2,20131223,0,-1,0,1,3,1,2013,1,0,1902,0
Wild,1,0,0,0,1,Flyers,2,1,1,0,4,20131223,1,2,3,3,5,3,2013,0,0,983,0
Sharks,0,2,1,1,4,Coyotes,1,1,1,0,3,20131227,-1,0,0,1,7,-1,2013,1,4,614,0
Oilers,1,0,1,0,2,Flames,0,0,0,0,0,20131227,1,1,2,2,2,-2,2013,0,4,171,0
Predators,0,1,0,0,1,Stars,1,2,1,0,4,20131227,1,2,3,3,5,3,2013,0,4,616,0
Wild,3,1,0,0,4,Jets,4,0,2,0,6,20131227,1,0,2,2,10,2,2013,0,4,388,0
Sabres,2,0,1,0,3,Maple Leafs,0,3,0,1,4,20131227,-2,1,0,1,7,1,2013,1,4,57,0
Penguins,0,1,2,1,4,Hurricanes,1,1,1,0,3,20131227,-1,-1,0,1,7,-1,2013,1,4,330,0
Rangers,0,1,1,0,2,Capitals,1,1,1,0,3,20131227,1,1,1,1,5,1,2013,0,4,204,0
Blue Jackets,1,0,0,1,2,Devils,0,0,1,0,1,20131227,1,1,0,1,3,-1,2013,1,4,467,0
Senators,0,0,0,0,0,Bruins,0,1,4,0,5,20131227,0,1,5,5,5,5,2013,0,4,320,0
Avalanche,0,1,1,0,2,Blackhawks,3,4,0,0,7,20131227,3,6,5,5,9,5,2013,0,4,916,0
Flyers,0,2,1,1,4,Oilers,2,0,1,0,3,20131228,-2,0,0,1,7,-1,2013,1,5,2011,0
Coyotes,0,0,2,0,2,Ducks,1,0,1,1,3,20131228,1,1,0,1,5,1,2013,1,5,356,0
Kings,0,1,1,0,2,Predators,1,0,2,0,3,20131228,1,0,1,1,5,1,2013,0,5,1776,0
Red Wings,2,0,2,0,4,Panthers,0,2,1,0,3,20131228,2,0,1,1,7,-1,2013,0,5,1155,0
Devils,1,0,1,0,2,Islanders,0,0,1,0,1,20131228,1,1,1,1,3,-1,2013,0,5,8,0
Bruins,1,1,1,0,3,Senators,2,1,1,0,4,20131228,1,1,1,1,7,1,2013,0,5,320,0
Blackhawks,3,1,1,0,5,Blues,1,2,2,1,6,20131228,-2,-1,0,1,11,1,2013,1,5,260,0
Canadiens,0,1,0,1,2,Lightning,0,1,0,0,1,20131228,0,0,0,1,3,-1,2013,1,5,1311,0
Canadiens,0,1,0,0,1,Panthers,1,2,1,0,4,20131229,1,2,3,3,5,3,2013,0,6,1418,0
Ducks,0,0,1,0,1,Sharks,2,1,0,0,3,20131229,2,3,2,2,4,2,2013,0,6,305,0
Jets,0,0,1,1,2,Avalanche,0,0,1,0,1,20131229,0,0,0,1,3,-1,2013,1,6,797,0
Islanders,0,2,3,0,5,Wild,1,2,1,0,4,20131229,-1,-1,1,1,9,-1,2013,0,6,1016,0
Capitals,0,0,1,0,1,Sabres,0,1,0,1,2,20131229,0,1,0,1,3,1,2013,1,6,292,0
Rangers,2,2,0,0,4,Lightning,2,0,1,0,3,20131229,0,2,1,1,7,-1,2013,0,6,1004,0
Hurricanes,0,2,0,0,2,Maple Leafs,1,2,2,0,5,20131229,1,1,3,3,7,3,2013,0,6,544,0
Blues,1,1,0,1,3,Stars,0,2,0,0,2,20131229,1,0,0,1,5,-1,2013,1,6,547,0
Penguins,1,1,3,0,5,Blue Jackets,1,1,1,0,3,20131229,0,0,2,2,8,-2,2013,0,6,161,0
Canucks,1,0,1,0,2,Flames,0,0,0,0,0,20131229,1,1,2,2,2,-2,2013,0,6,426,0
Kings,0,0,0,0,0,Blackhawks,1,0,0,0,1,20131230,1,1,1,1,1,1,2013,0,0,1741,0
Red Wings,1,0,3,0,4,Predators,2,1,3,0,6,20131230,1,2,2,2,10,2,2013,0,0,470,0
Flyers,1,1,1,1,4,Canucks,0,2,1,0,3,20131230,1,0,0,1,7,-1,2013,1,0,2404,0
Capitals,1,0,0,0,1,Senators,1,1,1,0,3,20131230,0,1,2,2,4,2,2013,0,0,446,0
Blue Jackets,1,1,1,0,3,Avalanche,1,2,2,0,5,20131231,0,1,2,2,8,2,2013,0,1,1163,0
Oilers,1,2,0,0,3,Coyotes,1,1,1,1,4,20131231,0,-1,0,1,7,1,2013,1,1,1392,0
Flyers,1,1,2,0,4,Flames,0,1,0,0,1,20131231,1,1,3,3,5,-3,2013,0,1,2003,0
Sharks,0,2,1,0,3,Ducks,1,3,2,0,6,20131231,1,2,3,3,9,3,2013,0,1,305,0
Kings,1,0,1,0,2,Stars,1,2,0,0,3,20131231,0,2,1,1,5,1,2013,0,1,1237,0
Canadiens,2,1,1,0,4,Hurricanes,0,0,4,1,5,20131231,-2,-3,0,1,9,1,2013,1,1,727,0
Islanders,0,3,2,0,5,Bruins,1,2,0,0,3,20131231,-1,0,2,2,8,-2,2013,0,1,190,0
Blues,0,2,0,0,2,Wild,0,0,1,0,1,20131231,0,2,1,1,3,-1,2013,0,1,466,0
Rangers,0,0,1,1,2,Panthers,0,1,0,0,1,20131231,0,-1,0,1,3,-1,2013,1,1,1091,0
Penguins,0,1,0,0,1,Devils,1,1,0,0,2,20131231,1,1,1,1,3,1,2013,0,1,306,0
Sabres,0,0,0,0,0,Jets,1,1,1,0,3,20131231,1,2,3,3,3,3,2013,0,1,996,0
Maple Leafs,0,1,1,1,3,Red Wings,0,1,1,0,2,20140101,0,0,0,1,5,-1,2013,1,2,205,0
Lightning,0,3,1,0,4,Canucks,0,2,0,0,2,20140101,0,1,2,2,6,-2,2013,0,2,2598,0
Oilers,0,1,0,0,1,Sharks,2,2,1,0,5,20140102,2,3,4,4,6,4,2013,0,3,1190,0
Blue Jackets,0,1,1,0,2,Coyotes,0,0,0,0,0,20140102,0,1,2,2,2,-2,2013,0,3,1664,0
Flyers,0,1,0,0,1,Avalanche,1,1,0,0,2,20140102,1,1,1,1,3,1,2013,0,3,1574,0
Canadiens,1,2,3,0,6,Stars,1,1,2,0,4,20140102,0,1,2,2,10,-2,2013,0,3,1505,0
Jets,1,1,1,0,3,Senators,2,0,2,0,4,20140102,1,0,1,1,7,1,2013,0,3,1033,0
Kings,0,0,0,0,0,Blues,1,2,2,0,5,20140102,1,3,5,5,5,5,2013,0,3,1586,0
Hurricanes,1,2,0,1,4,Capitals,0,3,0,0,3,20140102,1,0,0,1,7,-1,2013,1,3,233,0
Blackhawks,0,1,1,0,2,Islanders,1,1,0,1,3,20140102,1,1,0,1,5,1,2013,1,3,711,0
Predators,0,1,1,0,2,Bruins,0,0,2,1,3,20140102,0,-1,0,1,5,1,2013,1,3,941,0
Sabres,0,0,1,0,1,Wild,0,3,1,0,4,20140102,0,3,3,3,5,3,2013,0,3,729,0
Oilers,2,0,0,0,2,Ducks,3,1,1,0,5,20140103,1,2,3,3,7,3,2013,0,4,1368,0
Lightning,0,2,0,0,2,Flames,0,0,0,0,0,20140103,0,2,2,2,2,-2,2013,0,4,2289,0
Rangers,0,0,2,0,2,Penguins,2,2,1,0,5,20140103,2,4,3,3,7,3,2013,0,4,314,0
Blackhawks,0,1,4,0,5,Devils,0,1,2,0,3,20140103,0,0,2,2,8,-2,2013,0,4,703,0
Canucks,1,0,0,0,1,Kings,0,0,3,0,3,20140104,-1,-1,2,2,4,2,2013,0,5,1076,0
Flyers,0,2,3,0,5,Coyotes,0,3,0,0,3,20140104,0,-1,2,2,8,-2,2013,0,5,2078,0
Red Wings,3,1,1,0,5,Stars,1,0,0,0,1,20140104,2,3,4,4,6,-4,2013,0,5,999,0
Blue Jackets,2,0,0,0,2,Blues,0,3,3,0,6,20140104,-2,1,4,4,8,4,2013,0,5,395,0
Jets,1,0,0,0,1,Bruins,1,2,1,0,4,20140104,0,2,3,3,5,3,2013,0,5,1349,0
Predators,1,1,2,0,4,Panthers,2,1,1,1,5,20140104,1,1,0,1,9,1,2013,1,5,816,0
Senators,3,0,0,1,4,Canadiens,1,0,2,0,3,20140104,2,2,0,1,7,-1,2013,1,5,104,0
Rangers,2,3,2,0,7,Maple Leafs,0,1,0,0,1,20140104,2,4,6,6,8,-6,2013,0,5,341,0
Devils,0,0,1,0,1,Sabres,0,1,1,0,2,20140104,0,1,1,1,3,1,2013,0,5,284,0
Sharks,0,2,1,0,3,Avalanche,1,3,0,0,4,20140104,1,2,1,1,7,1,2013,0,5,927,0
Hurricanes,0,3,0,0,3,Islanders,0,1,1,0,2,20140104,0,2,1,1,5,-1,2013,0,5,423,0
Capitals,2,1,0,0,3,Wild,0,4,1,0,5,20140104,-2,1,2,2,8,2,2013,0,5,931,0
Jets,2,3,0,0,5,Penguins,0,4,2,0,6,20140105,-2,-1,1,1,11,1,2013,0,6,1060,0
Predators,0,0,1,0,1,Hurricanes,1,0,1,0,2,20140105,1,1,1,1,3,1,2013,0,6,456,0
Sharks,1,0,1,1,3,Blackhawks,0,0,2,0,2,20140105,1,1,0,1,5,-1,2013,1,6,1837,0
Lightning,1,2,0,0,3,Oilers,3,0,2,0,5,20140105,2,0,2,2,8,2,2013,0,6,2367,0
Canucks,2,0,1,0,3,Ducks,0,2,1,1,4,20140105,-2,0,0,1,7,1,2013,1,6,1076,0
Flames,1,2,1,0,4,Avalanche,2,0,1,0,3,20140106,-1,1,1,1,7,-1,2013,0,0,898,0
Blue Jackets,1,2,0,1,4,Rangers,1,0,2,0,3,20140106,0,2,0,1,7,-1,2013,1,0,476,0
Stars,2,1,0,0,3,Islanders,0,4,3,0,7,20140106,-2,1,4,4,10,4,2013,0,0,1370,0
Panthers,1,0,0,0,1,Canadiens,1,1,0,0,2,20140106,0,1,1,1,3,1,2013,0,0,1418,0
Bruins,0,1,1,0,2,Ducks,0,3,2,0,5,20140107,0,2,3,3,7,3,2013,0,1,2590,0
Penguins,1,1,2,1,5,Canucks,0,1,3,0,4,20140107,1,1,0,1,9,-1,2013,1,1,2168,0
Blues,1,3,1,0,5,Oilers,0,2,0,0,2,20140107,1,2,3,3,7,-3,2013,0,1,1508,0
Wild,0,0,1,1,2,Kings,0,0,1,0,1,20140107,0,0,0,1,3,-1,2013,1,1,1521,0
Lightning,1,1,2,0,4,Jets,1,1,0,0,2,20140107,0,0,2,2,6,-2,2013,0,1,1705,0
Sharks,0,1,1,0,2,Predators,0,3,0,0,3,20140107,0,2,1,1,5,1,2013,0,1,1934,0
Flyers,0,0,2,1,3,Devils,1,0,1,0,2,20140107,-1,-1,0,1,5,-1,2013,1,1,75,0
Islanders,1,1,3,0,5,Maple Leafs,1,1,1,0,3,20140107,0,0,2,2,8,-2,2013,0,1,341,0
Flames,0,0,0,0,0,Coyotes,0,3,3,0,6,20140107,0,3,6,6,6,6,2013,0,1,1224,0
Canadiens,0,1,0,0,1,Flyers,2,1,0,0,3,20140108,2,2,2,2,4,2,2013,0,2,400,0
Rangers,2,0,1,0,3,Blackhawks,0,2,0,0,2,20140108,2,0,1,1,5,-1,2013,0,2,711,0
Senators,1,2,0,0,3,Avalanche,2,0,1,1,4,20140108,1,-1,0,1,7,1,2013,1,2,1515,0
Panthers,0,0,1,1,2,Sabres,0,1,0,0,1,20140109,0,-1,0,1,3,-1,2013,1,3,1184,0
Stars,0,0,0,0,0,Devils,0,1,0,0,1,20140109,0,1,1,1,1,1,2013,0,3,1362,0
Maple Leafs,1,0,0,0,1,Hurricanes,3,1,2,0,6,20140109,2,3,5,5,7,5,2013,0,3,544,0
Capitals,3,0,1,0,4,Lightning,1,1,1,0,3,20140109,2,1,1,1,7,-1,2013,0,3,818,0
Blues,2,1,2,0,5,Flames,0,0,0,0,0,20140109,2,3,5,5,5,-5,2013,0,3,1440,0
Ducks,0,4,0,0,4,Predators,2,1,0,0,3,20140109,-2,1,1,1,7,-1,2013,0,3,1776,0
Bruins,0,1,1,0,2,Kings,1,2,1,0,4,20140109,1,2,2,2,6,2,2013,0,3,2590,0
Red Wings,1,0,0,0,1,Sharks,1,3,0,0,4,20140109,0,3,3,3,5,3,2013,0,3,2071,0
Wild,1,0,3,0,4,Coyotes,0,1,0,0,1,20140109,1,0,3,3,5,-3,2013,0,3,1278,0
Stars,1,1,0,0,2,Rangers,1,1,1,0,3,20140110,0,0,1,1,5,1,2013,0,4,1370,0
Maple Leafs,0,1,1,0,2,Capitals,0,1,2,0,3,20140110,0,0,1,1,5,1,2013,0,4,349,0
Hurricanes,0,0,0,0,0,Blue Jackets,2,0,1,0,3,20140110,2,2,3,3,3,3,2013,0,4,374,0
Islanders,0,0,1,1,2,Avalanche,0,1,0,0,1,20140110,0,-1,0,1,3,-1,2013,1,4,1627,0
Penguins,0,2,1,0,3,Oilers,0,0,3,1,4,20140110,0,-2,0,1,7,1,2013,1,4,1797,0
Blues,0,1,0,0,1,Canucks,0,1,1,0,2,20140110,0,0,1,1,3,1,2013,0,4,1778,0
Bruins,0,0,1,0,1,Sharks,0,0,0,0,0,20140111,0,0,1,1,1,-1,2013,0,5,2678,0
Red Wings,1,0,2,0,3,Kings,1,0,0,0,1,20140111,0,0,2,2,4,-2,2013,0,5,1979,0
Penguins,1,1,0,0,2,Flames,0,0,1,0,1,20140111,1,2,1,1,3,-1,2013,0,5,1777,0
Ducks,1,3,1,0,5,Coyotes,1,0,2,0,3,20140111,0,3,2,2,8,-2,2013,0,5,356,0
Panthers,0,1,0,0,1,Devils,1,0,0,1,2,20140111,1,0,0,1,3,1,2013,1,5,1090,0
Blue Jackets,0,4,2,0,6,Jets,1,1,1,0,3,20140111,-1,2,3,3,9,-3,2013,0,5,975,0
Senators,0,1,0,1,2,Predators,0,1,0,0,1,20140111,0,0,0,1,3,-1,2013,1,5,845,0
Blackhawks,0,0,1,0,1,Canadiens,0,1,0,1,2,20140111,0,1,0,1,3,1,2013,1,5,732,0
Lightning,1,4,1,0,6,Flyers,0,3,0,0,3,20140111,1,2,3,3,9,-3,2013,0,5,928,0
Avalanche,0,2,2,0,4,Wild,0,2,0,0,2,20140111,0,0,2,2,6,-2,2013,0,5,698,0
Wild,2,0,2,0,4,Predators,0,0,0,0,0,20140112,2,2,4,4,4,-4,2013,0,6,696,0
Oilers,1,1,1,0,3,Blackhawks,1,3,1,0,5,20140112,0,2,2,2,8,2,2013,0,6,1437,0
Red Wings,0,0,0,0,0,Ducks,0,1,0,0,1,20140112,0,1,1,1,1,1,2013,0,6,1979,0
Devils,0,2,0,0,2,Maple Leafs,1,1,0,1,3,20140112,1,0,0,1,5,1,2013,1,6,333,0
Flyers,0,0,1,0,1,Rangers,3,1,0,0,4,20140112,3,4,3,3,5,3,2013,0,6,80,0
Sabres,1,0,0,1,2,Capitals,1,0,0,0,1,20140112,0,0,0,1,3,-1,2013,1,6,292,0
Islanders,0,1,3,0,4,Stars,2,0,0,0,2,20140112,-2,-1,2,2,6,-2,2013,0,6,1370,0
Lightning,0,2,0,0,2,Blue Jackets,0,1,2,0,3,20140113,0,-1,1,1,5,1,2013,0,0,830,0
Coyotes,1,0,0,0,1,Jets,2,1,2,0,5,20140113,1,2,4,4,6,4,2013,0,0,1365,0
Canucks,0,0,0,0,0,Kings,0,0,1,0,1,20140113,0,0,1,1,1,1,2013,0,0,1076,0
Flames,0,1,1,0,2,Hurricanes,0,0,0,0,0,20140113,0,1,2,2,2,-2,2013,0,0,2038,0
Maple Leafs,2,1,1,0,4,Bruins,2,0,1,0,3,20140114,0,1,1,1,7,-1,2013,0,1,430,0
Lightning,0,2,0,0,2,Rangers,1,0,0,0,1,20140114,-1,1,1,1,3,-1,2013,0,1,1004,0
Sharks,1,0,0,1,2,Capitals,0,1,0,0,1,20140114,1,0,0,1,3,-1,2013,1,1,2416,0
Flyers,0,1,3,0,4,Sabres,1,0,2,0,3,20140114,-1,0,1,1,7,-1,2013,0,1,279,0
Devils,1,2,1,0,4,Canadiens,1,0,0,0,1,20140114,0,2,3,3,5,-3,2013,0,1,342,0
Islanders,0,1,1,0,2,Panthers,3,1,0,0,4,20140114,3,3,2,2,6,2,2013,0,1,1091,0
Avalanche,2,0,0,1,3,Blackhawks,0,1,1,0,2,20140114,2,1,0,1,5,-1,2013,1,1,916,0
Coyotes,0,1,0,0,1,Blues,1,1,0,0,2,20140114,1,1,1,1,3,1,2013,0,1,1270,0
Flames,1,0,1,0,2,Predators,1,0,3,0,4,20140114,0,0,2,2,6,2,2013,0,1,1692,0
Senators,1,0,2,0,3,Wild,0,0,0,0,0,20140114,1,1,3,3,3,-3,2013,0,1,838,0
Oilers,1,1,0,0,2,Stars,3,1,1,0,5,20140114,2,2,3,3,7,3,2013,0,1,1655,0
Canucks,0,1,0,0,1,Ducks,2,4,3,0,9,20140115,2,5,8,8,10,8,2013,0,2,1076,0
Capitals,1,1,1,0,3,Penguins,0,2,2,0,4,20140115,-1,0,1,1,7,1,2013,0,2,190,0
Sabres,0,2,1,0,3,Maple Leafs,1,2,0,1,4,20140115,1,1,0,1,7,1,2013,1,2,57,0
Red Wings,0,0,0,0,0,Rangers,0,0,1,0,1,20140116,0,0,1,1,1,1,2013,0,3,480,0
Canucks,0,0,0,0,0,Coyotes,1,0,0,0,1,20140116,1,1,1,1,1,1,2013,0,3,1228,0
Devils,0,0,1,0,1,Avalanche,1,0,0,1,2,20140116,1,1,0,1,3,1,2013,1,3,1618,0
Bruins,0,1,3,0,4,Stars,0,0,2,0,2,20140116,0,1,2,2,6,-2,2013,0,3,1548,0
Jets,2,2,1,0,5,Flames,0,0,2,0,2,20140116,2,4,3,3,7,-3,2013,0,3,740,0
Kings,1,0,3,0,4,Blues,0,1,0,0,1,20140116,1,0,3,3,5,-3,2013,0,3,1586,0
Sharks,0,1,2,0,3,Panthers,0,0,0,0,0,20140116,0,1,3,3,3,-3,2013,0,3,2558,0
Islanders,0,1,0,1,2,Lightning,1,0,0,0,1,20140116,-1,0,0,1,3,-1,2013,1,3,1004,0
Canadiens,3,0,1,1,5,Senators,2,2,0,0,4,20140116,1,-1,0,1,9,-1,2013,1,3,104,0
Oilers,0,1,0,0,1,Wild,1,2,1,0,4,20140116,1,2,3,3,5,3,2013,0,3,1083,0
Predators,2,0,1,1,4,Flyers,1,1,1,0,3,20140116,1,0,0,1,7,-1,2013,1,3,683,0
Capitals,0,1,0,0,1,Blue Jackets,2,1,2,0,5,20140117,2,2,4,4,6,4,2013,0,4,326,0
Ducks,0,0,2,0,2,Blackhawks,2,0,2,0,4,20140117,2,2,2,2,6,2,2013,0,4,1741,0
Ducks,1,2,0,0,3,Blues,0,0,2,0,2,20140118,1,3,1,1,5,-1,2013,0,5,1586,0
Flames,0,1,1,0,2,Canucks,0,1,1,1,3,20140118,0,0,0,1,5,1,2013,1,5,426,0
Stars,0,1,1,0,2,Wild,1,1,0,1,3,20140118,1,1,0,1,5,1,2013,1,5,863,0
Devils,1,0,1,0,2,Coyotes,2,1,0,0,3,20140118,1,2,1,1,5,1,2013,0,5,2131,0
Avalanche,3,0,2,0,5,Predators,0,1,3,0,4,20140118,3,2,1,1,9,-1,2013,0,5,1019,0
Islanders,2,2,0,0,4,Flyers,2,1,3,0,6,20140118,0,-1,2,2,10,2,2013,0,5,80,0
Kings,0,1,1,0,2,Red Wings,0,1,1,1,3,20140118,0,0,0,1,5,1,2013,1,5,1979,0
Canadiens,1,1,1,0,3,Maple Leafs,1,2,2,0,5,20140118,0,1,2,2,8,2,2013,0,5,303,0
Blue Jackets,2,1,0,1,4,Sabres,2,0,1,0,3,20140118,0,1,0,1,7,-1,2013,1,5,293,0
Oilers,0,1,1,0,2,Jets,0,0,2,1,3,20140118,0,-1,0,1,5,1,2013,1,5,738,0
Sharks,2,3,0,0,5,Lightning,3,1,0,0,4,20140118,-1,1,1,1,9,-1,2013,0,5,2365,0
Panthers,0,1,1,0,2,Hurricanes,0,1,2,0,3,20140118,0,0,1,1,5,1,2013,0,5,696,0
Rangers,1,2,1,0,4,Senators,1,0,0,0,1,20140118,0,2,3,3,5,-3,2013,0,5,334,0
Bruins,1,1,0,0,2,Blackhawks,1,1,0,1,3,20140119,0,0,0,1,5,1,2013,1,6,849,0
Lightning,3,2,0,0,5,Hurricanes,0,2,1,0,3,20140119,3,3,2,2,8,-2,2013,0,6,585,0
Capitals,0,1,0,0,1,Rangers,3,1,0,0,4,20140119,3,3,3,3,5,3,2013,0,6,204,0
Flames,2,0,0,0,2,Sharks,2,1,0,0,3,20140120,0,1,1,1,5,1,2013,0,0,1027,0
Maple Leafs,2,1,1,0,4,Coyotes,0,0,2,0,2,20140120,2,3,2,2,6,-2,2013,0,0,1885,0
Kings,0,1,1,0,2,Bruins,2,0,1,0,3,20140120,2,1,1,1,5,1,2013,0,0,2590,0
Blues,1,2,1,0,4,Red Wings,1,0,0,0,1,20140120,0,2,3,3,5,-3,2013,0,0,454,0
Panthers,1,1,3,0,5,Penguins,0,0,1,0,1,20140120,1,2,4,4,6,-4,2013,0,0,1013,0
Stars,1,0,0,0,1,Predators,2,1,1,0,4,20140120,1,2,3,3,5,3,2013,0,0,616,0
Flyers,0,3,0,0,3,Islanders,0,1,2,1,4,20140120,0,-2,0,1,7,1,2013,1,0,80,0
Jets,2,1,0,0,3,Ducks,1,0,1,0,2,20140121,1,2,1,1,5,-1,2013,0,1,1527,0
Maple Leafs,2,2,1,0,5,Avalanche,0,1,1,0,2,20140121,2,3,3,3,7,-3,2013,0,1,1341,0
Wild,0,0,0,0,0,Stars,2,1,1,0,4,20140121,2,3,4,4,4,4,2013,0,1,863,0
Canucks,1,1,0,0,2,Oilers,0,0,1,0,1,20140121,1,2,1,1,3,-1,2013,0,1,514,0
Senators,0,1,1,0,2,Capitals,0,0,0,0,0,20140121,0,1,2,2,2,-2,2013,0,1,446,0
Islanders,1,2,2,0,5,Rangers,2,1,0,0,3,20140121,-1,0,2,2,8,-2,2013,0,1,0,0
Blues,1,0,0,0,1,Devils,3,2,2,0,7,20140121,2,4,6,6,8,6,2013,0,1,863,0
Panthers,3,1,0,0,4,Sabres,2,0,1,0,3,20140121,1,2,1,1,7,-1,2013,0,1,1184,0
Kings,1,1,1,0,3,Blue Jackets,2,2,1,0,5,20140121,1,2,2,2,8,2,2013,0,1,1973,0
Hurricanes,1,1,1,0,3,Flyers,0,1,1,0,2,20140122,1,1,1,1,5,-1,2013,0,2,345,0
Canadiens,1,0,0,0,1,Penguins,2,3,0,0,5,20140122,1,4,4,4,6,4,2013,0,2,474,0
Blackhawks,2,1,1,0,4,Red Wings,2,2,0,1,5,20140122,0,1,0,1,9,1,2013,1,2,238,0
Coyotes,0,1,1,0,2,Flames,1,2,0,0,3,20140122,1,2,1,1,5,1,2013,0,2,1224,0
Predators,0,0,2,0,2,Canucks,0,1,0,0,1,20140123,0,-1,1,1,3,-1,2013,0,3,2030,0
Jets,0,0,0,0,0,Sharks,0,0,1,0,1,20140123,0,0,1,1,1,1,2013,0,3,1496,0
Maple Leafs,1,0,0,0,1,Stars,2,4,1,0,7,20140123,1,5,6,6,8,6,2013,0,3,1201,0
Kings,1,0,0,0,1,Ducks,0,2,0,0,2,20140123,-1,1,1,1,3,1,2013,0,3,0,0
Penguins,2,2,2,0,6,Islanders,2,0,2,0,4,20140123,0,2,2,2,10,-2,2013,0,3,314,0
Blackhawks,0,0,1,0,1,Wild,2,0,0,0,2,20140123,2,2,1,1,3,1,2013,0,3,355,0
Hurricanes,1,1,3,0,5,Sabres,1,1,1,0,3,20140123,0,0,2,2,8,-2,2013,0,3,491,0
Blues,1,0,1,0,2,Rangers,0,1,0,0,1,20140123,1,0,1,1,3,-1,2013,0,3,871,0
Senators,1,1,1,0,3,Lightning,1,1,1,1,4,20140123,0,0,0,1,7,1,2013,1,3,1251,0
Flyers,0,2,0,0,2,Blue Jackets,1,2,2,0,5,20140123,1,1,3,3,7,3,2013,0,3,414,0
Capitals,0,0,1,0,1,Devils,1,1,0,0,2,20140124,1,2,1,1,3,1,2013,0,4,198,0
Canadiens,0,1,0,0,1,Red Wings,1,2,1,0,4,20140124,1,2,3,3,5,3,2013,0,4,508,0
Avalanche,2,1,0,0,3,Panthers,0,0,2,0,2,20140124,2,3,1,1,5,-1,2013,0,4,1724,0
Predators,1,2,1,0,4,Flames,1,0,3,1,5,20140124,0,-2,0,1,9,1,2013,1,4,1692,0
Coyotes,3,1,0,0,4,Oilers,0,1,2,0,3,20140124,3,3,1,1,7,-1,2013,0,4,1392,0
Wild,1,1,0,0,2,Sharks,0,2,0,1,3,20140125,-1,0,0,1,5,1,2013,1,5,1570,0
Ducks,2,0,1,0,3,Kings,0,0,0,0,0,20140125,2,2,3,3,3,-3,2013,0,5,0,0
Penguins,0,0,0,0,0,Stars,1,2,0,0,3,20140125,1,3,3,3,3,3,2013,0,5,1069,0
Maple Leafs,0,3,1,0,4,Jets,2,2,0,1,5,20140125,2,1,0,1,9,1,2013,1,5,946,0
Sabres,2,1,2,0,5,Blue Jackets,1,0,1,0,2,20140125,1,2,3,3,7,-3,2013,0,5,293,0
Bruins,2,2,2,0,6,Flyers,0,0,1,0,1,20140125,2,4,5,5,7,-5,2013,0,5,270,0
Blues,1,1,1,1,4,Islanders,2,1,0,0,3,20140125,-1,-1,0,1,7,-1,2013,1,5,871,0
Senators,0,3,0,0,3,Hurricanes,1,4,1,0,6,20140125,1,2,3,3,9,3,2013,0,5,673,0
Avalanche,0,2,0,0,2,Lightning,0,3,2,0,5,20140125,0,1,3,3,7,3,2013,0,5,1521,0
Capitals,0,4,1,0,5,Canadiens,0,0,0,0,0,20140125,0,4,5,5,5,-5,2013,0,5,495,0
Rangers,2,4,1,0,7,Devils,3,0,0,0,3,20140126,-1,3,4,4,10,-4,2013,0,6,8,0
Panthers,1,0,3,1,5,Red Wings,0,3,1,0,4,20140126,1,-2,0,1,9,-1,2013,1,6,1155,0
Jets,0,0,3,0,3,Blackhawks,1,0,0,0,1,20140126,-1,-1,2,2,4,-2,2013,0,6,722,0
Predators,1,0,0,0,1,Oilers,2,2,1,0,5,20140126,1,3,4,4,6,4,2013,0,6,1758,0
Coyotes,1,2,1,0,4,Canucks,2,2,0,1,5,20140126,1,1,0,1,9,1,2013,1,6,1228,0
Blue Jackets,2,0,0,0,2,Hurricanes,0,0,3,0,3,20140127,-2,-2,1,1,5,1,2013,0,0,374,0
Bruins,1,3,2,0,6,Islanders,1,2,0,0,3,20140127,0,1,3,3,9,-3,2013,0,0,190,0
Sabres,0,0,0,0,0,Penguins,0,2,1,0,3,20140127,0,2,3,3,3,3,2013,0,0,178,0
Avalanche,2,1,1,0,4,Stars,1,2,0,0,3,20140127,1,0,1,1,7,-1,2013,0,0,661,0
Oilers,2,0,2,0,4,Canucks,1,1,0,0,2,20140127,1,0,2,2,6,-2,2013,0,0,514,0
Kings,0,1,0,0,1,Sharks,0,0,0,0,0,20140127,0,1,1,1,1,-1,2013,0,0,305,0
Wild,1,1,2,0,4,Ducks,1,0,1,0,2,20140128,0,1,2,2,6,-2,2013,0,1,1521,0
Blackhawks,2,2,0,0,4,Flames,2,2,0,1,5,20140128,0,0,0,1,9,1,2013,1,1,1397,0
Kings,0,0,0,0,0,Coyotes,1,1,1,0,3,20140128,1,2,3,3,3,3,2013,0,1,356,0
Predators,1,2,1,0,4,Jets,1,2,0,0,3,20140128,0,0,1,1,7,-1,2013,0,1,1084,0
Devils,0,0,0,0,0,Blues,1,0,2,0,3,20140128,1,1,3,3,3,3,2013,0,1,863,0
Hurricanes,0,0,0,0,0,Canadiens,2,1,0,0,3,20140128,2,3,3,3,3,3,2013,0,1,727,0
Senators,1,1,1,0,3,Blue Jackets,0,1,1,0,2,20140128,1,1,1,1,5,-1,2013,0,1,512,0
Red Wings,0,0,0,0,0,Flyers,1,2,2,0,5,20140128,1,3,5,5,5,5,2013,0,1,441,0
Lightning,0,2,0,0,2,Maple Leafs,0,2,1,0,3,20140128,0,0,1,1,5,1,2013,0,1,1096,0
Panthers,0,1,1,0,2,Bruins,2,2,2,0,6,20140128,2,3,4,4,8,4,2013,0,1,1257,0
Capitals,2,2,0,1,5,Sabres,1,2,1,0,4,20140128,1,1,0,1,9,-1,2013,1,1,292,0
Rangers,0,1,1,0,2,Islanders,0,1,0,0,1,20140129,0,0,1,1,3,-1,2013,0,2,0,0
Sharks,0,0,0,0,0,Oilers,1,0,2,0,3,20140129,1,1,3,3,3,3,2013,0,2,1190,0
Blackhawks,0,4,1,0,5,Canucks,1,1,0,0,2,20140129,-1,2,3,3,7,-3,2013,0,2,1775,0
Wild,1,0,3,0,4,Avalanche,1,3,1,0,5,20140130,0,3,1,1,9,1,2013,0,3,698,0
Penguins,3,1,0,0,4,Kings,1,0,0,0,1,20140130,2,3,3,3,5,-3,2013,0,3,2132,0
Flyers,1,0,2,0,3,Ducks,2,1,2,0,5,20140130,1,2,2,2,8,2,2013,0,3,2388,0
Sabres,1,1,1,0,3,Coyotes,2,0,0,0,2,20140130,-1,0,1,1,5,-1,2013,0,3,1902,0
Devils,1,1,0,1,3,Stars,0,1,1,0,2,20140130,1,1,0,1,5,-1,2013,1,3,1362,0
Sharks,0,0,1,0,1,Flames,1,1,2,0,4,20140130,1,2,3,3,5,3,2013,0,3,1027,0
Capitals,0,1,1,0,2,Blue Jackets,2,2,1,0,5,20140130,2,3,3,3,7,3,2013,0,3,326,0
Panthers,2,0,1,0,3,Maple Leafs,1,2,3,0,6,20140130,-1,1,3,3,9,3,2013,0,3,1234,0
Canadiens,2,2,0,0,4,Bruins,1,0,0,0,1,20140130,1,3,3,3,5,-3,2013,0,3,270,0
Lightning,0,1,2,0,3,Senators,2,2,1,0,5,20140130,2,3,2,2,8,2,2013,0,3,1251,0
Islanders,0,1,0,0,1,Rangers,1,0,3,0,4,20140131,1,0,3,3,5,3,2013,0,4,0,0
Blues,1,0,0,0,1,Hurricanes,1,1,1,0,3,20140131,0,1,2,2,4,2,2013,0,4,665,0
Capitals,1,0,2,0,3,Red Wings,0,2,1,1,4,20140131,-1,1,0,1,7,1,2013,1,4,394,0
Devils,0,2,0,0,2,Predators,1,0,1,1,3,20140131,1,-1,0,1,5,1,2013,1,4,750,0
Canucks,1,1,1,0,3,Jets,2,1,1,0,4,20140131,1,1,1,1,7,1,2013,0,4,1157,0
Blackhawks,0,0,1,0,1,Sharks,0,0,1,1,2,20140201,0,0,0,1,3,1,2013,1,5,1837,0
Stars,0,1,1,0,2,Ducks,0,0,0,0,0,20140201,0,1,2,2,2,-2,2013,0,5,1237,0
Wild,0,1,2,0,3,Flames,1,1,1,1,4,20140201,1,1,0,1,7,1,2013,1,5,1043,0
Penguins,0,1,0,0,1,Coyotes,1,1,1,0,3,20140201,1,1,2,2,4,2,2013,0,5,1824,0
Predators,0,1,2,0,3,Blues,1,1,1,1,4,20140201,1,1,0,1,7,1,2013,1,5,253,0
Panthers,0,1,0,0,1,Blue Jackets,2,1,1,0,4,20140201,2,2,3,3,5,3,2013,0,5,993,0
Senators,1,1,1,0,3,Maple Leafs,0,2,4,0,6,20140201,-1,0,3,3,9,3,2013,0,5,203,0
Sabres,0,1,0,0,1,Avalanche,3,2,2,0,7,20140201,3,4,6,6,8,6,2013,0,5,1366,0
Lightning,0,1,0,1,2,Canadiens,0,0,1,0,1,20140201,0,1,0,1,3,-1,2013,1,5,1311,0
Oilers,0,0,0,0,0,Bruins,0,1,3,0,4,20140201,0,1,4,4,4,4,2013,0,5,2074,0
Flyers,0,1,1,0,2,Kings,0,0,0,0,0,20140201,0,1,2,2,2,-2,2013,0,5,2388,0
Red Wings,1,2,2,0,5,Capitals,3,1,1,1,6,20140202,2,1,0,1,11,1,2013,1,6,394,0
Jets,0,1,1,0,2,Canadiens,0,1,0,0,1,20140202,0,0,1,1,3,-1,2013,0,6,1115,0
Blue Jackets,1,1,2,0,4,Ducks,0,0,2,0,2,20140203,1,2,2,2,6,-2,2013,0,0,1973,0
Avalanche,0,0,1,1,2,Devils,1,0,0,0,1,20140203,-1,-1,0,1,3,-1,2013,1,0,1618,0
Oilers,1,1,1,0,3,Sabres,2,0,0,0,2,20140203,-1,0,1,1,5,-1,2013,0,0,1734,0
Senators,1,0,0,0,1,Penguins,1,0,0,1,2,20140203,0,0,0,1,3,1,2013,1,0,392,0
Blackhawks,2,1,2,0,5,Kings,1,1,1,0,3,20140203,1,1,2,2,8,-2,2013,0,0,1741,0
Flyers,1,0,4,0,5,Sharks,2,0,0,0,2,20140203,-1,-1,3,3,7,-3,2013,0,0,2499,0
Canucks,0,0,0,0,0,Red Wings,0,1,1,0,2,20140203,0,1,2,2,2,2,2013,0,0,1967,0
Senators,0,1,3,1,5,Blues,1,2,1,0,4,20140204,-1,-2,0,1,9,-1,2013,1,1,860,0
Avalanche,0,1,0,0,1,Rangers,2,1,2,0,5,20140204,2,2,4,4,6,4,2013,0,1,1627,0
Canucks,0,1,0,0,1,Bruins,1,2,0,0,3,20140204,1,2,2,2,4,2,2013,0,1,2504,0
Stars,0,1,2,0,3,Coyotes,0,1,0,0,1,20140204,0,0,2,2,4,-2,2013,0,1,884,0
Islanders,0,0,1,0,1,Capitals,0,0,0,0,0,20140204,0,0,1,1,1,-1,2013,0,1,204,0
Lightning,0,0,1,0,1,Wild,1,0,1,0,2,20140204,1,1,1,1,3,1,2013,0,1,1318,0
Flames,0,0,0,0,0,Canadiens,0,1,1,0,2,20140204,0,1,2,2,2,2,2013,0,1,1852,0
Maple Leafs,0,0,1,0,1,Panthers,0,1,3,0,4,20140204,0,1,3,3,5,3,2013,0,1,1234,0
Jets,0,1,1,0,2,Hurricanes,0,0,1,0,1,20140204,0,1,1,1,3,-1,2013,0,1,1350,0
Stars,0,0,1,0,1,Sharks,0,1,0,1,2,20140205,0,1,0,1,3,1,2013,1,2,1449,0
Blackhawks,0,1,1,0,2,Ducks,0,0,0,0,0,20140205,0,1,2,2,2,-2,2013,0,2,1741,0
Penguins,1,2,2,0,5,Sabres,1,0,0,0,1,20140205,0,2,4,4,6,-4,2013,0,2,178,0
Blue Jackets,1,0,0,0,1,Kings,0,0,1,1,2,20140206,-1,-1,0,1,3,1,2013,1,3,1973,0
Bruins,0,0,2,0,2,Blues,1,1,0,1,3,20140206,1,2,0,1,5,1,2013,1,3,1035,0
Red Wings,0,2,1,0,3,Panthers,1,0,0,0,1,20140206,-1,1,2,2,4,-2,2013,0,3,1155,0
Maple Leafs,0,1,3,0,4,Lightning,0,0,1,0,1,20140206,0,1,3,3,5,-3,2013,0,3,1096,0
Predators,1,1,0,0,2,Wild,2,0,0,1,3,20140206,1,0,0,1,5,1,2013,1,3,696,0
Canucks,0,1,1,0,2,Canadiens,2,0,3,0,5,20140206,2,1,3,3,7,3,2013,0,3,2273,0
Jets,1,1,0,0,2,Capitals,1,0,3,0,4,20140206,0,-1,2,2,6,2,2013,0,3,1247,0
Avalanche,0,0,1,0,1,Flyers,0,1,2,0,3,20140206,0,1,2,2,4,2,2013,0,3,1574,0
Oilers,1,0,1,0,2,Rangers,0,1,0,0,1,20140206,1,0,1,1,3,-1,2013,0,3,2024,0
Flames,0,2,2,0,4,Islanders,0,1,1,0,2,20140206,0,1,2,2,6,-2,2013,0,3,2023,0
Sabres,0,0,2,0,2,Senators,0,1,2,0,3,20140206,0,1,1,1,5,1,2013,0,3,219,0
Oilers,1,0,0,0,1,Devils,1,0,0,1,2,20140207,0,0,0,1,3,1,2013,1,4,2016,0
Rangers,1,1,1,1,4,Penguins,1,1,1,0,3,20140207,0,0,0,1,7,-1,2013,1,4,314,0
Panthers,1,0,0,0,1,Hurricanes,3,1,1,0,5,20140207,2,3,4,4,6,4,2013,0,4,696,0
Blackhawks,0,0,0,0,0,Coyotes,1,1,0,0,2,20140207,1,2,2,2,2,2,2013,0,4,1450,0
Blue Jackets,0,1,1,0,2,Sharks,2,0,1,0,3,20140207,2,1,1,1,5,1,2013,0,4,2090,0
Devils,0,0,0,0,0,Capitals,0,0,3,0,3,20140208,0,0,3,3,3,3,2013,0,5,198,0
Ducks,1,1,3,0,5,Predators,1,0,1,0,2,20140208,0,1,3,3,7,-3,2013,0,5,1776,0
Avalanche,1,2,2,0,5,Islanders,0,0,2,0,2,20140208,1,3,3,3,7,-3,2013,0,5,1627,0
Coyotes,0,0,1,0,1,Stars,1,1,0,0,2,20140208,1,2,1,1,3,1,2013,0,5,884,0
Canadiens,0,2,2,0,4,Hurricanes,0,1,0,0,1,20140208,0,1,3,3,5,-3,2013,0,5,727,0
Canucks,1,0,0,0,1,Maple Leafs,0,0,3,0,3,20140208,-1,-1,2,2,4,2,2013,0,5,2090,0
Senators,0,1,1,0,2,Bruins,2,2,3,0,7,20140208,2,3,5,5,9,5,2013,0,5,320,0
Jets,1,1,1,0,3,Blues,2,0,1,1,4,20140208,1,0,0,1,7,1,2013,1,5,853,0
Flames,0,0,1,0,1,Flyers,0,1,1,0,2,20140208,0,1,1,1,3,1,2013,0,5,2003,0
Red Wings,1,1,0,0,2,Lightning,0,2,2,0,4,20140208,-1,0,2,2,6,2,2013,0,5,994,0
Hurricanes,0,1,1,0,2,Sabres,0,1,2,0,3,20140225,0,0,1,1,5,1,2013,0,1,491,0
Bruins,1,2,1,0,4,Sabres,1,2,1,1,5,20140226,0,0,0,1,9,1,2013,1,2,399,0
Red Wings,1,0,0,1,2,Canadiens,0,0,1,0,1,20140226,1,1,0,1,3,-1,2013,1,2,508,0
Kings,1,3,2,0,6,Avalanche,2,2,0,0,4,20140226,-1,0,2,2,10,-2,2013,0,2,830,0
Blues,0,0,0,0,0,Canucks,0,0,1,0,1,20140226,0,0,1,1,1,1,2013,0,2,1778,0
Wild,1,1,1,0,3,Oilers,0,0,0,0,0,20140227,1,2,3,3,3,-3,2013,0,3,1083,0
Kings,1,0,1,0,2,Flames,0,0,0,0,0,20140227,1,1,2,2,2,-2,2013,0,3,1197,0
Hurricanes,0,0,1,0,1,Stars,2,1,1,0,4,20140227,2,3,3,3,5,3,2013,0,3,1055,0
Coyotes,1,0,1,0,2,Jets,1,1,0,1,3,20140227,0,1,0,1,5,1,2013,1,3,1365,0
Lightning,2,0,0,0,2,Predators,0,2,1,0,3,20140227,-2,0,1,1,5,1,2013,0,3,621,0
Red Wings,4,2,0,0,6,Senators,0,1,0,0,1,20140227,4,5,5,5,7,-5,2013,0,3,406,0
Canadiens,1,2,2,1,6,Penguins,2,1,2,0,5,20140227,-1,0,0,1,11,-1,2013,1,3,474,0
Sharks,1,5,1,0,7,Flyers,2,0,1,0,3,20140227,-1,4,4,4,10,-4,2013,0,3,2499,0
Blackhawks,0,0,1,0,1,Rangers,1,0,1,0,2,20140227,1,1,1,1,3,1,2013,0,3,711,0
Maple Leafs,1,0,3,0,4,Islanders,2,0,2,1,5,20140227,1,1,0,1,9,1,2013,1,3,341,0
Blue Jackets,1,1,0,0,2,Devils,3,1,1,0,5,20140227,2,2,3,3,7,3,2013,0,3,467,0
Capitals,2,2,1,0,5,Panthers,1,1,2,0,4,20140227,1,2,1,1,9,-1,2013,0,3,924,0
Sharks,0,1,1,0,2,Sabres,1,0,3,0,4,20140228,1,0,2,2,6,2,2013,0,4,2279,0
Coyotes,1,0,1,0,2,Avalanche,1,0,3,0,4,20140228,0,0,2,2,6,2,2013,0,4,585,0
Wild,1,0,0,1,2,Canucks,1,0,0,0,1,20140228,0,0,0,1,3,-1,2013,1,4,1427,0
Blues,0,0,0,0,0,Ducks,1,0,0,0,1,20140228,1,1,1,1,1,1,2013,0,4,1586,0
Flames,1,0,0,1,2,Oilers,0,0,1,0,1,20140301,1,1,0,1,3,-1,2013,1,5,171,0
Penguins,0,0,1,0,1,Blackhawks,1,2,2,0,5,20140301,1,3,4,4,6,4,2013,0,5,409,0
Lightning,2,1,1,0,4,Stars,0,2,0,0,2,20140301,2,1,2,2,6,-2,2013,0,5,916,0
Maple Leafs,1,0,2,0,3,Canadiens,2,0,1,1,4,20140301,1,1,0,1,7,1,2013,1,5,303,0
Hurricanes,1,0,0,0,1,Kings,1,0,2,0,3,20140301,0,0,2,2,4,2,2013,0,5,2231,0
Capitals,1,2,1,0,4,Bruins,0,2,0,0,2,20140301,1,1,2,2,6,-2,2013,0,5,394,0
Devils,1,4,1,0,6,Islanders,0,1,0,0,1,20140301,1,4,5,5,7,-5,2013,0,5,8,0
Jets,0,2,1,0,3,Predators,0,0,1,0,1,20140301,0,2,2,2,4,-2,2013,0,5,1084,0
Panthers,1,2,0,0,3,Blue Jackets,2,2,2,0,6,20140301,1,1,3,3,9,3,2013,0,5,993,0
Rangers,0,2,0,0,2,Flyers,2,1,1,0,4,20140301,2,1,2,2,6,2,2013,0,5,80,0
Flyers,1,1,2,1,5,Capitals,2,2,0,0,4,20140302,-1,-2,0,1,9,-1,2013,1,6,123,0
Sharks,0,2,2,0,4,Devils,0,2,0,0,2,20140302,0,0,2,2,6,-2,2013,0,6,2540,0
Panthers,0,1,4,0,5,Islanders,2,1,0,0,3,20140302,-2,-2,2,2,8,-2,2013,0,6,1091,0
Senators,2,1,1,0,4,Canucks,2,0,0,0,2,20140302,0,1,2,2,6,-2,2013,0,6,2191,0
Bruins,1,2,3,0,6,Rangers,1,1,1,0,3,20140302,0,1,3,3,9,-3,2013,0,6,190,0
Lightning,1,2,0,0,3,Avalanche,2,0,4,0,6,20140302,1,-1,3,3,9,3,2013,0,6,1521,0
Blues,0,0,4,0,4,Coyotes,1,1,0,0,2,20140302,-1,-2,2,2,6,-2,2013,0,6,1270,0
Hurricanes,0,1,2,0,3,Ducks,3,2,0,0,5,20140302,3,4,2,2,8,2,2013,0,6,2231,0
Canadiens,1,0,0,0,1,Kings,1,1,0,0,2,20140303,0,1,1,1,3,1,2013,0,0,2448,0
Flames,0,1,1,0,2,Wild,0,1,2,0,3,20140303,0,0,1,1,5,1,2013,0,0,1043,0
Sabres,1,0,1,0,2,Stars,0,2,1,0,3,20140303,-1,1,1,1,5,1,2013,0,0,1197,0
Blue Jackets,0,2,0,0,2,Maple Leafs,0,0,1,0,1,20140303,0,2,1,1,3,-1,2013,0,0,313,0
Red Wings,1,1,1,0,3,Devils,1,0,3,0,4,20140304,0,-1,1,1,7,1,2013,0,1,471,0
Stars,0,0,2,0,2,Blue Jackets,3,0,1,0,4,20140304,3,3,2,2,6,2,2013,0,1,912,0
Avalanche,0,1,3,0,4,Blackhawks,0,1,1,0,2,20140304,0,0,2,2,6,-2,2013,0,1,916,0
Lightning,2,0,0,0,2,Blues,0,2,2,0,4,20140304,-2,0,2,2,6,2,2013,0,1,861,0
Penguins,0,1,2,0,3,Predators,0,1,0,0,1,20140304,0,0,2,2,4,-2,2013,0,1,471,0
Islanders,1,1,0,1,3,Jets,1,0,1,0,2,20140304,0,1,0,1,5,-1,2013,1,1,1287,0
Canucks,0,0,0,0,0,Coyotes,1,0,0,0,1,20140304,1,1,1,1,1,1,2013,0,1,1228,0
Senators,1,0,1,0,2,Oilers,1,1,1,0,3,20140304,0,1,1,1,5,1,2013,0,1,1754,0
Hurricanes,1,1,0,1,3,Sharks,2,0,0,0,2,20140304,-1,0,0,1,5,-1,2013,1,1,2382,0
Panthers,0,0,1,0,1,Bruins,2,1,1,0,4,20140304,2,3,3,3,5,3,2013,0,1,1257,0
Canadiens,2,1,0,1,4,Ducks,0,3,0,0,3,20140305,2,0,0,1,7,-1,2013,1,2,2448,0
Senators,0,0,1,0,1,Flames,1,2,1,0,4,20140305,1,3,3,3,5,3,2013,0,2,1773,0
Maple Leafs,0,1,1,1,3,Rangers,0,0,2,0,2,20140305,0,1,0,1,5,-1,2013,1,2,341,0
Capitals,0,1,3,0,4,Flyers,2,2,2,0,6,20140305,2,3,2,2,10,2,2013,0,2,123,0
Capitals,0,0,0,0,0,Bruins,0,2,1,0,3,20140306,0,2,3,3,3,3,2013,0,3,394,0
Kings,0,2,1,0,3,Jets,0,1,0,0,1,20140306,0,1,2,2,4,-2,2013,0,3,1527,0
Sabres,1,1,1,0,3,Lightning,0,0,1,0,1,20140306,1,2,2,2,4,-2,2013,0,3,1051,0
Avalanche,0,1,1,1,3,Red Wings,1,1,0,0,2,20140306,-1,-1,0,1,5,-1,2013,1,3,1154,0
Blue Jackets,1,0,0,0,1,Blackhawks,2,3,1,0,6,20140306,1,4,5,5,7,5,2013,0,3,275,0
Blues,1,1,0,0,2,Predators,1,0,0,0,1,20140306,0,1,1,1,3,-1,2013,0,3,253,0
Canucks,0,1,0,0,1,Stars,3,2,1,0,6,20140306,3,4,5,5,7,5,2013,0,3,1766,0
Canadiens,1,1,0,0,2,Coyotes,3,0,2,0,5,20140306,2,1,3,3,7,3,2013,0,3,2175,0
Islanders,2,0,0,0,2,Oilers,0,0,2,1,3,20140306,-2,-2,0,1,5,1,2013,1,3,2024,0
Penguins,2,0,1,0,3,Sharks,0,1,4,0,5,20140306,-2,-1,2,2,8,2,2013,0,3,2242,0
Penguins,1,0,1,1,3,Ducks,1,0,1,0,2,20140307,0,0,0,1,5,-1,2013,1,4,2132,0
Islanders,1,2,0,0,3,Flames,1,0,3,0,4,20140307,0,-2,1,1,7,1,2013,0,4,2023,0
Devils,0,3,1,0,4,Red Wings,1,4,2,0,7,20140307,1,2,3,3,11,3,2013,0,4,471,0
Rangers,0,0,4,0,4,Hurricanes,1,0,1,0,2,20140307,-1,-1,2,2,6,-2,2013,0,4,423,0
Sabres,0,0,0,0,0,Panthers,1,0,1,0,2,20140307,1,1,2,2,2,2,2013,0,4,1184,0
Senators,2,3,0,0,5,Jets,1,1,1,0,3,20140308,1,3,2,2,8,-2,2013,0,5,1033,0
Blues,0,1,1,0,2,Avalanche,0,0,1,0,1,20140308,0,1,1,1,3,-1,2013,0,5,794,0
Flyers,0,1,2,0,3,Maple Leafs,2,0,1,1,4,20140308,2,1,0,1,7,1,2013,1,5,334,0
Bruins,0,2,1,1,4,Lightning,0,3,0,0,3,20140308,0,-1,0,1,7,-1,2013,1,5,1183,0
Hurricanes,0,2,2,0,4,Devils,1,3,1,0,5,20140308,1,2,1,1,9,1,2013,0,5,419,0
Coyotes,1,1,0,0,2,Capitals,0,0,3,0,3,20140308,-1,-2,1,1,5,1,2013,0,5,1977,0
Blue Jackets,0,0,1,0,1,Predators,0,0,0,0,0,20140308,0,0,1,1,1,-1,2013,0,5,333,0
Wild,1,1,1,0,3,Stars,1,1,2,0,4,20140308,0,0,1,1,7,1,2013,0,5,863,0
Flames,0,1,0,0,1,Canucks,0,1,1,0,2,20140308,0,0,1,1,3,1,2013,0,5,426,0
Canadiens,0,0,0,0,0,Sharks,1,2,1,0,4,20140308,1,3,4,4,4,4,2013,0,5,2508,0
Kings,1,3,0,0,4,Oilers,1,0,1,0,2,20140309,0,3,2,2,6,-2,2013,0,6,1368,0
Blues,2,0,0,1,3,Wild,0,2,0,0,2,20140309,2,0,0,1,5,-1,2013,1,6,466,0
Bruins,0,1,4,0,5,Panthers,0,1,1,0,2,20140309,0,0,3,3,7,-3,2013,0,6,1257,0
Red Wings,0,0,0,0,0,Rangers,1,0,2,0,3,20140309,1,1,3,3,3,3,2013,0,6,480,0
Blackhawks,1,0,1,0,2,Sabres,1,0,0,0,1,20140309,0,0,1,1,3,-1,2013,0,6,453,0
Coyotes,0,1,2,1,4,Lightning,1,1,1,0,3,20140310,-1,-1,0,1,7,-1,2013,1,0,1793,0
Jets,0,2,0,0,2,Avalanche,0,2,0,1,3,20140310,0,0,0,1,5,1,2013,1,0,797,0
Kings,2,0,1,0,3,Flames,0,0,2,0,2,20140310,2,2,1,1,5,-1,2013,0,0,1197,0
Islanders,0,0,7,0,7,Canucks,1,2,1,0,4,20140310,-1,-3,3,3,11,-3,2013,0,0,2429,0
Maple Leafs,2,1,0,0,3,Ducks,0,1,0,0,1,20140310,2,2,2,2,4,-2,2013,0,0,2170,0
Penguins,2,1,0,0,3,Capitals,1,1,0,0,2,20140310,1,1,1,1,5,-1,2013,0,0,190,0
Predators,0,3,0,1,4,Senators,0,0,3,0,3,20140310,0,3,0,1,7,-1,2013,1,0,845,0
Maple Leafs,1,0,1,0,2,Sharks,2,2,2,0,6,20140311,1,3,4,4,8,4,2013,0,1,2249,0
Oilers,1,0,2,1,4,Wild,3,0,0,0,3,20140311,-2,-2,0,1,7,-1,2013,1,1,1083,0
Stars,1,0,1,1,3,Blues,1,0,1,0,2,20140311,0,0,0,1,5,-1,2013,1,1,547,0
Capitals,0,0,0,0,0,Penguins,1,0,1,0,2,20140311,1,1,2,2,2,2,2013,0,1,190,0
Coyotes,1,1,1,0,3,Panthers,0,0,1,0,1,20140311,1,2,2,2,4,-2,2013,0,1,1978,0
Red Wings,1,0,0,0,1,Blue Jackets,1,0,3,0,4,20140311,0,0,3,3,5,3,2013,0,1,163,0
Rangers,0,1,0,0,1,Hurricanes,0,2,1,0,3,20140311,0,1,2,2,4,2,2013,0,1,423,0
Devils,1,0,1,0,2,Flyers,0,1,0,0,1,20140311,1,0,1,1,3,-1,2013,0,1,75,0
Predators,1,2,1,0,4,Sabres,1,0,0,0,1,20140311,0,2,3,3,5,-3,2013,0,1,626,0
Bruins,0,3,1,0,4,Canadiens,0,0,1,0,1,20140312,0,3,3,3,5,-3,2013,0,2,270,0
Canucks,0,1,1,1,3,Jets,0,1,1,0,2,20140312,0,0,0,1,5,-1,2013,1,2,1157,0
Blackhawks,0,1,1,0,2,Avalanche,1,1,1,0,3,20140312,1,1,1,1,5,1,2013,0,2,916,0
Ducks,0,1,1,0,2,Flames,4,2,1,0,7,20140312,4,5,5,5,9,5,2013,0,2,1197,0
Rangers,0,1,0,0,1,Wild,1,0,1,0,2,20140313,1,0,1,1,3,1,2013,0,3,1016,0
Oilers,1,1,0,0,2,Blues,1,1,4,0,6,20140313,0,0,4,4,8,4,2013,0,3,1508,0
Maple Leafs,1,1,1,0,3,Kings,2,0,0,0,2,20140313,-1,0,1,1,5,-1,2013,0,3,2170,0
Sharks,1,0,2,1,4,Blue Jackets,1,1,1,0,3,20140313,0,-1,0,1,7,-1,2013,1,3,2090,0
Sabres,1,0,1,0,2,Hurricanes,1,0,3,0,4,20140313,0,0,2,2,6,2,2013,0,3,491,0
Panthers,2,0,2,0,4,Lightning,2,2,1,0,5,20140313,0,2,1,1,9,1,2013,0,3,205,0
Coyotes,0,0,1,0,1,Bruins,2,0,0,0,2,20140313,2,2,1,1,3,1,2013,0,3,2295,0
Ducks,0,6,0,0,6,Avalanche,1,3,0,0,4,20140314,-1,2,2,2,10,-2,2013,0,4,830,0
Flames,0,1,2,1,4,Stars,0,3,0,0,3,20140314,0,-2,0,1,7,-1,2013,1,4,1536,0
Rangers,2,1,1,0,4,Jets,2,0,0,0,2,20140314,0,1,2,2,6,-2,2013,0,4,1287,0
Canucks,1,0,2,0,3,Capitals,1,2,1,0,4,20140314,0,2,1,1,7,1,2013,0,4,2359,0
Devils,1,2,0,0,3,Panthers,1,1,3,0,5,20140314,0,-1,2,2,8,2,2013,0,4,1090,0
Oilers,0,0,1,0,1,Red Wings,1,0,0,1,2,20140314,1,1,0,1,3,1,2013,1,4,1592,0
Predators,2,0,1,0,3,Blackhawks,1,0,1,0,2,20140314,1,1,1,1,5,-1,2013,0,4,395,0
Sharks,2,2,0,0,4,Islanders,0,2,1,0,3,20140314,2,2,1,1,7,-1,2013,0,4,2549,0
Flames,0,2,0,0,2,Coyotes,2,0,1,0,3,20140315,2,0,1,1,5,1,2013,0,5,1224,0
Blue Jackets,0,1,0,1,2,Wild,0,0,1,0,1,20140315,0,1,0,1,3,-1,2013,1,5,626,0
Blues,1,2,1,0,4,Predators,0,1,0,0,1,20140315,1,2,3,3,5,-3,2013,0,5,253,0
Ducks,1,1,0,0,2,Kings,0,1,0,0,1,20140315,1,1,1,1,3,-1,2013,0,5,0,0
Senators,1,1,2,0,4,Canadiens,1,0,3,1,5,20140315,0,-1,0,1,9,1,2013,1,5,104,0
Penguins,0,0,0,0,0,Flyers,2,2,0,0,4,20140315,2,4,4,4,4,4,2013,0,5,257,0
Hurricanes,0,0,1,0,1,Bruins,1,1,3,0,5,20140315,1,2,4,4,6,4,2013,0,5,609,0
Devils,0,0,0,0,0,Lightning,0,2,1,0,3,20140315,0,2,3,3,3,3,2013,0,5,1000,0
Sabres,0,0,1,0,1,Islanders,2,0,2,0,4,20140315,2,2,3,3,5,3,2013,0,5,292,0
Flyers,3,1,0,0,4,Penguins,1,2,0,0,3,20140316,2,1,1,1,7,-1,2013,0,6,257,0
Canucks,2,0,1,1,4,Panthers,1,0,2,0,3,20140316,1,1,0,1,7,-1,2013,1,6,2803,0
Maple Leafs,1,1,0,0,2,Capitals,3,0,1,0,4,20140316,2,1,2,2,6,2,2013,0,6,349,0
Oilers,1,0,1,0,2,Hurricanes,1,0,0,0,1,20140316,0,0,1,1,3,-1,2013,0,6,2076,0
Sharks,1,0,0,0,1,Rangers,0,0,0,0,0,20140316,1,1,1,1,1,-1,2013,0,6,2549,0
Avalanche,0,1,2,0,3,Senators,0,0,1,0,1,20140316,0,1,2,2,4,-2,2013,0,6,1515,0
Canadiens,2,0,0,0,2,Sabres,0,0,0,0,0,20140316,2,2,2,2,2,-2,2013,0,6,311,0
Red Wings,0,1,0,0,1,Blackhawks,0,2,2,0,4,20140316,0,1,3,3,5,3,2013,0,6,238,0
Stars,2,0,0,0,2,Jets,3,2,2,0,7,20140316,1,3,5,5,9,5,2013,0,6,1183,0
Coyotes,2,0,2,0,4,Kings,1,2,0,0,3,20140317,1,-1,1,1,7,-1,2013,0,0,356,0
Canucks,0,0,3,0,3,Lightning,1,2,1,0,4,20140317,1,3,1,1,7,1,2013,0,0,2598,0
Wild,0,1,0,0,1,Bruins,0,2,2,0,4,20140317,0,1,3,3,5,3,2013,0,0,1120,0
Jets,0,0,1,0,1,Blues,0,1,2,0,3,20140317,0,1,2,2,4,2,2013,0,0,853,0
Stars,1,0,0,0,1,Penguins,2,1,2,0,5,20140318,1,2,4,4,6,4,2013,0,1,1069,0
Hurricanes,1,2,0,0,3,Blue Jackets,0,0,1,0,1,20140318,1,3,2,2,4,-2,2013,0,1,374,0
Avalanche,1,1,1,0,3,Canadiens,0,2,4,0,6,20140318,-1,0,3,3,9,3,2013,0,1,1618,0
Rangers,1,4,3,0,8,Senators,2,0,2,0,4,20140318,-1,3,4,4,12,-4,2013,0,1,334,0
Maple Leafs,0,0,2,0,2,Red Wings,1,0,2,0,3,20140318,1,1,1,1,5,1,2013,0,1,205,0
Blackhawks,2,0,0,0,2,Flyers,2,0,0,1,3,20140318,0,0,0,1,5,1,2013,1,1,664,0
Sabres,1,0,0,0,1,Flames,0,1,2,0,3,20140318,-1,0,2,2,4,2,2013,0,1,1731,0
Predators,0,1,0,0,1,Oilers,1,2,2,0,5,20140318,1,2,4,4,6,4,2013,0,1,1758,0
Capitals,2,0,1,0,3,Ducks,1,0,1,0,2,20140318,1,1,1,1,5,-1,2013,0,1,2294,0
Panthers,0,3,0,0,3,Sharks,0,1,1,0,2,20140318,0,2,1,1,5,-1,2013,0,1,2558,0
Bruins,1,2,1,0,4,Devils,0,1,1,0,2,20140318,1,2,2,2,6,-2,2013,0,1,196,0
Wild,2,1,3,0,6,Islanders,0,0,0,0,0,20140318,2,3,6,6,6,-6,2013,0,1,1016,0
Predators,0,0,0,0,0,Canucks,0,0,2,0,2,20140319,0,0,2,2,2,2,2013,0,2,2030,0
Avalanche,2,1,1,0,4,Jets,2,1,1,1,5,20140319,0,0,0,1,9,1,2013,1,2,797,0
Blues,0,0,0,0,0,Blackhawks,1,1,2,0,4,20140319,1,2,4,4,4,4,2013,0,2,260,0
Lightning,3,1,1,0,5,Maple Leafs,2,0,1,0,3,20140319,1,2,2,2,8,-2,2013,0,2,1096,0
Wild,0,0,3,0,3,Devils,1,1,1,1,4,20140320,1,2,0,1,7,1,2013,1,3,1007,0
Stars,0,1,1,0,2,Flyers,2,0,2,0,4,20140320,2,1,2,2,6,2,2013,0,3,1297,0
Blue Jackets,1,1,1,0,3,Canadiens,1,0,1,0,2,20140320,0,1,1,1,5,-1,2013,0,3,605,0
Lightning,2,1,2,0,5,Senators,2,1,1,0,4,20140320,0,0,1,1,9,-1,2013,0,3,1251,0
Penguins,0,3,1,0,4,Red Wings,1,1,2,1,5,20140320,1,-1,0,1,9,1,2013,1,3,205,0
Sabres,0,1,2,0,3,Oilers,1,0,0,0,1,20140320,-1,0,2,2,4,-2,2013,0,3,1734,0
Panthers,0,0,1,0,1,Coyotes,2,0,0,0,2,20140320,2,2,1,1,3,1,2013,0,3,1978,0
Capitals,0,0,1,0,1,Kings,1,0,0,1,2,20140320,1,1,0,1,3,1,2013,1,3,2294,0
Ducks,0,1,1,0,2,Sharks,1,0,2,0,3,20140320,1,0,1,1,5,1,2013,0,3,305,0
Predators,2,2,2,0,6,Flames,1,3,1,0,5,20140321,1,0,1,1,11,-1,2013,0,4,1692,0
Hurricanes,0,1,1,0,2,Blackhawks,0,2,1,0,3,20140321,0,1,1,1,5,1,2013,0,4,641,0
Rangers,0,0,3,0,3,Blue Jackets,0,0,1,0,1,20140321,0,0,2,2,4,-2,2013,0,4,476,0
Bruins,1,1,0,0,2,Avalanche,0,0,0,0,0,20140321,1,2,2,2,2,-2,2013,0,4,1765,0
Blues,1,0,0,0,1,Flyers,0,2,2,0,4,20140322,-1,1,3,3,5,3,2013,0,5,808,0
Lightning,0,1,2,0,3,Penguins,0,1,2,1,4,20140322,0,0,0,1,7,1,2013,1,5,874,0
Red Wings,1,1,1,0,3,Wild,1,0,1,0,2,20140322,0,1,1,1,5,-1,2013,0,5,542,0
Senators,1,0,0,0,1,Stars,0,1,2,0,3,20140322,-1,0,2,2,4,2,2013,0,5,1404,0
Panthers,0,0,0,0,0,Kings,2,1,1,0,4,20140322,2,3,4,4,4,4,2013,0,5,2335,0
Canadiens,3,0,1,0,4,Maple Leafs,2,0,1,0,3,20140322,1,1,1,1,7,-1,2013,0,5,303,0
Rangers,0,1,1,0,2,Devils,0,0,0,0,0,20140322,0,1,2,2,2,-2,2013,0,5,8,0
Hurricanes,0,3,0,0,3,Jets,0,1,1,0,2,20140322,0,2,1,1,5,-1,2013,0,5,1350,0
Bruins,1,0,3,0,4,Coyotes,1,1,0,0,2,20140322,0,-1,2,2,6,-2,2013,0,5,2295,0
Flames,1,4,3,0,8,Oilers,1,0,0,0,1,20140322,0,4,7,7,9,-7,2013,0,5,171,0
Capitals,1,0,1,1,3,Sharks,1,0,1,0,2,20140322,0,0,0,1,5,-1,2013,1,5,2416,0
Panthers,0,2,0,0,2,Ducks,1,4,1,0,6,20140323,1,3,4,4,8,4,2013,0,6,2335,0
Sabres,2,0,0,0,2,Canucks,2,1,1,0,4,20140323,0,1,2,2,6,2,2013,0,6,2137,0
Maple Leafs,0,1,1,0,2,Devils,1,2,0,0,3,20140323,1,2,1,1,5,1,2013,0,6,333,0
Predators,1,1,0,0,2,Blackhawks,0,0,0,0,0,20140323,1,2,2,2,2,-2,2013,0,6,395,0
Blues,0,0,1,0,1,Penguins,0,0,0,0,0,20140323,0,0,1,1,1,-1,2013,0,6,557,0
Blue Jackets,0,0,0,0,0,Islanders,1,1,0,0,2,20140323,1,2,2,2,2,2,2013,0,6,476,0
Wild,0,1,2,1,4,Red Wings,2,0,1,0,3,20140323,-2,-1,0,1,7,-1,2013,1,6,542,0
Coyotes,2,1,0,0,3,Rangers,0,2,1,1,4,20140324,-2,-1,0,1,7,1,2013,1,0,2139,0
Kings,0,2,1,0,3,Flyers,0,0,2,0,2,20140324,0,2,1,1,5,-1,2013,0,0,2388,0
Canadiens,1,0,0,1,2,Bruins,0,0,1,0,1,20140324,1,1,0,1,3,-1,2013,1,0,270,0
Senators,1,2,0,1,4,Lightning,1,1,1,0,3,20140324,0,1,0,1,7,-1,2013,1,0,1251,0
Jets,0,0,1,0,1,Stars,1,1,0,0,2,20140324,1,2,1,1,3,1,2013,0,0,1183,0
Sharks,1,0,0,0,1,Flames,0,1,0,1,2,20140324,-1,0,0,1,3,1,2013,1,0,1027,0
Sharks,0,3,2,0,5,Oilers,1,0,1,0,2,20140325,-1,2,3,3,7,-3,2013,0,1,1190,0
Avalanche,1,1,2,1,5,Predators,2,1,1,0,4,20140325,-1,-1,0,1,9,-1,2013,1,1,1019,0
Red Wings,1,1,0,0,2,Blue Jackets,2,0,2,0,4,20140325,1,0,2,2,6,2,2013,0,1,163,0
Stars,0,1,1,0,2,Blackhawks,1,2,1,0,4,20140325,1,2,2,2,6,2,2013,0,1,802,0
Sabres,0,0,0,0,0,Canadiens,0,0,2,0,2,20140325,0,0,2,2,2,2,2013,0,1,311,0
Islanders,4,1,0,0,5,Hurricanes,2,2,0,0,4,20140325,2,1,1,1,9,-1,2013,0,1,423,0
Kings,0,1,3,1,5,Capitals,2,1,1,0,4,20140325,-2,-2,0,1,9,-1,2013,1,1,2294,0
Coyotes,2,1,0,0,3,Penguins,2,0,0,0,2,20140325,0,1,1,1,5,-1,2013,0,1,1824,0
Blues,2,2,1,0,5,Maple Leafs,1,0,2,0,3,20140325,1,3,2,2,8,-2,2013,0,1,659,0
Senators,0,2,0,0,2,Panthers,0,2,0,1,3,20140325,0,0,0,1,5,1,2013,1,1,1370,0
Canucks,1,2,2,0,5,Wild,1,0,1,0,2,20140326,0,2,3,3,7,-3,2013,0,2,1427,0
Flyers,0,0,1,0,1,Rangers,1,1,1,0,3,20140326,1,2,2,2,4,2,2013,0,2,80,0
Ducks,1,0,2,0,3,Flames,0,2,0,0,2,20140326,1,-1,1,1,5,-1,2013,0,2,1197,0
Blackhawks,0,0,0,0,0,Bruins,1,0,2,0,3,20140327,1,1,3,3,3,3,2013,0,3,849,0
Coyotes,1,1,0,1,3,Devils,0,1,1,0,2,20140327,1,1,0,1,5,-1,2013,1,3,2131,0
Kings,1,1,1,0,3,Penguins,0,2,0,0,2,20140327,1,0,1,1,5,-1,2013,0,3,2132,0
Canadiens,2,1,2,0,5,Red Wings,0,1,3,0,4,20140327,2,2,1,1,9,-1,2013,0,3,508,0
Islanders,0,2,0,0,2,Lightning,0,1,1,1,3,20140327,0,-1,0,1,5,1,2013,1,3,1004,0
Hurricanes,1,2,0,0,3,Panthers,0,0,0,0,0,20140327,1,3,3,3,3,-3,2013,0,3,696,0
Wild,0,0,1,0,1,Blues,2,1,2,0,5,20140327,2,3,4,4,6,4,2013,0,3,466,0
Sabres,0,1,0,0,1,Predators,4,1,1,0,6,20140327,4,4,5,5,7,5,2013,0,3,626,0
Canucks,1,1,0,0,2,Avalanche,1,1,0,1,3,20140327,0,0,0,1,5,1,2013,1,3,1105,0
Jets,1,2,1,0,4,Sharks,2,1,0,0,3,20140327,-1,0,1,1,7,-1,2013,0,3,1496,0
Rangers,0,3,0,0,3,Flames,2,2,0,0,4,20140328,2,1,1,1,7,1,2013,0,4,2023,0
Ducks,1,1,1,0,3,Oilers,1,1,1,1,4,20140328,0,0,0,1,7,1,2013,1,4,1368,0
Blackhawks,0,2,1,0,3,Senators,2,1,2,0,5,20140328,2,1,2,2,8,2,2013,0,4,628,0
Maple Leafs,0,1,1,0,2,Flyers,1,1,2,0,4,20140328,1,1,2,2,6,2,2013,0,4,334,0
Penguins,0,0,2,0,2,Blue Jackets,0,0,1,0,1,20140328,0,0,1,1,3,-1,2013,0,4,161,0
Predators,0,2,1,0,3,Stars,2,3,2,0,7,20140328,2,3,4,4,10,4,2013,0,4,616,0
Jets,0,0,2,0,2,Kings,3,0,1,0,4,20140329,3,3,2,2,6,2,2013,0,5,1527,0
Ducks,2,1,2,0,5,Canucks,1,0,0,0,1,20140329,1,2,4,4,6,-4,2013,0,5,1076,0
Wild,0,0,3,0,3,Coyotes,1,0,0,0,1,20140329,-1,-1,2,2,4,-2,2013,0,5,1278,0
Stars,1,2,1,0,4,Blues,0,1,1,0,2,20140329,1,2,2,2,6,-2,2013,0,5,547,0
Blue Jackets,0,1,1,1,3,Hurricanes,0,1,1,0,2,20140329,0,0,0,1,5,-1,2013,1,5,374,0
Canadiens,2,1,1,0,4,Panthers,0,1,0,0,1,20140329,2,2,3,3,5,-3,2013,0,5,1418,0
Red Wings,0,3,1,0,4,Maple Leafs,1,1,0,0,2,20140329,-1,1,2,2,6,-2,2013,0,5,205,0
Lightning,2,0,1,1,4,Sabres,2,0,1,0,3,20140329,0,0,0,1,7,-1,2013,1,5,1051,0
Sharks,1,1,0,0,2,Avalanche,2,1,0,0,3,20140329,1,1,1,1,5,1,2013,0,5,927,0
Bruins,0,3,1,0,4,Capitals,0,1,1,0,2,20140329,0,2,2,2,6,-2,2013,0,5,394,0
Devils,0,1,0,0,1,Islanders,0,1,0,1,2,20140329,0,0,0,1,3,1,2013,1,5,8,0
Rangers,1,3,1,0,5,Oilers,0,0,0,0,0,20140330,1,4,5,5,5,-5,2013,0,6,2024,0
Capitals,1,1,1,0,3,Predators,2,0,1,1,4,20140330,1,0,0,1,7,1,2013,1,6,566,0
Flames,1,2,0,0,3,Senators,2,1,3,0,6,20140330,1,0,3,3,9,3,2013,0,6,1773,0
Lightning,1,0,1,0,2,Red Wings,2,1,0,0,3,20140330,1,2,1,1,5,1,2013,0,6,994,0
Bruins,1,2,0,1,4,Flyers,2,0,1,0,3,20140330,-1,1,0,1,7,-1,2013,1,6,270,0
Blackhawks,0,1,0,0,1,Penguins,2,0,2,0,4,20140330,2,1,3,3,5,3,2013,0,6,409,0
Hurricanes,1,0,0,0,1,Senators,1,0,0,1,2,20140331,0,0,0,1,3,1,2013,1,0,673,0
Panthers,1,2,0,0,3,Devils,3,1,2,0,6,20140331,2,1,3,3,9,3,2013,0,0,1090,0
Jets,2,2,0,0,4,Ducks,0,1,3,1,5,20140331,-2,-3,0,1,9,1,2013,1,0,1527,0
Wild,0,1,2,0,3,Kings,1,1,0,0,2,20140331,-1,-1,1,1,5,-1,2013,0,0,1521,0
Oilers,1,2,1,0,4,Sharks,2,1,2,0,5,20140401,1,0,1,1,9,1,2013,0,1,1190,0
Jets,1,0,0,1,2,Coyotes,0,1,0,0,1,20140401,1,0,0,1,3,-1,2013,1,1,1365,0
Rangers,2,0,1,0,3,Canucks,0,1,0,0,1,20140401,2,1,2,2,4,-2,2013,0,1,2429,0
Canadiens,1,0,0,0,1,Lightning,0,1,2,0,3,20140401,-1,0,2,2,4,2,2013,0,1,1311,0
Flyers,0,0,0,0,0,Blues,0,0,0,1,1,20140401,0,0,0,1,1,1,2013,1,1,808,0
Stars,1,2,2,0,5,Capitals,0,0,0,0,0,20140401,1,3,5,5,5,-5,2013,0,1,1181,0
Hurricanes,1,2,1,0,4,Penguins,1,0,0,0,1,20140401,0,2,3,3,5,-3,2013,0,1,330,0
Panthers,1,0,1,0,2,Islanders,1,2,1,0,4,20140401,0,2,2,2,6,2,2013,0,1,1091,0
Flames,0,1,1,0,2,Maple Leafs,0,1,2,0,3,20140401,0,0,1,1,5,1,2013,0,1,1682,0
Devils,0,1,1,0,2,Sabres,0,0,2,1,3,20140401,0,-1,0,1,5,1,2013,1,1,284,0
Avalanche,0,0,2,1,3,Blue Jackets,0,2,0,0,2,20140401,0,-2,0,1,5,-1,2013,1,1,1163,0
Islanders,1,0,1,0,2,Senators,0,0,1,0,1,20140402,1,1,1,1,3,-1,2013,0,2,334,0
Bruins,1,0,1,0,2,Red Wings,0,1,2,0,3,20140402,-1,0,1,1,5,1,2013,0,2,611,0
Oilers,0,1,1,0,2,Ducks,0,0,3,0,3,20140402,0,-1,1,1,5,1,2013,0,2,1368,0
Coyotes,0,0,0,0,0,Kings,1,1,2,0,4,20140402,1,2,4,4,4,4,2013,0,2,356,0
Rangers,1,1,0,0,2,Avalanche,0,1,1,1,3,20140403,-1,-1,0,1,5,1,2013,1,3,1627,0
Kings,1,0,0,0,1,Sharks,0,2,0,0,2,20140403,-1,1,1,1,3,1,2013,0,3,305,0
Penguins,1,1,2,0,4,Jets,0,2,0,0,2,20140403,1,0,2,2,6,-2,2013,0,3,1060,0
Bruins,1,0,2,0,3,Maple Leafs,2,1,0,1,4,20140403,1,2,0,1,7,1,2013,1,3,430,0
Wild,1,0,1,0,2,Blackhawks,0,1,1,1,3,20140403,-1,0,0,1,5,1,2013,1,3,355,0
Stars,0,1,0,0,1,Hurricanes,0,3,1,0,4,20140403,0,2,3,3,5,3,2013,0,3,1055,0
Sabres,0,0,1,0,1,Blues,0,1,1,0,2,20140403,0,1,1,1,3,1,2013,0,3,660,0
Flames,2,0,2,0,4,Lightning,0,1,0,0,1,20140403,2,1,3,3,5,-3,2013,0,3,2289,0
Blue Jackets,0,1,1,0,2,Flyers,0,0,0,0,0,20140403,0,1,2,2,2,-2,2013,0,3,414,0
Canadiens,3,2,2,0,7,Senators,3,0,1,0,4,20140404,0,2,3,3,11,-3,2013,0,4,104,0
Blackhawks,1,2,1,0,4,Blue Jackets,1,2,0,0,3,20140404,0,0,1,1,7,-1,2013,0,4,275,0
Capitals,1,0,0,0,1,Devils,0,1,1,0,2,20140404,-1,0,1,1,3,1,2013,0,4,198,0
Sabres,0,1,1,0,2,Red Wings,3,0,0,0,3,20140404,3,2,1,1,5,1,2013,0,4,215,0
Flames,0,2,0,0,2,Panthers,0,1,0,0,1,20140404,0,1,1,1,3,-1,2013,0,4,2493,0
Oilers,1,0,1,1,3,Coyotes,0,1,1,0,2,20140404,1,0,0,1,5,-1,2013,1,4,1392,0
Predators,4,1,0,0,5,Ducks,1,1,0,0,2,20140404,3,3,3,3,7,-3,2013,0,4,1776,0
Predators,0,3,0,0,3,Sharks,0,0,0,0,0,20140405,0,3,3,3,3,-3,2013,0,5,1934,0
Kings,0,1,0,0,1,Canucks,0,0,2,0,2,20140405,0,-1,1,1,3,1,2013,0,5,1076,0
Penguins,0,0,0,0,0,Wild,3,1,0,0,4,20140405,3,4,4,4,4,4,2013,0,5,741,0
Devils,1,1,1,0,3,Hurricanes,0,1,0,0,1,20140405,1,1,2,2,4,-2,2013,0,5,419,0
Jets,2,1,1,0,4,Maple Leafs,2,0,0,0,2,20140405,0,1,2,2,6,-2,2013,0,5,946,0
Stars,3,0,2,0,5,Lightning,0,2,0,0,2,20140405,3,1,3,3,7,-3,2013,0,5,916,0
Red Wings,0,0,3,0,3,Canadiens,1,2,2,0,5,20140405,1,3,2,2,8,2,2013,0,5,508,0
Capitals,0,3,0,1,4,Islanders,1,2,0,0,3,20140405,-1,0,0,1,7,-1,2013,1,5,204,0
Flyers,0,2,0,0,2,Bruins,1,1,3,0,5,20140405,1,0,3,3,7,3,2013,0,5,270,0
Senators,2,1,0,0,3,Rangers,0,2,0,0,2,20140405,2,1,1,1,5,-1,2013,0,5,334,0
Avalanche,0,3,1,0,4,Blues,0,0,0,0,0,20140405,0,3,4,4,4,-4,2013,0,5,794,0
Ducks,1,0,1,0,2,Oilers,0,3,1,0,4,20140406,-1,2,2,2,6,2,2013,0,6,1368,0
Penguins,0,2,0,1,3,Avalanche,0,0,2,0,2,20140406,0,2,0,1,5,-1,2013,1,6,1317,0
Islanders,0,0,0,0,0,Blue Jackets,2,2,0,0,4,20140406,2,4,4,4,4,4,2013,0,6,476,0
Stars,1,1,0,0,2,Panthers,0,2,1,0,3,20140406,-1,0,1,1,5,1,2013,0,6,1110,0
Blues,1,0,1,0,2,Blackhawks,0,2,2,0,4,20140406,-1,1,2,2,6,2,2013,0,6,260,0
Sabres,0,0,2,0,2,Flyers,1,3,1,0,5,20140406,1,4,3,3,7,3,2013,0,6,279,0
Flames,0,0,1,0,1,Devils,0,0,0,0,0,20140407,0,0,1,1,1,-1,2013,0,0,2015,0
Wild,0,1,0,0,1,Jets,0,0,0,0,0,20140407,0,1,1,1,1,-1,2013,0,0,388,0
Ducks,1,1,1,0,3,Canucks,0,0,0,0,0,20140407,1,2,3,3,3,-3,2013,0,0,1076,0
Avalanche,2,0,2,0,4,Oilers,1,0,0,0,1,20140408,1,1,3,3,5,-3,2013,0,1,1036,0
Predators,0,1,1,0,2,Stars,1,1,0,1,3,20140408,1,1,0,1,5,1,2013,1,1,616,0
Capitals,1,2,1,0,4,Blues,0,1,0,0,1,20140408,1,2,3,3,5,-3,2013,0,1,708,0
Bruins,2,1,0,0,3,Wild,2,0,1,1,4,20140408,0,-1,0,1,7,1,2013,1,1,1120,0
Maple Leafs,0,0,0,0,0,Lightning,0,2,1,0,3,20140408,0,2,3,3,3,3,2013,0,1,1096,0
Coyotes,2,0,1,0,3,Blue Jackets,1,1,1,1,4,20140408,-1,0,0,1,7,1,2013,1,1,1664,0
Hurricanes,1,0,0,0,1,Rangers,1,2,1,0,4,20140408,0,2,3,3,5,3,2013,0,1,423,0
Senators,0,1,3,0,4,Islanders,0,0,1,0,1,20140408,0,1,3,3,5,-3,2013,0,1,334,0
Red Wings,0,1,3,0,4,Sabres,0,1,1,0,2,20140408,0,0,2,2,6,-2,2013,0,1,215,0
Flyers,0,4,1,0,5,Panthers,0,0,2,0,2,20140408,0,4,3,3,7,-3,2013,0,1,1021,0
Canadiens,0,0,2,0,2,Blackhawks,0,0,2,1,3,20140409,0,0,0,1,5,1,2013,1,2,732,0
Red Wings,1,1,1,0,3,Penguins,0,2,1,1,4,20140409,-1,0,0,1,7,1,2013,1,2,205,0
Blue Jackets,3,0,0,0,3,Stars,0,0,1,0,1,20140409,3,3,2,2,4,-2,2013,0,2,912,0
Kings,0,2,1,0,3,Flames,1,2,0,1,4,20140409,1,1,0,1,7,1,2013,1,2,1197,0
Sharks,1,1,0,0,2,Ducks,1,3,1,0,5,20140409,0,2,3,3,7,3,2013,0,2,305,0
Blues,0,2,0,0,2,Wild,1,2,1,0,4,20140410,1,1,2,2,6,2,2013,0,3,466,0
Kings,2,1,0,0,3,Oilers,0,0,0,0,0,20140410,2,3,3,3,3,-3,2013,0,3,1368,0
Bruins,1,0,0,0,1,Jets,0,0,1,1,2,20140410,-1,-1,0,1,3,1,2013,1,3,1349,0
Coyotes,0,0,0,0,0,Predators,0,1,1,0,2,20140410,0,1,2,2,2,2,2013,0,3,1442,0
Avalanche,1,0,3,0,4,Canucks,1,0,1,0,2,20140410,0,0,2,2,6,-2,2013,0,3,1105,0
Flyers,0,1,1,0,2,Lightning,1,0,3,0,4,20140410,1,0,2,2,6,2,2013,0,3,928,0
Devils,0,1,0,0,1,Senators,0,1,0,1,2,20140410,0,0,0,1,3,1,2013,1,3,330,0
Islanders,0,2,0,0,2,Canadiens,0,0,0,0,0,20140410,0,2,2,2,2,-2,2013,0,3,343,0
Capitals,1,2,2,0,5,Hurricanes,0,1,1,0,2,20140410,1,2,3,3,7,-3,2013,0,3,233,0
Maple Leafs,0,1,1,0,2,Panthers,1,1,2,0,4,20140410,1,1,2,2,6,2,2013,0,3,1234,0
Sabres,0,1,0,0,1,Rangers,0,1,1,0,2,20140410,0,0,1,1,3,1,2013,0,3,292,0
Avalanche,0,1,0,0,1,Sharks,2,0,3,0,5,20140411,2,1,4,4,6,4,2013,0,4,927,0
Jets,2,1,2,0,5,Flames,0,3,0,0,3,20140411,2,0,2,2,8,-2,2013,0,4,740,0
Islanders,1,0,1,1,3,Devils,2,0,0,0,2,20140411,-1,-1,0,1,5,-1,2013,1,4,8,0
Blue Jackets,0,1,1,0,2,Lightning,0,3,0,0,3,20140411,0,2,1,1,5,1,2013,0,4,830,0
Blues,0,0,0,0,0,Stars,0,2,1,0,3,20140411,0,2,3,3,3,3,2013,0,4,547,0
Blackhawks,0,0,0,0,0,Capitals,2,2,0,0,4,20140411,2,4,4,4,4,4,2013,0,4,594,0
Hurricanes,2,0,0,0,2,Red Wings,0,0,1,0,1,20140411,2,2,1,1,3,-1,2013,0,4,511,0
Sabres,0,1,0,0,1,Bruins,2,1,1,0,4,20140412,2,2,3,3,5,3,2013,0,5,399,0
Ducks,1,1,1,1,4,Kings,1,0,2,0,3,20140412,0,1,0,1,7,-1,2013,1,5,0,0
Canucks,0,1,1,0,2,Oilers,2,2,1,0,5,20140412,2,3,3,3,7,3,2013,0,5,514,0
Sharks,2,0,1,0,3,Coyotes,0,1,1,0,2,20140412,2,1,1,1,5,-1,2013,0,5,614,0
Flyers,1,1,1,1,4,Penguins,1,0,2,0,3,20140412,0,1,0,1,7,-1,2013,1,5,257,0
Blue Jackets,1,1,1,0,3,Panthers,1,1,0,0,2,20140412,0,0,1,1,5,-1,2013,0,5,993,0
Maple Leafs,0,0,0,0,0,Senators,0,1,0,0,1,20140412,0,1,1,1,1,1,2013,0,5,203,0
Rangers,0,0,0,0,0,Canadiens,0,0,0,1,1,20140412,0,0,0,1,1,1,2013,1,5,343,0
Blackhawks,2,1,2,0,5,Predators,1,1,5,0,7,20140412,-1,-1,2,2,12,2,2013,0,5,395,0
Stars,1,0,0,0,1,Coyotes,0,1,1,0,2,20140413,-1,0,1,1,3,1,2013,0,6,884,0
Flames,0,1,0,0,1,Canucks,2,3,0,0,5,20140413,2,4,4,4,6,4,2013,0,6,426,0
Avalanche,1,1,0,0,2,Ducks,0,0,2,1,3,20140413,-1,-2,0,1,5,1,2013,1,6,830,0
Predators,1,4,2,0,7,Wild,2,1,0,0,3,20140413,-1,2,4,4,10,-4,2013,0,6,696,0
Islanders,0,1,2,1,4,Sabres,1,1,1,0,3,20140413,-1,-1,0,1,7,-1,2013,1,6,292,0
Hurricanes,3,1,1,1,6,Flyers,1,3,1,0,5,20140413,2,0,0,1,11,-1,2013,1,6,345,0
Bruins,1,0,1,0,2,Devils,1,0,2,0,3,20140413,0,0,1,1,5,1,2013,0,6,196,0
Red Wings,1,1,1,0,3,Blues,0,0,0,0,0,20140413,1,2,3,3,3,-3,2013,0,6,454,0
Senators,1,1,0,1,3,Penguins,1,1,0,0,2,20140413,0,0,0,1,5,-1,2013,1,6,392,0
Lightning,0,0,0,1,1,Capitals,0,0,0,0,0,20140413,0,0,0,1,1,-1,2013,1,6,818,0
Canadiens,1,1,2,1,5,Lightning,1,1,2,0,4,20140416,0,0,0,1,9,-1,2013,1,2,1311,1
Blue Jackets,2,1,0,0,3,Penguins,1,2,1,0,4,20140416,-1,0,1,1,7,1,2013,0,2,161,1
Stars,0,2,1,0,3,Ducks,3,1,0,0,4,20140416,3,2,1,1,7,1,2013,0,2,1237,1
Kings,0,0,3,0,3,Sharks,3,2,1,0,6,20140417,3,5,3,3,9,3,2013,0,3,305,1
Wild,1,3,0,0,4,Avalanche,1,1,2,1,5,20140417,0,-2,0,1,9,1,2013,1,3,698,1
Flyers,1,0,0,0,1,Rangers,1,0,3,0,4,20140417,0,0,3,3,5,3,2013,0,3,80,1
Blackhawks,3,0,0,0,3,Blues,2,0,1,1,4,20140417,-1,-1,0,1,7,1,2013,1,3,260,1
Canadiens,0,2,2,0,4,Lightning,0,0,1,0,1,20140418,0,2,3,3,5,-3,2013,0,4,1311,1
Stars,1,0,1,0,2,Ducks,1,1,1,0,3,20140418,0,1,1,1,5,1,2013,0,4,1237,1
Red Wings,0,0,1,0,1,Bruins,0,0,0,0,0,20140418,0,0,1,1,1,-1,2013,0,4,611,1
Blackhawks,0,1,2,0,3,Blues,2,0,1,1,4,20140419,2,1,0,1,7,1,2013,1,5,260,1
Blue Jackets,1,1,1,1,4,Penguins,3,0,0,0,3,20140419,-2,-1,0,1,7,-1,2013,1,5,161,1
Wild,1,0,1,0,2,Avalanche,1,2,1,0,4,20140419,0,2,2,2,6,2,2013,0,5,698,1
Flyers,1,2,1,0,4,Rangers,2,0,0,0,2,20140420,-1,1,2,2,6,-2,2013,0,6,80,1
Red Wings,0,1,0,0,1,Bruins,2,1,1,0,4,20140420,2,2,3,3,5,3,2013,0,6,611,1
Lightning,0,1,1,0,2,Canadiens,1,1,1,0,3,20140420,1,1,1,1,5,1,2013,0,6,1311,1
Kings,2,0,0,0,2,Sharks,0,3,4,0,7,20140420,-2,1,5,5,9,5,2013,0,6,305,1
Ducks,0,0,0,0,0,Stars,1,1,1,0,3,20140421,1,2,3,3,3,3,2013,0,0,1237,1
Blues,0,0,0,0,0,Blackhawks,1,0,1,0,2,20140421,1,1,2,2,2,2,2013,0,0,260,1
Penguins,0,1,3,0,4,Blue Jackets,2,0,1,0,3,20140421,-2,-1,1,1,7,-1,2013,0,0,161,1
Avalanche,0,0,0,0,0,Wild,0,0,0,1,1,20140421,0,0,0,1,1,1,2013,1,0,698,1
Bruins,2,0,1,0,3,Red Wings,0,0,0,0,0,20140422,2,2,3,3,3,-3,2013,0,1,611,1
Rangers,2,1,1,0,4,Flyers,1,0,0,0,1,20140422,1,2,3,3,5,-3,2013,0,1,80,1
Sharks,1,1,1,1,4,Kings,0,2,1,0,3,20140422,1,0,0,1,7,-1,2013,1,1,305,1
Lightning,0,1,2,0,3,Canadiens,2,1,1,0,4,20140422,2,2,1,1,7,1,2013,0,1,1311,1
Penguins,3,0,0,0,3,Blue Jackets,1,1,1,1,4,20140423,-2,-1,0,1,7,1,2013,1,2,161,1
Ducks,2,0,0,0,2,Stars,0,2,2,0,4,20140423,-2,0,2,2,6,2,2013,0,2,1237,1
Blues,0,2,1,0,3,Blackhawks,0,2,1,1,4,20140423,0,0,0,1,7,1,2013,1,2,260,1
Bruins,0,1,1,1,3,Red Wings,1,1,0,0,2,20140424,-1,-1,0,1,5,-1,2013,1,3,611,1
Avalanche,0,1,0,0,1,Wild,1,1,0,0,2,20140424,1,1,1,1,3,1,2013,0,3,698,1
Sharks,1,1,1,0,3,Kings,1,3,2,0,6,20140424,0,2,3,3,9,3,2013,0,3,305,1
Blackhawks,1,1,0,1,3,Blues,0,1,1,0,2,20140425,1,1,0,1,5,-1,2013,1,4,260,1
Stars,1,1,0,0,2,Ducks,2,1,3,0,6,20140425,1,1,4,4,8,4,2013,0,4,1237,1
Rangers,1,0,0,0,1,Flyers,1,1,0,0,2,20140425,0,1,1,1,3,1,2013,0,4,80,1
Red Wings,0,1,1,0,2,Bruins,1,1,2,0,4,20140426,1,1,2,2,6,2,2013,0,5,611,1
Wild,0,1,2,0,3,Avalanche,0,2,1,1,4,20140426,0,1,0,1,7,1,2013,1,5,698,1
Kings,2,1,0,0,3,Sharks,0,0,0,0,0,20140426,2,3,3,3,3,-3,2013,0,5,305,1
Blue Jackets,1,0,0,0,1,Penguins,0,1,2,0,3,20140426,-1,0,2,2,4,2,2013,0,5,161,1
Flyers,0,1,1,0,2,Rangers,1,2,1,0,4,20140427,1,2,2,2,6,2,2013,0,6,80,1
Blues,1,0,0,0,1,Blackhawks,1,0,4,0,5,20140427,0,0,4,4,6,4,2013,0,6,260,1
Ducks,1,1,2,1,5,Stars,3,1,0,0,4,20140427,-2,-2,0,1,9,-1,2013,1,6,1237,1
Penguins,2,2,0,0,4,Blue Jackets,0,0,3,0,3,20140428,2,4,1,1,7,-1,2013,0,0,161,1
Avalanche,1,1,0,0,2,Wild,2,0,3,0,5,20140428,1,0,3,3,7,3,2013,0,0,698,1
Sharks,0,1,0,0,1,Kings,1,0,3,0,4,20140428,1,0,3,3,5,3,2013,0,0,305,1
Rangers,0,0,2,0,2,Flyers,1,3,1,0,5,20140429,1,4,3,3,7,3,2013,0,1,80,1
Flyers,0,0,1,0,1,Rangers,0,2,0,0,2,20140430,0,2,1,1,3,1,2013,0,2,80,1
Wild,1,1,2,1,5,Avalanche,2,0,2,0,4,20140430,-1,0,0,1,9,-1,2013,1,2,698,1
Kings,0,2,3,0,5,Sharks,0,1,0,0,1,20140430,0,1,4,4,6,-4,2013,0,2,305,1
Canadiens,1,1,1,1,4,Bruins,0,0,3,0,3,20140501,1,2,0,1,7,-1,2013,1,3,270,1
Rangers,2,0,0,1,3,Penguins,0,2,0,0,2,20140502,2,0,0,1,5,-1,2013,1,4,314,1
Wild,0,0,2,0,2,Blackhawks,1,1,3,0,5,20140502,1,2,3,3,7,3,2013,0,4,355,1
Canadiens,0,2,1,0,3,Bruins,1,0,4,0,5,20140503,1,-1,2,2,8,2,2013,0,5,270,1
Kings,1,0,1,1,3,Ducks,1,0,1,0,2,20140503,0,0,0,1,5,-1,2013,1,5,0,1
Rangers,0,0,0,0,0,Penguins,0,1,2,0,3,20140504,0,1,3,3,3,3,2013,0,6,314,1
Wild,0,0,1,0,1,Blackhawks,1,1,2,0,4,20140504,1,2,3,3,5,3,2013,0,6,355,1
Penguins,0,2,0,0,2,Rangers,0,0,0,0,0,20140505,0,2,2,2,2,-2,2013,0,0,314,1
Kings,2,0,1,0,3,Ducks,1,0,0,0,1,20140505,1,1,2,2,4,-2,2013,0,0,0,1
Bruins,0,1,1,0,2,Canadiens,2,1,1,0,4,20140506,2,2,2,2,6,2,2013,0,1,270,1
Blackhawks,0,0,0,0,0,Wild,0,0,4,0,4,20140506,0,0,4,4,4,4,2013,0,1,355,1
Penguins,1,1,2,0,4,Rangers,0,1,1,0,2,20140507,1,1,2,2,6,-2,2013,0,2,314,1
Bruins,0,0,0,1,1,Canadiens,0,0,0,0,0,20140508,0,0,0,1,1,-1,2013,1,3,270,1
Ducks,1,1,1,0,3,Kings,0,1,1,0,2,20140508,1,1,1,1,5,-1,2013,0,3,0,1
Rangers,2,2,1,0,5,Penguins,0,1,0,0,1,20140509,2,3,4,4,6,-4,2013,0,4,314,1
Blackhawks,1,1,0,0,2,Wild,1,2,1,0,4,20140509,0,1,2,2,6,2,2013,0,4,355,1
Canadiens,0,1,1,0,2,Bruins,1,2,1,0,4,20140510,1,2,2,2,6,2,2013,0,5,270,1
Ducks,2,0,0,0,2,Kings,0,0,0,0,0,20140510,2,2,2,2,2,-2,2013,0,5,0,1
Wild,1,0,0,0,1,Blackhawks,0,1,1,0,2,20140511,-1,0,1,1,3,1,2013,0,6,355,1
Penguins,1,0,0,0,1,Rangers,2,1,0,0,3,20140511,1,2,2,2,4,2,2013,0,6,314,1
Bruins,0,0,0,0,0,Canadiens,1,2,1,0,4,20140512,1,3,4,4,4,4,2013,0,0,270,1
Kings,1,1,1,0,3,Ducks,1,3,0,0,4,20140512,0,2,1,1,7,1,2013,0,0,0,1
Rangers,1,1,0,0,2,Penguins,0,1,0,0,1,20140513,1,1,1,1,3,-1,2013,0,1,314,1
Blackhawks,1,0,0,1,2,Wild,0,1,0,0,1,20140513,1,0,0,1,3,-1,2013,1,1,355,1
Canadiens,1,1,1,0,3,Bruins,0,1,0,0,1,20140514,1,1,2,2,4,-2,2013,0,2,270,1
Ducks,0,1,0,0,1,Kings,1,1,0,0,2,20140514,1,1,1,1,3,1,2013,0,2,0,1
Kings,3,2,1,0,6,Ducks,0,1,1,0,2,20140516,3,4,4,4,8,-4,2013,0,4,0,1
Rangers,2,2,3,0,7,Canadiens,0,1,1,0,2,20140517,2,3,5,5,9,-5,2013,0,5,343,1
Kings,0,1,0,0,1,Blackhawks,1,1,1,0,3,20140518,1,1,2,2,4,2,2013,0,6,1741,1
Rangers,2,1,0,0,3,Canadiens,1,0,0,0,1,20140519,1,2,2,2,4,-2,2013,0,0,343,1
Kings,0,1,5,0,6,Blackhawks,1,1,0,0,2,20140521,-1,-1,4,4,8,-4,2013,0,2,1741,1
Canadiens,0,1,1,1,3,Rangers,1,0,1,0,2,20140522,-1,0,0,1,5,-1,2013,1,3,343,1
Blackhawks,2,0,1,0,3,Kings,1,2,1,0,4,20140524,-1,1,1,1,7,1,2013,0,5,1741,1
Canadiens,0,1,1,0,2,Rangers,1,1,0,1,3,20140525,1,1,0,1,5,1,2013,1,6,343,1
Blackhawks,0,1,1,0,2,Kings,3,1,1,0,5,20140526,3,3,3,3,7,3,2013,0,0,1741,1
Rangers,1,3,0,0,4,Canadiens,2,3,2,0,7,20140527,1,1,3,3,11,3,2013,0,1,343,1
Kings,2,2,0,0,4,Blackhawks,3,0,1,1,5,20140528,1,-1,0,1,9,1,2013,1,2,1741,1
Canadiens,0,0,0,0,0,Rangers,0,1,0,0,1,20140529,0,1,1,1,1,1,2013,0,3,343,1
Blackhawks,0,2,2,0,4,Kings,1,0,2,0,3,20140530,-1,1,1,1,7,-1,2013,0,4,1741,1
Kings,2,1,1,1,5,Blackhawks,3,1,0,0,4,20140601,-1,-1,0,1,9,-1,2013,1,6,1741,1
Rangers,2,0,0,0,2,Kings,1,1,0,1,3,20140604,-1,0,0,1,5,1,2013,1,2,2445,1
Rangers,2,2,0,0,4,Kings,0,2,2,1,5,20140607,-2,-2,0,1,9,1,2013,1,5,2445,1
Kings,1,2,0,0,3,Rangers,0,0,0,0,0,20140609,1,3,3,3,3,-3,2013,0,0,2445,1
Kings,0,1,0,0,1,Rangers,1,1,0,0,2,20140611,1,1,1,1,3,1,2013,0,2,2445,1
Rangers,0,2,0,0,2,Kings,1,0,1,1,3,20140613,1,-1,0,1,5,1,2013,1,4,2445,1
Canucks,1,2,1,0,4,Flames,0,2,0,0,2,20141008,1,1,2,2,6,-2,2014,0,2,426,0
Sharks,1,3,0,0,4,Kings,0,0,0,0,0,20141008,1,4,4,4,4,-4,2014,0,2,305,0
Canadiens,1,1,2,0,4,Maple Leafs,2,0,1,0,3,20141008,-1,0,1,1,7,-1,2014,0,2,303,0
Flyers,0,0,1,0,1,Bruins,1,0,1,0,2,20141008,1,1,1,1,3,1,2014,0,2,270,0
Blackhawks,1,0,1,1,3,Stars,0,2,0,0,2,20141009,1,-1,0,1,5,-1,2014,1,3,802,0
Blue Jackets,0,1,2,0,3,Sabres,0,1,0,0,1,20141009,0,0,2,2,4,-2,2014,0,3,293,0
Canadiens,0,0,1,1,2,Capitals,1,0,0,0,1,20141009,-1,-1,0,1,3,-1,2014,1,3,495,0
Devils,1,2,3,0,6,Flyers,0,3,1,0,4,20141009,1,0,2,2,10,-2,2014,0,3,75,0
Ducks,1,2,1,0,4,Penguins,3,2,1,0,6,20141009,2,2,2,2,10,2,2014,0,3,2132,0
Bruins,1,0,0,0,1,Red Wings,0,2,0,0,2,20141009,-1,1,1,1,3,1,2014,0,3,611,0
Panthers,0,1,1,0,2,Lightning,0,1,1,1,3,20141009,0,0,0,1,5,1,2014,1,3,205,0
Senators,0,1,1,0,2,Predators,0,0,3,0,3,20141009,0,-1,1,1,5,1,2014,0,3,845,0
Rangers,1,0,2,0,3,Blues,0,0,2,0,2,20141009,1,1,1,1,5,-1,2014,0,3,871,0
Avalanche,0,0,0,0,0,Wild,1,4,0,0,5,20141009,1,5,5,5,5,5,2014,0,3,698,0
Flames,2,0,3,0,5,Oilers,1,1,0,0,2,20141009,1,0,3,3,7,-3,2014,0,3,171,0
Jets,4,1,1,0,6,Coyotes,1,0,1,0,2,20141009,3,4,4,4,8,-4,2014,0,3,1365,0
Islanders,2,1,2,0,5,Hurricanes,0,0,3,0,3,20141010,2,3,2,2,8,-2,2014,0,4,423,0
Stars,1,0,0,0,1,Predators,0,1,3,0,4,20141011,-1,0,3,3,5,3,2014,0,5,616,0
Sabres,2,0,0,0,2,Blackhawks,2,0,4,0,6,20141011,0,0,4,4,8,4,2014,0,5,453,0
Jets,0,0,0,0,0,Sharks,2,1,0,0,3,20141011,2,3,3,3,3,3,2014,0,5,1496,0
Oilers,2,2,0,0,4,Canucks,1,2,1,1,5,20141011,-1,-1,0,1,9,1,2014,1,5,514,0
Flames,0,0,1,0,1,Blues,2,2,0,0,4,20141011,2,4,3,3,5,3,2014,0,5,1440,0
Kings,2,0,0,0,2,Coyotes,1,1,0,1,3,20141011,-1,0,0,1,5,1,2014,1,5,356,0
Rangers,0,1,1,0,2,Blue Jackets,2,1,2,0,5,20141011,2,2,3,3,7,3,2014,0,5,476,0
Wild,1,1,1,0,3,Avalanche,0,0,0,0,0,20141011,1,2,3,3,3,-3,2014,0,5,698,0
Devils,4,1,0,0,5,Panthers,0,1,0,0,1,20141011,4,4,4,4,6,-4,2014,0,5,1090,0
Senators,0,0,2,1,3,Lightning,1,0,1,0,2,20141011,-1,-1,0,1,5,-1,2014,1,5,1251,0
Canadiens,0,0,3,1,4,Flyers,2,1,0,0,3,20141011,-2,-3,0,1,7,-1,2014,1,5,400,0
Penguins,3,1,1,0,5,Maple Leafs,0,1,1,0,2,20141011,3,3,3,3,7,-3,2014,0,5,222,0
Hurricanes,2,0,1,0,3,Islanders,2,2,0,0,4,20141011,0,2,1,1,7,1,2014,0,5,423,0
Capitals,2,1,1,0,4,Bruins,0,0,0,0,0,20141011,2,3,4,4,4,-4,2014,0,5,394,0
Ducks,0,1,2,0,3,Red Wings,0,1,1,0,2,20141011,0,0,1,1,5,-1,2014,0,5,1979,0
Jets,0,1,0,0,1,Kings,2,2,0,0,4,20141012,2,3,3,3,5,3,2014,0,6,1527,0
Maple Leafs,1,5,0,0,6,Rangers,1,1,1,0,3,20141012,0,4,3,3,9,-3,2014,0,6,341,0
Avalanche,0,1,1,0,2,Bruins,0,1,0,0,1,20141013,0,0,1,1,3,-1,2014,0,0,1765,0
Ducks,1,1,3,0,5,Sabres,0,0,1,0,1,20141013,1,2,4,4,6,-4,2014,0,0,2193,0
Senators,0,1,0,0,1,Panthers,0,0,0,0,0,20141013,0,1,1,1,1,-1,2014,0,0,1370,0
Canadiens,1,0,0,0,1,Lightning,2,2,3,0,7,20141013,1,3,6,6,8,6,2014,0,0,1311,0
Flames,1,1,0,1,3,Predators,1,1,0,0,2,20141014,0,0,0,1,5,-1,2014,1,1,1692,0
Devils,0,1,1,0,2,Lightning,0,0,1,0,1,20141014,0,1,1,1,3,-1,2014,0,1,1000,0
Oilers,0,0,1,0,1,Kings,3,2,1,0,6,20141014,3,5,5,5,7,5,2014,0,1,1368,0
Avalanche,1,1,0,0,2,Maple Leafs,1,0,1,1,3,20141014,0,-1,0,1,5,1,2014,1,1,1341,0
Sabres,1,1,1,1,4,Hurricanes,0,1,2,0,3,20141014,1,1,0,1,7,-1,2014,1,1,491,0
Ducks,2,1,0,1,4,Flyers,0,2,1,0,3,20141014,2,1,0,1,7,-1,2014,1,1,2388,0
Sharks,3,1,1,1,6,Capitals,0,3,2,0,5,20141014,3,1,0,1,11,-1,2014,1,1,2416,0
Islanders,1,1,4,0,6,Rangers,1,1,1,0,3,20141014,0,0,3,3,9,-3,2014,0,1,0,0
Stars,2,0,2,0,4,Blue Jackets,0,2,0,0,2,20141014,2,0,2,2,6,-2,2014,0,1,912,0
Bruins,1,1,0,1,3,Red Wings,1,0,1,0,2,20141015,0,1,0,1,5,-1,2014,1,2,611,0
Flames,0,1,0,1,2,Blackhawks,0,0,1,0,1,20141015,0,1,0,1,3,-1,2014,1,2,1397,0
Oilers,2,0,2,0,4,Coyotes,2,2,3,0,7,20141015,0,2,3,3,11,3,2014,0,2,1392,0
Blues,0,0,0,0,0,Kings,0,0,0,1,1,20141016,0,0,0,1,1,1,2014,1,3,1586,0
Sharks,0,2,1,0,3,Islanders,0,1,2,1,4,20141016,0,-1,0,1,7,1,2014,1,3,2549,0
Hurricanes,0,1,0,0,1,Rangers,0,0,1,1,2,20141016,0,-1,0,1,3,1,2014,1,3,423,0
Bruins,1,2,1,0,4,Canadiens,1,3,2,0,6,20141016,0,1,2,2,10,2,2014,0,3,270,0
Avalanche,3,0,0,0,3,Senators,1,1,3,0,5,20141016,-2,-1,2,2,8,2,2014,0,3,1515,0
Devils,2,0,0,0,2,Capitals,2,1,3,0,6,20141016,0,1,4,4,8,4,2014,0,3,198,0
Stars,0,1,2,0,3,Penguins,2,0,0,0,2,20141016,-2,-1,1,1,5,-1,2014,0,3,1069,0
Canucks,0,1,1,0,2,Oilers,0,0,0,0,0,20141017,0,1,2,2,2,-2,2014,0,4,514,0
Wild,0,1,0,0,1,Ducks,0,0,2,0,2,20141017,0,-1,1,1,3,1,2014,0,4,1521,0
Predators,1,0,1,0,2,Jets,0,0,0,0,0,20141017,1,1,2,2,2,-2,2014,0,4,1084,0
Red Wings,1,2,1,0,4,Maple Leafs,0,0,1,0,1,20141017,1,3,3,3,5,-3,2014,0,4,205,0
Flames,0,0,2,0,2,Blue Jackets,2,1,0,0,3,20141017,2,3,1,1,5,1,2014,0,4,1670,0
Panthers,0,1,0,0,1,Sabres,0,0,0,0,0,20141017,0,1,1,1,1,-1,2014,0,4,1184,0
Lightning,2,1,1,0,4,Canucks,1,1,0,0,2,20141018,1,1,2,2,6,-2,2014,0,5,2598,0
Blues,1,2,3,0,6,Coyotes,0,0,1,0,1,20141018,1,3,5,5,7,-5,2014,0,5,1270,0
Flyers,2,0,3,1,6,Stars,1,3,1,0,5,20141018,1,-2,0,1,11,-1,2014,1,5,1297,0
Islanders,1,0,0,0,1,Penguins,0,2,1,0,3,20141018,-1,1,2,2,4,2,2014,0,5,314,0
Sharks,1,1,2,0,4,Devils,0,0,2,0,2,20141018,1,2,2,2,6,-2,2014,0,5,2540,0
Predators,1,0,0,0,1,Blackhawks,1,0,0,1,2,20141018,0,0,0,1,3,1,2014,1,5,395,0
Blue Jackets,0,2,0,0,2,Senators,1,1,1,0,3,20141018,1,0,1,1,5,1,2014,0,5,512,0
Avalanche,1,0,1,0,2,Canadiens,0,3,0,0,3,20141018,-1,2,1,1,5,1,2014,0,5,1618,0
Maple Leafs,0,0,0,0,0,Red Wings,0,0,0,1,1,20141018,0,0,0,1,1,1,2014,1,5,205,0
Bruins,2,2,0,0,4,Sabres,0,0,0,0,0,20141018,2,4,4,4,4,-4,2014,0,5,399,0
Panthers,0,0,1,0,1,Capitals,1,0,0,1,2,20141018,1,1,0,1,3,1,2014,1,5,924,0
Wild,0,0,1,0,1,Kings,1,0,1,0,2,20141019,1,1,1,1,3,1,2014,0,6,1521,0
Sharks,0,0,0,0,0,Rangers,0,3,1,0,4,20141019,0,3,4,4,4,4,2014,0,6,2549,0
Flames,0,3,1,0,4,Jets,1,0,0,0,1,20141019,-1,2,3,3,5,-3,2014,0,6,740,0
Blues,0,0,0,0,0,Ducks,2,1,0,0,3,20141019,2,3,3,3,3,3,2014,0,6,1586,0
Lightning,0,1,1,0,2,Oilers,0,2,1,0,3,20141020,0,1,1,1,5,1,2014,0,0,2367,0
Coyotes,1,1,1,0,3,Predators,1,1,1,1,4,20141021,0,0,0,1,7,1,2014,1,1,1442,0
Lightning,0,0,1,1,2,Flames,0,0,1,0,1,20141021,0,0,0,1,3,-1,2014,1,1,2289,0
Canucks,0,2,1,0,3,Stars,3,3,0,0,6,20141021,3,4,3,3,9,3,2014,0,1,1766,0
Flyers,0,0,0,0,0,Blackhawks,3,0,1,0,4,20141021,3,3,4,4,4,4,2014,0,1,664,0
Hurricanes,1,0,0,0,1,Jets,2,1,0,0,3,20141021,1,2,2,2,4,2,2014,0,1,1350,0
Panthers,2,1,0,1,4,Avalanche,0,3,0,0,3,20141021,2,0,0,1,7,-1,2014,1,1,1724,0
Rangers,1,0,2,1,4,Devils,1,1,1,0,3,20141021,0,-1,0,1,7,-1,2014,1,1,8,0
Maple Leafs,1,4,0,0,5,Islanders,2,0,0,0,2,20141021,-1,3,3,3,7,-3,2014,0,1,341,0
Sharks,1,2,0,0,3,Bruins,1,1,3,0,5,20141021,0,-1,2,2,8,2,2014,0,1,2678,0
Red Wings,0,1,0,0,1,Canadiens,0,0,1,1,2,20141021,0,-1,0,1,3,1,2014,1,1,508,0
Flyers,2,0,3,0,5,Penguins,1,1,1,0,3,20141022,1,0,2,2,8,-2,2014,0,2,257,0
Capitals,1,1,0,0,2,Oilers,1,2,0,0,3,20141022,0,1,1,1,5,1,2014,0,2,1985,0
Sabres,0,0,1,0,1,Ducks,1,1,2,0,4,20141022,1,2,3,3,5,3,2014,0,2,2193,0
Blue Jackets,0,3,2,0,5,Sharks,2,0,2,0,4,20141023,-2,1,1,1,9,-1,2014,0,3,2090,0
Sabres,0,0,0,0,0,Kings,1,1,0,0,2,20141023,1,2,2,2,2,2,2014,0,3,2193,0
Hurricanes,0,0,0,0,0,Flames,1,2,2,0,5,20141023,1,3,5,5,5,5,2014,0,3,2038,0
Coyotes,0,0,0,0,0,Wild,0,2,0,0,2,20141023,0,2,2,2,2,2,2014,0,3,1278,0
Islanders,1,2,0,0,3,Bruins,1,0,1,0,2,20141023,0,2,1,1,5,-1,2014,0,3,190,0
Blackhawks,1,0,1,0,2,Predators,1,1,1,0,3,20141023,0,1,1,1,5,1,2014,0,3,395,0
Penguins,2,1,0,0,3,Red Wings,1,0,2,1,4,20141023,-1,-2,0,1,7,1,2014,1,3,205,0
Canucks,1,0,3,0,4,Blues,0,1,0,0,1,20141023,1,0,3,3,5,-3,2014,0,3,1778,0
Hurricanes,0,2,1,0,3,Oilers,0,2,4,0,6,20141024,0,0,3,3,9,3,2014,0,4,2076,0
Blue Jackets,1,0,0,0,1,Ducks,2,1,1,0,4,20141024,1,2,3,3,5,3,2014,0,4,1973,0
Canucks,2,0,1,0,3,Avalanche,1,2,4,0,7,20141024,-1,1,4,4,10,4,2014,0,4,1105,0
Stars,0,2,0,1,3,Devils,1,0,1,0,2,20141024,-1,1,0,1,5,-1,2014,1,4,1362,0
Lightning,1,3,0,0,4,Jets,0,1,1,0,2,20141024,1,3,2,2,6,-2,2014,0,4,1705,0
Capitals,1,1,1,0,3,Flames,1,0,0,0,1,20141025,0,1,2,2,4,-2,2014,0,5,1967,0
Sabres,0,0,2,0,2,Sharks,0,0,1,0,1,20141025,0,0,1,1,3,-1,2014,0,5,2279,0
Bruins,1,1,2,0,4,Maple Leafs,0,0,1,0,1,20141025,1,2,3,3,5,-3,2014,0,5,430,0
Rangers,1,0,0,0,1,Canadiens,1,1,1,0,3,20141025,0,1,2,2,4,2,2014,0,5,343,0
Devils,0,2,0,1,3,Senators,0,1,1,0,2,20141025,0,1,0,1,5,-1,2014,1,5,330,0
Red Wings,1,0,1,0,2,Flyers,0,1,3,0,4,20141025,-1,0,2,2,6,2,2014,0,5,441,0
Stars,1,3,1,0,5,Islanders,2,2,3,0,7,20141025,1,0,2,2,12,2,2014,0,5,1370,0
Lightning,1,1,0,0,2,Wild,4,2,1,0,7,20141025,3,4,5,5,9,5,2014,0,5,1318,0
Penguins,1,0,2,0,3,Predators,0,0,0,0,0,20141025,1,1,3,3,3,-3,2014,0,5,471,0
Blackhawks,1,0,1,0,2,Blues,1,2,0,0,3,20141025,0,2,1,1,5,1,2014,0,5,260,0
Panthers,0,0,1,0,1,Coyotes,0,0,1,1,2,20141025,0,0,0,1,3,1,2014,1,5,1978,0
Senators,0,1,0,0,1,Blackhawks,0,2,0,0,2,20141026,0,1,1,1,3,1,2014,0,6,628,0
Blue Jackets,1,1,0,0,2,Kings,0,3,2,0,5,20141026,-1,1,3,3,7,3,2014,0,6,1973,0
Capitals,0,2,0,0,2,Canucks,0,3,1,0,4,20141026,0,1,2,2,6,2,2014,0,6,2359,0
Sharks,2,1,1,0,4,Ducks,0,0,1,0,1,20141026,2,3,3,3,5,-3,2014,0,6,305,0
Avalanche,1,0,0,0,1,Jets,1,0,0,1,2,20141026,0,0,0,1,3,1,2014,1,6,797,0
Canadiens,0,0,0,0,0,Oilers,1,1,1,0,3,20141027,1,2,3,3,3,3,2014,0,0,1826,0
Wild,0,3,1,0,4,Rangers,0,0,5,0,5,20141027,0,-3,1,1,9,1,2014,0,0,1016,0
Hurricanes,0,0,1,0,1,Canucks,1,2,1,0,4,20141028,1,3,3,3,5,3,2014,0,1,2409,0
Sharks,1,0,1,1,3,Avalanche,0,1,1,0,2,20141028,1,0,0,1,5,-1,2014,1,1,927,0
Canadiens,0,1,0,1,2,Flames,0,1,0,0,1,20141028,0,0,0,1,3,-1,2014,1,1,1852,0
Ducks,0,0,1,0,1,Blackhawks,0,0,0,0,0,20141028,0,0,1,1,1,-1,2014,0,1,1741,0
Coyotes,0,2,1,0,3,Lightning,2,2,3,0,7,20141028,2,2,4,4,10,4,2014,0,1,1793,0
Sabres,0,0,0,0,0,Maple Leafs,0,1,3,0,4,20141028,0,1,4,4,4,4,2014,0,1,57,0
Blues,1,1,1,1,4,Stars,1,1,1,0,3,20141028,0,0,0,1,7,-1,2014,1,1,547,0
Jets,0,3,1,0,4,Islanders,1,2,0,0,3,20141028,-1,0,1,1,7,-1,2014,0,1,1287,0
Devils,1,2,0,0,3,Penguins,1,4,3,0,8,20141028,0,2,5,5,11,5,2014,0,1,306,0
Senators,1,1,3,0,5,Blue Jackets,1,1,0,0,2,20141028,0,0,3,3,7,-3,2014,0,1,512,0
Wild,1,0,3,0,4,Bruins,1,2,0,0,3,20141028,0,-2,1,1,7,-1,2014,0,1,1120,0
Kings,1,0,1,0,2,Flyers,2,0,0,1,3,20141028,1,1,0,1,5,1,2014,1,1,2388,0
Red Wings,0,1,3,0,4,Capitals,0,2,0,0,2,20141029,0,-1,2,2,6,-2,2014,0,2,394,0
Predators,0,2,2,0,4,Oilers,0,0,1,0,1,20141029,0,2,3,3,5,-3,2014,0,2,1758,0
Coyotes,1,0,0,0,1,Panthers,0,1,1,0,2,20141030,-1,0,1,1,3,1,2014,0,3,1978,0
Islanders,0,0,0,0,0,Avalanche,1,3,1,0,5,20141030,1,4,5,5,5,5,2014,0,3,1627,0
Sharks,1,1,1,0,3,Wild,0,1,2,1,4,20141030,-1,-1,0,1,7,1,2014,1,3,1570,0
Ducks,0,0,0,0,0,Blues,1,0,1,0,2,20141030,1,1,2,2,2,2,2014,0,3,1586,0
Flyers,1,0,2,0,3,Lightning,1,1,2,0,4,20141030,0,1,1,1,7,1,2014,0,3,928,0
Canadiens,0,0,2,0,2,Canucks,0,1,1,1,3,20141030,0,1,0,1,5,1,2014,1,3,2273,0
Kings,0,0,0,0,0,Penguins,2,0,1,0,3,20141030,2,2,3,3,3,3,2014,0,3,2132,0
Jets,1,0,0,0,1,Devils,0,0,1,1,2,20141030,-1,-1,0,1,3,1,2014,1,3,1280,0
Bruins,0,1,1,1,3,Sabres,0,2,0,0,2,20141030,0,-1,0,1,5,-1,2014,1,3,399,0
Blackhawks,2,0,2,1,5,Senators,1,1,2,0,4,20141030,1,0,0,1,9,-1,2014,1,3,628,0
Predators,0,2,1,0,3,Flames,0,1,3,0,4,20141031,0,-1,1,1,7,1,2014,0,4,1692,0
Ducks,0,1,0,1,2,Stars,0,0,1,0,1,20141031,0,1,0,1,3,-1,2014,1,4,1237,0
Kings,0,1,1,0,2,Red Wings,4,0,1,0,5,20141031,4,3,3,3,7,3,2014,0,4,1979,0
Maple Leafs,1,1,2,0,4,Blue Jackets,0,0,1,0,1,20141031,1,2,3,3,5,-3,2014,0,4,313,0
Islanders,1,0,0,0,1,Sharks,1,0,2,0,3,20141101,0,0,2,2,4,2,2014,0,5,2549,0
Canucks,1,1,1,0,3,Oilers,1,1,0,0,2,20141101,0,0,1,1,5,-1,2014,0,5,514,0
Avalanche,0,0,2,0,2,Blues,1,0,1,1,3,20141101,1,1,0,1,5,1,2014,1,5,794,0
Coyotes,0,0,0,0,0,Hurricanes,2,1,0,0,3,20141101,2,3,3,3,3,3,2014,0,5,1898,0
Jets,0,0,0,1,1,Rangers,0,0,0,0,0,20141101,0,0,0,1,1,-1,2014,1,5,1287,0
Blue Jackets,1,1,0,0,2,Devils,0,1,2,0,3,20141101,-1,-1,1,1,5,1,2014,0,5,467,0
Stars,0,1,0,0,1,Wild,0,3,1,0,4,20141101,0,2,3,3,5,3,2014,0,5,863,0
Capitals,1,2,0,0,3,Lightning,1,2,1,0,4,20141101,0,0,1,1,7,1,2014,0,5,818,0
Blackhawks,1,1,0,0,2,Maple Leafs,1,1,1,0,3,20141101,0,0,1,1,5,1,2014,0,5,436,0
Sabres,0,0,0,0,0,Penguins,1,2,2,0,5,20141101,1,3,5,5,5,5,2014,0,5,178,0
Senators,1,0,1,0,2,Bruins,1,2,1,0,4,20141101,0,2,2,2,6,2,2014,0,5,320,0
Flyers,0,0,1,0,1,Panthers,1,0,1,0,2,20141101,1,1,1,1,3,1,2014,0,5,1021,0
Red Wings,0,1,1,0,2,Sabres,0,1,1,1,3,20141102,0,0,0,1,5,1,2014,1,6,215,0
Kings,0,1,1,0,2,Hurricanes,1,2,0,0,3,20141102,1,2,1,1,5,1,2014,0,6,2231,0
Flames,2,1,3,0,6,Canadiens,0,0,2,0,2,20141102,2,3,4,4,8,-4,2014,0,6,1852,0
Coyotes,1,2,3,0,6,Capitals,3,0,2,0,5,20141102,-2,0,1,1,11,-1,2014,0,6,1977,0
Ducks,1,2,0,0,3,Avalanche,2,0,0,0,2,20141102,-1,1,1,1,5,-1,2014,0,6,830,0
Jets,1,0,0,0,1,Blackhawks,0,0,0,0,0,20141102,1,1,1,1,1,-1,2014,0,6,722,0
Predators,0,1,2,0,3,Canucks,1,0,0,0,1,20141102,-1,0,2,2,4,-2,2014,0,6,2030,0
Blues,0,1,2,1,4,Rangers,1,0,2,0,3,20141103,-1,0,0,1,7,-1,2014,1,0,871,0
Predators,0,1,0,0,1,Jets,2,0,1,0,3,20141104,2,1,2,2,4,2,2014,0,1,1084,0
Kings,0,1,2,0,3,Stars,1,0,0,0,1,20141104,-1,0,2,2,4,-2,2014,0,1,1237,0
Maple Leafs,0,1,1,0,2,Coyotes,2,1,0,0,3,20141104,2,2,1,1,5,1,2014,0,1,1885,0
Blues,0,0,1,0,1,Devils,0,0,0,0,0,20141104,0,0,1,1,1,-1,2014,0,1,863,0
Canucks,0,1,4,0,5,Avalanche,2,0,0,0,2,20141104,-2,-1,3,3,7,-3,2014,0,1,1105,0
Red Wings,0,0,1,0,1,Senators,0,1,2,0,3,20141104,0,1,2,2,4,2,2014,0,1,406,0
Penguins,1,2,1,0,4,Wild,0,0,1,0,1,20141104,1,3,3,3,5,-3,2014,0,1,741,0
Hurricanes,2,1,1,0,4,Blue Jackets,1,0,1,0,2,20141104,1,2,2,2,6,-2,2014,0,1,374,0
Panthers,0,1,0,0,1,Bruins,0,1,0,1,2,20141104,0,0,0,1,3,1,2014,1,1,1257,0
Oilers,0,1,0,0,1,Flyers,2,2,0,0,4,20141104,2,3,3,3,5,3,2014,0,1,2011,0
Blackhawks,1,1,3,0,5,Canadiens,0,0,0,0,0,20141104,1,2,5,5,5,-5,2014,0,1,732,0
Flames,1,1,1,1,4,Capitals,1,2,0,0,3,20141104,0,-1,0,1,7,-1,2014,1,1,1967,0
Canadiens,0,0,1,1,2,Sabres,0,0,1,0,1,20141105,0,0,0,1,3,-1,2014,1,2,311,0
Red Wings,0,2,1,0,3,Rangers,1,1,1,1,4,20141105,1,0,0,1,7,1,2014,1,2,480,0
Islanders,1,1,0,1,3,Ducks,0,2,0,0,2,20141105,1,0,0,1,5,-1,2014,1,2,2445,0
Maple Leafs,1,1,1,0,3,Avalanche,1,1,1,1,4,20141106,0,0,0,1,7,1,2014,1,3,1341,0
Canucks,1,2,0,0,3,Sharks,1,1,0,0,2,20141106,0,1,1,1,5,-1,2014,0,3,821,0
Islanders,1,0,0,1,2,Kings,1,0,0,0,1,20141106,0,0,0,1,3,-1,2014,1,3,2445,0
Predators,0,2,1,0,3,Stars,0,1,1,0,2,20141106,0,1,1,1,5,-1,2014,0,3,616,0
Devils,0,0,3,0,3,Blues,1,1,2,0,4,20141106,1,2,1,1,7,1,2014,0,3,863,0
Penguins,1,2,0,1,4,Jets,1,1,1,0,3,20141106,0,1,0,1,7,-1,2014,1,3,1060,0
Wild,0,0,0,0,0,Senators,0,2,1,0,3,20141106,0,2,3,3,3,3,2014,0,3,838,0
Panthers,0,1,0,0,1,Flyers,2,2,0,0,4,20141106,2,3,3,3,5,3,2014,0,3,1021,0
Oilers,1,0,1,0,2,Bruins,1,0,4,0,5,20141106,0,0,3,3,7,3,2014,0,3,2074,0
Flames,1,1,0,0,2,Lightning,1,2,2,0,5,20141106,0,1,3,3,7,3,2014,0,3,2289,0
Oilers,0,1,2,0,3,Sabres,0,1,1,0,2,20141107,0,0,1,1,5,-1,2014,0,4,1734,0
Blue Jackets,0,2,0,0,2,Hurricanes,0,1,1,1,3,20141107,0,-1,0,1,5,1,2014,1,4,374,0
Devils,1,0,1,0,2,Red Wings,2,2,0,0,4,20141107,1,3,2,2,6,2,2014,0,4,471,0
Capitals,0,3,0,0,3,Blackhawks,1,1,0,0,2,20141107,-1,1,1,1,5,-1,2014,0,4,594,0
Coyotes,0,2,0,1,3,Ducks,2,0,0,0,2,20141107,-2,0,0,1,5,-1,2014,1,4,356,0
Avalanche,0,0,3,0,3,Flyers,1,3,0,0,4,20141108,1,4,1,1,7,1,2014,0,5,1574,0
Canucks,0,0,1,0,1,Kings,3,1,1,0,5,20141108,3,4,4,4,6,4,2014,0,5,1076,0
Predators,0,1,1,0,2,Blues,1,0,0,0,1,20141108,-1,0,1,1,3,-1,2014,0,5,253,0
Hurricanes,1,0,2,0,3,Capitals,2,1,0,1,4,20141108,1,2,0,1,7,1,2014,1,5,233,0
Islanders,0,0,1,0,1,Coyotes,0,0,0,0,0,20141108,0,0,1,1,1,-1,2014,0,5,2139,0
Sharks,1,0,4,0,5,Stars,2,1,0,0,3,20141108,-1,-2,2,2,8,-2,2014,0,5,1449,0
Jets,1,0,0,1,2,Senators,1,0,0,0,1,20141108,0,0,0,1,3,-1,2014,1,5,1033,0
Wild,0,1,0,0,1,Canadiens,0,2,2,0,4,20141108,0,1,3,3,5,3,2014,0,5,938,0
Rangers,2,1,1,0,4,Maple Leafs,3,0,2,0,5,20141108,1,0,1,1,9,1,2014,0,5,341,0
Penguins,3,3,0,0,6,Sabres,0,1,0,0,1,20141108,3,5,5,5,7,-5,2014,0,5,178,0
Flames,0,3,3,0,6,Panthers,1,3,0,0,4,20141108,-1,-1,2,2,10,-2,2014,0,5,2493,0
Lightning,4,2,1,0,7,Blue Jackets,0,2,2,0,4,20141108,4,4,3,3,11,-3,2014,0,5,830,0
Canucks,0,1,0,1,2,Ducks,0,1,0,0,1,20141109,0,0,0,1,3,-1,2014,1,6,1076,0
Sharks,1,1,0,0,2,Blackhawks,3,0,2,0,5,20141109,2,1,3,3,7,3,2014,0,6,1837,0
Maple Leafs,1,3,1,0,5,Senators,2,1,0,0,3,20141109,-1,1,2,2,8,-2,2014,0,6,203,0
Lightning,1,2,0,1,4,Red Wings,1,1,1,0,3,20141109,0,1,0,1,7,-1,2014,1,6,994,0
Oilers,1,1,1,0,3,Rangers,1,0,0,0,1,20141109,0,1,2,2,4,-2,2014,0,6,2024,0
Devils,1,1,0,0,2,Bruins,2,2,0,0,4,20141110,1,2,2,2,6,2,2014,0,0,196,0
Flames,1,0,0,0,1,Hurricanes,1,2,1,0,4,20141110,0,2,3,3,5,3,2014,0,0,2038,0
Sabres,0,0,1,0,1,Blues,1,2,3,0,6,20141111,1,3,5,5,7,5,2014,0,1,660,0
Stars,0,2,2,0,4,Coyotes,1,1,1,0,3,20141111,-1,0,1,1,7,-1,2014,0,1,884,0
Senators,0,2,1,0,3,Canucks,0,2,1,1,4,20141111,0,0,0,1,7,1,2014,1,1,2191,0
Lightning,1,0,1,0,2,Blackhawks,0,1,1,1,3,20141111,-1,0,0,1,5,1,2014,1,1,1004,0
Oilers,0,2,0,0,2,Predators,3,0,0,0,3,20141111,3,1,1,1,5,1,2014,0,1,1758,0
Sharks,0,0,1,0,1,Panthers,2,1,1,0,4,20141111,2,3,3,3,5,3,2014,0,1,2558,0
Wild,0,0,1,0,1,Devils,0,2,1,0,3,20141111,0,2,2,2,4,2,2014,0,1,1007,0
Blue Jackets,1,1,0,0,2,Capitals,3,0,1,0,4,20141111,2,1,2,2,6,2,2014,0,1,326,0
Penguins,0,0,0,0,0,Rangers,3,1,1,0,5,20141111,3,4,5,5,5,5,2014,0,1,314,0
Avalanche,0,0,0,0,0,Islanders,2,2,2,0,6,20141111,2,4,6,6,6,6,2014,0,1,1627,0
Jets,0,0,0,0,0,Canadiens,0,1,2,0,3,20141111,0,1,3,3,3,3,2014,0,1,1115,0
Bruins,0,1,0,0,1,Maple Leafs,1,4,1,0,6,20141112,1,4,5,5,7,5,2014,0,2,430,0
Kings,2,1,2,0,5,Ducks,0,2,3,1,6,20141112,-2,-1,0,1,11,1,2014,1,2,0,0
Sabres,2,0,1,0,3,Wild,4,1,1,0,6,20141113,2,3,3,3,9,3,2014,0,3,729,0
Predators,1,2,0,0,3,Blues,2,1,1,0,4,20141113,1,0,1,1,7,1,2014,0,3,253,0
Sharks,0,2,0,0,2,Lightning,0,0,1,0,1,20141113,0,2,1,1,3,-1,2014,0,3,2365,0
Stars,1,1,0,0,2,Kings,0,0,0,0,0,20141113,1,2,2,2,2,-2,2014,0,3,1237,0
Jets,1,1,1,0,3,Hurricanes,0,1,0,0,1,20141113,1,1,2,2,4,-2,2014,0,3,1350,0
Avalanche,1,1,1,1,4,Rangers,0,3,0,0,3,20141113,1,-1,0,1,7,-1,2014,1,3,1627,0
Coyotes,1,2,0,0,3,Flames,1,3,1,0,5,20141113,0,1,2,2,8,2,2014,0,3,1224,0
Bruins,1,0,0,0,1,Canadiens,0,3,2,0,5,20141113,-1,2,4,4,6,4,2014,0,3,270,0
Senators,3,0,0,1,4,Oilers,0,1,2,0,3,20141113,3,2,0,1,7,-1,2014,1,3,1754,0
Penguins,0,1,1,0,2,Maple Leafs,0,0,1,0,1,20141114,0,1,1,1,3,-1,2014,0,4,222,0
Blackhawks,1,0,0,0,1,Red Wings,1,2,1,0,4,20141114,0,2,3,3,5,3,2014,0,4,238,0
Coyotes,1,3,1,0,5,Canucks,0,0,0,0,0,20141114,1,4,5,5,5,-5,2014,0,4,1228,0
Blue Jackets,2,2,0,0,4,Flyers,1,1,1,0,3,20141114,1,2,1,1,7,-1,2014,0,4,414,0
Islanders,0,2,1,1,4,Panthers,1,0,2,0,3,20141114,-1,1,0,1,7,-1,2014,1,4,1091,0
Devils,0,0,1,0,1,Capitals,0,0,0,0,0,20141114,0,0,1,1,1,-1,2014,0,4,198,0
Hurricanes,1,0,0,0,1,Bruins,2,0,0,0,2,20141115,1,1,1,1,3,1,2014,0,5,609,0
Wild,0,1,1,0,2,Stars,0,1,0,0,1,20141115,0,0,1,1,3,-1,2014,0,5,863,0
Ducks,0,2,0,0,2,Kings,0,1,1,1,3,20141115,0,-1,0,1,5,1,2014,1,5,0,0
Maple Leafs,0,2,0,0,2,Sabres,2,2,2,0,6,20141115,2,2,4,4,8,4,2014,0,5,57,0
Flyers,0,2,1,0,3,Canadiens,2,1,3,0,6,20141115,2,1,3,3,9,3,2014,0,5,400,0
Islanders,2,0,0,0,2,Lightning,3,1,1,0,5,20141115,1,2,3,3,7,3,2014,0,5,1004,0
Avalanche,1,0,2,0,3,Devils,1,0,1,0,2,20141115,0,0,1,1,5,-1,2014,0,5,1618,0
Rangers,2,0,0,0,2,Penguins,1,1,0,1,3,20141115,-1,0,0,1,5,1,2014,1,5,314,0
Sharks,0,1,0,0,1,Blue Jackets,1,1,0,0,2,20141115,1,1,1,1,3,1,2014,0,5,2090,0
Jets,0,1,0,0,1,Predators,0,1,1,0,2,20141115,0,0,1,1,3,1,2014,0,5,1084,0
Capitals,0,1,0,0,1,Blues,1,1,2,0,4,20141115,1,1,3,3,5,3,2014,0,5,708,0
Senators,1,0,1,0,2,Flames,0,1,3,0,4,20141115,-1,0,2,2,6,2,2014,0,5,1773,0
Coyotes,1,0,1,0,2,Oilers,0,0,1,0,1,20141116,1,1,1,1,3,-1,2014,0,6,1392,0
Panthers,1,4,1,0,6,Ducks,1,0,1,0,2,20141116,0,4,4,4,8,-4,2014,0,6,2335,0
Sharks,1,0,1,0,2,Hurricanes,0,0,0,0,0,20141116,1,1,2,2,2,-2,2014,0,6,2382,0
Canadiens,0,2,2,0,4,Red Wings,0,0,1,0,1,20141116,0,2,3,3,5,-3,2014,0,6,508,0
Jets,0,0,3,0,3,Wild,3,0,0,1,4,20141116,3,3,0,1,7,1,2014,1,6,388,0
Stars,2,0,0,0,2,Blackhawks,2,0,4,0,6,20141116,0,0,4,4,8,4,2014,0,6,802,0
Lightning,2,2,1,0,5,Rangers,0,1,0,0,1,20141117,2,3,4,4,6,-4,2014,0,0,1004,0
Capitals,1,0,0,1,2,Coyotes,0,1,0,0,1,20141118,1,0,0,1,3,-1,2014,1,1,1977,0
Panthers,0,0,2,0,2,Kings,0,4,1,0,5,20141118,0,4,3,3,7,3,2014,0,1,2335,0
Ducks,1,1,1,0,3,Flames,0,0,3,1,4,20141118,-1,-2,0,1,7,1,2014,1,1,1197,0
Hurricanes,0,4,2,0,6,Stars,2,0,2,0,4,20141118,-2,2,2,2,10,-2,2014,0,1,1055,0
Red Wings,1,1,3,0,5,Blue Jackets,0,0,0,0,0,20141118,1,2,5,5,5,-5,2014,0,1,163,0
Penguins,2,2,0,0,4,Canadiens,0,0,0,0,0,20141118,2,4,4,4,4,-4,2014,0,1,474,0
Predators,3,1,5,0,9,Maple Leafs,0,0,2,0,2,20141118,3,4,7,7,11,-7,2014,0,1,646,0
Sharks,0,1,0,0,1,Sabres,0,3,1,0,4,20141118,0,2,3,3,5,3,2014,0,1,2279,0
Lightning,1,0,1,0,2,Islanders,0,3,2,0,5,20141118,-1,2,3,3,7,3,2014,0,1,1004,0
Blues,0,0,0,0,0,Bruins,1,1,0,0,2,20141118,1,2,2,2,2,2,2014,0,1,1035,0
Devils,0,0,1,0,1,Jets,0,2,1,0,3,20141118,0,2,2,2,4,2,2014,0,1,1280,0
Flyers,0,0,0,0,0,Rangers,1,1,0,0,2,20141119,1,2,2,2,2,2,2014,0,2,80,0
Canucks,1,3,1,0,5,Oilers,0,3,1,0,4,20141119,1,1,1,1,9,-1,2014,0,2,514,0
Bruins,0,0,3,1,4,Blue Jackets,2,0,1,0,3,20141121,-2,-2,0,1,7,-1,2014,1,4,642,0
Islanders,3,1,0,1,5,Penguins,2,1,1,0,4,20141121,1,1,0,1,9,-1,2014,1,4,314,0
Devils,0,2,0,0,2,Oilers,0,0,0,0,0,20141121,0,2,2,2,2,-2,2014,0,4,2016,0
Hurricanes,3,0,0,0,3,Avalanche,1,1,2,0,4,20141122,-2,-1,1,1,7,1,2014,0,5,1459,0
Coyotes,2,0,1,1,4,Sharks,0,2,1,0,3,20141122,2,0,0,1,7,-1,2014,1,5,614,0
Blackhawks,3,3,1,0,7,Oilers,0,0,1,0,1,20141122,3,6,6,6,8,-6,2014,0,5,1437,0
Devils,2,1,1,0,4,Flames,0,1,3,1,5,20141122,-2,-2,0,1,9,1,2014,1,5,2015,0
Kings,0,3,1,0,4,Stars,3,2,0,0,5,20141122,3,2,1,1,9,1,2014,0,5,1237,0
Wild,0,1,0,0,1,Lightning,0,2,0,0,2,20141122,0,1,1,1,3,1,2014,0,5,1318,0
Blue Jackets,1,0,1,0,2,Flyers,2,1,1,0,4,20141122,1,2,2,2,6,2,2014,0,5,414,0
Canadiens,1,1,0,0,2,Bruins,0,0,0,0,0,20141122,1,2,2,2,2,-2,2014,0,5,270,0
Sabres,0,1,1,0,2,Capitals,0,0,1,0,1,20141122,0,1,1,1,3,-1,2014,0,5,292,0
Panthers,0,0,2,0,2,Predators,0,1,1,1,3,20141122,0,1,0,1,5,1,2014,1,5,816,0
Blues,2,1,0,0,3,Senators,1,1,0,0,2,20141122,1,1,1,1,5,-1,2014,0,5,860,0
Penguins,1,0,0,0,1,Islanders,0,1,3,0,4,20141122,-1,0,3,3,5,3,2014,0,5,314,0
Red Wings,0,1,0,0,1,Maple Leafs,1,0,3,0,4,20141122,1,0,3,3,5,3,2014,0,5,205,0
Blues,0,2,2,0,4,Jets,1,1,0,0,2,20141123,-1,0,2,2,6,-2,2014,0,6,853,0
Canadiens,0,0,0,0,0,Rangers,1,2,2,0,5,20141123,1,3,5,5,5,5,2014,0,6,343,0
Coyotes,0,0,1,0,1,Ducks,0,2,0,0,2,20141123,0,2,1,1,3,1,2014,0,6,356,0
Blackhawks,0,1,0,0,1,Canucks,1,0,3,0,4,20141123,1,0,3,3,5,3,2014,0,6,1775,0
Penguins,1,1,0,1,3,Bruins,0,2,0,0,2,20141124,1,0,0,1,5,-1,2014,1,0,481,0
Flyers,0,0,0,0,0,Islanders,0,0,0,1,1,20141124,0,0,0,1,1,1,2014,1,0,80,0
Senators,1,0,2,0,3,Red Wings,1,3,0,0,4,20141124,0,3,1,1,7,1,2014,0,0,406,0
Wild,2,1,1,0,4,Panthers,0,1,0,0,1,20141124,2,2,3,3,5,-3,2014,0,0,1513,0
Devils,0,0,0,0,0,Canucks,0,1,1,0,2,20141125,0,1,2,2,2,2,2014,0,1,2421,0
Flames,0,0,2,0,2,Ducks,1,2,0,0,3,20141125,1,3,1,1,5,1,2014,0,1,1197,0
Avalanche,0,1,2,1,4,Coyotes,3,0,0,0,3,20141125,-3,-2,0,1,7,-1,2014,1,1,585,0
Kings,1,1,1,0,3,Predators,1,2,0,1,4,20141125,0,1,0,1,7,1,2014,1,1,1776,0
Senators,0,0,2,1,3,Blues,1,1,0,0,2,20141125,-1,-2,0,1,5,-1,2014,1,1,860,0
Jets,1,2,1,0,4,Blue Jackets,1,0,1,0,2,20141125,0,2,2,2,6,-2,2014,0,1,975,0
Oilers,1,0,1,0,2,Stars,1,2,0,0,3,20141125,0,2,1,1,5,1,2014,0,1,1655,0
Flames,0,1,1,0,2,Sharks,0,0,0,0,0,20141126,0,1,2,2,2,-2,2014,0,2,1027,0
Blackhawks,0,2,1,0,3,Avalanche,0,1,1,0,2,20141126,0,1,1,1,5,-1,2014,0,2,916,0
Hurricanes,0,0,0,0,0,Panthers,1,0,0,0,1,20141126,1,1,1,1,1,1,2014,0,2,696,0
Kings,4,0,0,0,4,Wild,0,0,0,0,0,20141126,4,4,4,4,4,-4,2014,0,2,1521,0
Flyers,0,1,1,0,2,Red Wings,1,3,1,0,5,20141126,1,3,3,3,7,3,2014,0,2,441,0
Maple Leafs,0,3,0,0,3,Penguins,2,1,0,1,4,20141126,2,0,0,1,7,1,2014,1,2,222,0
Capitals,1,1,0,0,2,Islanders,2,0,0,1,3,20141126,1,0,0,1,5,1,2014,1,2,204,0
Jets,1,1,0,0,2,Sabres,0,0,1,0,1,20141126,1,2,1,1,3,-1,2014,0,2,996,0
Rangers,2,0,1,0,3,Lightning,2,1,1,0,4,20141126,0,1,1,1,7,1,2014,0,2,1004,0
Oilers,0,0,0,0,0,Predators,0,0,0,1,1,20141127,0,0,0,1,1,1,2014,1,3,1758,0
Senators,1,1,0,0,2,Panthers,1,0,2,0,3,20141128,0,-1,1,1,5,1,2014,0,4,1370,0
Wild,2,1,1,1,5,Stars,0,3,1,0,4,20141128,2,0,0,1,9,-1,2014,1,4,863,0
Oilers,0,2,1,0,3,Blues,1,0,2,1,4,20141128,1,-1,0,1,7,1,2014,1,4,1508,0
Canucks,0,1,4,0,5,Blue Jackets,0,0,0,0,0,20141128,0,1,5,5,5,-5,2014,0,4,2050,0
Hurricanes,1,1,2,0,4,Penguins,1,1,0,0,2,20141128,0,0,2,2,6,-2,2014,0,4,330,0
Red Wings,1,2,1,1,5,Devils,3,1,0,0,4,20141128,-2,-1,0,1,9,-1,2014,1,4,471,0
Rangers,1,1,1,0,3,Flyers,0,0,0,0,0,20141128,1,2,3,3,3,-3,2014,0,4,80,0
Islanders,2,0,0,0,2,Capitals,2,1,2,0,5,20141128,0,1,3,3,7,3,2014,0,4,204,0
Blackhawks,2,1,1,0,4,Ducks,1,0,0,0,1,20141128,1,2,3,3,5,-3,2014,0,4,1741,0
Canadiens,0,0,1,0,1,Sabres,1,0,1,0,2,20141128,1,1,1,1,3,1,2014,0,4,311,0
Jets,1,0,0,0,1,Bruins,0,0,1,1,2,20141128,-1,-1,0,1,3,1,2014,1,4,1349,0
Flyers,1,1,0,0,2,Rangers,1,1,3,0,5,20141129,0,0,3,3,7,3,2014,0,5,80,0
Flames,0,1,2,0,3,Coyotes,0,0,0,0,0,20141129,0,1,3,3,3,-3,2014,0,5,1224,0
Blackhawks,2,1,1,0,4,Kings,0,1,0,0,1,20141129,2,2,3,3,5,-3,2014,0,5,1741,0
Stars,2,0,0,0,2,Avalanche,2,1,2,0,5,20141129,0,1,3,3,7,3,2014,0,5,661,0
Blues,0,1,1,1,3,Wild,0,2,0,0,2,20141129,0,-1,0,1,5,-1,2014,1,5,466,0
Ducks,1,1,2,0,4,Sharks,3,2,1,0,6,20141129,2,3,2,2,10,2,2014,0,5,305,0
Penguins,2,0,1,0,3,Hurricanes,1,0,1,0,2,20141129,1,1,1,1,5,-1,2014,0,5,330,0
Devils,1,0,0,0,1,Islanders,1,1,1,0,3,20141129,0,1,2,2,4,2,2014,0,5,8,0
Senators,1,0,0,0,1,Lightning,0,1,3,0,4,20141129,-1,0,3,3,5,3,2014,0,5,1251,0
Capitals,0,1,1,0,2,Maple Leafs,2,3,1,0,6,20141129,2,4,4,4,8,4,2014,0,5,349,0
Sabres,1,0,2,1,4,Canadiens,0,1,2,0,3,20141129,1,0,0,1,7,-1,2014,1,5,311,0
Blue Jackets,0,0,1,0,1,Predators,0,1,1,0,2,20141129,0,1,1,1,3,1,2014,0,5,333,0
Canucks,0,1,2,0,3,Red Wings,2,1,2,0,5,20141130,2,2,2,2,8,2,2014,0,6,1967,0
Lightning,2,1,3,0,6,Rangers,1,2,0,0,3,20141201,1,0,3,3,9,-3,2014,0,0,1004,0
Panthers,0,1,0,0,1,Blue Jackets,1,0,1,0,2,20141201,1,0,1,1,3,1,2014,0,0,993,0
Canadiens,1,2,1,0,4,Avalanche,1,2,0,0,3,20141201,0,0,1,1,7,-1,2014,0,0,1618,0
Coyotes,0,4,1,0,5,Oilers,1,0,1,0,2,20141201,-1,3,3,3,7,-3,2014,0,0,1392,0
Bruins,0,1,1,0,2,Ducks,0,2,1,0,3,20141201,0,1,1,1,5,1,2014,0,0,2590,0
Flyers,1,0,0,0,1,Sharks,0,1,1,0,2,20141202,-1,0,1,1,3,1,2014,0,1,2499,0
Bruins,0,0,0,0,0,Kings,1,0,1,0,2,20141202,1,1,2,2,2,2,2014,0,1,2590,0
Panthers,1,1,2,0,4,Red Wings,1,0,2,0,3,20141202,0,1,1,1,7,-1,2014,0,1,1155,0
Coyotes,1,1,0,0,2,Flames,2,1,2,0,5,20141202,1,1,3,3,7,3,2014,0,1,1224,0
Lightning,0,0,1,0,1,Sabres,0,0,1,1,2,20141202,0,0,0,1,3,1,2014,1,1,1051,0
Senators,1,0,1,0,2,Islanders,0,1,1,1,3,20141202,-1,0,0,1,5,1,2014,1,1,334,0
Predators,0,0,1,0,1,Hurricanes,1,0,1,0,2,20141202,1,1,1,1,3,1,2014,0,1,456,0
Canucks,1,2,1,0,4,Capitals,0,2,1,0,3,20141202,1,1,1,1,7,-1,2014,0,1,2359,0
Devils,0,0,0,0,0,Penguins,0,0,1,0,1,20141202,0,0,1,1,1,1,2014,0,1,306,0
Stars,0,1,2,0,3,Maple Leafs,2,2,1,0,5,20141202,2,3,2,2,8,2,2014,0,1,1201,0
Canadiens,0,0,1,0,1,Wild,1,1,0,0,2,20141203,1,2,1,1,3,1,2014,0,2,938,0
Blues,0,1,0,0,1,Blackhawks,1,0,3,0,4,20141203,1,0,3,3,5,3,2014,0,2,260,0
Oilers,1,0,1,0,2,Jets,1,0,1,1,3,20141203,0,0,0,1,5,1,2014,1,2,738,0
Flyers,0,3,1,0,4,Ducks,0,3,1,1,5,20141203,0,0,0,1,9,1,2014,1,2,2388,0
Bruins,2,2,0,0,4,Sharks,0,4,3,0,7,20141204,-2,0,3,3,11,3,2014,0,3,2678,0
Kings,1,2,1,0,4,Coyotes,0,0,0,0,0,20141204,1,3,4,4,4,-4,2014,0,3,356,0
Avalanche,0,2,1,0,3,Flames,0,1,2,1,4,20141204,0,-1,0,1,7,1,2014,1,3,898,0
Blues,1,1,1,0,3,Predators,2,1,1,0,4,20141204,1,1,1,1,7,1,2014,0,3,253,0
Stars,1,1,0,0,2,Red Wings,3,0,2,0,5,20141204,2,1,3,3,7,3,2014,0,3,999,0
Islanders,0,1,1,0,2,Senators,0,1,0,0,1,20141204,0,0,1,1,3,-1,2014,0,3,334,0
Devils,1,2,2,0,5,Maple Leafs,0,2,1,0,3,20141204,1,1,2,2,8,-2,2014,0,3,333,0
Sabres,0,0,0,0,0,Lightning,1,3,1,0,5,20141204,1,4,5,5,5,5,2014,0,3,1051,0
Capitals,1,0,1,0,2,Hurricanes,0,0,1,0,1,20141204,1,1,1,1,3,-1,2014,0,3,233,0
Canucks,1,2,0,0,3,Penguins,0,0,0,0,0,20141204,1,3,3,3,3,-3,2014,0,3,2168,0
Blue Jackets,2,1,0,1,4,Panthers,0,3,0,0,3,20141204,2,0,0,1,7,-1,2014,1,3,993,0
Ducks,2,1,2,0,5,Wild,0,3,1,0,4,20141205,2,0,1,1,9,-1,2014,0,4,1521,0
Avalanche,1,0,1,0,2,Jets,2,1,3,0,6,20141205,1,2,4,4,8,4,2014,0,4,797,0
Canadiens,1,2,0,0,3,Blackhawks,2,0,2,0,4,20141205,1,-1,1,1,7,1,2014,0,4,732,0
Blue Jackets,2,0,1,0,3,Lightning,0,0,1,0,1,20141206,2,2,2,2,4,-2,2014,0,5,830,0
Bruins,2,3,0,0,5,Coyotes,1,0,1,0,2,20141206,1,4,3,3,7,-3,2014,0,5,2295,0
Capitals,1,2,1,0,4,Devils,1,0,0,0,1,20141206,0,2,3,3,5,-3,2014,0,5,198,0
Rangers,2,0,0,0,2,Red Wings,0,2,1,0,3,20141206,-2,0,1,1,5,1,2014,0,5,480,0
Sharks,0,2,1,0,3,Flames,1,1,0,0,2,20141206,-1,0,1,1,5,-1,2014,0,5,1027,0
Canucks,0,1,1,0,2,Maple Leafs,2,2,1,0,5,20141206,2,3,3,3,7,3,2014,0,5,2090,0
Senators,0,2,0,0,2,Penguins,1,1,1,0,3,20141206,1,0,1,1,5,1,2014,0,5,392,0
Canadiens,0,0,1,0,1,Stars,1,2,1,0,4,20141206,1,3,3,3,5,3,2014,0,5,1505,0
Blues,0,3,3,0,6,Islanders,3,1,0,0,4,20141206,-3,-1,2,2,10,-2,2014,0,5,871,0
Blackhawks,1,1,1,0,3,Predators,0,0,1,0,1,20141206,1,2,2,2,4,-2,2014,0,5,395,0
Flyers,1,1,0,0,2,Kings,0,0,1,0,1,20141206,1,2,1,1,3,-1,2014,0,5,2388,0
Sabres,0,2,0,0,2,Panthers,1,2,0,0,3,20141206,1,1,1,1,5,1,2014,0,5,1184,0
Ducks,1,2,0,1,4,Jets,1,1,1,0,3,20141207,0,1,0,1,7,-1,2014,1,6,1527,0
Red Wings,2,1,0,0,3,Hurricanes,0,1,0,0,1,20141207,2,2,2,2,4,-2,2014,0,6,511,0
Canucks,2,1,0,0,3,Senators,0,3,0,1,4,20141207,-2,0,0,1,7,1,2014,1,6,2191,0
Sharks,0,1,0,0,1,Oilers,0,1,1,0,2,20141207,0,0,1,1,3,1,2014,0,6,1190,0
Devils,0,2,0,0,2,Hurricanes,0,1,0,0,1,20141208,0,1,1,1,3,-1,2014,0,0,419,0
Penguins,1,0,2,0,3,Rangers,0,2,1,1,4,20141208,-1,1,0,1,7,1,2014,1,0,314,0
Panthers,0,1,1,0,2,Blues,2,0,2,0,4,20141208,2,1,2,2,6,2,2014,0,0,1061,0
Oilers,2,0,0,0,2,Sharks,2,2,1,0,5,20141209,0,2,3,3,7,3,2014,0,1,1190,0
Predators,1,0,2,0,3,Avalanche,0,0,0,0,0,20141209,1,1,3,3,3,-3,2014,0,1,1019,0
Jets,2,3,0,0,5,Stars,1,1,0,0,2,20141209,1,3,3,3,7,-3,2014,0,1,1183,0
Islanders,3,1,0,0,4,Wild,0,1,4,0,5,20141209,-3,-3,1,1,9,1,2014,0,1,1016,0
Canucks,0,1,0,0,1,Canadiens,0,1,2,0,3,20141209,0,0,2,2,4,2,2014,0,1,2273,0
Flames,0,0,1,0,1,Maple Leafs,1,1,2,0,4,20141209,1,2,3,3,5,3,2014,0,1,1682,0
Kings,0,0,0,0,0,Sabres,0,0,1,0,1,20141209,0,0,1,1,1,1,2014,0,1,2193,0
Flyers,1,0,1,0,2,Blue Jackets,1,1,0,1,3,20141209,0,1,0,1,5,1,2014,1,1,414,0
Blackhawks,0,1,1,1,3,Devils,1,0,1,0,2,20141209,-1,0,0,1,5,-1,2014,1,1,703,0
Capitals,2,1,2,0,5,Lightning,1,1,1,0,3,20141209,1,1,2,2,8,-2,2014,0,1,818,0
Maple Leafs,0,0,1,1,2,Red Wings,0,1,0,0,1,20141210,0,-1,0,1,3,-1,2014,1,2,205,0
Oilers,0,0,1,0,1,Ducks,1,1,0,0,2,20141210,1,2,1,1,3,1,2014,0,2,1368,0
Islanders,0,2,1,0,3,Blues,2,0,4,0,6,20141211,2,0,3,3,9,3,2014,0,3,871,0
Jets,0,2,1,0,3,Avalanche,0,1,2,1,4,20141211,0,-1,0,1,7,1,2014,1,3,797,0
Hurricanes,0,0,1,0,1,Lightning,0,0,2,0,2,20141211,0,0,1,1,3,1,2014,0,3,585,0
Wild,0,0,1,0,1,Sharks,0,1,1,0,2,20141211,0,1,1,1,3,1,2014,0,3,1570,0
Blue Jackets,1,0,1,1,3,Capitals,1,0,1,0,2,20141211,0,0,0,1,5,-1,2014,1,3,326,0
Blackhawks,2,1,0,0,3,Bruins,0,1,1,0,2,20141211,2,2,1,1,5,-1,2014,0,3,849,0
Kings,0,2,3,0,5,Senators,0,1,2,0,3,20141211,0,1,2,2,8,-2,2014,0,3,2345,0
Predators,3,0,2,0,5,Coyotes,1,0,0,0,1,20141211,2,2,4,4,6,-4,2014,0,3,1442,0
Flames,0,2,1,0,3,Sabres,0,2,2,0,4,20141211,0,0,1,1,7,1,2014,0,3,1731,0
Devils,0,1,0,0,1,Flyers,2,0,2,0,4,20141211,2,1,3,3,5,3,2014,0,3,75,0
Flames,1,0,0,0,1,Penguins,2,0,1,0,3,20141212,1,1,2,2,4,2,2014,0,4,1777,0
Kings,0,0,2,0,2,Canadiens,1,2,3,0,6,20141212,1,3,4,4,8,4,2014,0,4,2448,0
Panthers,2,0,0,1,3,Red Wings,2,0,0,0,2,20141212,0,0,0,1,5,-1,2014,1,4,1155,0
Ducks,1,2,1,0,4,Oilers,0,1,1,0,2,20141212,1,2,2,2,6,-2,2014,0,4,1368,0
Predators,0,0,0,0,0,Sharks,1,0,1,0,2,20141213,1,1,2,2,2,2,2014,0,5,1934,0
Blues,1,1,0,1,3,Avalanche,1,1,0,0,2,20141213,0,0,0,1,5,-1,2014,1,5,794,0
Devils,0,2,1,0,3,Stars,2,2,0,0,4,20141213,2,2,1,1,7,1,2014,0,5,1362,0
Ducks,0,3,1,0,4,Jets,1,0,0,0,1,20141213,-1,2,3,3,5,-3,2014,0,5,1527,0
Rangers,3,2,0,0,5,Canucks,0,0,1,0,1,20141213,3,5,4,4,6,-4,2014,0,5,2429,0
Blackhawks,0,1,1,0,2,Islanders,0,1,2,0,3,20141213,0,0,1,1,5,1,2014,0,5,711,0
Penguins,0,1,2,0,3,Blue Jackets,1,0,2,1,4,20141213,1,0,0,1,7,1,2014,1,5,161,0
Senators,0,1,1,1,3,Bruins,1,1,0,0,2,20141213,-1,-1,0,1,5,-1,2014,1,5,320,0
Hurricanes,0,1,0,0,1,Flyers,2,3,0,0,5,20141213,2,4,4,4,6,4,2014,0,5,345,0
Wild,1,1,1,1,4,Coyotes,1,2,0,0,3,20141213,0,-1,0,1,7,-1,2014,1,5,1278,0
Red Wings,1,0,0,0,1,Maple Leafs,1,1,2,0,4,20141213,0,1,3,3,5,3,2014,0,5,205,0
Lightning,0,0,2,0,2,Capitals,0,2,2,0,4,20141213,0,2,2,2,6,2,2014,0,5,818,0
Panthers,0,2,1,0,3,Sabres,2,0,1,1,4,20141213,2,0,0,1,7,1,2014,1,5,1184,0
Kings,0,2,1,0,3,Maple Leafs,2,0,1,1,4,20141214,2,0,0,1,7,1,2014,1,6,2170,0
Flames,0,1,0,0,1,Blackhawks,0,1,1,0,2,20141214,0,0,1,1,3,1,2014,0,6,1397,0
Rangers,1,0,1,0,2,Oilers,0,0,0,0,0,20141214,1,1,2,2,2,-2,2014,0,6,2024,0
Senators,1,1,2,0,4,Sabres,0,3,1,1,5,20141215,-1,1,0,1,9,1,2014,1,0,219,0
Lightning,1,0,1,0,2,Penguins,1,2,1,0,4,20141215,0,2,2,2,6,2,2014,0,0,874,0
Devils,2,0,0,0,2,Islanders,0,1,1,1,3,20141215,-2,-1,0,1,5,1,2014,1,0,8,0
Kings,0,2,0,0,2,Blues,0,1,4,0,5,20141216,0,-1,3,3,7,3,2014,0,1,1586,0
Oilers,1,0,0,0,1,Coyotes,0,1,0,1,2,20141216,-1,0,0,1,3,1,2014,1,1,1392,0
Rangers,2,2,1,0,5,Flames,0,1,1,0,2,20141216,2,3,3,3,7,-3,2014,0,1,2023,0
Wild,1,0,2,0,3,Blackhawks,0,3,2,0,5,20141216,-1,2,2,2,8,2,2014,0,1,355,0
Sabres,1,0,0,0,1,Jets,0,3,2,0,5,20141216,-1,2,4,4,6,4,2014,0,1,996,0
Capitals,0,1,0,0,1,Panthers,1,0,0,1,2,20141216,1,0,0,1,3,1,2014,1,1,924,0
Blue Jackets,0,0,0,1,1,Red Wings,0,0,0,0,0,20141216,0,0,0,1,1,-1,2014,1,1,163,0
Hurricanes,0,0,1,0,1,Canadiens,1,1,2,0,4,20141216,1,2,3,3,5,3,2014,0,1,727,0
Ducks,0,1,1,0,2,Maple Leafs,1,1,4,0,6,20141216,1,1,4,4,8,4,2014,0,1,2170,0
Bruins,0,1,1,0,2,Predators,0,1,1,1,3,20141216,0,0,0,1,5,1,2014,1,1,941,0
Lightning,0,2,1,0,3,Flyers,1,0,0,0,1,20141216,-1,1,2,2,4,-2,2014,0,1,928,0
Senators,1,0,1,0,2,Devils,0,0,0,0,0,20141217,1,1,2,2,2,-2,2014,0,2,330,0
Bruins,2,0,0,1,3,Wild,1,0,1,0,2,20141217,1,1,0,1,5,-1,2014,1,2,1120,0
Stars,0,1,1,0,2,Canucks,0,0,0,0,0,20141217,0,1,2,2,2,-2,2014,0,2,1766,0
Oilers,1,2,0,0,3,Sharks,0,2,2,0,4,20141218,-1,-1,1,1,7,1,2014,0,3,1190,0
Ducks,1,0,1,0,2,Canadiens,0,0,1,0,1,20141218,1,1,1,1,3,-1,2014,0,3,2448,0
Blues,3,1,0,0,4,Kings,1,2,3,0,6,20141218,-2,-1,2,2,10,2,2014,0,3,1586,0
Avalanche,0,0,0,0,0,Penguins,0,0,0,1,1,20141218,0,0,0,1,1,1,2014,1,3,1317,0
Panthers,1,0,0,1,2,Flyers,0,1,0,0,1,20141218,1,0,0,1,3,-1,2014,1,3,1021,0
Maple Leafs,0,1,0,0,1,Hurricanes,2,0,2,0,4,20141218,2,1,3,3,5,3,2014,0,3,544,0
Capitals,2,0,2,1,5,Blue Jackets,0,2,2,0,4,20141218,2,0,0,1,9,-1,2014,1,3,326,0
Lightning,0,1,1,0,2,Devils,2,0,0,1,3,20141219,2,1,0,1,5,1,2014,1,4,1000,0
Ducks,0,1,1,0,2,Senators,2,2,2,0,6,20141219,2,3,4,4,8,4,2014,0,4,2345,0
Islanders,1,1,0,0,2,Red Wings,1,0,0,0,1,20141219,0,1,1,1,3,-1,2014,0,4,480,0
Bruins,0,1,0,0,1,Jets,1,1,0,0,2,20141219,1,1,1,1,3,1,2014,0,4,1349,0
Stars,0,2,0,0,2,Flames,0,1,0,0,1,20141219,0,1,1,1,3,-1,2014,0,4,1536,0
Blackhawks,0,1,1,0,2,Blue Jackets,1,0,1,1,3,20141220,1,0,0,1,5,1,2014,1,5,275,0
Blues,0,2,0,0,2,Sharks,0,1,1,1,3,20141220,0,-1,0,1,5,1,2014,1,5,1719,0
Flames,0,1,1,0,2,Canucks,2,0,0,1,3,20141220,2,1,0,1,5,1,2014,1,5,426,0
Predators,3,0,2,1,6,Wild,2,1,2,0,5,20141220,1,0,0,1,11,-1,2014,1,5,696,0
Rangers,0,0,2,1,3,Hurricanes,1,0,1,0,2,20141220,-1,-1,0,1,5,-1,2014,1,5,423,0
Avalanche,2,0,3,0,5,Sabres,0,0,1,0,1,20141220,2,2,4,4,6,-4,2014,0,5,1366,0
Panthers,1,0,0,0,1,Penguins,2,0,1,0,3,20141220,1,1,2,2,4,2,2014,0,5,1013,0
Lightning,0,0,1,0,1,Islanders,0,0,3,0,3,20141220,0,0,2,2,4,2,2014,0,5,1004,0
Senators,1,0,0,0,1,Canadiens,1,1,2,0,4,20141220,0,1,3,3,5,3,2014,0,5,104,0
Flyers,3,2,2,0,7,Maple Leafs,3,0,1,0,4,20141220,0,2,3,3,11,-3,2014,0,5,334,0
Coyotes,0,2,0,0,2,Kings,1,1,2,0,4,20141220,1,0,2,2,6,2,2014,0,5,356,0
Capitals,0,2,2,0,4,Devils,0,0,0,0,0,20141220,0,2,4,4,4,-4,2014,0,5,198,0
Avalanche,0,0,1,1,2,Red Wings,0,0,1,0,1,20141221,0,0,0,1,3,-1,2014,1,6,1154,0
Stars,2,1,2,1,6,Oilers,1,4,0,0,5,20141221,1,-2,0,1,11,-1,2014,1,6,1655,0
Sabres,0,2,1,0,3,Bruins,1,1,1,1,4,20141221,1,0,0,1,7,1,2014,1,6,399,0
Maple Leafs,0,0,0,0,0,Blackhawks,2,0,2,0,4,20141221,2,2,4,4,4,4,2014,0,6,436,0
Hurricanes,0,0,0,0,0,Rangers,1,0,0,0,1,20141221,1,1,1,1,1,1,2014,0,6,423,0
Flyers,1,0,2,1,4,Jets,2,1,0,0,3,20141221,-1,-2,0,1,7,-1,2014,1,6,1273,0
Flames,0,1,2,1,4,Kings,2,1,0,0,3,20141222,-2,-2,0,1,7,-1,2014,1,0,1197,0
Sharks,0,0,2,0,2,Ducks,0,1,1,1,3,20141222,0,1,0,1,5,1,2014,1,0,305,0
Penguins,1,0,2,0,3,Panthers,0,1,2,1,4,20141222,-1,0,0,1,7,1,2014,1,0,1013,0
Coyotes,0,1,0,0,1,Canucks,3,2,2,0,7,20141222,3,4,6,6,8,6,2014,0,0,1228,0
Senators,0,1,0,0,1,Capitals,0,2,0,0,2,20141222,0,1,1,1,3,1,2014,0,0,446,0
Predators,0,2,3,0,5,Blue Jackets,0,0,1,0,1,20141222,0,2,4,4,6,-4,2014,0,0,333,0
Jets,3,1,1,0,5,Blackhawks,0,1,0,0,1,20141223,3,3,4,4,6,-4,2014,0,1,722,0
Coyotes,2,1,2,0,5,Oilers,1,0,0,0,1,20141223,1,2,4,4,6,-4,2014,0,1,1392,0
Penguins,0,1,2,0,3,Lightning,2,2,0,0,4,20141223,2,3,1,1,7,1,2014,0,1,874,0
Sabres,2,1,0,0,3,Red Wings,1,1,4,0,6,20141223,-1,-1,3,3,9,3,2014,0,1,215,0
Blues,0,0,0,0,0,Avalanche,2,3,0,0,5,20141223,2,5,5,5,5,5,2014,0,1,794,0
Capitals,0,0,2,0,2,Rangers,1,1,2,0,4,20141223,1,2,2,2,6,2,2014,0,1,204,0
Hurricanes,0,0,1,1,2,Devils,1,0,0,0,1,20141223,-1,-1,0,1,3,-1,2014,1,1,419,0
Canadiens,0,2,1,0,3,Islanders,1,0,0,0,1,20141223,-1,1,2,2,4,-2,2014,0,1,343,0
Maple Leafs,1,2,1,0,4,Stars,0,0,0,0,0,20141223,1,3,4,4,4,-4,2014,0,1,1201,0
Predators,2,0,1,0,3,Bruins,2,2,1,0,5,20141223,0,2,2,2,8,2,2014,0,1,941,0
Flyers,2,1,2,0,5,Wild,1,1,0,0,2,20141223,1,1,3,3,7,-3,2014,0,1,983,0
Ducks,1,0,0,0,1,Coyotes,1,0,0,1,2,20141227,0,0,0,1,3,1,2014,1,5,356,0
Sharks,1,0,0,0,1,Kings,1,1,1,0,3,20141227,0,1,2,2,4,2,2014,0,5,305,0
Oilers,0,0,1,0,1,Flames,3,0,1,0,4,20141227,3,3,3,3,5,3,2014,0,5,171,0
Blackhawks,2,1,2,0,5,Avalanche,2,0,0,0,2,20141227,0,1,3,3,7,-3,2014,0,5,916,0
Stars,2,2,0,0,4,Blues,2,0,1,0,3,20141227,0,2,1,1,7,-1,2014,0,5,547,0
Devils,0,1,0,0,1,Rangers,1,1,1,0,3,20141227,1,1,2,2,4,2,2014,0,5,8,0
Capitals,1,0,2,0,3,Penguins,0,0,0,0,0,20141227,1,1,3,3,3,-3,2014,0,5,190,0
Jets,0,1,2,1,4,Wild,1,0,2,0,3,20141227,-1,0,0,1,7,-1,2014,1,5,388,0
Hurricanes,0,0,1,0,1,Lightning,1,0,1,0,2,20141227,1,1,1,1,3,1,2014,0,5,585,0
Red Wings,1,0,1,1,3,Senators,1,1,0,0,2,20141227,0,-1,0,1,5,-1,2014,1,5,406,0
Islanders,1,2,0,0,3,Sabres,0,0,3,1,4,20141227,-1,-3,0,1,7,1,2014,1,5,292,0
Bruins,1,1,0,0,2,Blue Jackets,1,4,1,0,6,20141227,0,3,4,4,8,4,2014,0,5,642,0
Flyers,0,1,0,0,1,Predators,1,2,1,0,4,20141227,1,2,3,3,5,3,2014,0,5,683,0
Maple Leafs,0,4,0,0,4,Panthers,0,2,4,0,6,20141228,0,-2,2,2,10,2,2014,0,6,1234,0
Canucks,0,1,0,0,1,Ducks,0,0,1,1,2,20141228,0,-1,0,1,3,1,2014,1,6,1076,0
Rangers,2,0,0,0,2,Stars,2,1,0,0,3,20141229,0,1,1,1,5,1,2014,0,0,1370,0
Flyers,0,0,2,0,2,Coyotes,1,1,2,0,4,20141229,1,2,2,2,6,2,2014,0,0,2078,0
Predators,2,2,0,0,4,Blackhawks,0,3,1,1,5,20141229,-2,-1,0,1,9,1,2014,1,0,395,0
Wild,0,3,0,0,3,Jets,1,1,0,0,2,20141229,-1,1,1,1,5,-1,2014,0,0,388,0
Kings,0,1,0,0,1,Flames,2,0,0,0,2,20141229,2,1,1,1,3,1,2014,0,0,1197,0
Maple Leafs,2,0,0,0,2,Lightning,0,2,1,0,3,20141229,-2,0,1,1,5,1,2014,0,0,1096,0
Canadiens,0,2,1,0,3,Hurricanes,0,0,1,0,1,20141229,0,2,2,2,4,-2,2014,0,0,727,0
Red Wings,1,1,0,0,2,Bruins,3,0,2,0,5,20141229,2,1,3,3,7,3,2014,0,0,611,0
Avalanche,0,0,0,0,0,Blues,0,2,1,0,3,20141229,0,2,3,3,3,3,2014,0,0,794,0
Capitals,0,0,3,0,3,Islanders,1,1,1,1,4,20141229,1,2,0,1,7,1,2014,1,0,204,0
Sabres,0,2,0,0,2,Senators,1,1,3,0,5,20141229,1,0,3,3,7,3,2014,0,0,219,0
Penguins,1,0,0,0,1,Devils,0,2,1,0,3,20141229,-1,1,2,2,4,2,2014,0,0,306,0
Canadiens,0,1,0,1,2,Panthers,0,0,1,0,1,20141230,0,1,0,1,3,-1,2014,1,1,1418,0
Blues,0,2,0,0,2,Predators,1,1,1,0,3,20141230,1,0,1,1,5,1,2014,0,1,253,0
Kings,0,0,2,0,2,Oilers,1,1,0,1,3,20141230,1,2,0,1,5,1,2014,1,1,1368,0
Canucks,1,2,0,0,3,Sharks,0,1,0,0,1,20141230,1,2,2,2,4,-2,2014,0,1,821,0
Flyers,1,0,2,0,3,Avalanche,0,2,1,1,4,20141231,-1,1,0,1,7,1,2014,1,2,1574,0
Sharks,1,0,2,0,3,Ducks,0,0,0,0,0,20141231,1,1,3,3,3,-3,2014,0,2,305,0
Coyotes,0,0,0,0,0,Stars,0,2,4,0,6,20141231,0,2,6,6,6,6,2014,0,2,884,0
Devils,0,1,0,0,1,Red Wings,0,1,2,0,3,20141231,0,0,2,2,4,2,2014,0,2,471,0
Rangers,1,2,2,0,5,Panthers,0,1,1,0,2,20141231,1,2,3,3,7,-3,2014,0,2,1091,0
Hurricanes,1,0,0,0,1,Penguins,1,0,1,0,2,20141231,0,0,1,1,3,1,2014,0,2,330,0
Maple Leafs,1,2,0,1,4,Bruins,0,3,0,0,3,20141231,1,0,0,1,7,-1,2014,1,2,430,0
Lightning,1,1,3,0,5,Sabres,1,0,0,0,1,20141231,0,1,4,4,6,-4,2014,0,2,1051,0
Oilers,1,1,1,0,3,Flames,0,1,2,1,4,20141231,-1,-1,0,1,7,1,2014,1,2,171,0
Wild,1,0,0,0,1,Blue Jackets,0,1,2,0,3,20141231,-1,0,2,2,4,2,2014,0,2,626,0
Islanders,2,1,2,0,5,Jets,0,1,1,0,2,20141231,2,2,3,3,7,-3,2014,0,2,1287,0
Blackhawks,1,1,0,0,2,Capitals,2,0,1,0,3,20150101,1,0,1,1,5,1,2014,0,3,594,0
Kings,0,1,2,0,3,Canucks,1,1,0,0,2,20150101,-1,-1,1,1,5,-1,2014,0,3,1076,0
Panthers,2,0,0,0,2,Sabres,0,0,0,0,0,20150102,2,2,2,2,2,-2,2014,0,4,1184,0
Blues,0,3,0,0,3,Ducks,1,2,1,0,4,20150102,1,0,1,1,7,1,2014,0,4,1586,0
Oilers,0,0,1,0,1,Avalanche,0,1,0,1,2,20150102,0,1,0,1,3,1,2014,1,4,1036,0
Islanders,1,0,1,0,2,Flames,0,0,1,0,1,20150102,1,1,1,1,3,-1,2014,0,4,2023,0
Canadiens,0,2,2,0,4,Devils,0,0,2,0,2,20150102,0,2,2,2,6,-2,2014,0,4,342,0
Flyers,0,0,1,0,1,Hurricanes,1,1,0,0,2,20150102,1,2,1,1,3,1,2014,0,4,345,0
Lightning,1,1,1,0,3,Penguins,3,1,2,0,6,20150102,2,2,3,3,9,3,2014,0,4,874,0
Maple Leafs,0,0,1,0,1,Wild,0,1,2,0,3,20150102,0,1,2,2,4,2,2014,0,4,691,0
Senators,0,1,1,1,3,Bruins,0,1,1,0,2,20150103,0,0,0,1,5,-1,2014,1,5,320,0
Predators,3,2,1,1,7,Kings,1,2,3,0,6,20150103,2,2,0,1,13,-1,2014,1,5,1776,0
Maple Leafs,0,1,0,0,1,Jets,0,3,2,0,5,20150103,0,2,4,4,6,4,2014,0,5,946,0
Canadiens,2,1,1,0,4,Penguins,1,0,0,0,1,20150103,1,2,3,3,5,-3,2014,0,5,474,0
Flyers,0,1,1,0,2,Devils,3,2,0,0,5,20150103,3,4,3,3,7,3,2014,0,5,75,0
Blue Jackets,0,2,1,0,3,Coyotes,1,3,2,0,6,20150103,1,2,3,3,9,3,2014,0,5,1664,0
Wild,0,1,0,0,1,Stars,1,5,1,0,7,20150103,1,5,6,6,8,6,2014,0,5,863,0
Red Wings,0,0,1,0,1,Canucks,0,1,3,0,4,20150103,0,1,3,3,5,3,2014,0,5,1967,0
Blues,2,2,3,0,7,Sharks,2,0,0,0,2,20150103,0,2,5,5,9,-5,2014,0,5,1719,0
Sabres,0,1,0,0,1,Rangers,4,2,0,0,6,20150103,4,5,5,5,7,5,2014,0,5,292,0
Predators,0,3,0,0,3,Ducks,1,1,1,1,4,20150104,1,-1,0,1,7,1,2014,1,6,1776,0
Islanders,0,1,1,0,2,Oilers,1,1,3,0,5,20150104,1,1,3,3,7,3,2014,0,6,2024,0
Stars,1,2,1,0,4,Blackhawks,1,2,1,1,5,20150104,0,0,0,1,9,1,2014,1,6,802,0
Lightning,0,3,1,0,4,Senators,1,1,0,0,2,20150104,-1,1,2,2,6,-2,2014,0,6,1251,0
Bruins,0,1,0,0,1,Hurricanes,1,0,0,1,2,20150104,1,0,0,1,3,1,2014,1,6,609,0
Blue Jackets,1,2,1,0,4,Avalanche,1,2,0,0,3,20150104,0,0,1,1,7,-1,2014,0,6,1163,0
Panthers,0,2,1,0,3,Capitals,0,3,1,0,4,20150104,0,1,1,1,7,1,2014,0,6,924,0
Sharks,1,1,1,0,3,Jets,1,0,1,0,2,20150105,0,1,1,1,5,-1,2014,0,0,1496,0
Islanders,1,0,1,0,2,Canucks,1,2,0,0,3,20150106,0,2,1,1,5,1,2014,0,1,2429,0
Blues,1,3,2,0,6,Coyotes,0,0,0,0,0,20150106,1,4,6,6,6,-6,2014,0,1,1270,0
Avalanche,2,0,0,0,2,Blackhawks,0,0,0,0,0,20150106,2,2,2,2,2,-2,2014,0,1,916,0
Blue Jackets,2,1,1,0,4,Stars,0,2,0,0,2,20150106,2,1,2,2,6,-2,2014,0,1,912,0
Red Wings,0,2,2,0,4,Oilers,1,0,1,0,2,20150106,-1,1,2,2,6,-2,2014,0,1,1592,0
Hurricanes,1,0,1,0,2,Predators,0,0,3,0,3,20150106,-1,-1,1,1,5,1,2014,0,1,456,0
Lightning,0,4,0,0,4,Canadiens,1,0,1,0,2,20150106,-1,3,2,2,6,-2,2014,0,1,1311,0
Senators,0,0,1,0,1,Flyers,0,0,1,1,2,20150106,0,0,0,1,3,1,2014,1,1,373,0
Sabres,0,1,0,0,1,Devils,3,0,1,0,4,20150106,3,2,3,3,5,3,2014,0,1,284,0
Sharks,0,1,2,1,4,Wild,2,0,1,0,3,20150106,-2,-1,0,1,7,-1,2014,1,1,1570,0
Capitals,1,3,2,0,6,Maple Leafs,0,2,0,0,2,20150107,1,2,4,4,8,-4,2014,0,2,349,0
Bruins,1,1,0,1,3,Penguins,1,0,1,0,2,20150107,0,1,0,1,5,-1,2014,1,2,481,0
Red Wings,1,1,1,0,3,Flames,1,0,1,0,2,20150107,0,1,1,1,5,-1,2014,0,2,1573,0
Rangers,0,1,3,0,4,Ducks,0,0,1,0,1,20150107,0,1,3,3,5,-3,2014,0,2,2445,0
Jets,0,0,1,0,1,Coyotes,2,1,1,0,4,20150108,2,3,3,3,5,3,2014,0,3,1365,0
Rangers,1,3,0,0,4,Kings,2,0,1,0,3,20150108,-1,2,1,1,7,-1,2014,0,3,2445,0
Panthers,1,2,0,0,3,Canucks,1,0,0,0,1,20150108,0,2,2,2,4,-2,2014,0,3,2803,0
Senators,0,1,1,0,2,Avalanche,2,1,2,0,5,20150108,2,2,3,3,7,3,2014,0,3,1515,0
Capitals,1,0,1,0,2,Flyers,1,0,1,1,3,20150108,0,0,0,1,5,1,2014,1,3,123,0
Sharks,1,1,0,0,2,Blues,3,2,2,0,7,20150108,2,3,5,5,9,5,2014,0,3,1719,0
Blackhawks,2,0,2,0,4,Wild,0,1,1,0,2,20150108,2,1,2,2,6,-2,2014,0,3,355,0
Sabres,0,1,1,0,2,Hurricanes,0,4,1,0,5,20150108,0,3,3,3,7,3,2014,0,3,491,0
Stars,0,2,0,0,2,Predators,1,1,0,1,3,20150108,1,0,0,1,5,1,2014,1,3,616,0
Devils,0,0,0,0,0,Bruins,1,1,1,0,3,20150108,1,2,3,3,3,3,2014,0,3,196,0
Islanders,0,0,2,1,3,Devils,0,1,1,0,2,20150109,0,-1,0,1,5,-1,2014,1,4,8,0
Sabres,0,1,0,0,1,Lightning,1,0,1,0,2,20150109,1,0,1,1,3,1,2014,0,4,1051,0
Blue Jackets,1,1,0,0,2,Maple Leafs,4,0,1,0,5,20150109,3,2,3,3,7,3,2014,0,4,313,0
Panthers,2,2,2,0,6,Flames,2,2,1,0,5,20150109,0,0,1,1,11,-1,2014,0,4,2493,0
Blackhawks,1,1,0,0,2,Oilers,2,1,2,0,5,20150109,1,1,3,3,7,3,2014,0,4,1437,0
Hurricanes,3,1,0,0,4,Blues,1,2,1,1,5,20150110,-2,-1,0,1,9,1,2014,1,5,665,0
Flames,1,0,0,0,1,Canucks,0,0,0,0,0,20150110,1,1,1,1,1,-1,2014,0,5,426,0
Jets,3,0,1,1,5,Kings,2,0,2,0,4,20150110,1,1,0,1,9,-1,2014,1,5,1527,0
Rangers,2,0,1,0,3,Sharks,0,0,1,0,1,20150110,2,2,2,2,4,-2,2014,0,5,2549,0
Islanders,1,3,1,0,5,Blue Jackets,1,0,1,0,2,20150110,0,3,3,3,7,-3,2014,0,5,476,0
Senators,2,1,2,0,5,Coyotes,1,0,0,0,1,20150110,1,2,4,4,6,-4,2014,0,5,2071,0
Penguins,0,1,0,1,2,Canadiens,1,0,0,0,1,20150110,-1,0,0,1,3,-1,2014,1,5,474,0
Stars,2,0,1,0,3,Avalanche,0,3,1,0,4,20150110,-2,1,1,1,7,1,2014,0,5,661,0
Predators,1,0,2,0,3,Wild,1,0,0,0,1,20150110,0,0,2,2,4,-2,2014,0,5,696,0
Bruins,1,0,2,0,3,Flyers,0,0,1,0,1,20150110,1,1,2,2,4,-2,2014,0,5,270,0
Red Wings,0,1,0,0,1,Capitals,1,2,0,0,3,20150110,1,2,2,2,4,2,2014,0,5,394,0
Panthers,1,1,2,0,4,Oilers,0,1,1,0,2,20150111,1,1,2,2,6,-2,2014,0,6,2569,0
Wild,0,0,1,0,1,Blackhawks,2,2,0,0,4,20150111,2,4,3,3,5,3,2014,0,6,355,0
Jets,3,1,0,0,4,Ducks,1,1,2,1,5,20150111,-2,-2,0,1,9,1,2014,1,6,1527,0
Lightning,1,1,1,0,3,Flyers,2,5,0,0,7,20150112,1,5,4,4,10,4,2014,0,0,928,0
Avalanche,0,1,0,0,1,Capitals,1,1,0,0,2,20150112,1,1,1,1,3,1,2014,0,0,1489,0
Maple Leafs,0,0,0,0,0,Kings,1,0,1,0,2,20150112,1,1,2,2,2,2,2014,0,0,2170,0
Senators,3,0,1,0,4,Stars,1,4,0,0,5,20150113,-2,2,1,1,9,1,2014,0,1,1404,0
Canucks,0,1,0,0,1,Predators,2,0,3,0,5,20150113,2,1,4,4,6,4,2014,0,1,2030,0
Oilers,0,0,2,0,2,Blues,2,1,1,0,4,20150113,2,3,2,2,6,2,2014,0,1,1508,0
Panthers,0,1,1,0,2,Jets,2,4,2,0,8,20150113,2,5,6,6,10,6,2014,0,1,1899,0
Sharks,0,2,1,0,3,Coyotes,1,1,0,0,2,20150113,-1,0,1,1,5,-1,2014,0,1,614,0
Wild,0,1,1,0,2,Penguins,2,1,4,0,7,20150113,2,2,5,5,9,5,2014,0,1,741,0
Islanders,0,3,0,0,3,Rangers,0,0,0,0,0,20150113,0,3,3,3,3,-3,2014,0,1,0,0
Red Wings,1,2,0,0,3,Sabres,0,1,0,0,1,20150113,1,2,2,2,4,-2,2014,0,1,215,0
Lightning,1,1,1,0,3,Bruins,1,2,1,0,4,20150113,0,1,1,1,7,1,2014,0,1,1183,0
Avalanche,0,0,2,0,2,Hurricanes,1,1,0,1,3,20150113,1,2,0,1,5,1,2014,1,1,1459,0
Canadiens,0,0,3,0,3,Blue Jackets,1,0,1,0,2,20150114,-1,-1,1,1,5,-1,2014,0,2,605,0
Flyers,0,0,0,0,0,Capitals,1,0,0,0,1,20150114,1,1,1,1,1,1,2014,0,2,123,0
Maple Leafs,0,0,0,0,0,Ducks,1,2,1,0,4,20150114,1,3,4,4,4,4,2014,0,2,2170,0
Devils,1,4,0,0,5,Kings,0,1,2,0,3,20150114,1,4,2,2,8,-2,2014,0,2,2436,0
Maple Leafs,1,0,0,0,1,Sharks,2,0,1,0,3,20150115,1,1,2,2,4,2,2014,0,3,2249,0
Flames,0,1,3,0,4,Coyotes,0,1,0,0,1,20150115,0,0,3,3,5,-3,2014,0,3,1224,0
Jets,1,0,1,0,2,Stars,0,0,1,0,1,20150115,1,1,1,1,3,-1,2014,0,3,1183,0
Red Wings,0,2,0,1,3,Blues,0,0,2,0,2,20150115,0,2,0,1,5,-1,2014,1,3,454,0
Canadiens,1,0,0,0,1,Senators,2,1,1,0,4,20150115,1,2,3,3,5,3,2014,0,3,104,0
Oilers,1,1,0,0,2,Lightning,0,1,2,0,3,20150115,-1,-1,1,1,5,1,2014,0,3,2367,0
Canucks,2,2,0,0,4,Flyers,0,0,0,0,0,20150115,2,4,4,4,4,-4,2014,0,3,2404,0
Wild,2,3,2,0,7,Sabres,0,0,0,0,0,20150115,2,5,7,7,7,-7,2014,0,3,729,0
Rangers,0,0,0,0,0,Bruins,1,1,1,0,3,20150115,1,2,3,3,3,3,2014,0,3,190,0
Avalanche,1,1,2,0,4,Panthers,1,1,0,0,2,20150115,0,0,2,2,6,-2,2014,0,3,1724,0
Penguins,2,1,0,0,3,Islanders,1,1,4,0,6,20150116,-1,-1,3,3,9,3,2014,0,4,314,0
Rangers,0,2,0,0,2,Blue Jackets,0,0,1,0,1,20150116,0,2,1,1,3,-1,2014,0,4,476,0
Canucks,0,3,0,0,3,Hurricanes,0,0,0,0,0,20150116,0,3,3,3,3,-3,2014,0,4,2409,0
Capitals,0,2,1,0,3,Predators,1,1,2,0,4,20150116,1,0,1,1,7,1,2014,0,4,566,0
Jets,1,0,3,0,4,Blackhawks,1,0,1,0,2,20150116,0,0,2,2,6,-2,2014,0,4,722,0
Devils,1,0,0,0,1,Ducks,1,2,2,0,5,20150116,0,2,4,4,6,4,2014,0,4,2436,0
Blue Jackets,1,0,2,0,3,Bruins,1,0,0,0,1,20150117,0,0,2,2,4,-2,2014,0,5,642,0
Maple Leafs,0,0,0,0,0,Blues,1,0,2,0,3,20150117,1,1,3,3,3,3,2014,0,5,659,0
Islanders,0,2,2,0,4,Canadiens,1,2,3,0,6,20150117,1,1,2,2,10,2,2014,0,5,343,0
Hurricanes,1,0,2,0,3,Senators,0,1,1,0,2,20150117,1,0,1,1,5,-1,2014,0,5,673,0
Predators,1,0,1,0,2,Red Wings,3,2,0,0,5,20150117,2,4,3,3,7,3,2014,0,5,470,0
Avalanche,0,1,1,0,2,Lightning,1,0,1,1,3,20150117,1,0,0,1,5,1,2014,1,5,1521,0
Oilers,0,1,1,1,3,Panthers,0,2,0,0,2,20150117,0,-1,0,1,5,-1,2014,1,5,2569,0
Capitals,0,2,2,0,4,Stars,2,1,2,0,5,20150117,2,1,1,1,9,1,2014,0,5,1181,0
Coyotes,0,1,0,0,1,Wild,1,1,1,0,3,20150117,1,1,2,2,4,2,2014,0,5,1278,0
Flames,2,1,0,1,4,Sharks,0,3,0,0,3,20150117,2,0,0,1,7,-1,2014,1,5,1027,0
Ducks,0,1,1,1,3,Kings,0,2,0,0,2,20150117,0,-1,0,1,5,-1,2014,1,5,0,0
Flyers,0,2,2,0,4,Sabres,1,1,1,0,3,20150117,-1,0,1,1,7,-1,2014,0,5,279,0
Sabres,3,0,1,0,4,Red Wings,0,3,3,0,6,20150118,-3,0,2,2,10,2,2014,0,6,215,0
Stars,3,0,3,0,6,Blackhawks,2,1,0,0,3,20150118,1,0,3,3,9,-3,2014,0,6,802,0
Rangers,2,2,1,0,5,Penguins,1,0,1,0,2,20150118,1,3,3,3,7,-3,2014,0,6,314,0
Coyotes,1,0,2,0,3,Jets,1,1,1,1,4,20150118,0,1,0,1,7,1,2014,1,6,1365,0
Flyers,0,2,2,0,4,Islanders,2,3,2,0,7,20150119,2,3,3,3,11,3,2014,0,0,80,0
Hurricanes,2,1,1,0,4,Maple Leafs,0,0,1,0,1,20150119,2,3,3,3,5,-3,2014,0,0,544,0
Canucks,2,0,0,0,2,Panthers,0,0,1,0,1,20150119,2,2,1,1,3,-1,2014,0,0,2803,0
Blue Jackets,1,0,2,0,3,Wild,1,0,0,0,1,20150119,0,0,2,2,4,-2,2014,0,0,626,0
Avalanche,1,0,0,0,1,Blues,1,2,0,0,3,20150119,0,2,2,2,4,2,2014,0,0,794,0
Devils,2,1,2,0,5,Sharks,1,1,0,0,2,20150119,1,1,3,3,7,-3,2014,0,0,2540,0
Flames,0,0,1,1,2,Kings,0,0,1,0,1,20150119,0,0,0,1,3,-1,2014,1,0,1197,0
Bruins,0,2,1,0,3,Stars,0,1,0,0,1,20150120,0,1,2,2,4,-2,2014,0,1,1548,0
Coyotes,0,1,0,0,1,Blackhawks,2,3,1,0,6,20150120,2,4,5,5,7,5,2014,0,1,1450,0
Canucks,0,0,1,0,1,Lightning,0,1,3,0,4,20150120,0,1,3,3,5,3,2014,0,1,2598,0
Penguins,0,1,1,0,2,Flyers,1,0,1,1,3,20150120,1,0,0,1,5,1,2014,1,1,257,0
Predators,0,1,0,0,1,Canadiens,0,0,1,1,2,20150120,0,-1,0,1,3,1,2014,1,1,937,0
Oilers,1,1,2,1,5,Capitals,3,0,1,0,4,20150120,-2,-1,0,1,9,-1,2014,1,1,1985,0
Senators,0,2,0,0,2,Rangers,0,1,1,1,3,20150120,0,-1,0,1,5,1,2014,1,1,334,0
Wild,1,0,3,0,4,Red Wings,2,2,0,1,5,20150120,1,3,0,1,9,1,2014,1,1,542,0
Maple Leafs,0,1,2,0,3,Senators,3,0,1,0,4,20150121,3,2,1,1,7,1,2014,0,2,203,0
Blackhawks,1,1,0,1,3,Penguins,0,2,0,0,2,20150121,1,0,0,1,5,-1,2014,1,2,409,0
Blue Jackets,0,0,0,0,0,Jets,2,2,0,0,4,20150121,2,4,4,4,4,4,2014,0,2,975,0
Bruins,0,1,1,0,2,Avalanche,1,0,1,1,3,20150121,1,0,0,1,5,1,2014,1,2,1765,0
Flames,0,2,1,0,3,Ducks,3,1,2,0,6,20150121,3,2,3,3,9,3,2014,0,2,1197,0
Kings,0,1,1,0,2,Sharks,1,1,2,0,4,20150121,1,1,2,2,6,2,2014,0,2,305,0
Stars,1,1,0,0,2,Canadiens,2,1,0,0,3,20150127,1,1,1,1,5,1,2014,0,1,1505,0
Ducks,1,1,2,0,4,Canucks,0,0,0,0,0,20150127,1,2,4,4,4,-4,2014,0,1,1076,0
Wild,1,0,1,0,2,Oilers,0,1,0,0,1,20150127,1,0,1,1,3,-1,2014,0,1,1083,0
Sabres,1,0,0,0,1,Flames,1,0,3,0,4,20150127,0,0,3,3,5,3,2014,0,1,1731,0
Avalanche,1,1,1,0,3,Predators,0,2,1,1,4,20150127,-1,0,0,1,7,1,2014,1,1,1019,0
Capitals,0,2,1,0,3,Blue Jackets,0,3,1,0,4,20150127,0,1,1,1,7,1,2014,0,1,326,0
Red Wings,1,4,0,0,5,Panthers,2,1,1,0,4,20150127,-1,2,1,1,9,-1,2014,0,1,1155,0
Jets,0,2,1,0,3,Penguins,1,1,3,0,5,20150127,1,0,2,2,8,2,2014,0,1,1060,0
Coyotes,2,1,0,0,3,Flyers,1,2,0,1,4,20150127,-1,0,0,1,7,1,2014,1,1,2078,0
Rangers,0,0,1,0,1,Islanders,1,1,2,0,4,20150127,1,2,3,3,5,3,2014,0,1,0,0
Lightning,1,1,0,0,2,Hurricanes,2,1,1,0,4,20150127,1,1,2,2,6,2,2014,0,1,585,0
Maple Leafs,0,0,1,0,1,Devils,0,0,1,1,2,20150128,0,0,0,1,3,1,2014,1,2,333,0
Penguins,0,0,0,0,0,Capitals,1,1,2,0,4,20150128,1,2,4,4,4,4,2014,0,2,190,0
Blackhawks,2,0,1,0,3,Kings,1,1,2,0,4,20150128,-1,0,1,1,7,1,2014,0,2,1741,0
Sabres,1,0,1,0,2,Oilers,2,0,1,0,3,20150129,1,1,1,1,5,1,2014,0,3,1734,0
Predators,1,2,1,0,4,Blues,0,4,0,1,5,20150129,-1,1,0,1,9,1,2014,1,3,253,0
Ducks,1,0,2,0,3,Sharks,1,5,0,0,6,20150129,0,5,3,3,9,3,2014,0,3,305,0
Blue Jackets,0,2,0,0,2,Panthers,0,2,1,0,3,20150129,0,0,1,1,5,1,2014,0,3,993,0
Wild,1,0,0,0,1,Flames,0,0,0,0,0,20150129,1,1,1,1,1,-1,2014,0,3,1043,0
Stars,3,0,3,0,6,Senators,2,0,1,0,3,20150129,1,1,3,3,9,-3,2014,0,3,1404,0
Coyotes,0,0,3,0,3,Maple Leafs,1,0,0,0,1,20150129,-1,-1,2,2,4,-2,2014,0,3,1885,0
Bruins,2,1,2,0,5,Islanders,0,2,0,0,2,20150129,2,1,3,3,7,-3,2014,0,3,190,0
Jets,2,0,0,0,2,Flyers,2,1,2,0,5,20150129,0,1,3,3,7,3,2014,0,3,1273,0
Canadiens,0,0,1,0,1,Rangers,0,0,0,0,0,20150129,0,0,1,1,1,-1,2014,0,3,343,0
Red Wings,1,0,0,0,1,Lightning,2,3,0,0,5,20150129,1,4,4,4,6,4,2014,0,3,994,0
Penguins,0,0,1,1,2,Devils,0,0,1,0,1,20150130,0,0,0,1,3,-1,2014,1,4,306,0
Blues,2,0,0,1,3,Hurricanes,1,1,0,0,2,20150130,1,0,0,1,5,-1,2014,1,4,665,0
Predators,0,0,0,0,0,Avalanche,1,0,2,0,3,20150130,1,1,3,3,3,3,2014,0,4,1019,0
Sabres,1,1,0,0,2,Canucks,1,2,2,0,5,20150130,0,1,3,3,7,3,2014,0,4,2137,0
Blackhawks,1,2,1,0,4,Ducks,0,0,1,0,1,20150130,1,3,3,3,5,-3,2014,0,4,1741,0
Blackhawks,0,0,0,0,0,Sharks,1,0,1,0,2,20150131,1,1,2,2,2,2,2014,0,5,1837,0
Oilers,2,0,0,0,2,Flames,0,0,4,0,4,20150131,-2,-2,2,2,6,2,2014,0,5,171,0
Blue Jackets,0,0,1,0,1,Lightning,1,0,2,0,3,20150131,1,1,2,2,4,2,2014,0,5,830,0
Stars,1,2,2,0,5,Jets,0,1,1,0,2,20150131,1,2,3,3,7,-3,2014,0,5,1183,0
Hurricanes,0,1,0,0,1,Rangers,2,0,2,0,4,20150131,2,1,3,3,5,3,2014,0,5,423,0
Maple Leafs,0,0,0,0,0,Flyers,1,0,0,0,1,20150131,1,1,1,1,1,1,2014,0,5,334,0
Kings,0,0,1,0,1,Bruins,0,1,2,0,3,20150131,0,1,2,2,4,2,2014,0,5,2590,0
Coyotes,1,0,1,0,2,Senators,1,2,4,0,7,20150131,0,2,5,5,9,5,2014,0,5,2071,0
Islanders,0,0,1,0,1,Red Wings,1,1,2,0,4,20150131,1,2,3,3,5,3,2014,0,5,480,0
Panthers,0,0,1,0,1,Devils,2,0,1,0,3,20150131,2,2,2,2,4,2,2014,0,5,1090,0
Capitals,0,0,0,0,0,Canadiens,0,0,0,1,1,20150131,0,0,0,1,1,1,2014,1,5,495,0
Wild,0,2,2,0,4,Canucks,0,0,2,0,2,20150201,0,2,2,2,6,-2,2014,0,6,1427,0
Coyotes,0,1,2,0,3,Canadiens,2,0,0,0,2,20150201,-2,-1,1,1,5,-1,2014,0,6,2175,0
Blues,1,2,1,0,4,Capitals,1,1,1,0,3,20150201,0,1,1,1,7,-1,2014,0,6,708,0
Predators,2,1,1,0,4,Penguins,0,0,0,0,0,20150201,2,3,4,4,4,-4,2014,0,6,471,0
Panthers,1,2,0,0,3,Rangers,1,2,3,0,6,20150202,0,0,3,3,9,3,2014,0,0,1091,0
Jets,1,0,1,0,2,Flames,1,1,3,0,5,20150202,0,1,3,3,7,3,2014,0,0,740,0
Oilers,1,2,1,1,5,Sharks,1,0,3,0,4,20150202,0,2,0,1,9,-1,2014,1,0,1190,0
Avalanche,0,0,2,1,3,Stars,1,1,0,0,2,20150203,-1,-2,0,1,5,-1,2014,1,1,661,0
Blackhawks,0,0,0,0,0,Wild,2,1,0,0,3,20150203,2,3,3,3,3,3,2014,0,1,355,0
Jets,1,0,1,0,2,Canucks,1,0,1,1,3,20150203,0,0,0,1,5,1,2014,1,1,1157,0
Hurricanes,0,2,2,0,4,Ducks,0,2,2,1,5,20150203,0,0,0,1,9,1,2014,1,1,2231,0
Lightning,1,0,0,0,1,Blues,0,0,1,1,2,20150203,-1,-1,0,1,3,1,2014,1,1,861,0
Kings,0,0,0,0,0,Capitals,1,1,2,0,4,20150203,1,2,4,4,4,4,2014,0,1,2294,0
Sabres,3,0,0,0,3,Canadiens,1,0,1,0,2,20150203,2,2,1,1,5,-1,2014,0,1,311,0
Coyotes,1,2,1,0,4,Blue Jackets,0,1,0,0,1,20150203,1,2,3,3,5,-3,2014,0,1,1664,0
Panthers,1,1,2,0,4,Islanders,1,1,0,0,2,20150203,0,0,2,2,6,-2,2014,0,1,1091,0
Senators,0,1,0,0,1,Devils,0,1,1,0,2,20150203,0,0,1,1,3,1,2014,0,1,330,0
Maple Leafs,0,1,2,0,3,Predators,2,0,2,0,4,20150203,2,1,1,1,7,1,2014,0,1,646,0
Bruins,2,0,0,0,2,Rangers,1,2,0,0,3,20150204,-1,1,1,1,5,1,2014,0,2,190,0
Penguins,0,2,0,0,2,Oilers,0,0,0,0,0,20150204,0,2,2,2,2,-2,2014,0,2,1797,0
Sharks,0,0,1,0,1,Flames,0,3,0,0,3,20150204,0,3,2,2,4,2,2014,0,2,1027,0
Sharks,1,2,2,0,5,Canucks,0,0,1,0,1,20150205,1,3,4,4,6,-4,2014,0,3,821,0
Hurricanes,1,0,0,1,2,Coyotes,1,0,0,0,1,20150205,0,0,0,1,3,-1,2014,1,3,1898,0
Red Wings,0,1,2,0,3,Avalanche,0,0,0,0,0,20150205,0,1,3,3,3,-3,2014,0,3,1154,0
Lightning,2,0,3,0,5,Stars,0,2,1,0,3,20150205,2,0,2,2,8,-2,2014,0,3,916,0
Kings,1,0,1,0,2,Panthers,1,0,2,0,3,20150205,0,0,1,1,5,1,2014,0,3,2335,0
Capitals,0,2,0,0,2,Senators,0,1,0,0,1,20150205,0,1,1,1,3,-1,2014,0,3,446,0
Islanders,0,2,0,1,3,Flyers,1,1,0,0,2,20150205,-1,0,0,1,5,-1,2014,1,3,80,0
Blues,0,1,2,0,3,Sabres,0,0,0,0,0,20150205,0,1,3,3,3,-3,2014,0,3,660,0
Ducks,2,2,1,0,5,Predators,0,0,2,0,2,20150205,2,4,3,3,7,-3,2014,0,3,1776,0
Maple Leafs,0,0,1,0,1,Devils,1,2,1,0,4,20150206,1,3,3,3,5,3,2014,0,4,333,0
Ducks,1,0,1,0,2,Capitals,0,1,1,1,3,20150206,-1,0,0,1,5,1,2014,1,4,2294,0
Blues,0,1,0,0,1,Blue Jackets,2,3,2,0,7,20150206,2,4,6,6,8,6,2014,0,4,395,0
Blackhawks,0,1,0,1,2,Jets,1,0,0,0,1,20150206,-1,0,0,1,3,-1,2014,1,4,722,0
Penguins,2,1,1,0,4,Flames,0,0,0,0,0,20150206,2,3,4,4,4,-4,2014,0,4,1777,0
Red Wings,0,1,2,0,3,Coyotes,0,0,1,0,1,20150207,0,1,2,2,4,-2,2014,0,5,1687,0
Hurricanes,1,2,2,0,5,Sharks,0,1,3,0,4,20150207,1,2,1,1,9,-1,2014,0,5,2382,0
Penguins,0,0,0,0,0,Canucks,2,2,1,0,5,20150207,2,4,5,5,5,5,2014,0,5,2168,0
Blue Jackets,0,0,4,0,4,Senators,0,0,1,0,1,20150207,0,0,3,3,5,-3,2014,0,5,512,0
Avalanche,0,0,0,0,0,Wild,1,0,0,0,1,20150207,1,1,1,1,1,1,2014,0,5,698,0
Oilers,0,0,1,0,1,Maple Leafs,0,3,2,0,5,20150207,0,3,4,4,6,4,2014,0,5,1683,0
Devils,1,0,1,0,2,Canadiens,0,3,3,0,6,20150207,-1,2,4,4,8,4,2014,0,5,342,0
Kings,3,0,1,0,4,Lightning,0,1,1,0,2,20150207,3,2,2,2,6,-2,2014,0,5,2149,0
Rangers,0,1,1,0,2,Predators,0,2,1,0,3,20150207,0,1,1,1,5,1,2014,0,5,758,0
Islanders,1,0,0,0,1,Bruins,1,0,1,0,2,20150207,0,0,1,1,3,1,2014,0,5,190,0
Stars,0,1,1,0,2,Sabres,1,2,0,0,3,20150207,1,2,1,1,5,1,2014,0,5,1197,0
Canadiens,0,1,2,0,3,Bruins,0,0,1,0,1,20150208,0,1,2,2,4,-2,2014,0,6,270,0
Avalanche,1,0,2,0,3,Jets,0,4,1,0,5,20150208,-1,3,2,2,8,2,2014,0,6,797,0
Stars,0,2,0,1,3,Rangers,0,1,1,0,2,20150208,0,1,0,1,5,-1,2014,1,6,1370,0
Blackhawks,1,1,2,0,4,Blues,0,2,0,0,2,20150208,1,0,2,2,6,-2,2014,0,6,260,0
Islanders,1,2,0,0,3,Sabres,0,2,0,0,2,20150208,1,1,1,1,5,-1,2014,0,6,292,0
Flyers,0,1,2,0,3,Capitals,0,1,0,0,1,20150208,0,0,2,2,4,-2,2014,0,6,123,0
Predators,0,0,2,1,3,Panthers,0,2,0,0,2,20150208,0,-2,0,1,5,-1,2014,1,6,816,0
Ducks,0,1,2,0,3,Lightning,3,1,1,0,5,20150208,3,3,2,2,8,2,2014,0,6,2149,0
Kings,2,1,1,0,4,Blue Jackets,1,1,1,0,3,20150209,1,1,1,1,7,-1,2014,0,0,1973,0
Canucks,1,1,1,0,3,Wild,3,2,0,0,5,20150209,2,3,2,2,8,2,2014,0,0,1427,0
Coyotes,0,1,1,1,3,Blackhawks,0,1,1,0,2,20150209,0,0,0,1,5,-1,2014,1,0,1450,0
Flames,1,1,2,0,4,Sharks,0,1,0,0,1,20150209,1,1,3,3,5,-3,2014,0,0,1027,0
Oilers,1,1,0,0,2,Devils,1,0,0,0,1,20150209,0,1,1,1,3,-1,2014,0,0,2016,0
Lightning,0,0,2,0,2,Predators,0,2,0,1,3,20150210,0,2,0,1,5,1,2014,1,1,621,0
Wild,0,0,1,0,1,Jets,0,0,1,1,2,20150210,0,0,0,1,3,1,2014,1,1,388,0
Coyotes,1,0,0,0,1,Blues,1,1,0,0,2,20150210,0,1,1,1,3,1,2014,0,1,1270,0
Ducks,0,2,0,0,2,Panthers,2,3,1,0,6,20150210,2,3,4,4,8,4,2014,0,1,2335,0
Rangers,2,2,1,0,5,Maple Leafs,1,1,2,0,4,20150210,1,2,1,1,9,-1,2014,0,1,341,0
Oilers,1,1,0,0,2,Islanders,1,1,1,0,3,20150210,0,0,1,1,5,1,2014,0,1,2024,0
Senators,1,0,1,0,2,Sabres,0,0,1,0,1,20150210,1,1,1,1,3,-1,2014,0,1,219,0
Stars,3,1,1,0,5,Bruins,1,2,0,0,3,20150210,2,1,2,2,8,-2,2014,0,1,1548,0
Flyers,1,0,0,0,1,Canadiens,0,0,1,1,2,20150210,-1,-1,0,1,3,1,2014,1,1,400,0
Red Wings,0,1,0,0,1,Penguins,2,2,0,0,4,20150211,2,3,3,3,5,3,2014,0,2,205,0
Canucks,0,3,1,1,5,Blackhawks,0,1,3,0,4,20150211,0,2,0,1,9,-1,2014,1,2,1775,0
Capitals,1,1,2,1,5,Sharks,0,3,1,0,4,20150211,1,-1,0,1,9,-1,2014,1,2,2416,0
Flames,0,2,1,0,3,Kings,1,1,3,0,5,20150212,1,0,2,2,8,2,2014,0,3,1197,0
Rangers,1,2,3,0,6,Avalanche,0,1,2,0,3,20150212,1,2,3,3,9,-3,2014,0,3,1627,0
Jets,1,0,0,0,1,Predators,1,1,1,0,3,20150212,0,1,2,2,4,2,2014,0,3,1084,0
Oilers,0,2,1,1,4,Canadiens,1,1,1,0,3,20150212,-1,0,0,1,7,-1,2014,1,3,1826,0
Blues,2,3,1,0,6,Lightning,0,2,1,0,3,20150212,2,3,3,3,9,-3,2014,0,3,861,0
Penguins,2,1,1,1,5,Senators,0,0,4,0,4,20150212,2,3,0,1,9,-1,2014,1,3,392,0
Ducks,0,2,0,0,2,Hurricanes,0,1,0,0,1,20150212,0,1,1,1,3,-1,2014,0,3,2231,0
Maple Leafs,0,2,0,0,2,Islanders,2,1,0,0,3,20150212,2,1,1,1,5,1,2014,0,3,341,0
Panthers,0,1,0,0,1,Wild,1,1,0,0,2,20150212,1,1,1,1,3,1,2014,0,3,1513,0
Bruins,1,0,1,0,2,Canucks,2,1,2,0,5,20150213,1,2,3,3,7,3,2014,0,4,2504,0
Sharks,0,2,2,0,4,Coyotes,2,0,0,0,2,20150213,-2,0,2,2,6,-2,2014,0,4,614,0
Panthers,0,0,0,0,0,Stars,2,0,0,0,2,20150213,2,2,2,2,2,2,2014,0,4,1110,0
Flyers,1,1,1,0,3,Blue Jackets,0,1,2,1,4,20150213,-1,-1,0,1,7,1,2014,1,4,414,0
Devils,1,0,0,0,1,Blackhawks,0,0,3,0,3,20150213,-1,-1,2,2,4,2,2014,0,4,703,0
Jets,1,2,1,1,5,Red Wings,1,2,1,0,4,20150214,0,0,0,1,9,-1,2014,1,5,855,0
Oilers,1,1,0,0,2,Senators,1,4,2,0,7,20150214,0,3,5,5,9,5,2014,0,5,1754,0
Maple Leafs,1,0,0,0,1,Canadiens,1,0,0,1,2,20150214,0,0,0,1,3,1,2014,1,5,303,0
Capitals,0,0,1,0,1,Kings,0,1,2,0,3,20150214,0,1,2,2,4,2,2014,0,5,2294,0
Stars,0,0,1,0,1,Avalanche,1,1,2,0,4,20150214,1,2,3,3,5,3,2014,0,5,661,0
Canucks,1,1,0,0,2,Flames,0,2,1,0,3,20150214,-1,0,1,1,5,1,2014,0,5,426,0
Rangers,0,1,4,0,5,Coyotes,0,1,0,0,1,20150214,0,0,4,4,6,-4,2014,0,5,2139,0
Devils,0,1,0,0,1,Predators,1,0,2,0,3,20150214,1,0,2,2,4,2,2014,0,5,750,0
Blue Jackets,2,1,0,0,3,Islanders,2,1,3,0,6,20150214,0,0,3,3,9,3,2014,0,5,476,0
Hurricanes,1,2,0,0,3,Wild,3,1,2,0,6,20150214,2,1,3,3,9,3,2014,0,5,995,0
Blues,0,1,0,1,2,Panthers,0,0,1,0,1,20150215,0,1,0,1,3,-1,2014,1,6,1061,0
Flyers,1,0,1,0,2,Sabres,0,1,0,0,1,20150215,1,0,1,1,3,-1,2014,0,6,279,0
Lightning,1,1,3,0,5,Sharks,0,1,1,0,2,20150215,1,1,3,3,7,-3,2014,0,6,2365,0
Capitals,2,2,1,0,5,Ducks,2,1,0,0,3,20150215,0,1,2,2,8,-2,2014,0,6,2294,0
Penguins,0,0,1,0,1,Blackhawks,0,1,0,1,2,20150215,0,1,0,1,3,1,2014,1,6,409,0
Coyotes,1,0,1,0,2,Avalanche,3,2,0,0,5,20150216,2,4,3,3,7,3,2014,0,0,585,0
Lightning,1,0,1,0,2,Kings,0,1,2,0,3,20150216,-1,0,1,1,5,1,2014,0,0,2149,0
Wild,1,0,1,0,2,Canucks,0,1,2,0,3,20150216,-1,0,1,1,5,1,2014,0,0,1427,0
Bruins,2,1,0,0,3,Flames,0,1,2,1,4,20150216,-2,-2,0,1,7,1,2014,1,0,2089,0
Hurricanes,1,3,2,0,6,Senators,1,2,0,0,3,20150216,0,1,3,3,9,-3,2014,0,0,673,0
Canadiens,0,0,2,0,2,Red Wings,0,0,0,0,0,20150216,0,0,2,2,2,-2,2014,0,0,508,0
Oilers,2,0,2,0,4,Jets,1,1,2,1,5,20150216,-1,0,0,1,9,1,2014,1,0,738,0
Rangers,1,2,3,0,6,Islanders,2,2,1,0,5,20150216,-1,-1,1,1,11,-1,2014,0,0,0,0
Islanders,1,1,2,0,4,Hurricanes,0,0,1,0,1,20150217,1,2,3,3,5,-3,2014,0,1,423,0
Blue Jackets,2,0,3,0,5,Flyers,0,2,0,0,2,20150217,2,0,3,3,7,-3,2014,0,1,414,0
Capitals,1,0,2,0,3,Penguins,0,1,0,0,1,20150217,1,0,2,2,4,-2,2014,0,1,190,0
Sabres,0,0,1,0,1,Devils,1,0,0,1,2,20150217,1,1,0,1,3,1,2014,1,1,284,0
Panthers,1,2,0,0,3,Maple Leafs,1,0,1,0,2,20150217,0,2,1,1,5,-1,2014,0,1,1234,0
Stars,3,1,0,0,4,Blues,0,0,1,0,1,20150217,3,4,3,3,5,-3,2014,0,1,547,0
Sharks,1,0,0,0,1,Predators,2,3,0,0,5,20150217,1,4,4,4,6,4,2014,0,1,1934,0
Kings,0,3,1,0,4,Avalanche,1,0,0,0,1,20150218,-1,2,3,3,5,-3,2014,0,2,830,0
Lightning,0,4,0,0,4,Ducks,1,0,0,0,1,20150218,-1,3,3,3,5,-3,2014,0,2,2149,0
Canadiens,0,1,1,0,2,Senators,0,2,2,0,4,20150218,0,1,2,2,6,2,2014,0,2,104,0
Wild,2,0,0,1,3,Flames,1,0,1,0,2,20150218,1,1,0,1,5,-1,2014,1,2,1043,0
Red Wings,0,1,1,1,3,Blackhawks,0,1,1,0,2,20150218,0,0,0,1,5,-1,2014,1,2,238,0
Bruins,1,2,0,0,3,Oilers,2,1,0,1,4,20150218,1,0,0,1,7,1,2014,1,2,2074,0
Sharks,1,2,2,0,5,Stars,0,1,1,0,2,20150219,1,2,3,3,7,-3,2014,0,3,1449,0
Jets,0,1,0,0,1,Capitals,2,2,1,0,5,20150219,2,3,4,4,6,4,2014,0,3,1247,0
Panthers,0,1,1,1,3,Canadiens,0,2,0,0,2,20150219,0,-1,0,1,5,-1,2014,1,3,1418,0
Canucks,0,2,2,1,5,Rangers,1,1,2,0,4,20150219,-1,0,0,1,9,-1,2014,1,3,2429,0
Predators,1,1,0,0,2,Islanders,3,0,2,0,5,20150219,2,1,3,3,7,3,2014,0,3,758,0
Sabres,1,1,0,1,3,Flyers,1,1,0,0,2,20150219,0,0,0,1,5,-1,2014,1,3,279,0
Blue Jackets,1,0,1,0,2,Penguins,0,1,0,0,1,20150219,1,0,1,1,3,-1,2014,0,3,161,0
Maple Leafs,1,0,0,0,1,Hurricanes,2,0,0,0,2,20150220,1,1,1,1,3,1,2014,0,4,544,0
Canucks,0,1,1,0,2,Devils,1,2,1,0,4,20150220,1,2,2,2,6,2,2014,0,4,2421,0
Rangers,1,2,0,0,3,Sabres,1,0,0,0,1,20150220,0,2,2,2,4,-2,2014,0,4,292,0
Bruins,1,0,0,0,1,Blues,0,4,1,0,5,20150220,-1,3,4,4,6,4,2014,0,4,1035,0
Avalanche,1,0,3,0,4,Blackhawks,0,1,0,0,1,20150220,1,0,3,3,5,-3,2014,0,4,916,0
Wild,2,1,1,0,4,Oilers,0,0,0,0,0,20150220,2,3,4,4,4,-4,2014,0,4,1083,0
Ducks,0,1,5,0,6,Flames,1,1,1,0,3,20150220,-1,-1,3,3,9,-3,2014,0,4,1197,0
Kings,1,0,1,0,2,Sharks,1,0,0,0,1,20150221,0,0,1,1,3,-1,2014,0,5,305,0
Penguins,1,2,1,0,4,Blues,0,0,2,0,2,20150221,1,3,2,2,6,-2,2014,0,5,557,0
Red Wings,1,1,4,1,7,Stars,1,3,2,0,6,20150221,0,-2,0,1,13,-1,2014,1,5,999,0
Ducks,1,0,1,0,2,Oilers,0,1,0,0,1,20150221,1,0,1,1,3,-1,2014,0,5,1368,0
Lightning,0,2,2,0,4,Coyotes,1,0,1,0,2,20150221,-1,1,2,2,6,-2,2014,0,5,1793,0
Panthers,1,0,0,0,1,Senators,1,1,2,0,4,20150221,0,1,3,3,5,3,2014,0,5,1370,0
Islanders,1,0,1,0,2,Capitals,1,0,1,1,3,20150221,0,0,0,1,5,1,2014,1,5,204,0
Blue Jackets,1,0,0,0,1,Canadiens,2,0,1,0,3,20150221,1,1,2,2,4,2,2014,0,5,605,0
Jets,2,1,0,0,3,Maple Leafs,1,1,1,1,4,20150221,-1,-1,0,1,7,1,2014,1,5,946,0
Predators,1,0,1,0,2,Flyers,1,1,0,1,3,20150221,0,1,0,1,5,1,2014,1,5,683,0
Hurricanes,0,0,1,0,1,Devils,3,0,0,0,3,20150221,3,3,2,2,4,2,2014,0,5,419,0
Stars,0,1,1,0,2,Wild,0,0,6,0,6,20150222,0,-1,4,4,8,4,2014,0,6,863,0
Blue Jackets,0,2,1,0,3,Rangers,2,1,0,1,4,20150222,2,1,0,1,7,1,2014,1,6,476,0
Lightning,1,1,2,0,4,Avalanche,1,3,1,0,5,20150222,0,2,1,1,9,1,2014,0,6,1521,0
Panthers,0,0,1,0,1,Penguins,1,1,3,0,5,20150222,1,2,4,4,6,4,2014,0,6,1013,0
Predators,0,0,1,1,2,Sabres,0,1,0,0,1,20150222,0,-1,0,1,3,-1,2014,1,6,626,0
Bruins,2,4,0,0,6,Blackhawks,1,0,1,0,2,20150222,1,5,4,4,8,-4,2014,0,6,849,0
Capitals,0,2,0,0,2,Flyers,1,1,1,0,3,20150222,1,0,1,1,5,1,2014,0,6,123,0
Canucks,0,3,1,0,4,Islanders,0,0,0,0,0,20150222,0,3,4,4,4,-4,2014,0,6,2429,0
Coyotes,0,0,0,0,0,Devils,1,0,2,0,3,20150223,1,1,3,3,3,3,2014,0,0,2131,0
Red Wings,0,2,1,0,3,Ducks,0,0,3,1,4,20150223,0,-2,0,1,7,1,2014,1,0,1979,0
Oilers,2,0,0,0,2,Wild,1,0,0,0,1,20150224,1,1,1,1,3,-1,2014,0,1,1083,0
Red Wings,0,0,0,0,0,Kings,1,0,0,0,1,20150224,1,1,1,1,1,1,2014,0,1,1979,0
Panthers,0,0,2,0,2,Blackhawks,1,1,0,1,3,20150224,1,2,0,1,5,1,2014,1,1,1189,0
Stars,0,1,1,0,2,Jets,1,1,2,0,4,20150224,1,1,2,2,6,2,2014,0,1,1183,0
Coyotes,0,1,0,0,1,Islanders,0,1,4,0,5,20150224,0,0,4,4,6,4,2014,0,1,2139,0
Canadiens,1,3,1,0,5,Blues,0,2,0,0,2,20150224,1,2,3,3,7,-3,2014,0,1,962,0
Flyers,1,0,0,0,1,Hurricanes,1,2,1,0,4,20150224,0,2,3,3,5,3,2014,0,1,345,0
Flames,0,0,0,0,0,Rangers,0,0,1,0,1,20150224,0,0,1,1,1,1,2014,0,1,2023,0
Canucks,1,0,1,0,2,Bruins,1,0,0,0,1,20150224,0,0,1,1,3,-1,2014,0,1,2504,0
Sabres,2,2,0,0,4,Blue Jackets,0,2,0,0,2,20150224,2,2,2,2,6,-2,2014,0,1,293,0
Avalanche,1,0,1,0,2,Predators,1,2,2,0,5,20150224,0,2,3,3,7,3,2014,0,1,1019,0
Flames,0,1,2,0,3,Devils,1,0,0,0,1,20150225,-1,0,2,2,4,-2,2014,0,2,2015,0
Penguins,2,1,1,0,4,Capitals,1,0,2,0,3,20150225,1,2,1,1,7,-1,2014,0,2,190,0
Senators,1,1,1,0,3,Ducks,0,0,0,0,0,20150225,1,2,3,3,3,-3,2014,0,2,2345,0
Red Wings,0,1,2,0,3,Sharks,1,1,0,0,2,20150226,-1,-1,1,1,5,-1,2014,0,3,2071,0
Senators,0,0,1,0,1,Kings,0,0,0,0,0,20150226,0,0,1,1,1,-1,2014,0,3,2345,0
Blues,0,1,0,1,2,Jets,0,0,1,0,1,20150226,0,1,0,1,3,-1,2014,1,3,853,0
Wild,1,2,1,0,4,Predators,0,2,0,0,2,20150226,1,1,2,2,6,-2,2014,0,3,696,0
Flyers,0,0,2,0,2,Maple Leafs,1,1,1,0,3,20150226,1,2,1,1,5,1,2014,0,3,334,0
Coyotes,3,0,0,0,3,Rangers,1,2,1,0,4,20150226,-2,0,1,1,7,1,2014,0,3,2139,0
Canadiens,3,0,2,0,5,Blue Jackets,1,0,1,0,2,20150226,2,2,3,3,7,-3,2014,0,3,605,0
Canucks,1,1,1,0,3,Sabres,1,1,4,0,6,20150226,0,0,3,3,9,3,2014,0,3,2137,0
Blackhawks,1,1,1,0,3,Panthers,0,0,0,0,0,20150226,1,2,3,3,3,-3,2014,0,3,1189,0
Bruins,1,0,1,1,3,Devils,0,0,2,0,2,20150227,1,1,0,1,5,-1,2014,1,4,196,0
Flames,0,0,1,0,1,Islanders,1,0,1,0,2,20150227,1,1,1,1,3,1,2014,0,4,2023,0
Capitals,0,0,0,0,0,Hurricanes,1,1,1,0,3,20150227,1,2,3,3,3,3,2014,0,4,233,0
Blackhawks,0,0,0,0,0,Lightning,0,2,2,0,4,20150227,0,2,4,4,4,4,2014,0,4,1004,0
Avalanche,0,1,3,1,5,Stars,0,2,2,0,4,20150227,0,-1,0,1,9,-1,2014,1,4,661,0
Kings,1,1,0,0,2,Ducks,0,0,4,0,4,20150227,-1,-2,2,2,6,2,2014,0,4,0,0
Senators,0,1,3,0,4,Sharks,1,1,0,0,2,20150228,-1,-1,2,2,6,-2,2014,0,5,2408,0
Wild,1,1,1,0,3,Avalanche,0,1,0,0,1,20150228,1,1,2,2,4,-2,2014,0,5,698,0
Blues,1,0,1,0,2,Oilers,0,1,0,0,1,20150228,1,0,1,1,3,-1,2014,0,5,1508,0
Rangers,1,1,0,0,2,Flyers,1,1,2,0,4,20150228,0,0,2,2,6,2,2014,0,5,80,0
Sabres,2,0,1,0,3,Panthers,0,3,2,0,5,20150228,-2,1,2,2,8,2,2014,0,5,1184,0
Coyotes,0,0,1,0,1,Bruins,2,2,0,0,4,20150228,2,4,3,3,5,3,2014,0,5,2295,0
Hurricanes,1,4,0,0,5,Islanders,1,1,1,0,3,20150228,0,3,2,2,8,-2,2014,0,5,423,0
Devils,1,0,1,0,2,Blue Jackets,0,0,0,0,0,20150228,1,1,2,2,2,-2,2014,0,5,467,0
Maple Leafs,0,0,0,0,0,Canadiens,2,0,2,0,4,20150228,2,2,4,4,4,4,2014,0,5,303,0
Red Wings,1,1,2,0,4,Predators,0,3,0,0,3,20150228,1,-1,1,1,7,-1,2014,0,5,470,0
Ducks,1,0,2,0,3,Stars,0,1,0,0,1,20150301,1,0,2,2,4,-2,2014,0,6,1237,0
Blues,2,0,3,0,5,Canucks,2,2,1,1,6,20150301,0,2,0,1,11,1,2014,1,6,1778,0
Blue Jackets,1,0,2,0,3,Penguins,1,3,1,0,5,20150301,0,3,2,2,8,2,2014,0,6,161,0
Lightning,1,0,2,0,3,Panthers,1,2,1,0,4,20150301,0,2,1,1,7,1,2014,0,6,205,0
Kings,0,1,1,0,2,Jets,1,3,1,0,5,20150301,1,3,3,3,7,3,2014,0,6,1527,0
Maple Leafs,0,0,0,0,0,Capitals,1,1,2,0,4,20150301,1,2,4,4,4,4,2014,0,6,349,0
Predators,0,1,0,0,1,Rangers,1,1,2,0,4,20150302,1,1,3,3,5,3,2014,0,0,758,0
Hurricanes,0,0,2,0,2,Blackhawks,1,3,1,0,5,20150302,1,4,3,3,7,3,2014,0,0,641,0
Canadiens,0,0,0,0,0,Sharks,2,1,1,0,4,20150302,2,3,4,4,4,4,2014,0,0,2508,0
Kings,2,2,1,0,5,Oilers,0,1,1,0,2,20150303,2,3,3,3,7,-3,2014,0,1,1368,0
Sharks,3,1,2,0,6,Canucks,0,2,0,0,2,20150303,3,2,4,4,8,-4,2014,0,1,821,0
Ducks,1,1,2,0,4,Coyotes,0,1,0,0,1,20150303,1,1,3,3,5,-3,2014,0,1,356,0
Islanders,1,0,1,0,2,Stars,0,0,2,1,3,20150303,-1,-1,0,1,5,1,2014,1,1,1370,0
Predators,0,1,0,0,1,Devils,2,0,1,0,3,20150303,2,1,2,2,4,2,2014,0,1,750,0
Maple Leafs,0,1,2,0,3,Panthers,1,1,0,0,2,20150303,-1,-1,1,1,5,-1,2014,0,1,1234,0
Sabres,0,0,0,0,0,Lightning,1,2,0,0,3,20150303,1,3,3,3,3,3,2014,0,1,1051,0
Capitals,2,1,2,0,5,Blue Jackets,0,2,1,0,3,20150303,2,1,2,2,8,-2,2014,0,1,326,0
Flames,1,1,0,1,3,Flyers,0,0,2,0,2,20150303,1,2,0,1,5,-1,2014,1,1,2003,0
Senators,0,2,0,0,2,Wild,0,2,0,1,3,20150303,0,0,0,1,5,1,2014,1,1,838,0
Senators,1,2,0,0,3,Jets,0,0,1,0,1,20150304,1,3,2,2,4,-2,2014,0,2,1033,0
Rangers,1,0,0,0,1,Red Wings,1,0,0,1,2,20150304,0,0,0,1,3,1,2014,1,2,480,0
Canadiens,0,0,1,0,1,Ducks,1,1,1,0,3,20150304,1,2,2,2,4,2,2014,0,2,2448,0
Penguins,0,0,1,0,1,Avalanche,0,2,1,0,3,20150304,0,2,2,2,4,2,2014,0,2,1317,0
Canadiens,0,2,1,0,3,Kings,2,0,1,1,4,20150305,2,0,0,1,7,1,2014,1,3,2448,0
Canucks,0,0,2,0,2,Coyotes,1,0,1,1,3,20150305,1,1,0,1,5,1,2014,1,3,1228,0
Islanders,2,0,2,0,4,Predators,1,0,2,0,3,20150305,1,1,1,1,7,-1,2014,0,3,758,0
Blues,1,0,0,0,1,Flyers,0,0,3,0,3,20150305,-1,-1,2,2,4,2,2014,0,3,808,0
Maple Leafs,0,1,1,0,2,Lightning,2,0,2,0,4,20150305,2,1,2,2,6,2,2014,0,3,1096,0
Wild,0,0,2,0,2,Capitals,1,0,0,0,1,20150305,-1,-1,1,1,3,-1,2014,0,3,931,0
Stars,2,0,1,1,4,Panthers,1,2,0,0,3,20150305,1,-1,0,1,7,-1,2014,1,3,1110,0
Flames,1,1,1,1,4,Bruins,1,1,1,0,3,20150305,0,0,0,1,7,-1,2014,1,3,2089,0
Penguins,0,3,2,0,5,Ducks,0,0,2,0,2,20150306,0,3,3,3,7,-3,2014,0,4,2132,0
Oilers,1,0,0,0,1,Blackhawks,0,0,1,1,2,20150306,-1,-1,0,1,3,1,2014,1,4,1437,0
Wild,1,0,2,0,3,Hurricanes,0,1,0,0,1,20150306,1,0,2,2,4,-2,2014,0,4,995,0
Sabres,2,0,0,0,2,Senators,0,1,2,0,3,20150306,-2,-1,1,1,5,1,2014,0,4,219,0
Blue Jackets,1,2,0,0,3,Devils,0,1,1,0,2,20150306,1,2,1,1,5,-1,2014,0,4,467,0
Flames,1,2,2,0,5,Red Wings,2,0,0,0,2,20150306,-1,1,3,3,7,-3,2014,0,4,1573,0
Flyers,0,1,1,0,2,Bruins,1,0,1,1,3,20150307,1,0,0,1,5,1,2014,1,5,270,0
Sabres,1,0,0,0,1,Capitals,1,3,2,0,6,20150307,0,3,5,5,7,5,2014,0,5,292,0
Blues,3,2,1,0,6,Maple Leafs,0,0,1,0,1,20150307,3,5,5,5,7,-5,2014,0,5,659,0
Canadiens,0,1,1,0,2,Coyotes,0,0,0,0,0,20150307,0,1,2,2,2,-2,2014,0,5,2175,0
Stars,1,2,1,0,4,Lightning,2,0,3,0,5,20150307,1,-1,1,1,9,1,2014,0,5,916,0
Islanders,0,2,1,0,3,Panthers,1,1,1,1,4,20150307,1,0,0,1,7,1,2014,1,5,1091,0
Avalanche,3,0,1,0,4,Blue Jackets,0,0,0,0,0,20150307,3,3,4,4,4,-4,2014,0,5,1163,0
Jets,1,1,1,0,3,Predators,0,1,0,0,1,20150307,1,1,2,2,4,-2,2014,0,5,1084,0
Penguins,0,0,0,1,1,Kings,0,0,0,0,0,20150307,0,0,0,1,1,-1,2014,1,5,2132,0
Canucks,1,1,1,0,3,Sharks,2,0,0,0,2,20150307,-1,0,1,1,5,-1,2014,0,5,821,0
Rangers,0,0,0,1,1,Blackhawks,0,0,0,0,0,20150308,0,0,0,1,1,-1,2014,1,6,711,0
Flames,0,0,4,0,4,Senators,2,2,0,1,5,20150308,2,4,0,1,9,1,2014,1,6,1773,0
Oilers,1,2,1,0,4,Hurricanes,0,3,4,0,7,20150308,-1,0,3,3,11,3,2014,0,6,2076,0
Flyers,1,0,1,0,2,Devils,1,2,2,0,5,20150308,0,2,3,3,7,3,2014,0,6,75,0
Red Wings,1,0,2,0,3,Bruins,2,2,1,0,5,20150308,1,3,2,2,8,2,2014,0,6,611,0
Avalanche,1,1,1,0,3,Wild,0,0,2,0,2,20150308,1,2,1,1,5,-1,2014,0,6,698,0
Islanders,0,0,3,1,4,Maple Leafs,1,1,1,0,3,20150309,-1,-2,0,1,7,-1,2014,1,0,341,0
Oilers,1,0,1,0,2,Red Wings,0,2,3,0,5,20150309,-1,1,3,3,7,3,2014,0,0,1592,0
Penguins,0,0,1,0,1,Sharks,1,0,0,1,2,20150309,1,1,0,1,3,1,2014,1,0,2242,0
Predators,0,1,0,1,2,Coyotes,0,0,1,0,1,20150309,0,1,0,1,3,-1,2014,1,0,1442,0
Ducks,0,0,1,0,1,Canucks,1,0,1,0,2,20150309,1,1,1,1,3,1,2014,0,0,1076,0
Jets,1,0,3,0,4,Blues,1,3,1,0,5,20150310,0,3,1,1,9,1,2014,0,1,853,0
Devils,0,1,1,0,2,Wild,1,3,2,0,6,20150310,1,3,4,4,8,4,2014,0,1,1007,0
Kings,3,1,1,0,5,Avalanche,1,0,1,0,2,20150310,2,3,3,3,7,-3,2014,0,1,830,0
Bruins,0,3,0,0,3,Senators,0,0,1,0,1,20150310,0,3,2,2,4,-2,2014,0,1,320,0
Blue Jackets,1,1,1,1,4,Hurricanes,3,0,0,0,3,20150310,-2,-1,0,1,7,-1,2014,1,1,374,0
Stars,1,0,1,0,2,Flyers,1,0,0,0,1,20150310,0,0,1,1,3,-1,2014,0,1,1297,0
Lightning,0,0,0,1,1,Canadiens,0,0,0,0,0,20150310,0,0,0,1,1,-1,2014,1,1,1311,0
Rangers,0,1,1,0,2,Islanders,1,0,0,0,1,20150310,-1,0,1,1,3,-1,2014,0,1,0,0
Sabres,2,1,0,0,3,Maple Leafs,2,0,1,1,4,20150311,0,-1,0,1,7,1,2014,1,2,57,0
Rangers,2,0,1,0,3,Capitals,1,0,0,0,1,20150311,1,1,2,2,4,-2,2014,0,2,204,0
Ducks,2,1,0,0,3,Flames,2,3,1,0,6,20150311,0,2,3,3,9,3,2014,0,2,1197,0
Predators,0,0,0,0,0,Sharks,0,1,1,0,2,20150312,0,1,2,2,2,2,2014,0,3,1934,0
Kings,1,1,2,0,4,Canucks,0,0,0,0,0,20150312,1,2,4,4,4,-4,2014,0,3,1076,0
Devils,0,1,0,0,1,Avalanche,0,1,0,1,2,20150312,0,0,0,1,3,1,2014,1,3,1618,0
Flyers,0,0,0,0,0,Blues,0,0,0,1,1,20150312,0,0,0,1,1,1,2014,1,3,808,0
Blackhawks,1,0,1,0,2,Coyotes,1,0,0,0,1,20150312,0,0,1,1,3,-1,2014,0,3,1450,0
Blue Jackets,2,1,0,0,3,Red Wings,1,0,0,0,1,20150312,1,2,2,2,4,-2,2014,0,3,163,0
Senators,0,2,3,0,5,Canadiens,2,0,0,0,2,20150312,-2,0,3,3,7,-3,2014,0,3,104,0
Stars,3,0,2,0,5,Hurricanes,1,0,2,0,3,20150312,2,2,2,2,8,-2,2014,0,3,1055,0
Oilers,0,2,2,0,4,Penguins,3,1,2,0,6,20150312,3,2,2,2,10,2,2014,0,3,1797,0
Lightning,1,0,1,0,2,Bruins,1,0,1,1,3,20150312,0,0,0,1,5,1,2014,1,3,1183,0
Jets,0,1,1,0,2,Panthers,1,1,2,0,4,20150312,1,1,2,2,6,2,2014,0,3,1899,0
Senators,0,2,0,0,2,Islanders,0,0,1,0,1,20150313,0,2,1,1,3,-1,2014,0,4,334,0
Stars,2,2,0,0,4,Capitals,1,0,1,0,2,20150313,1,3,2,2,6,-2,2014,0,4,1181,0
Oilers,0,3,1,0,4,Blue Jackets,2,1,1,1,5,20150313,2,0,0,1,9,1,2014,1,4,1703,0
Maple Leafs,1,1,1,0,3,Flames,4,2,0,0,6,20150313,3,4,3,3,9,3,2014,0,4,1682,0
Ducks,1,1,0,0,2,Wild,0,1,0,0,1,20150313,1,1,1,1,3,-1,2014,0,4,1521,0
Wild,0,1,2,0,3,Blues,0,1,0,0,1,20150314,0,0,2,2,4,-2,2014,0,5,466,0
Flames,0,0,2,0,2,Avalanche,0,2,1,0,3,20150314,0,2,1,1,5,1,2014,0,5,898,0
Predators,0,0,2,0,2,Kings,1,0,0,0,1,20150314,-1,-1,1,1,3,-1,2014,0,5,1776,0
Devils,0,1,3,0,4,Coyotes,0,0,1,0,1,20150314,0,1,3,3,5,-3,2014,0,5,2131,0
Panthers,0,1,1,0,2,Hurricanes,0,0,0,0,0,20150314,0,1,2,2,2,-2,2014,0,5,696,0
Bruins,1,0,1,0,2,Penguins,0,0,0,0,0,20150314,1,1,2,2,2,-2,2014,0,5,481,0
Canadiens,0,2,1,0,3,Islanders,0,0,1,0,1,20150314,0,2,2,2,4,-2,2014,0,5,343,0
Maple Leafs,0,0,1,0,1,Canucks,1,2,1,0,4,20150314,1,3,3,3,5,3,2014,0,5,2090,0
Rangers,0,0,2,0,2,Sabres,0,0,0,0,0,20150314,0,0,2,2,2,-2,2014,0,5,292,0
Blackhawks,1,1,4,0,6,Sharks,1,1,0,0,2,20150314,0,0,4,4,8,-4,2014,0,5,1837,0
Jets,0,0,2,0,2,Lightning,0,0,1,0,1,20150314,0,0,1,1,3,-1,2014,0,5,1705,0
Red Wings,0,1,1,0,2,Flyers,2,1,4,0,7,20150314,2,2,5,5,9,5,2014,0,5,441,0
Predators,0,2,0,0,2,Ducks,0,0,4,0,4,20150315,0,-2,2,2,6,2,2014,0,6,1776,0
Bruins,0,0,0,0,0,Capitals,1,1,0,0,2,20150315,1,2,2,2,2,2,2014,0,6,394,0
Panthers,0,0,1,0,1,Rangers,1,0,1,0,2,20150315,1,1,1,1,3,1,2014,0,6,1091,0
Blues,0,0,3,0,3,Stars,0,0,0,0,0,20150315,0,0,3,3,3,-3,2014,0,6,547,0
Hurricanes,0,3,0,0,3,Blue Jackets,1,1,0,0,2,20150315,-1,1,1,1,5,-1,2014,0,6,374,0
Flyers,0,1,0,0,1,Senators,0,1,0,1,2,20150315,0,0,0,1,3,1,2014,1,6,373,0
Red Wings,2,2,1,0,5,Penguins,0,0,1,0,1,20150315,2,4,4,4,6,-4,2014,0,6,205,0
Capitals,1,1,1,1,4,Sabres,2,0,1,0,3,20150316,-1,0,0,1,7,-1,2014,1,0,292,0
Canadiens,0,1,1,0,2,Lightning,2,1,1,0,4,20150316,2,2,2,2,6,2,2014,0,0,1311,0
Maple Leafs,1,0,0,0,1,Oilers,4,0,0,0,4,20150316,3,3,3,3,5,3,2014,0,0,1683,0
Coyotes,0,0,0,0,0,Kings,0,1,0,0,1,20150316,0,1,1,1,1,1,2014,0,0,356,0
Flyers,0,1,0,0,1,Canucks,0,1,3,0,4,20150317,0,0,3,3,5,3,2014,0,1,2404,0
Blues,0,1,3,0,4,Flames,0,0,0,0,0,20150317,0,1,4,4,4,-4,2014,0,1,1440,0
Islanders,0,0,1,0,1,Blackhawks,2,1,1,0,4,20150317,2,3,3,3,5,3,2014,0,1,711,0
Sharks,0,1,1,0,2,Jets,3,1,1,0,5,20150317,3,3,3,3,7,3,2014,0,1,1496,0
Canadiens,0,3,0,0,3,Panthers,0,2,0,0,2,20150317,0,1,1,1,5,-1,2014,0,1,1418,0
Sabres,0,0,1,1,2,Bruins,1,0,0,0,1,20150317,-1,-1,0,1,3,-1,2014,1,1,399,0
Penguins,0,0,0,0,0,Devils,0,1,1,0,2,20150317,0,1,2,2,2,2,2014,0,1,306,0
Wild,1,0,1,1,3,Predators,0,2,0,0,2,20150317,1,-1,0,1,5,-1,2014,1,1,696,0
Senators,0,1,0,1,2,Hurricanes,1,0,0,0,1,20150317,-1,0,0,1,3,-1,2014,1,1,673,0
Blue Jackets,1,1,1,1,4,Oilers,0,1,2,0,3,20150318,1,1,0,1,7,-1,2014,1,2,1703,0
Blackhawks,0,0,1,0,1,Rangers,0,0,0,0,0,20150318,0,0,1,1,1,-1,2014,0,2,711,0
Kings,1,0,1,0,2,Ducks,0,0,2,1,3,20150318,-1,-1,0,1,5,1,2014,1,2,0,0
Bruins,2,2,0,0,4,Senators,2,2,2,0,6,20150319,0,0,2,2,10,2,2014,0,3,320,0
Sharks,1,3,0,0,4,Maple Leafs,0,1,0,0,1,20150319,1,3,3,3,5,-3,2014,0,3,2249,0
Hurricanes,0,0,0,0,0,Canadiens,2,1,1,0,4,20150319,2,3,4,4,4,4,2014,0,3,727,0
Red Wings,0,0,1,0,1,Panthers,0,2,1,0,3,20150319,0,2,2,2,4,2,2014,0,3,1155,0
Blues,0,1,0,0,1,Jets,0,0,1,1,2,20150319,0,-1,0,1,3,1,2014,1,3,853,0
Penguins,0,1,0,0,1,Stars,0,2,0,0,2,20150319,0,1,1,1,3,1,2014,0,3,1069,0
Flyers,0,1,0,0,1,Flames,0,2,2,0,4,20150319,0,1,3,3,5,3,2014,0,3,2003,0
Blue Jackets,0,3,3,0,6,Canucks,0,2,0,0,2,20150319,0,1,4,4,8,-4,2014,0,3,2050,0
Avalanche,2,1,2,0,5,Coyotes,1,0,1,0,2,20150319,1,2,3,3,7,-3,2014,0,3,585,0
Capitals,0,2,1,0,3,Wild,0,1,1,0,2,20150319,0,1,1,1,5,-1,2014,0,3,931,0
Devils,0,2,1,0,3,Sabres,0,0,1,0,1,20150320,0,2,2,2,4,-2,2014,0,4,284,0
Red Wings,0,1,0,0,1,Lightning,0,1,2,0,3,20150320,0,0,2,2,4,2,2014,0,4,994,0
Avalanche,0,0,2,0,2,Ducks,1,0,1,1,3,20150320,1,1,0,1,5,1,2014,1,4,830,0
Canucks,0,1,3,0,4,Kings,0,1,0,0,1,20150321,0,0,3,3,5,-3,2014,0,5,1076,0
Blues,0,2,1,0,3,Wild,2,3,1,0,6,20150321,2,3,3,3,9,3,2014,0,5,466,0
Blue Jackets,1,0,1,1,3,Flames,1,1,0,0,2,20150321,0,-1,0,1,5,-1,2014,1,5,1670,0
Bruins,0,1,0,0,1,Panthers,1,0,0,1,2,20150321,1,0,0,1,3,1,2014,1,5,1257,0
Maple Leafs,0,3,0,0,3,Senators,2,2,1,0,5,20150321,2,1,2,2,8,2,2014,0,5,203,0
Sharks,0,0,0,0,0,Canadiens,1,0,1,0,2,20150321,1,1,2,2,2,2,2014,0,5,2508,0
Islanders,1,0,2,0,3,Devils,0,0,0,0,0,20150321,1,1,3,3,3,-3,2014,0,5,8,0
Rangers,0,2,0,1,3,Hurricanes,1,0,1,0,2,20150321,-1,1,0,1,5,-1,2014,1,5,423,0
Capitals,0,0,0,0,0,Jets,1,1,1,0,3,20150321,1,2,3,3,3,3,2014,0,5,1247,0
Sabres,0,0,0,0,0,Predators,0,1,2,0,3,20150321,0,1,3,3,3,3,2014,0,5,626,0
Blackhawks,0,0,0,0,0,Stars,2,0,2,0,4,20150321,2,2,4,4,4,4,2014,0,5,802,0
Penguins,0,2,1,0,3,Coyotes,1,0,0,0,1,20150321,-1,1,2,2,4,-2,2014,0,5,1824,0
Flyers,3,0,1,0,4,Oilers,3,1,0,1,5,20150321,0,1,0,1,9,1,2014,1,5,2011,0
Canucks,1,0,2,0,3,Coyotes,1,0,0,0,1,20150322,0,0,2,2,4,-2,2014,0,6,1228,0
Ducks,2,0,0,0,2,Rangers,3,2,2,0,7,20150322,1,3,5,5,9,5,2014,0,6,2445,0
Bruins,1,0,2,0,3,Lightning,3,1,1,0,5,20150322,2,3,2,2,8,2,2014,0,6,1183,0
Blues,0,1,0,0,1,Red Wings,0,0,1,1,2,20150322,0,-1,0,1,3,1,2014,1,6,454,0
Kings,2,0,1,0,3,Devils,0,1,0,0,1,20150323,2,1,2,2,4,-2,2014,0,0,2436,0
Blackhawks,2,0,1,0,3,Hurricanes,0,1,0,0,1,20150323,2,1,2,2,4,-2,2014,0,0,641,0
Wild,1,0,1,0,2,Maple Leafs,0,0,1,0,1,20150323,1,1,1,1,3,-1,2014,0,0,691,0
Sharks,0,2,0,0,2,Senators,1,0,4,0,5,20150323,1,-1,3,3,7,3,2014,0,0,2408,0
Sabres,1,1,1,0,3,Stars,1,0,3,0,4,20150323,0,-1,1,1,7,1,2014,0,0,1197,0
Avalanche,1,0,1,0,2,Flames,2,0,1,0,3,20150323,1,1,1,1,5,1,2014,0,0,898,0
Jets,1,2,1,0,4,Oilers,0,0,1,0,1,20150323,1,3,3,3,5,-3,2014,0,0,738,0
Jets,1,1,0,0,2,Canucks,0,3,2,0,5,20150324,-1,1,3,3,7,3,2014,0,1,1157,0
Canadiens,0,2,0,0,2,Predators,1,0,1,1,3,20150324,1,-1,0,1,5,1,2014,1,1,937,0
Panthers,0,3,0,0,3,Lightning,2,0,2,0,4,20150324,2,-1,1,1,7,1,2014,0,1,205,0
Coyotes,1,2,1,1,5,Red Wings,0,2,2,0,4,20150324,1,1,0,1,9,-1,2014,1,1,1687,0
Ducks,2,1,0,0,3,Blue Jackets,1,3,1,0,5,20150324,-1,1,2,2,8,2,2014,0,1,1973,0
Blues,0,2,0,1,3,Penguins,0,2,0,0,2,20150324,0,0,0,1,5,-1,2014,1,1,557,0
Kings,1,1,2,0,4,Rangers,1,0,1,0,2,20150324,0,1,2,2,6,-2,2014,0,1,2445,0
Wild,0,0,1,1,2,Islanders,0,1,0,0,1,20150324,0,-1,0,1,3,-1,2014,1,1,1016,0
Blackhawks,0,0,1,0,1,Flyers,1,2,1,0,4,20150325,1,3,3,3,5,3,2014,0,2,664,0
Avalanche,0,2,1,0,3,Oilers,3,0,1,0,4,20150325,3,1,1,1,7,1,2014,0,2,1036,0
Stars,0,3,0,1,4,Flames,0,2,1,0,3,20150325,0,1,0,1,7,-1,2014,1,2,1536,0
Avalanche,0,3,1,0,4,Canucks,0,0,1,0,1,20150326,0,3,3,3,5,-3,2014,0,3,1105,0
Canadiens,0,1,1,0,2,Jets,1,3,1,0,5,20150326,1,3,3,3,7,3,2014,0,3,1115,0
Predators,2,1,0,0,3,Lightning,1,1,0,0,2,20150326,1,1,1,1,5,-1,2014,0,3,621,0
Sharks,3,0,3,0,6,Red Wings,2,0,2,0,4,20150326,1,1,2,2,10,-2,2014,0,3,2071,0
Panthers,0,3,1,0,4,Maple Leafs,0,0,1,0,1,20150326,0,3,3,3,5,-3,2014,0,3,1234,0
Rangers,3,2,0,0,5,Senators,1,0,0,0,1,20150326,2,4,4,4,6,-4,2014,0,3,334,0
Kings,0,1,2,0,3,Islanders,0,1,1,0,2,20150326,0,0,1,1,5,-1,2014,0,3,2445,0
Devils,0,1,1,0,2,Capitals,1,1,0,1,3,20150326,1,1,0,1,5,1,2014,1,3,198,0
Coyotes,1,2,0,1,4,Sabres,1,1,1,0,3,20150326,0,1,0,1,7,-1,2014,1,3,1902,0
Ducks,0,1,1,1,3,Bruins,0,1,1,0,2,20150326,0,0,0,1,5,-1,2014,1,3,2590,0
Penguins,1,0,1,0,2,Hurricanes,2,2,1,0,5,20150326,1,3,3,3,7,3,2014,0,3,330,0
Flames,1,0,1,0,2,Wild,1,0,3,0,4,20150327,0,0,2,2,6,2,2014,0,4,1043,0
Blue Jackets,4,0,1,0,5,Blackhawks,2,0,0,0,2,20150327,2,2,3,3,7,-3,2014,0,4,275,0
Stars,0,0,0,0,0,Oilers,1,0,3,0,4,20150327,1,1,4,4,4,4,2014,0,4,1655,0
Panthers,0,2,0,0,2,Canadiens,1,1,0,1,3,20150328,1,0,0,1,5,1,2014,1,5,1418,0
Stars,1,0,2,1,4,Canucks,1,1,1,0,3,20150328,0,-1,0,1,7,-1,2014,1,5,1766,0
Sabres,0,0,3,0,3,Avalanche,2,2,1,0,5,20150328,2,4,2,2,8,2,2014,0,5,1366,0
Blue Jackets,1,2,1,0,4,Blues,0,2,0,0,2,20150328,1,1,2,2,6,-2,2014,0,5,395,0
Devils,1,0,0,0,1,Hurricanes,0,1,2,0,3,20150328,-1,0,2,2,4,2,2014,0,5,419,0
Senators,0,2,1,0,3,Maple Leafs,0,0,3,1,4,20150328,0,-2,0,1,7,1,2014,1,5,203,0
Kings,0,1,0,0,1,Wild,2,0,2,0,4,20150328,2,1,3,3,5,3,2014,0,5,1521,0
Coyotes,0,0,2,0,2,Penguins,0,0,3,0,3,20150328,0,0,1,1,5,1,2014,0,5,1824,0
Predators,3,1,0,0,4,Capitals,0,2,1,0,3,20150328,3,2,1,1,7,-1,2014,0,5,566,0
Rangers,0,1,1,0,2,Bruins,3,1,0,0,4,20150328,3,3,2,2,6,2,2014,0,5,190,0
Lightning,0,0,0,0,0,Red Wings,0,3,1,0,4,20150328,0,3,4,4,4,4,2014,0,5,994,0
Ducks,1,2,0,0,3,Islanders,1,0,1,0,2,20150328,0,2,1,1,5,-1,2014,0,5,2445,0
Sharks,2,0,0,1,3,Flyers,1,0,1,0,2,20150328,1,1,0,1,5,-1,2014,1,5,2499,0
Capitals,1,1,3,0,5,Rangers,2,0,0,0,2,20150329,-1,0,3,3,7,-3,2014,0,6,204,0
Bruins,1,0,0,1,2,Hurricanes,0,1,0,0,1,20150329,1,0,0,1,3,-1,2014,1,6,609,0
Red Wings,3,1,0,0,4,Islanders,3,2,0,0,5,20150329,0,1,1,1,9,1,2014,0,6,480,0
Flames,2,2,1,0,5,Predators,1,0,1,0,2,20150329,1,3,3,3,7,-3,2014,0,6,1692,0
Ducks,1,0,1,0,2,Devils,0,0,1,0,1,20150329,1,1,1,1,3,-1,2014,0,6,2436,0
Sharks,0,2,0,0,2,Penguins,2,0,0,1,3,20150329,2,0,0,1,5,1,2014,1,6,2242,0
Blackhawks,1,1,2,0,4,Jets,0,3,0,0,3,20150329,1,-1,1,1,7,-1,2014,0,6,722,0
Panthers,0,2,2,0,4,Senators,0,0,2,0,2,20150329,0,2,2,2,6,-2,2014,0,6,1370,0
Flames,1,3,1,0,5,Stars,2,0,1,0,3,20150330,-1,2,2,2,8,-2,2014,0,0,1536,0
Oilers,1,1,2,0,4,Avalanche,1,0,0,0,1,20150330,0,1,3,3,5,-3,2014,0,0,1036,0
Sabres,0,2,2,0,4,Coyotes,1,0,0,0,1,20150330,-1,1,3,3,5,-3,2014,0,0,1902,0
Kings,1,0,0,0,1,Blackhawks,1,2,1,0,4,20150330,0,2,3,3,5,3,2014,0,0,1741,0
Lightning,0,3,2,0,5,Canadiens,0,1,2,0,3,20150330,0,2,2,2,8,-2,2014,0,0,1311,0
Canucks,0,2,2,0,4,Blues,0,1,0,0,1,20150330,0,1,3,3,5,-3,2014,0,0,1778,0
Panthers,0,2,0,0,2,Bruins,1,0,2,0,3,20150331,1,-1,1,1,5,1,2014,0,1,1257,0
Devils,1,0,1,0,2,Blue Jackets,0,2,0,1,3,20150331,-1,1,0,1,5,1,2014,1,1,467,0
Hurricanes,0,2,0,0,2,Capitals,2,2,0,0,4,20150331,2,2,2,2,6,2,2014,0,1,233,0
Lightning,1,0,0,0,1,Maple Leafs,2,0,1,0,3,20150331,1,1,2,2,4,2,2014,0,1,1096,0
Senators,0,0,1,1,2,Red Wings,0,1,0,0,1,20150331,0,-1,0,1,3,-1,2014,1,1,406,0
Rangers,1,1,1,0,3,Jets,1,1,0,0,2,20150331,0,0,1,1,5,-1,2014,0,1,1287,0
Canucks,0,2,2,1,5,Predators,2,1,1,0,4,20150331,-2,-1,0,1,9,-1,2014,1,1,2030,0
Maple Leafs,1,2,0,0,3,Sabres,1,1,2,0,4,20150401,0,-1,1,1,7,1,2014,0,2,57,0
Flyers,1,1,2,0,4,Penguins,1,0,0,0,1,20150401,0,1,3,3,5,-3,2014,0,2,257,0
Oilers,0,1,0,0,1,Ducks,2,2,1,0,5,20150401,2,3,4,4,6,4,2014,0,2,1368,0
Avalanche,0,0,1,0,1,Sharks,0,1,4,0,5,20150401,0,1,4,4,6,4,2014,0,2,927,0
Coyotes,0,1,0,0,1,Sharks,2,0,1,0,3,20150403,2,1,2,2,4,2,2014,0,4,614,0
Avalanche,1,1,2,0,4,Ducks,2,0,0,0,2,20150403,-1,0,2,2,6,-2,2014,0,4,830,0
Blackhawks,2,0,2,0,4,Sabres,0,1,2,0,3,20150403,2,1,1,1,7,-1,2014,0,4,453,0
Canadiens,2,0,0,0,2,Devils,1,1,0,1,3,20150403,-1,0,0,1,5,1,2014,1,4,342,0
Blues,1,3,3,0,7,Stars,1,4,0,0,5,20150403,0,-1,2,2,12,-2,2014,0,4,547,0
Avalanche,0,1,0,0,1,Kings,1,1,1,0,3,20150404,1,1,2,2,4,2,2014,0,5,830,0
Sharks,1,1,1,0,3,Coyotes,2,1,2,0,5,20150404,1,1,2,2,8,2,2014,0,5,614,0
Stars,0,1,2,1,4,Predators,1,0,2,0,3,20150404,-1,0,0,1,7,-1,2014,1,5,616,0
Devils,0,0,1,0,1,Rangers,3,1,2,0,6,20150404,3,4,5,5,7,5,2014,0,5,8,0
Lightning,0,2,2,0,4,Panthers,0,0,0,0,0,20150404,0,2,4,4,4,-4,2014,0,5,205,0
Red Wings,1,1,0,1,3,Wild,1,0,1,0,2,20150404,0,1,0,1,5,-1,2014,1,5,542,0
Flames,1,1,2,0,4,Oilers,0,0,0,0,0,20150404,1,2,4,4,4,-4,2014,0,5,171,0
Sabres,0,0,0,0,0,Islanders,1,0,2,0,3,20150404,1,1,3,3,3,3,2014,0,5,292,0
Maple Leafs,0,1,0,0,1,Bruins,0,1,0,1,2,20150404,0,0,0,1,3,1,2014,1,5,430,0
Canucks,2,1,1,0,4,Jets,3,1,1,0,5,20150404,1,1,1,1,9,1,2014,0,5,1157,0
Penguins,1,1,1,0,3,Blue Jackets,0,2,3,0,5,20150404,-1,0,2,2,8,2,2014,0,5,161,0
Flyers,0,1,1,0,2,Hurricanes,1,1,0,1,3,20150404,1,1,0,1,5,1,2014,1,5,345,0
Capitals,0,1,2,0,3,Senators,3,0,0,1,4,20150404,3,2,0,1,7,1,2014,1,5,446,0
Blues,0,2,0,0,2,Blackhawks,1,0,0,0,1,20150405,-1,1,1,1,3,-1,2014,0,6,260,0
Capitals,1,1,0,0,2,Red Wings,0,1,0,0,1,20150405,1,1,1,1,3,-1,2014,0,6,394,0
Senators,0,1,1,0,2,Maple Leafs,1,1,0,1,3,20150405,1,1,0,1,5,1,2014,1,6,203,0
Penguins,1,0,0,0,1,Flyers,1,1,2,0,4,20150405,0,1,3,3,5,3,2014,0,6,257,0
Canadiens,1,3,0,0,4,Panthers,0,1,0,0,1,20150405,1,3,3,3,5,-3,2014,0,6,1418,0
Hurricanes,0,1,2,0,3,Sabres,2,2,0,0,4,20150406,2,3,1,1,7,1,2014,0,0,491,0
Blue Jackets,1,1,1,0,3,Rangers,1,1,1,1,4,20150406,0,0,0,1,7,1,2014,1,0,476,0
Jets,1,1,0,0,2,Wild,0,0,0,0,0,20150406,1,2,2,2,2,-2,2014,0,0,388,0
Kings,1,0,0,0,1,Canucks,0,0,1,1,2,20150406,-1,-1,0,1,3,1,2014,1,0,1076,0
Stars,2,1,2,0,5,Sharks,0,1,0,0,1,20150406,2,2,4,4,6,-4,2014,0,0,1449,0
Wild,0,0,2,0,2,Blackhawks,0,0,1,0,1,20150407,0,0,1,1,3,-1,2014,0,1,355,0
Kings,0,1,1,0,2,Oilers,0,2,2,0,4,20150407,0,1,2,2,6,2,2014,0,1,1368,0
Predators,1,0,1,0,2,Avalanche,0,2,1,0,3,20150407,-1,1,1,1,5,1,2014,0,1,1019,0
Jets,0,1,0,0,1,Blues,0,0,0,0,0,20150407,0,1,1,1,1,-1,2014,0,1,853,0
Coyotes,0,1,1,0,2,Flames,1,0,2,0,3,20150407,1,0,1,1,5,1,2014,0,1,1224,0
Penguins,3,0,0,0,3,Senators,0,1,2,1,4,20150407,-3,-2,0,1,7,1,2014,1,1,392,0
Islanders,0,1,3,0,4,Flyers,2,1,2,0,5,20150407,2,2,1,1,9,1,2014,0,1,80,0
Hurricanes,0,2,0,0,2,Red Wings,0,1,2,0,3,20150407,0,-1,1,1,5,1,2014,0,1,511,0
Rangers,2,0,2,0,4,Devils,1,0,1,0,2,20150407,1,1,2,2,6,-2,2014,0,1,8,0
Maple Leafs,0,0,0,0,0,Blue Jackets,3,2,0,0,5,20150408,3,5,5,5,5,5,2014,0,2,313,0
Bruins,0,0,0,0,0,Capitals,2,1,0,0,3,20150408,2,3,3,3,3,3,2014,0,2,394,0
Stars,0,3,1,0,4,Ducks,0,0,0,0,0,20150408,0,3,4,4,4,-4,2014,0,2,1237,0
Coyotes,0,0,0,0,0,Canucks,1,3,1,0,5,20150409,1,4,5,5,5,5,2014,0,3,1228,0
Sharks,0,0,3,0,3,Oilers,0,1,0,0,1,20150409,0,-1,2,2,4,-2,2014,0,3,1190,0
Kings,0,0,1,0,1,Flames,2,0,1,0,3,20150409,2,2,2,2,4,2,2014,0,3,1197,0
Jets,0,0,0,0,0,Avalanche,0,0,0,1,1,20150409,0,0,0,1,1,1,2014,1,3,797,0
Blackhawks,0,0,1,0,1,Blues,0,1,1,0,2,20150409,0,1,1,1,3,1,2014,0,3,260,0
Wild,0,2,2,0,4,Predators,2,0,0,0,2,20150409,-2,0,2,2,6,-2,2014,0,3,696,0
Red Wings,1,1,1,0,3,Canadiens,1,1,1,1,4,20150409,0,0,0,1,7,1,2014,1,3,508,0
Bruins,0,1,1,0,2,Panthers,0,1,3,0,4,20150409,0,0,2,2,6,2,2014,0,3,1257,0
Hurricanes,1,0,2,0,3,Flyers,0,0,1,0,1,20150409,1,1,2,2,4,-2,2014,0,3,345,0
Senators,0,2,1,0,3,Rangers,0,0,0,0,0,20150409,0,2,3,3,3,-3,2014,0,3,334,0
Devils,1,2,0,0,3,Lightning,2,1,0,1,4,20150409,1,0,0,1,7,1,2014,1,3,1000,0
Sabres,1,1,0,0,2,Blue Jackets,2,0,2,0,4,20150410,1,0,2,2,6,2,2014,0,4,293,0
Islanders,1,0,2,0,3,Penguins,0,1,0,0,1,20150410,1,0,2,2,4,-2,2014,0,4,314,0
Devils,0,1,1,0,2,Panthers,0,1,2,0,3,20150411,0,0,1,1,5,1,2014,0,5,1090,0
Oilers,2,3,0,0,5,Canucks,1,2,2,1,6,20150411,-1,-2,0,1,11,1,2014,1,5,514,0
Ducks,1,1,0,0,2,Coyotes,0,0,1,0,1,20150411,1,2,1,1,3,-1,2014,0,5,356,0
Blackhawks,0,1,1,0,2,Avalanche,1,1,1,0,3,20150411,1,1,1,1,5,1,2014,0,5,916,0
Predators,1,0,0,0,1,Stars,2,0,2,0,4,20150411,1,1,3,3,5,3,2014,0,5,616,0
Bruins,0,1,1,0,2,Lightning,0,1,1,1,3,20150411,0,0,0,1,5,1,2014,1,5,1183,0
Red Wings,1,0,1,0,2,Hurricanes,0,0,0,0,0,20150411,1,1,2,2,2,-2,2014,0,5,511,0
Blue Jackets,1,0,3,1,5,Islanders,0,1,3,0,4,20150411,1,0,0,1,9,-1,2014,1,5,476,0
Penguins,0,1,1,0,2,Sabres,0,0,0,0,0,20150411,0,1,2,2,2,-2,2014,0,5,178,0
Sharks,1,0,0,0,1,Kings,0,1,3,0,4,20150411,-1,0,3,3,5,3,2014,0,5,305,0
Flames,1,0,0,0,1,Jets,1,0,4,0,5,20150411,0,0,4,4,6,4,2014,0,5,740,0
Wild,0,1,1,0,2,Blues,0,3,1,0,4,20150411,0,2,2,2,6,2,2014,0,5,466,0
Rangers,2,1,1,0,4,Capitals,0,1,1,0,2,20150411,2,2,2,2,6,-2,2014,0,5,204,0
Senators,1,1,1,0,3,Flyers,0,1,0,0,1,20150411,1,1,2,2,4,-2,2014,0,5,373,0
Canadiens,1,2,0,1,4,Maple Leafs,2,1,0,0,3,20150411,-1,0,0,1,7,-1,2014,1,5,303,0
Flames,0,0,2,0,2,Canucks,0,1,0,0,1,20150415,0,-1,1,1,3,-1,2014,0,2,426,1
Blackhawks,0,3,0,1,4,Predators,3,0,0,0,3,20150415,-3,0,0,1,7,-1,2014,1,2,395,1
Islanders,1,2,1,0,4,Capitals,1,0,0,0,1,20150415,0,2,3,3,5,-3,2014,0,2,204,1
Senators,1,2,0,0,3,Canadiens,0,4,0,0,4,20150415,-1,1,1,1,7,1,2014,0,2,104,1
Penguins,0,1,0,0,1,Rangers,2,0,0,0,2,20150416,2,1,1,1,3,1,2014,0,3,314,1
Red Wings,1,1,1,0,3,Lightning,1,0,1,0,2,20150416,0,1,1,1,5,-1,2014,0,3,994,1
Wild,1,1,2,0,4,Blues,0,0,2,0,2,20150416,1,2,2,2,6,-2,2014,0,3,466,1
Jets,1,1,0,0,2,Ducks,1,0,3,0,4,20150416,0,-1,2,2,6,2,2014,0,3,1527,1
Flames,0,0,1,0,1,Canucks,2,0,2,0,4,20150417,2,2,3,3,5,3,2014,0,4,426,1
Blackhawks,1,1,0,0,2,Predators,2,1,3,0,6,20150417,1,1,4,4,8,4,2014,0,4,395,1
Senators,1,0,1,0,2,Canadiens,0,2,0,1,3,20150417,-1,1,0,1,5,1,2014,1,4,104,1
Islanders,1,2,0,0,3,Capitals,0,2,2,0,4,20150417,-1,-1,1,1,7,1,2014,0,4,204,1
Wild,0,0,1,0,1,Blues,2,0,2,0,4,20150418,2,2,3,3,5,3,2014,0,5,466,1
Red Wings,0,0,1,0,1,Lightning,1,3,1,0,5,20150418,1,4,4,4,6,4,2014,0,5,994,1
Penguins,0,3,1,0,4,Rangers,1,0,2,0,3,20150418,-1,2,1,1,7,-1,2014,0,5,314,1
Jets,0,1,0,0,1,Ducks,0,0,2,0,2,20150418,0,-1,1,1,3,1,2014,0,5,1527,1
Capitals,0,0,1,0,1,Islanders,0,1,0,1,2,20150419,0,1,0,1,3,1,2014,1,6,204,1
Predators,1,1,0,0,2,Blackhawks,1,3,0,0,4,20150419,0,2,2,2,6,2,2014,0,6,395,1
Canadiens,0,0,1,1,2,Senators,1,0,0,0,1,20150419,-1,-1,0,1,3,-1,2014,1,6,104,1
Canucks,1,0,1,0,2,Flames,2,0,2,0,4,20150419,1,1,2,2,6,2,2014,0,6,426,1
Ducks,1,2,1,1,5,Jets,1,3,0,0,4,20150420,0,-1,0,1,9,-1,2014,1,0,1527,1
Rangers,1,1,0,0,2,Penguins,0,0,1,0,1,20150420,1,2,1,1,3,-1,2014,0,0,314,1
Blues,0,0,0,0,0,Wild,0,2,1,0,3,20150420,0,2,3,3,3,3,2014,0,0,466,1
Predators,1,1,0,0,2,Blackhawks,1,0,1,1,3,20150421,0,-1,0,1,5,1,2014,1,1,395,1
Canucks,1,0,0,0,1,Flames,3,0,0,0,3,20150421,2,2,2,2,4,2,2014,0,1,426,1
Lightning,0,0,0,0,0,Red Wings,1,0,2,0,3,20150421,1,1,3,3,3,3,2014,0,1,994,1
Capitals,1,0,0,1,2,Islanders,1,0,0,0,1,20150421,0,0,0,1,3,-1,2014,1,1,204,1
Canadiens,0,0,0,0,0,Senators,0,0,1,0,1,20150422,0,0,1,1,1,1,2014,0,2,104,1
Rangers,0,1,0,1,2,Penguins,1,0,0,0,1,20150422,-1,0,0,1,3,-1,2014,1,2,314,1
Blues,3,3,0,0,6,Wild,0,1,0,0,1,20150422,3,5,5,5,7,-5,2014,0,2,466,1
Ducks,1,1,3,0,5,Jets,1,0,1,0,2,20150422,0,1,3,3,7,-3,2014,0,2,1527,1
Lightning,0,0,2,1,3,Red Wings,0,2,0,0,2,20150423,0,-2,0,1,5,-1,2014,1,3,994,1
Islanders,1,0,0,0,1,Capitals,1,1,3,0,5,20150423,0,1,4,4,6,4,2014,0,3,204,1
Blackhawks,1,0,1,0,2,Predators,1,0,4,0,5,20150423,0,0,3,3,7,3,2014,0,3,395,1
Flames,1,0,0,0,1,Canucks,0,1,1,0,2,20150423,-1,0,1,1,3,1,2014,0,3,426,1
Senators,2,1,2,0,5,Canadiens,0,0,1,0,1,20150424,2,3,4,4,6,-4,2014,0,4,104,1
Penguins,0,1,0,0,1,Rangers,1,0,0,1,2,20150424,1,0,0,1,3,1,2014,1,4,314,1
Wild,1,2,1,0,4,Blues,1,0,0,0,1,20150424,0,2,3,3,5,-3,2014,0,4,466,1
Red Wings,1,1,2,0,4,Lightning,0,0,0,0,0,20150425,1,2,4,4,4,-4,2014,0,5,994,1
Canucks,3,1,0,0,4,Flames,1,2,4,0,7,20150425,-2,-1,3,3,11,3,2014,0,5,426,1
Predators,3,0,0,0,3,Blackhawks,3,0,1,0,4,20150425,0,0,1,1,7,1,2014,0,5,395,1
Capitals,1,0,0,0,1,Islanders,1,0,2,0,3,20150425,0,0,2,2,4,2,2014,0,5,204,1
Blues,0,1,0,0,1,Wild,1,1,2,0,4,20150426,1,1,3,3,5,3,2014,0,6,466,1
Canadiens,1,0,1,0,2,Senators,0,0,0,0,0,20150426,1,1,2,2,2,-2,2014,0,6,104,1
Lightning,2,1,2,0,5,Red Wings,0,1,1,0,2,20150427,2,2,3,3,7,-3,2014,0,0,994,1
Islanders,0,0,1,0,1,Capitals,0,1,1,0,2,20150427,0,1,1,1,3,1,2014,0,0,204,1
Red Wings,0,0,0,0,0,Lightning,0,0,2,0,2,20150429,0,0,2,2,2,2,2014,0,2,994,1
Flames,0,0,1,0,1,Ducks,2,2,2,0,6,20150430,2,4,5,5,7,5,2014,0,3,1197,1
Capitals,1,0,1,0,2,Rangers,0,0,1,0,1,20150430,1,1,1,1,3,-1,2014,0,3,204,1
Lightning,0,0,1,1,2,Canadiens,0,0,1,0,1,20150501,0,0,0,1,3,-1,2014,1,4,1311,1
Wild,0,3,0,0,3,Blackhawks,3,1,0,0,4,20150501,3,1,1,1,7,1,2014,0,4,355,1
Capitals,0,1,1,0,2,Rangers,2,0,1,0,3,20150502,2,1,1,1,5,1,2014,0,5,204,1
Lightning,1,3,2,0,6,Canadiens,1,0,1,0,2,20150503,0,3,4,4,8,-4,2014,0,6,1311,1
Wild,0,0,1,0,1,Blackhawks,0,2,2,0,4,20150503,0,2,3,3,5,3,2014,0,6,355,1
Flames,0,0,0,0,0,Ducks,1,0,2,0,3,20150503,1,1,3,3,3,3,2014,0,6,1197,1
Rangers,0,0,0,0,0,Capitals,0,1,0,0,1,20150504,0,1,1,1,1,1,2014,0,0,204,1
Ducks,2,1,0,0,3,Flames,1,1,1,1,4,20150505,-1,-1,0,1,7,1,2014,1,1,1197,1
Blackhawks,1,0,0,0,1,Wild,0,0,0,0,0,20150505,1,1,1,1,1,-1,2014,0,1,355,1
Canadiens,0,0,1,0,1,Lightning,1,0,1,0,2,20150506,1,1,1,1,3,1,2014,0,2,1311,1
Rangers,0,1,0,0,1,Capitals,0,1,1,0,2,20150506,0,0,1,1,3,1,2014,0,2,204,1
Canadiens,2,3,1,0,6,Lightning,0,1,1,0,2,20150507,2,4,4,4,8,-4,2014,0,3,1311,1
Blackhawks,1,1,2,0,4,Wild,0,1,2,0,3,20150507,1,1,1,1,7,-1,2014,0,3,355,1
Capitals,0,0,1,0,1,Rangers,0,0,1,1,2,20150508,0,0,0,1,3,1,2014,1,4,204,1
Ducks,1,1,2,0,4,Flames,2,0,0,0,2,20150508,-1,0,2,2,6,-2,2014,0,4,1197,1
Lightning,0,0,1,0,1,Canadiens,1,0,1,0,2,20150509,1,1,1,1,3,1,2014,0,5,1311,1
Rangers,2,0,2,0,4,Capitals,0,1,2,0,3,20150510,2,1,1,1,7,-1,2014,0,6,204,1
Flames,1,1,0,0,2,Ducks,0,1,1,1,3,20150510,-1,-1,0,1,5,1,2014,1,6,1197,1
Canadiens,0,0,1,0,1,Lightning,1,2,1,0,4,20150512,1,3,3,3,5,3,2014,0,1,1311,1
Capitals,1,0,0,0,1,Rangers,0,1,0,1,2,20150513,-1,0,0,1,3,1,2014,1,2,204,1
Lightning,0,0,1,0,1,Rangers,0,1,1,0,2,20150516,0,1,1,1,3,1,2014,0,5,1004,1
Blackhawks,0,1,0,0,1,Ducks,1,1,2,0,4,20150517,1,1,3,3,5,3,2014,0,6,1741,1
Lightning,2,1,3,0,6,Rangers,1,1,0,0,2,20150518,1,1,4,4,8,-4,2014,0,0,1004,1
Blackhawks,2,0,0,1,3,Ducks,1,1,0,0,2,20150519,1,0,0,1,5,-1,2014,1,1,1741,1
Rangers,2,1,2,0,5,Lightning,1,3,1,1,6,20150520,-1,1,0,1,11,1,2014,1,2,1004,1
Ducks,1,1,0,0,2,Blackhawks,1,0,0,0,1,20150521,0,1,1,1,3,-1,2014,0,3,1741,1
Rangers,1,2,2,0,5,Lightning,0,1,0,0,1,20150522,1,2,4,4,6,-4,2014,0,4,1004,1
Ducks,0,1,3,0,4,Blackhawks,1,0,3,1,5,20150523,1,0,0,1,9,1,2014,1,5,1741,1
Lightning,0,2,0,0,2,Rangers,0,0,0,0,0,20150524,0,2,2,2,2,-2,2014,0,6,1004,1
Blackhawks,0,2,2,0,4,Ducks,3,0,1,1,5,20150525,3,1,0,1,9,1,2014,1,0,1741,1
Rangers,2,0,5,0,7,Lightning,1,0,2,0,3,20150526,1,1,4,4,10,-4,2014,0,1,1004,1
Ducks,0,1,1,0,2,Blackhawks,0,3,2,0,5,20150527,0,2,3,3,7,3,2014,0,2,1741,1
Lightning,0,0,2,0,2,Rangers,0,0,0,0,0,20150529,0,0,2,2,2,-2,2014,0,4,1004,1
Blackhawks,2,2,1,0,5,Ducks,0,1,2,0,3,20150530,2,3,2,2,8,-2,2014,0,5,1741,1
Blackhawks,0,0,2,0,2,Lightning,1,0,0,0,1,20150603,-1,-1,1,1,3,-1,2014,0,2,1004,1
Blackhawks,0,2,1,0,3,Lightning,1,2,1,0,4,20150606,1,1,1,1,7,1,2014,0,5,1004,1
Lightning,1,0,2,0,3,Blackhawks,1,0,1,0,2,20150608,0,0,1,1,5,-1,2014,0,0,1004,1
Lightning,0,1,0,0,1,Blackhawks,0,1,1,0,2,20150610,0,0,1,1,3,1,2014,0,2,1004,1
Blackhawks,1,0,1,0,2,Lightning,0,1,0,0,1,20150613,1,0,1,1,3,-1,2014,0,5,1004,1
Lightning,0,0,0,0,0,Blackhawks,0,1,1,0,2,20150615,0,1,2,2,2,2,2014,0,0,1004,1
Canadiens,1,0,2,0,3,Maple Leafs,0,1,0,0,1,20151007,1,0,2,2,4,-2,2015,0,2,303,0
Rangers,3,0,0,0,3,Blackhawks,1,1,0,0,2,20151007,2,1,1,1,5,-1,2015,0,2,711,0
Canucks,2,1,2,0,5,Flames,0,1,0,0,1,20151007,2,2,4,4,6,-4,2015,0,2,426,0
Sharks,2,2,1,0,5,Kings,1,0,0,0,1,20151007,1,3,4,4,6,-4,2015,0,2,305,0
Rangers,1,0,3,0,4,Blue Jackets,0,1,1,0,2,20151009,1,0,2,2,6,-2,2015,0,4,476,0
Jets,0,3,0,0,3,Devils,0,1,0,0,1,20151009,0,2,2,2,4,-2,2015,0,4,1280,0
Maple Leafs,0,0,0,0,0,Red Wings,2,2,0,0,4,20151009,2,4,4,4,4,4,2015,0,4,205,0
Blackhawks,1,1,0,1,3,Islanders,0,1,1,0,2,20151009,1,1,0,1,5,-1,2015,1,4,711,0
Coyotes,2,2,0,0,4,Kings,0,1,0,0,1,20151009,2,3,3,3,5,-3,2015,0,4,356,0
Ducks,0,0,0,0,0,Sharks,0,1,1,0,2,20151010,0,1,2,2,2,2,2015,0,5,305,0
Flames,1,0,1,1,3,Canucks,0,2,0,0,2,20151010,1,-1,0,1,5,-1,2015,1,5,426,0
Penguins,0,1,0,0,1,Coyotes,0,2,0,0,2,20151010,0,1,1,1,3,1,2015,0,5,1824,0
Islanders,0,0,1,0,1,Blackhawks,1,2,1,0,4,20151010,1,3,3,3,5,3,2015,0,5,711,0
Blues,0,1,1,0,2,Wild,1,2,0,0,3,20151010,1,2,1,1,5,1,2015,0,5,466,0
Oilers,0,0,0,0,0,Predators,0,1,1,0,2,20151010,0,1,2,2,2,2,2015,0,5,1758,0
Senators,0,3,1,1,5,Maple Leafs,0,2,2,0,4,20151010,0,1,0,1,9,-1,2015,1,5,203,0
Stars,2,1,0,0,3,Avalanche,1,2,3,0,6,20151010,-1,0,3,3,9,3,2015,0,5,661,0
Devils,2,0,1,0,3,Capitals,2,0,3,0,5,20151010,0,0,2,2,8,2,2015,0,5,198,0
Blue Jackets,0,0,2,0,2,Rangers,3,1,1,0,5,20151010,3,4,3,3,7,3,2015,0,5,476,0
Flyers,0,1,0,0,1,Panthers,4,1,2,0,7,20151010,4,4,6,6,8,6,2015,0,5,1021,0
Red Wings,0,1,3,0,4,Hurricanes,0,2,1,0,3,20151010,0,-1,1,1,7,-1,2015,0,5,511,0
Lightning,0,2,2,0,4,Sabres,0,1,0,0,1,20151010,0,1,3,3,5,-3,2015,0,5,1051,0
Canadiens,1,2,1,0,4,Bruins,0,1,1,0,2,20151010,1,2,2,2,6,-2,2015,0,5,270,0
Canadiens,2,0,1,0,3,Senators,0,1,0,0,1,20151011,2,1,2,2,4,-2,2015,0,6,104,0
Canucks,0,1,0,1,2,Ducks,0,1,0,0,1,20151012,0,0,0,1,3,-1,2015,1,0,1076,0
Blue Jackets,0,0,2,0,2,Sabres,0,1,3,0,4,20151012,0,1,2,2,6,2,2015,0,0,293,0
Panthers,0,0,0,0,0,Flyers,1,0,0,0,1,20151012,1,1,1,1,1,1,2015,0,0,1021,0
Lightning,2,2,2,0,6,Bruins,2,1,0,0,3,20151012,0,1,3,3,9,-3,2015,0,0,1183,0
Jets,0,1,1,0,2,Islanders,1,2,1,0,4,20151012,1,2,2,2,6,2,2015,0,0,1287,0
Canucks,0,2,1,0,3,Kings,0,0,0,0,0,20151013,0,2,3,3,3,-3,2015,0,1,1076,0
Canadiens,1,1,1,0,3,Penguins,0,2,0,0,2,20151013,1,0,1,1,5,-1,2015,0,1,474,0
Predators,1,0,2,0,3,Devils,0,0,1,0,1,20151013,1,1,2,2,4,-2,2015,0,1,750,0
Jets,1,1,2,0,4,Rangers,1,0,0,0,1,20151013,0,1,3,3,5,-3,2015,0,1,1287,0
Sharks,1,2,2,0,5,Capitals,0,0,0,0,0,20151013,1,3,5,5,5,-5,2015,0,1,2416,0
Panthers,1,0,3,0,4,Hurricanes,0,1,0,0,1,20151013,1,0,3,3,5,-3,2015,0,1,696,0
Lightning,0,0,1,0,1,Red Wings,0,1,2,0,3,20151013,0,1,2,2,4,2,2015,0,1,994,0
Oilers,0,2,0,0,2,Stars,1,1,2,0,4,20151013,1,0,2,2,6,2,2015,0,1,1655,0
Blues,1,3,0,0,4,Flames,2,0,1,0,3,20151013,-1,2,1,1,7,-1,2015,0,1,1440,0
Bruins,2,3,1,0,6,Avalanche,0,1,1,0,2,20151014,2,4,4,4,8,-4,2015,0,2,1765,0
Blackhawks,0,0,0,0,0,Flyers,0,2,1,0,3,20151014,0,2,3,3,3,3,2015,0,2,664,0
Coyotes,3,1,0,0,4,Ducks,0,0,0,0,0,20151014,3,4,4,4,4,-4,2015,0,2,356,0
Senators,1,3,3,0,7,Blue Jackets,2,1,0,0,3,20151014,-1,1,4,4,10,-4,2015,0,2,512,0
Sabres,0,1,1,0,2,Panthers,2,0,1,0,3,20151015,2,1,1,1,5,1,2015,0,3,1184,0
Wild,2,2,0,0,4,Coyotes,0,2,1,0,3,20151015,2,2,1,1,7,-1,2015,0,3,1278,0
Blues,1,1,2,0,4,Oilers,1,0,1,0,2,20151015,0,1,2,2,6,-2,2015,0,3,1508,0
Stars,2,2,1,0,5,Lightning,1,0,2,0,3,20151015,1,3,2,2,8,-2,2015,0,3,916,0
Senators,0,0,0,0,0,Penguins,0,2,0,0,2,20151015,0,2,2,2,2,2,2015,0,3,392,0
Blackhawks,0,0,1,0,1,Capitals,1,1,2,0,4,20151015,1,2,3,3,5,3,2015,0,3,594,0
Predators,1,1,1,0,3,Islanders,0,2,2,0,4,20151015,-1,0,1,1,7,1,2015,0,3,758,0
Rangers,0,0,0,0,0,Canadiens,0,1,2,0,3,20151015,0,1,3,3,3,3,2015,0,3,343,0
Sharks,1,0,0,1,2,Devils,0,0,1,0,1,20151016,1,1,0,1,3,-1,2015,1,4,2540,0
Maple Leafs,0,3,3,0,6,Blue Jackets,1,1,1,0,3,20151016,-1,1,3,3,9,-3,2015,0,4,313,0
Hurricanes,1,2,2,0,5,Red Wings,0,2,1,0,3,20151016,1,1,2,2,8,-2,2015,0,4,511,0
Flames,1,0,0,0,1,Jets,0,1,2,0,3,20151016,-1,0,2,2,4,2,2015,0,4,740,0
Blues,1,2,1,0,4,Canucks,0,1,2,0,3,20151016,1,2,1,1,7,-1,2015,0,4,1778,0
Avalanche,1,1,1,0,3,Ducks,0,0,0,0,0,20151016,1,2,3,3,3,-3,2015,0,4,830,0
Wild,0,0,1,0,1,Kings,0,1,0,1,2,20151016,0,1,0,1,3,1,2015,1,4,1521,0
Bruins,0,2,3,0,5,Coyotes,1,0,2,0,3,20151017,-1,1,2,2,8,-2,2015,0,5,2295,0
Oilers,1,1,3,0,5,Flames,0,1,1,0,2,20151017,1,1,3,3,7,-3,2015,0,5,171,0
Sharks,1,2,0,0,3,Islanders,0,3,3,0,6,20151017,-1,0,3,3,9,3,2015,0,5,2549,0
Hurricanes,0,0,1,0,1,Capitals,1,0,3,0,4,20151017,1,1,3,3,5,3,2015,0,5,233,0
Maple Leafs,1,0,0,0,1,Penguins,2,0,0,0,2,20151017,1,1,1,1,3,1,2015,0,5,222,0
Blue Jackets,0,0,1,0,1,Blackhawks,0,2,2,0,4,20151017,0,2,3,3,5,3,2015,0,5,275,0
Sabres,1,0,0,0,1,Lightning,0,1,1,0,2,20151017,-1,0,1,1,3,1,2015,0,5,1051,0
Predators,1,1,1,1,4,Senators,0,2,1,0,3,20151017,1,0,0,1,7,-1,2015,1,5,845,0
Red Wings,0,1,0,0,1,Canadiens,0,1,3,0,4,20151017,0,0,3,3,5,3,2015,0,5,508,0
Stars,0,1,3,0,4,Panthers,0,2,0,0,2,20151017,0,-1,2,2,6,-2,2015,0,5,1110,0
Avalanche,0,1,0,0,1,Kings,1,1,0,0,2,20151018,1,1,1,1,3,1,2015,0,6,830,0
Devils,0,1,0,1,2,Rangers,1,0,0,0,1,20151018,-1,0,0,1,3,-1,2015,1,6,8,0
Blues,0,2,2,0,4,Jets,0,2,0,0,2,20151018,0,0,2,2,6,-2,2015,0,6,853,0
Wild,1,0,0,0,1,Ducks,2,0,2,0,4,20151018,1,1,3,3,5,3,2015,0,6,1521,0
Oilers,1,0,0,1,2,Canucks,1,0,0,0,1,20151018,0,0,0,1,3,-1,2015,1,6,514,0
Sharks,0,0,0,0,0,Rangers,1,1,2,0,4,20151019,1,2,4,4,4,4,2015,0,0,2549,0
Coyotes,0,0,2,0,2,Devils,0,1,1,1,3,20151020,0,1,0,1,5,1,2015,1,1,2131,0
Panthers,0,0,2,0,2,Penguins,1,0,1,1,3,20151020,1,1,0,1,5,1,2015,1,1,1013,0
Islanders,1,0,3,0,4,Blue Jackets,0,0,0,0,0,20151020,1,1,4,4,4,-4,2015,0,1,476,0
Stars,1,1,0,0,2,Flyers,0,0,1,0,1,20151020,1,2,1,1,3,-1,2015,0,1,1297,0
Blues,0,0,0,0,0,Canadiens,1,1,1,0,3,20151020,1,2,3,3,3,3,2015,0,1,962,0
Lightning,0,3,1,0,4,Predators,1,2,1,1,5,20151020,1,0,0,1,9,1,2015,1,1,621,0
Capitals,1,3,2,0,6,Flames,1,0,1,0,2,20151020,0,3,4,4,8,-4,2015,0,1,1967,0
Red Wings,0,0,1,0,1,Oilers,1,2,0,0,3,20151021,1,3,2,2,4,2,2015,0,2,1592,0
Maple Leafs,1,0,0,0,1,Sabres,0,0,1,1,2,20151021,-1,-1,0,1,3,1,2015,1,2,57,0
Flyers,2,0,2,1,5,Bruins,2,2,0,0,4,20151021,0,-2,0,1,9,-1,2015,1,2,270,0
Hurricanes,0,0,0,1,1,Avalanche,0,0,0,0,0,20151021,0,0,0,1,1,-1,2015,1,2,1459,0
Kings,2,1,1,0,4,Sharks,0,1,0,0,1,20151022,2,2,3,3,5,-3,2015,0,3,305,0
Panthers,1,0,1,0,2,Blackhawks,1,1,1,0,3,20151022,0,1,1,1,5,1,2015,0,3,1189,0
Capitals,1,0,2,0,3,Canucks,0,2,0,0,2,20151022,1,-1,1,1,5,-1,2015,0,3,2359,0
Ducks,0,0,1,0,1,Predators,0,3,2,0,5,20151022,0,3,4,4,6,4,2015,0,3,1776,0
Blue Jackets,2,0,0,0,2,Wild,1,2,0,0,3,20151022,-1,1,1,1,5,1,2015,0,3,626,0
Devils,2,0,2,1,5,Senators,1,1,2,0,4,20151022,1,0,0,1,9,-1,2015,1,3,330,0
Stars,2,2,0,0,4,Penguins,0,1,0,0,1,20151022,2,3,3,3,5,-3,2015,0,3,1069,0
Coyotes,1,0,0,0,1,Rangers,0,1,3,0,4,20151022,-1,0,3,3,5,3,2015,0,3,2139,0
Canadiens,1,3,3,0,7,Sabres,0,2,0,0,2,20151023,1,2,5,5,9,-5,2015,0,4,311,0
Bruins,1,2,2,0,5,Islanders,2,0,1,0,3,20151023,-1,1,2,2,8,-2,2015,0,4,190,0
Lightning,1,2,0,1,4,Jets,1,1,1,0,3,20151023,0,1,0,1,7,-1,2015,1,4,1705,0
Red Wings,2,0,0,0,2,Flames,1,0,1,1,3,20151023,-1,-1,0,1,5,1,2015,1,4,1573,0
Capitals,3,3,1,0,7,Oilers,2,2,0,0,4,20151023,1,2,3,3,11,-3,2015,0,4,1985,0
Hurricanes,0,0,0,0,0,Kings,1,0,2,0,3,20151023,1,1,3,3,3,3,2015,0,4,2231,0
Red Wings,0,0,2,1,3,Canucks,1,1,0,0,2,20151024,-1,-2,0,1,5,-1,2015,1,5,1967,0
Blue Jackets,2,0,2,0,4,Avalanche,1,2,0,0,3,20151024,1,-1,1,1,7,-1,2015,0,5,1163,0
Lightning,0,0,0,0,0,Blackhawks,0,0,0,1,1,20151024,0,0,0,1,1,1,2015,1,5,1004,0
Panthers,2,2,2,0,6,Stars,1,0,1,0,2,20151024,1,3,4,4,8,-4,2015,0,5,1110,0
Penguins,0,1,0,1,2,Predators,0,0,1,0,1,20151024,0,1,0,1,3,-1,2015,1,5,471,0
Islanders,1,1,0,1,3,Blues,0,0,2,0,2,20151024,1,2,0,1,5,-1,2015,1,5,871,0
Devils,1,2,1,0,4,Sabres,1,1,1,0,3,20151024,0,1,1,1,7,-1,2015,0,5,284,0
Coyotes,1,0,3,0,4,Senators,0,1,0,0,1,20151024,1,0,3,3,5,-3,2015,0,5,2071,0
Maple Leafs,0,2,1,0,3,Canadiens,1,4,0,0,5,20151024,1,3,2,2,8,2,2015,0,5,303,0
Hurricanes,0,2,0,0,2,Sharks,2,2,1,0,5,20151024,2,2,3,3,7,3,2015,0,5,2382,0
Ducks,0,0,0,0,0,Wild,1,2,0,0,3,20151024,1,3,3,3,3,3,2015,0,5,1521,0
Rangers,1,1,0,0,2,Flyers,1,1,0,1,3,20151024,0,0,0,1,5,1,2015,1,5,80,0
Kings,1,1,1,0,3,Oilers,1,0,1,0,2,20151025,0,1,1,1,5,-1,2015,0,6,1368,0
Flames,1,0,0,0,1,Rangers,0,2,2,0,4,20151025,-1,1,3,3,5,3,2015,0,6,2023,0
Wild,1,2,1,0,4,Jets,3,2,0,0,5,20151025,2,2,1,1,9,1,2015,0,6,388,0
Flames,0,0,0,0,0,Islanders,0,1,3,0,4,20151026,0,1,4,4,4,4,2015,0,0,2023,0
Coyotes,2,1,1,0,4,Maple Leafs,1,0,2,0,3,20151026,1,2,1,1,7,-1,2015,0,0,1885,0
Ducks,0,0,0,0,0,Blackhawks,0,0,0,1,1,20151026,0,0,0,1,1,1,2015,1,0,1741,0
Oilers,1,1,1,0,3,Wild,2,0,2,0,4,20151027,1,0,1,1,7,1,2015,0,1,1083,0
Canadiens,0,0,1,0,1,Canucks,3,0,2,0,5,20151027,3,3,4,4,6,4,2015,0,1,2273,0
Ducks,3,0,0,0,3,Stars,0,3,1,0,4,20151027,-3,0,1,1,7,1,2015,0,1,1237,0
Kings,0,1,3,0,4,Jets,0,1,0,0,1,20151027,0,0,3,3,5,-3,2015,0,1,1527,0
Lightning,0,0,0,0,0,Blues,1,0,1,0,2,20151027,1,1,2,2,2,2,2015,0,1,861,0
Avalanche,0,0,1,0,1,Panthers,1,0,3,0,4,20151027,1,1,3,3,5,3,2015,0,1,1724,0
Hurricanes,0,1,2,0,3,Red Wings,0,1,0,0,1,20151027,0,0,2,2,4,-2,2015,0,1,511,0
Sabres,2,0,1,1,4,Flyers,1,0,2,0,3,20151027,1,1,0,1,7,-1,2015,1,1,279,0
Blue Jackets,0,0,3,0,3,Devils,0,0,1,0,1,20151027,0,0,2,2,4,-2,2015,0,1,467,0
Coyotes,0,0,0,0,0,Bruins,1,2,3,0,6,20151027,1,3,6,6,6,6,2015,0,1,2295,0
Flames,0,1,3,0,4,Senators,0,2,2,1,5,20151028,0,1,0,1,9,1,2015,1,2,1773,0
Penguins,0,0,3,0,3,Capitals,0,0,1,0,1,20151028,0,0,2,2,4,-2,2015,0,2,190,0
Predators,1,0,1,0,2,Sharks,0,0,1,0,1,20151028,1,1,1,1,3,-1,2015,0,2,1934,0
Blackhawks,1,0,0,0,1,Jets,1,1,1,0,3,20151029,0,1,2,2,4,2,2015,0,3,722,0
Canadiens,3,0,0,0,3,Oilers,0,1,3,0,4,20151029,-3,-2,1,1,7,1,2015,0,3,1826,0
Ducks,0,1,0,0,1,Blues,0,1,1,0,2,20151029,0,0,1,1,3,1,2015,0,3,1586,0
Canucks,1,1,1,0,3,Stars,1,0,2,1,4,20151029,0,-1,0,1,7,1,2015,1,3,1766,0
Avalanche,1,1,0,0,2,Lightning,0,1,0,0,1,20151029,1,1,1,1,3,-1,2015,0,3,1521,0
Devils,0,1,3,0,4,Flyers,0,1,0,0,1,20151029,0,0,3,3,5,-3,2015,0,3,75,0
Hurricanes,1,0,1,1,3,Islanders,1,1,0,0,2,20151029,0,-1,0,1,5,-1,2015,1,3,423,0
Sabres,2,0,1,0,3,Penguins,2,2,0,0,4,20151029,0,2,1,1,7,1,2015,0,3,178,0
Flyers,0,0,1,0,1,Sabres,1,1,1,0,3,20151030,1,2,2,2,4,2,2015,0,4,279,0
Maple Leafs,0,0,1,0,1,Rangers,1,0,2,0,3,20151030,1,1,2,2,4,2,2015,0,4,341,0
Blue Jackets,0,0,1,0,1,Capitals,0,1,1,0,2,20151030,0,1,1,1,3,1,2015,0,4,326,0
Avalanche,0,1,1,0,2,Hurricanes,0,2,1,0,3,20151030,0,1,1,1,5,1,2015,0,4,1459,0
Senators,1,1,1,0,3,Red Wings,0,1,0,0,1,20151030,1,1,2,2,4,-2,2015,0,4,406,0
Bruins,1,2,0,0,3,Panthers,0,1,0,0,1,20151030,1,2,2,2,4,-2,2015,0,4,1257,0
Blackhawks,2,2,0,0,4,Wild,3,1,1,0,5,20151030,1,0,1,1,9,1,2015,0,4,355,0
Canadiens,1,3,2,0,6,Flames,0,2,0,0,2,20151030,1,2,4,4,8,-4,2015,0,4,1852,0
Canucks,3,1,0,0,4,Coyotes,0,2,1,0,3,20151030,3,2,1,1,7,-1,2015,0,4,1228,0
Jets,3,0,0,0,3,Blue Jackets,1,0,1,0,2,20151031,2,2,1,1,5,-1,2015,0,5,975,0
Flames,3,1,1,0,5,Oilers,1,1,2,0,4,20151031,2,2,1,1,9,-1,2015,0,5,171,0
Wild,2,0,0,0,2,Blues,2,0,0,1,3,20151031,0,0,0,1,5,1,2015,1,5,466,0
Capitals,0,0,1,1,2,Panthers,0,1,0,0,1,20151031,0,-1,0,1,3,-1,2015,1,5,924,0
Bruins,1,0,2,0,3,Lightning,1,0,0,0,1,20151031,0,0,2,2,4,-2,2015,0,5,1183,0
Red Wings,1,2,2,0,5,Senators,0,1,2,0,3,20151031,1,2,2,2,8,-2,2015,0,5,406,0
Penguins,1,2,1,0,4,Maple Leafs,0,0,0,0,0,20151031,1,3,4,4,4,-4,2015,0,5,222,0
Predators,0,2,1,0,3,Kings,0,1,2,1,4,20151031,0,-1,0,1,7,1,2015,1,5,1776,0
Sharks,0,3,0,0,3,Stars,1,2,2,0,5,20151031,1,0,2,2,8,2,2015,0,5,1449,0
Islanders,0,2,0,0,2,Devils,2,0,0,1,3,20151031,2,0,0,1,5,1,2015,1,5,8,0
Sharks,1,1,2,0,4,Avalanche,1,1,1,0,3,20151101,0,0,1,1,7,-1,2015,0,6,927,0
Lightning,0,2,2,0,4,Hurricanes,1,0,2,0,3,20151101,-1,1,1,1,7,-1,2015,0,6,585,0
Jets,0,0,1,0,1,Canadiens,2,3,0,0,5,20151101,2,5,4,4,6,4,2015,0,6,1115,0
Sabres,0,0,2,0,2,Islanders,0,1,0,0,1,20151101,0,-1,1,1,3,-1,2015,0,6,292,0
Predators,0,2,0,0,2,Ducks,3,1,0,0,4,20151101,3,2,2,2,6,2,2015,0,6,1776,0
Stars,1,0,0,0,1,Maple Leafs,1,2,1,0,4,20151102,0,2,3,3,5,3,2015,0,0,1201,0
Kings,2,0,0,0,2,Blackhawks,1,0,3,0,4,20151102,-1,-1,2,2,6,2,2015,0,0,1741,0
Flyers,0,1,0,0,1,Canucks,1,1,2,0,4,20151102,1,1,3,3,5,3,2015,0,0,2404,0
Flames,0,2,1,0,3,Avalanche,1,2,3,0,6,20151103,1,1,3,3,9,3,2015,0,1,898,0
Kings,0,1,2,0,3,Blues,0,0,0,0,0,20151103,0,1,3,3,3,-3,2015,0,1,1586,0
Lightning,0,1,0,0,1,Red Wings,0,1,1,0,2,20151103,0,0,1,1,3,1,2015,0,1,994,0
Senators,0,1,0,1,2,Canadiens,0,1,0,0,1,20151103,0,0,0,1,3,-1,2015,1,1,104,0
Flyers,0,2,0,0,2,Oilers,1,0,3,0,4,20151103,1,-1,2,2,6,2,2015,0,1,2011,0
Devils,0,0,1,0,1,Islanders,1,0,1,0,2,20151103,1,1,1,1,3,1,2015,0,1,8,0
Stars,1,2,2,0,5,Bruins,2,0,1,0,3,20151103,-1,1,2,2,8,-2,2015,0,1,1548,0
Capitals,1,1,0,0,2,Rangers,2,2,1,0,5,20151103,1,2,3,3,7,3,2015,0,1,204,0
Blue Jackets,1,3,1,0,5,Sharks,1,1,0,0,2,20151103,0,2,3,3,7,-3,2015,0,1,2090,0
Blues,2,3,0,1,6,Blackhawks,5,0,0,0,5,20151104,-3,0,0,1,11,-1,2015,1,2,260,0
Penguins,1,0,2,0,3,Canucks,0,0,2,0,2,20151104,1,1,1,1,5,-1,2015,0,2,2168,0
Jets,2,0,2,0,4,Maple Leafs,1,1,0,0,2,20151104,1,0,2,2,6,-2,2015,0,2,946,0
Panthers,0,2,0,0,2,Ducks,0,1,1,1,3,20151104,0,-1,0,1,5,1,2015,1,2,2335,0
Panthers,1,1,0,0,2,Sharks,2,2,1,0,5,20151105,1,2,3,3,7,3,2015,0,3,2558,0
Avalanche,0,1,1,0,2,Coyotes,1,2,1,0,4,20151105,1,2,2,2,6,2,2015,0,3,585,0
Blue Jackets,2,0,1,0,3,Kings,1,0,1,0,2,20151105,1,1,1,1,5,-1,2015,0,3,1973,0
Predators,0,1,2,0,3,Wild,0,1,1,0,2,20151105,0,0,1,1,5,-1,2015,0,3,696,0
Flyers,0,1,0,0,1,Flames,1,0,0,1,2,20151105,1,0,0,1,3,1,2015,1,3,2003,0
Islanders,0,1,0,0,1,Canadiens,1,0,3,0,4,20151105,1,0,3,3,5,3,2015,0,3,343,0
Lightning,3,0,1,0,4,Sabres,0,1,0,0,1,20151105,3,2,3,3,5,-3,2015,0,3,1051,0
Bruins,1,0,0,0,1,Capitals,1,2,1,0,4,20151105,0,2,3,3,5,3,2015,0,3,394,0
Jets,0,1,1,0,2,Senators,1,1,0,1,3,20151105,1,1,0,1,5,1,2015,1,3,1033,0
Red Wings,1,0,0,1,2,Maple Leafs,0,0,1,0,1,20151106,1,1,0,1,3,-1,2015,1,4,205,0
Blackhawks,0,1,1,0,2,Devils,3,1,0,0,4,20151106,3,3,2,2,6,2,2015,0,4,703,0
Stars,0,1,3,0,4,Hurricanes,0,1,0,0,1,20151106,0,0,3,3,5,-3,2015,0,4,1055,0
Rangers,0,2,0,0,2,Avalanche,1,0,0,0,1,20151106,-1,1,1,1,3,-1,2015,0,4,1627,0
Penguins,0,1,1,0,2,Oilers,0,1,0,0,1,20151106,0,0,1,1,3,-1,2015,0,4,1797,0
Blue Jackets,0,1,1,0,2,Ducks,1,1,2,0,4,20151106,1,1,2,2,6,2,2015,0,4,1973,0
Bruins,1,1,0,0,2,Canadiens,0,1,3,0,4,20151107,-1,-1,2,2,6,2,2015,0,5,270,0
Lightning,0,0,0,0,0,Wild,0,1,0,0,1,20151107,0,1,1,1,1,1,2015,0,5,1318,0
Blues,1,0,3,0,4,Predators,0,0,0,0,0,20151107,1,1,4,4,4,-4,2015,0,5,253,0
Flyers,1,0,2,0,3,Jets,0,0,0,0,0,20151107,1,1,3,3,3,-3,2015,0,5,1273,0
Senators,0,2,0,0,2,Hurricanes,0,1,1,1,3,20151107,0,-1,0,1,5,1,2015,1,5,673,0
Panthers,1,0,0,0,1,Kings,0,3,1,0,4,20151107,-1,2,3,3,5,3,2015,0,5,2335,0
Ducks,1,0,0,0,1,Sharks,0,0,0,0,0,20151107,1,1,1,1,1,-1,2015,0,5,305,0
Rangers,1,3,0,0,4,Coyotes,0,0,1,0,1,20151107,1,4,3,3,5,-3,2015,0,5,2139,0
Canucks,0,1,1,0,2,Sabres,0,2,1,0,3,20151107,0,1,1,1,5,1,2015,0,5,2137,0
Maple Leafs,1,0,1,0,2,Capitals,0,1,1,1,3,20151107,-1,0,0,1,5,1,2015,1,5,349,0
Penguins,1,1,0,0,2,Flames,3,1,1,0,5,20151107,2,2,3,3,7,3,2015,0,5,1777,0
Bruins,1,1,0,0,2,Islanders,0,0,1,0,1,20151108,1,2,1,1,3,-1,2015,0,6,190,0
Oilers,0,0,2,0,2,Blackhawks,2,0,2,0,4,20151108,2,2,2,2,6,2,2015,0,6,1437,0
Stars,2,0,2,0,4,Red Wings,1,0,0,0,1,20151108,1,1,3,3,5,-3,2015,0,6,999,0
Canucks,1,2,0,0,3,Devils,2,1,0,1,4,20151108,1,0,0,1,7,1,2015,1,6,2421,0
Coyotes,0,3,0,1,4,Ducks,2,0,1,0,3,20151109,-2,1,0,1,7,-1,2015,1,0,356,0
Senators,3,2,0,0,5,Predators,1,3,3,0,7,20151110,-2,-1,2,2,12,2,2015,0,1,845,0
Islanders,2,0,2,0,4,Sharks,0,1,1,0,2,20151110,2,1,2,2,6,-2,2015,0,1,2549,0
Coyotes,1,1,1,0,3,Kings,1,1,0,0,2,20151110,0,0,1,1,5,-1,2015,0,1,356,0
Maple Leafs,1,0,2,0,3,Stars,0,1,1,0,2,20151110,1,0,1,1,5,-1,2015,0,1,1201,0
Jets,1,0,2,0,3,Wild,1,4,0,0,5,20151110,0,4,2,2,8,2,2015,0,1,388,0
Flames,1,2,0,0,3,Panthers,2,1,1,0,4,20151110,1,0,1,1,7,1,2015,0,1,2493,0
Sabres,1,1,2,0,4,Lightning,0,1,0,0,1,20151110,1,1,3,3,5,-3,2015,0,1,1051,0
Capitals,0,0,0,0,0,Red Wings,0,0,1,0,1,20151110,0,0,1,1,1,1,2015,0,1,394,0
Canucks,2,0,3,0,5,Blue Jackets,2,0,1,0,3,20151110,0,0,2,2,8,-2,2015,0,1,2050,0
Avalanche,1,2,1,0,4,Flyers,0,0,0,0,0,20151110,1,3,4,4,4,-4,2015,0,1,1574,0
Hurricanes,0,0,0,0,0,Rangers,2,0,1,0,3,20151110,2,2,3,3,3,3,2015,0,1,423,0
Blues,0,1,1,0,2,Devils,0,0,0,0,0,20151110,0,1,2,2,2,-2,2015,0,1,863,0
Canadiens,1,2,0,0,3,Penguins,2,0,1,1,4,20151111,1,-1,0,1,7,1,2015,1,2,474,0
Oilers,0,1,2,1,4,Ducks,1,0,2,0,3,20151111,-1,0,0,1,7,-1,2015,1,2,1368,0
Maple Leafs,0,0,1,1,2,Predators,0,0,1,0,1,20151112,0,0,0,1,3,-1,2015,1,3,646,0
Devils,0,2,1,0,3,Blackhawks,1,0,1,0,2,20151112,-1,1,1,1,5,-1,2015,0,3,703,0
Oilers,1,0,0,0,1,Coyotes,1,2,1,0,4,20151112,0,2,3,3,5,3,2015,0,3,1392,0
Sabres,1,1,1,0,3,Panthers,0,1,1,0,2,20151112,1,1,1,1,5,-1,2015,0,3,1184,0
Jets,2,0,1,0,3,Stars,2,1,3,0,6,20151112,0,1,3,3,9,3,2015,0,3,1183,0
Islanders,1,0,0,0,1,Kings,1,1,0,0,2,20151112,0,1,1,1,3,1,2015,0,3,2445,0
Flames,0,1,0,0,1,Lightning,0,1,2,0,3,20151112,0,0,2,2,4,2,2015,0,3,2289,0
Wild,1,1,0,1,3,Hurricanes,2,0,0,0,2,20151112,-1,0,0,1,5,-1,2015,1,3,995,0
Capitals,1,3,1,0,5,Flyers,1,1,0,0,2,20151112,0,2,3,3,7,-3,2015,0,3,123,0
Blues,1,2,0,0,3,Rangers,3,1,2,0,6,20151112,2,1,3,3,9,3,2015,0,3,871,0
Avalanche,2,0,1,0,3,Bruins,2,0,0,0,2,20151112,0,0,1,1,5,-1,2015,0,3,1765,0
Canucks,1,0,1,0,2,Senators,1,1,1,0,3,20151112,0,1,1,1,5,1,2015,0,3,2191,0
Blue Jackets,0,2,0,0,2,Penguins,0,0,1,0,1,20151113,0,2,1,1,3,-1,2015,0,4,161,0
Flames,0,1,1,1,3,Capitals,0,0,2,0,2,20151113,0,1,0,1,5,-1,2015,1,4,1967,0
Sharks,2,1,0,0,3,Red Wings,1,0,1,0,2,20151113,1,2,1,1,5,-1,2015,0,4,2071,0
Islanders,1,1,2,0,4,Ducks,0,1,0,0,1,20151113,1,1,3,3,5,-3,2015,0,4,2445,0
Wild,0,1,1,0,2,Stars,1,0,1,1,3,20151114,1,0,0,1,5,1,2015,1,5,863,0
Blackhawks,1,2,1,0,4,Blues,0,2,0,0,2,20151114,1,1,2,2,6,-2,2015,0,5,260,0
Jets,0,0,0,0,0,Predators,4,1,2,0,7,20151114,4,5,7,7,7,7,2015,0,5,1084,0
Coyotes,1,1,0,0,2,Blue Jackets,2,1,2,0,5,20151114,1,1,3,3,7,3,2015,0,5,1664,0
Flyers,0,1,1,1,3,Hurricanes,1,1,0,0,2,20151114,-1,-1,0,1,5,-1,2015,1,5,345,0
Penguins,0,0,0,0,0,Devils,1,1,2,0,4,20151114,1,2,4,4,4,4,2015,0,5,306,0
Oilers,0,2,1,0,3,Kings,2,1,1,0,4,20151114,2,1,1,1,7,1,2015,0,5,1368,0
Avalanche,3,1,2,0,6,Canadiens,0,1,0,0,1,20151114,3,3,5,5,7,-5,2015,0,5,1618,0
Canucks,0,1,1,0,2,Maple Leafs,1,1,2,0,4,20151114,1,1,2,2,6,2,2015,0,5,2090,0
Sharks,1,0,0,1,2,Sabres,0,0,1,0,1,20151114,1,1,0,1,3,-1,2015,1,5,2279,0
Red Wings,0,0,1,0,1,Bruins,0,3,0,0,3,20151114,0,3,2,2,4,2,2015,0,5,611,0
Rangers,1,0,0,1,2,Senators,1,0,0,0,1,20151114,0,0,0,1,3,-1,2015,1,5,334,0
Panthers,1,2,1,1,5,Lightning,1,2,1,0,4,20151114,0,0,0,1,9,-1,2015,1,5,205,0
Maple Leafs,1,1,1,0,3,Rangers,0,2,2,0,4,20151115,-1,0,1,1,7,1,2015,0,6,341,0
Flames,0,1,0,0,1,Blackhawks,0,3,1,0,4,20151115,0,2,3,3,5,3,2015,0,6,1397,0
Lightning,0,0,0,0,0,Panthers,0,0,1,0,1,20151116,0,0,1,1,1,1,2015,0,0,205,0
Red Wings,2,1,0,1,4,Senators,1,0,2,0,3,20151116,1,2,0,1,7,-1,2015,1,0,406,0
Canucks,2,1,0,0,3,Canadiens,0,2,1,1,4,20151116,-2,-1,0,1,7,1,2015,1,0,2273,0
Jets,0,2,0,0,2,Blues,2,1,0,0,3,20151116,2,1,1,1,5,1,2015,0,0,853,0
Coyotes,0,0,2,0,2,Islanders,1,0,4,0,5,20151116,1,1,3,3,7,3,2015,0,0,2139,0
Ducks,1,1,2,0,4,Hurricanes,0,1,0,0,1,20151116,1,1,3,3,5,-3,2015,0,0,2231,0
Devils,0,2,0,0,2,Flames,2,1,0,0,3,20151117,2,1,1,1,5,1,2015,0,1,2015,0
Ducks,1,0,1,0,2,Predators,2,1,0,0,3,20151117,1,2,1,1,5,1,2015,0,1,1776,0
Wild,1,1,1,0,3,Penguins,2,2,0,0,4,20151117,1,2,1,1,7,1,2015,0,1,741,0
Blues,1,0,0,0,1,Blue Jackets,1,1,1,0,3,20151117,0,1,2,2,4,2,2015,0,1,395,0
Avalanche,0,1,0,0,1,Maple Leafs,2,1,2,0,5,20151117,2,2,4,4,6,4,2015,0,1,1341,0
Stars,1,0,2,0,3,Sabres,0,0,1,0,1,20151117,1,1,2,2,4,-2,2015,0,1,1197,0
Sharks,2,3,0,0,5,Bruins,2,1,1,0,4,20151117,0,2,1,1,9,-1,2015,0,1,2678,0
Kings,1,0,1,1,3,Flyers,1,0,1,0,2,20151117,0,0,0,1,5,-1,2015,1,1,2388,0
Canucks,0,1,0,0,1,Jets,1,1,2,0,4,20151118,1,1,3,3,5,3,2015,0,2,1157,0
Capitals,1,0,0,1,2,Red Wings,1,0,0,0,1,20151118,0,0,0,1,3,-1,2015,1,2,394,0
Blackhawks,0,2,1,1,4,Oilers,0,1,2,0,3,20151118,0,1,0,1,7,-1,2015,1,2,1437,0
Sabres,0,2,0,0,2,Blues,1,1,0,1,3,20151119,1,0,0,1,5,1,2015,1,3,660,0
Ducks,0,1,2,0,3,Panthers,0,0,1,0,1,20151119,0,1,2,2,4,-2,2015,0,3,2335,0
Rangers,0,0,1,0,1,Lightning,1,0,1,0,2,20151119,1,1,1,1,3,1,2015,0,3,1004,0
Blue Jackets,0,0,0,0,0,Senators,0,2,1,0,3,20151119,0,2,3,3,3,3,2015,0,3,512,0
Coyotes,2,1,0,0,3,Canadiens,0,1,1,0,2,20151119,2,2,1,1,5,-1,2015,0,3,2175,0
Avalanche,1,0,2,0,3,Penguins,0,3,1,0,4,20151119,-1,2,1,1,7,1,2015,0,3,1317,0
Sharks,0,0,0,1,1,Flyers,0,0,0,0,0,20151119,0,0,0,1,1,-1,2015,1,3,2499,0
Wild,0,2,0,0,2,Bruins,1,2,1,0,4,20151119,1,1,2,2,6,2,2015,0,3,1120,0
Stars,1,0,2,0,3,Capitals,1,0,1,0,2,20151119,0,0,1,1,5,-1,2015,0,3,1181,0
Maple Leafs,0,0,1,1,2,Hurricanes,0,0,1,0,1,20151120,0,0,0,1,3,-1,2015,1,4,544,0
Predators,0,0,0,0,0,Blue Jackets,2,1,1,0,4,20151120,2,3,4,4,4,4,2015,0,4,333,0
Kings,1,1,0,0,2,Red Wings,1,2,0,0,3,20151120,0,1,1,1,5,1,2015,0,4,1979,0
Canadiens,3,1,1,0,5,Islanders,1,1,1,0,3,20151120,2,2,2,2,8,-2,2015,0,4,343,0
Blackhawks,1,0,0,0,1,Flames,1,0,0,1,2,20151120,0,0,0,1,3,1,2015,1,4,1397,0
Devils,0,1,0,0,1,Oilers,1,1,3,0,5,20151120,1,1,4,4,6,4,2015,0,4,2016,0
Blackhawks,2,0,1,0,3,Canucks,2,1,3,0,6,20151121,0,1,3,3,9,3,2015,0,5,1775,0
Sabres,0,0,0,0,0,Stars,1,0,2,0,3,20151121,1,1,3,3,3,3,2015,0,5,1197,0
Red Wings,2,1,0,1,4,Blues,2,0,1,0,3,20151121,0,1,0,1,7,-1,2015,1,5,454,0
Coyotes,2,0,0,0,2,Jets,1,1,1,0,3,20151121,-1,0,1,1,5,1,2015,0,5,1365,0
Avalanche,0,2,1,0,3,Capitals,4,0,3,0,7,20151121,4,2,4,4,10,4,2015,0,5,1489,0
Predators,0,0,0,0,0,Wild,1,2,1,0,4,20151121,1,3,4,4,4,4,2015,0,5,696,0
Rangers,1,1,2,1,5,Panthers,0,2,2,0,4,20151121,1,0,0,1,9,-1,2015,1,5,1091,0
Ducks,0,0,0,0,0,Lightning,0,3,2,0,5,20151121,0,3,5,5,5,5,2015,0,5,2149,0
Flyers,0,0,0,0,0,Senators,1,2,1,0,4,20151121,1,3,4,4,4,4,2015,0,5,373,0
Maple Leafs,0,0,0,0,0,Bruins,0,0,2,0,2,20151121,0,0,2,2,2,2,2015,0,5,430,0
Sharks,1,1,1,0,3,Penguins,0,1,0,0,1,20151121,1,1,2,2,4,-2,2015,0,5,2242,0
Kings,0,2,1,0,3,Hurricanes,1,3,0,0,4,20151122,1,2,1,1,7,1,2015,0,6,2231,0
Sharks,1,0,4,0,5,Blue Jackets,0,2,1,0,3,20151122,1,-1,2,2,8,-2,2015,0,6,2090,0
Islanders,1,0,1,0,2,Canadiens,0,2,2,0,4,20151122,-1,1,2,2,6,2,2015,0,6,343,0
Devils,0,1,2,0,3,Canucks,0,0,2,0,2,20151122,0,1,1,1,5,-1,2015,0,6,2421,0
Avalanche,0,1,3,0,4,Jets,1,0,0,0,1,20151123,-1,0,3,3,5,-3,2015,0,0,797,0
Kings,1,1,1,0,3,Panthers,0,1,0,0,1,20151123,1,1,2,2,4,-2,2015,0,0,2335,0
Bruins,2,1,0,1,4,Maple Leafs,0,3,0,0,3,20151123,2,0,0,1,7,-1,2015,1,0,430,0
Oilers,0,0,0,0,0,Capitals,0,0,1,0,1,20151123,0,0,1,1,1,1,2015,0,0,1985,0
Predators,0,0,0,0,0,Rangers,0,1,2,0,3,20151123,0,1,3,3,3,3,2015,0,0,758,0
Blues,0,0,2,0,2,Sabres,0,1,0,0,1,20151123,0,-1,1,1,3,-1,2015,0,0,660,0
Hurricanes,0,0,2,0,2,Flyers,0,2,0,1,3,20151123,0,2,0,1,5,1,2015,1,0,345,0
Senators,2,2,3,0,7,Stars,0,1,3,0,4,20151124,2,3,3,3,11,-3,2015,0,1,1404,0
Flames,2,1,0,0,3,Ducks,2,0,3,0,5,20151124,0,-1,2,2,8,2,2015,0,1,1197,0
Senators,2,2,1,0,5,Avalanche,1,0,2,0,3,20151125,1,3,2,2,8,-2,2015,0,2,1515,0
Flyers,1,0,0,0,1,Islanders,1,1,1,0,3,20151125,0,1,2,2,4,2,2015,0,2,80,0
Blackhawks,2,1,2,0,5,Sharks,1,0,1,0,2,20151125,1,2,3,3,7,-3,2015,0,2,1837,0
Kings,0,0,1,0,1,Lightning,0,0,1,1,2,20151125,0,0,0,1,3,1,2015,1,2,2149,0
Bruins,1,0,1,1,3,Red Wings,0,2,0,0,2,20151125,1,-1,0,1,5,-1,2015,1,2,611,0
Canucks,1,1,1,0,3,Wild,1,0,1,0,2,20151125,0,1,1,1,5,-1,2015,0,2,1427,0
Ducks,0,0,2,0,2,Coyotes,1,1,2,0,4,20151125,1,2,2,2,6,2,2015,0,2,356,0
Jets,2,1,0,0,3,Capitals,2,2,1,0,5,20151125,0,1,2,2,8,2,2015,0,2,1247,0
Predators,1,2,0,0,3,Sabres,0,1,1,0,2,20151125,1,2,1,1,5,-1,2015,0,2,626,0
Blue Jackets,1,1,0,0,2,Devils,0,1,0,0,1,20151125,1,1,1,1,3,-1,2015,0,2,467,0
Oilers,1,0,0,0,1,Hurricanes,1,2,1,0,4,20151125,0,2,3,3,5,3,2015,0,2,2076,0
Blues,1,0,2,0,3,Penguins,1,1,1,1,4,20151125,0,1,0,1,7,1,2015,1,2,557,0
Canadiens,1,1,3,0,5,Rangers,0,1,0,0,1,20151125,1,1,4,4,6,-4,2015,0,2,343,0
Flames,0,1,0,0,1,Coyotes,0,1,0,1,2,20151127,0,0,0,1,3,1,2015,1,4,1224,0
Canucks,0,1,1,0,2,Stars,1,1,0,1,3,20151127,1,1,0,1,5,1,2015,1,4,1766,0
Islanders,0,0,2,0,2,Panthers,1,1,0,1,3,20151127,1,2,0,1,5,1,2015,1,4,1091,0
Oilers,0,2,1,0,3,Red Wings,0,3,0,1,4,20151127,0,1,0,1,7,1,2015,1,4,1592,0
Penguins,0,0,1,0,1,Blue Jackets,0,0,1,1,2,20151127,0,0,0,1,3,1,2015,1,4,161,0
Hurricanes,0,1,0,0,1,Sabres,1,2,1,0,4,20151127,1,2,3,3,5,3,2015,0,4,491,0
Canadiens,0,1,1,1,3,Devils,0,2,0,0,2,20151127,0,-1,0,1,5,-1,2015,1,4,342,0
Blackhawks,0,0,2,1,3,Ducks,1,1,0,0,2,20151127,-1,-2,0,1,5,-1,2015,1,4,1741,0
Jets,0,1,2,0,3,Wild,0,0,1,0,1,20151127,0,1,2,2,4,-2,2015,0,4,388,0
Predators,1,0,1,0,2,Flyers,1,0,1,1,3,20151127,0,0,0,1,5,1,2015,1,4,683,0
Rangers,0,2,1,0,3,Bruins,1,1,2,0,4,20151127,1,0,1,1,7,1,2015,0,4,190,0
Lightning,0,0,2,0,2,Capitals,1,2,1,0,4,20151127,1,3,2,2,6,2,2015,0,4,818,0
Flames,0,0,2,0,2,Sharks,2,2,1,0,5,20151128,2,4,3,3,7,3,2015,0,5,1027,0
Blackhawks,1,1,0,0,2,Kings,0,0,2,1,3,20151128,-1,-2,0,1,5,1,2015,1,5,1741,0
Senators,1,1,1,0,3,Coyotes,1,2,1,0,4,20151128,0,1,1,1,7,1,2015,0,5,2071,0
Jets,0,2,1,0,3,Avalanche,2,1,2,0,5,20151128,2,1,2,2,8,2,2015,0,5,797,0
Stars,0,0,3,1,4,Wild,2,1,0,0,3,20151128,-2,-3,0,1,7,-1,2015,1,5,863,0
Sabres,0,2,2,0,4,Predators,1,0,0,0,1,20151128,-1,1,3,3,5,-3,2015,0,5,626,0
Blue Jackets,1,0,0,0,1,Blues,0,1,2,0,3,20151128,-1,0,2,2,4,2,2015,0,5,395,0
Islanders,0,2,1,0,3,Lightning,1,1,0,0,2,20151128,-1,0,1,1,5,-1,2015,0,5,1004,0
Devils,0,0,2,1,3,Canadiens,0,1,1,0,2,20151128,0,-1,0,1,5,-1,2015,1,5,342,0
Capitals,1,3,0,0,4,Maple Leafs,1,1,0,0,2,20151128,0,2,2,2,6,-2,2015,0,5,349,0
Flyers,0,1,2,0,3,Rangers,0,0,0,0,0,20151128,0,1,3,3,3,-3,2015,0,5,80,0
Oilers,2,0,0,1,3,Penguins,0,2,0,0,2,20151128,2,0,0,1,5,-1,2015,1,5,1797,0
Panthers,0,0,1,1,2,Red Wings,0,1,0,0,1,20151129,0,-1,0,1,3,-1,2015,1,6,1155,0
Avalanche,1,1,1,0,3,Islanders,1,1,3,0,5,20151130,0,0,2,2,8,2,2015,0,0,1627,0
Hurricanes,0,2,1,0,3,Rangers,2,2,0,0,4,20151130,2,2,1,1,7,1,2015,0,0,423,0
Oilers,0,0,0,0,0,Maple Leafs,1,0,2,0,3,20151130,1,1,3,3,3,3,2015,0,0,1683,0
Canucks,0,0,0,0,0,Ducks,2,0,2,0,4,20151130,2,2,4,4,4,4,2015,0,0,1076,0
Penguins,1,2,2,0,5,Sharks,0,1,0,0,1,20151201,1,2,4,4,6,-4,2015,0,1,2242,0
Canucks,1,0,0,0,1,Kings,0,0,1,1,2,20151201,-1,-1,0,1,3,1,2015,1,1,1076,0
Stars,2,1,0,0,3,Flames,0,0,3,1,4,20151201,-2,-3,0,1,7,1,2015,1,1,1536,0
Wild,1,0,1,0,2,Blackhawks,0,1,0,0,1,20151201,1,0,1,1,3,-1,2015,0,1,355,0
Coyotes,1,1,0,0,2,Predators,0,1,4,0,5,20151201,-1,-1,3,3,7,3,2015,0,1,1442,0
Blue Jackets,1,0,0,0,1,Canadiens,1,0,1,0,2,20151201,0,0,1,1,3,1,2015,0,1,605,0
Sabres,1,1,2,0,4,Red Wings,2,1,1,1,5,20151201,1,1,0,1,9,1,2015,1,1,215,0
Flyers,1,2,1,0,4,Senators,1,1,0,0,2,20151201,0,1,2,2,6,-2,2015,0,1,373,0
Avalanche,0,2,0,0,2,Devils,0,0,1,0,1,20151201,0,2,1,1,3,-1,2015,0,1,1618,0
Panthers,0,3,0,0,3,Blues,0,1,0,0,1,20151201,0,2,2,2,4,-2,2015,0,1,1061,0
Bruins,0,1,1,0,2,Oilers,0,1,1,1,3,20151202,0,0,0,1,5,1,2015,1,2,2074,0
Maple Leafs,1,0,0,0,1,Jets,2,0,4,0,6,20151202,1,1,5,5,7,5,2015,0,2,946,0
Rangers,0,1,0,0,1,Islanders,0,1,0,1,2,20151202,0,0,0,1,3,1,2015,1,2,0,0
Lightning,0,2,0,0,2,Ducks,0,1,0,0,1,20151202,0,1,1,1,3,-1,2015,0,2,2149,0
Coyotes,0,1,0,0,1,Red Wings,3,1,1,0,5,20151203,3,3,4,4,6,4,2015,0,3,1687,0
Panthers,1,1,0,0,2,Predators,0,1,0,0,1,20151203,1,1,1,1,3,-1,2015,0,3,816,0
Blackhawks,0,2,1,0,3,Senators,2,0,1,1,4,20151203,2,0,0,1,7,1,2015,1,3,628,0
Stars,1,1,2,0,4,Canucks,1,0,1,0,2,20151203,0,1,2,2,6,-2,2015,0,3,1766,0
Maple Leafs,0,0,0,0,0,Wild,0,1,0,0,1,20151203,0,1,1,1,1,1,2015,0,3,691,0
Capitals,1,1,1,0,3,Canadiens,0,1,1,0,2,20151203,1,1,1,1,5,-1,2015,0,3,495,0
Avalanche,0,2,0,0,2,Rangers,0,0,1,0,1,20151203,0,2,1,1,3,-1,2015,0,3,1627,0
Devils,1,3,1,0,5,Hurricanes,0,1,0,0,1,20151203,1,3,4,4,6,-4,2015,0,3,419,0
Sharks,0,0,0,0,0,Ducks,0,0,1,0,1,20151204,0,0,1,1,1,1,2015,0,4,305,0
Stars,0,1,0,0,1,Oilers,1,0,0,1,2,20151204,1,0,0,1,3,1,2015,1,4,1655,0
Coyotes,1,0,1,0,2,Sabres,0,2,3,0,5,20151204,-1,1,3,3,7,3,2015,0,4,1902,0
Blues,1,0,0,0,1,Islanders,0,0,1,1,2,20151204,-1,-1,0,1,3,1,2015,1,4,871,0
Flyers,1,1,1,1,4,Devils,1,0,2,0,3,20151204,0,1,0,1,7,-1,2015,1,4,75,0
Panthers,0,1,0,1,2,Blue Jackets,0,1,0,0,1,20151204,0,0,0,1,3,-1,2015,1,4,993,0
Bruins,1,2,1,0,4,Flames,2,1,1,1,5,20151204,1,0,0,1,9,1,2015,1,4,2089,0
Capitals,0,1,0,0,1,Jets,1,0,0,1,2,20151205,1,0,0,1,3,1,2015,1,5,1247,0
Penguins,0,2,1,0,3,Kings,0,4,1,0,5,20151205,0,2,2,2,8,2,2015,0,5,2132,0
Islanders,1,0,1,0,2,Senators,0,0,2,1,3,20151205,-1,-1,0,1,5,1,2015,1,5,334,0
Predators,0,3,1,0,4,Red Wings,1,1,2,1,5,20151205,1,-1,0,1,9,1,2015,1,5,470,0
Canadiens,1,1,0,0,2,Hurricanes,1,1,1,0,3,20151205,0,0,1,1,5,1,2015,0,5,727,0
Maple Leafs,1,2,1,0,4,Blues,1,0,0,0,1,20151205,0,2,3,3,5,-3,2015,0,5,659,0
Blue Jackets,2,2,0,0,4,Flyers,0,1,0,0,1,20151205,2,3,3,3,5,-3,2015,0,5,414,0
Avalanche,0,0,0,0,0,Wild,0,1,2,0,3,20151205,0,1,3,3,3,3,2015,0,5,698,0
Bruins,2,1,1,0,4,Canucks,0,0,0,0,0,20151205,2,3,4,4,4,-4,2015,0,5,2504,0
Lightning,2,1,1,0,4,Sharks,0,1,2,0,3,20151205,2,2,1,1,7,-1,2015,0,5,2365,0
Lightning,0,1,0,0,1,Kings,1,2,0,0,3,20151206,1,2,2,2,4,2,2015,0,6,2149,0
Penguins,1,0,0,0,1,Ducks,0,2,0,0,2,20151206,-1,1,1,1,3,1,2015,0,6,2132,0
Senators,0,1,0,0,1,Rangers,2,0,2,0,4,20151206,2,1,3,3,5,3,2015,0,6,334,0
Coyotes,2,0,2,0,4,Hurricanes,2,1,2,0,5,20151206,0,1,1,1,9,1,2015,0,6,1898,0
Sabres,1,1,0,0,2,Oilers,3,1,0,0,4,20151206,2,2,2,2,6,2,2015,0,6,1734,0
Panthers,0,2,0,0,2,Devils,2,1,1,0,4,20151206,2,1,2,2,6,2,2015,0,6,1090,0
Jets,0,1,0,0,1,Blackhawks,1,0,2,0,3,20151206,1,0,2,2,4,2,2015,0,6,722,0
Sabres,1,0,1,0,2,Canucks,2,2,1,0,5,20151207,1,3,3,3,7,3,2015,0,0,2137,0
Predators,1,1,1,0,3,Bruins,1,1,0,0,2,20151207,0,0,1,1,5,-1,2015,0,0,941,0
Wild,0,0,1,0,1,Avalanche,0,1,0,1,2,20151207,0,1,0,1,3,1,2015,1,0,698,0
Islanders,2,1,0,1,4,Flyers,1,1,1,0,3,20151208,1,1,0,1,7,-1,2015,1,1,80,0
Kings,0,1,1,1,3,Blue Jackets,0,2,0,0,2,20151208,0,-1,0,1,5,-1,2015,1,1,1973,0
Red Wings,1,1,0,0,2,Capitals,1,0,1,1,3,20151208,0,-1,0,1,5,1,2015,1,1,394,0
Senators,0,1,3,0,4,Panthers,1,1,0,0,2,20151208,-1,-1,2,2,6,-2,2015,0,1,1370,0
Coyotes,1,0,0,0,1,Blues,0,2,2,0,4,20151208,-1,1,3,3,5,3,2015,0,1,1270,0
Predators,0,1,0,0,1,Blackhawks,1,1,2,0,4,20151208,1,1,3,3,5,3,2015,0,1,395,0
Hurricanes,0,1,4,0,5,Stars,4,1,1,0,6,20151208,4,4,1,1,11,1,2015,0,1,1055,0
Sharks,2,0,0,0,2,Flames,2,2,0,0,4,20151208,0,2,2,2,6,2,2015,0,1,1027,0
Devils,1,1,0,0,2,Maple Leafs,1,1,0,1,3,20151208,0,0,0,1,5,1,2015,1,1,333,0
Rangers,0,0,1,0,1,Canucks,0,0,2,0,2,20151209,0,0,1,1,3,1,2015,0,2,2429,0
Penguins,1,0,3,0,4,Avalanche,2,0,0,0,2,20151209,-1,-1,2,2,6,-2,2015,0,2,1317,0
Sharks,0,0,3,0,3,Oilers,0,1,2,1,4,20151209,0,1,0,1,7,1,2015,1,2,1190,0
Bruins,0,0,3,0,3,Canadiens,1,0,0,0,1,20151209,-1,-1,2,2,4,-2,2015,0,2,270,0
Canadiens,0,1,1,0,2,Red Wings,0,1,2,0,3,20151210,0,0,1,1,5,1,2015,0,3,508,0
Senators,0,0,1,0,1,Lightning,1,0,3,0,4,20151210,1,1,3,3,5,3,2015,0,3,1251,0
Capitals,0,0,1,0,1,Panthers,1,1,2,0,4,20151210,1,2,3,3,5,3,2015,0,3,924,0
Flyers,0,3,1,0,4,Blues,0,1,1,0,2,20151210,0,2,2,2,6,-2,2015,0,3,808,0
Blackhawks,0,0,1,0,1,Predators,3,0,2,0,5,20151210,3,3,4,4,6,4,2015,0,3,395,0
Blue Jackets,1,1,2,0,4,Jets,3,0,3,0,6,20151210,2,1,2,2,10,2,2015,0,3,975,0
Sabres,0,0,3,0,3,Flames,0,2,2,0,4,20151210,0,2,1,1,7,1,2015,0,3,1731,0
Hurricanes,1,2,2,0,5,Ducks,0,0,1,0,1,20151211,1,3,4,4,6,-4,2015,0,4,2231,0
Rangers,1,2,2,0,5,Oilers,3,0,4,0,7,20151211,2,0,2,2,12,2,2015,0,4,2024,0
Jets,0,0,0,0,0,Blackhawks,1,1,0,0,2,20151211,1,2,2,2,2,2,2015,0,4,722,0
Flyers,0,1,0,0,1,Stars,0,2,1,0,3,20151211,0,1,2,2,4,2,2015,0,4,1297,0
Kings,1,0,1,1,3,Penguins,0,1,1,0,2,20151211,1,0,0,1,5,-1,2015,1,4,2132,0
Red Wings,0,2,0,0,2,Devils,0,0,2,1,3,20151211,0,-2,0,1,5,1,2015,1,4,471,0
Wild,0,1,0,0,1,Coyotes,0,1,0,1,2,20151211,0,0,0,1,3,1,2015,1,4,1278,0
Rangers,1,0,3,0,4,Flames,0,2,2,1,5,20151212,-1,1,0,1,9,1,2015,1,5,2023,0
Wild,0,0,2,0,2,Sharks,0,0,0,0,0,20151212,0,0,2,2,2,-2,2015,0,5,1570,0
Hurricanes,2,1,1,1,5,Coyotes,0,1,3,0,4,20151212,2,2,0,1,9,-1,2015,1,5,1898,0
Stars,0,0,0,0,0,Blues,1,0,2,0,3,20151212,1,1,3,3,3,3,2015,0,5,547,0
Islanders,1,1,0,1,3,Blue Jackets,0,1,1,0,2,20151212,1,1,0,1,5,-1,2015,1,5,476,0
Capitals,1,1,0,0,2,Lightning,0,0,1,0,1,20151212,1,2,1,1,3,-1,2015,0,5,818,0
Avalanche,2,0,1,0,3,Predators,1,0,1,0,2,20151212,1,1,1,1,5,-1,2015,0,5,1019,0
Senators,0,1,0,0,1,Canadiens,2,1,0,0,3,20151212,2,2,2,2,4,2,2015,0,5,104,0
Kings,1,0,0,0,1,Sabres,1,0,0,1,2,20151212,0,0,0,1,3,1,2015,1,5,2193,0
Panthers,0,0,1,0,1,Bruins,1,1,1,0,3,20151212,1,2,2,2,4,2,2015,0,5,1257,0
Devils,0,0,0,0,0,Islanders,2,2,0,0,4,20151213,2,4,4,4,4,4,2015,0,6,8,0
Avalanche,2,0,1,0,3,Blues,0,0,1,0,1,20151213,2,2,2,2,4,-2,2015,0,6,794,0
Canucks,0,0,0,0,0,Blackhawks,1,0,3,0,4,20151213,1,1,4,4,4,4,2015,0,6,1775,0
Lightning,0,1,1,0,2,Blue Jackets,0,1,0,0,1,20151214,0,0,1,1,3,-1,2015,0,0,830,0
Oilers,2,0,0,1,3,Bruins,0,1,1,0,2,20151214,2,1,0,1,5,-1,2015,1,0,2074,0
Capitals,2,0,2,0,4,Penguins,1,0,0,0,1,20151214,1,1,3,3,5,-3,2015,0,0,190,0
Kings,1,1,1,0,3,Senators,0,4,1,0,5,20151214,-1,2,2,2,8,2,2015,0,0,2345,0
Sabres,0,0,2,0,2,Red Wings,0,1,0,0,1,20151214,0,-1,1,1,3,-1,2015,0,0,215,0
Avalanche,1,1,1,0,3,Blackhawks,0,0,0,0,0,20151215,1,2,3,3,3,-3,2015,0,1,916,0
Blues,0,2,2,0,4,Jets,1,2,0,0,3,20151215,-1,-1,1,1,7,-1,2015,0,1,853,0
Blue Jackets,0,1,0,0,1,Stars,1,3,1,0,5,20151215,1,3,4,4,6,4,2015,0,1,912,0
Canucks,0,1,1,0,2,Wild,2,4,0,0,6,20151215,2,5,4,4,8,4,2015,0,1,1427,0
Oilers,0,2,0,0,2,Rangers,1,2,1,0,4,20151215,1,1,2,2,6,2,2015,0,1,2024,0
Sharks,1,2,0,0,3,Canadiens,0,1,0,0,1,20151215,1,2,2,2,4,-2,2015,0,1,2508,0
Lightning,1,1,2,1,5,Maple Leafs,2,1,1,0,4,20151215,-1,-1,0,1,9,-1,2015,1,1,1096,0
Hurricanes,1,1,1,0,3,Flyers,0,3,0,1,4,20151215,-1,1,0,1,7,1,2015,1,1,345,0
Flames,0,1,0,1,2,Predators,1,0,0,0,1,20151215,-1,0,0,1,3,-1,2015,1,1,1692,0
Panthers,0,3,2,0,5,Islanders,0,1,0,0,1,20151215,0,2,4,4,6,-4,2015,0,1,1091,0
Devils,0,1,1,0,2,Sabres,0,0,0,0,0,20151215,0,1,2,2,2,-2,2015,0,1,284,0
Senators,0,0,1,0,1,Capitals,1,1,0,0,2,20151216,1,2,1,1,3,1,2015,0,2,446,0
Penguins,0,0,0,0,0,Bruins,1,1,1,0,3,20151216,1,2,3,3,3,3,2015,0,2,481,0
Blue Jackets,2,3,2,0,7,Coyotes,1,3,1,0,5,20151217,1,1,2,2,12,-2,2015,0,3,1664,0
Islanders,0,1,0,0,1,Avalanche,1,0,1,0,2,20151217,1,0,1,1,3,1,2015,0,3,1627,0
Flames,2,1,0,0,3,Stars,1,0,0,0,1,20151217,1,2,2,2,4,-2,2015,0,3,1536,0
Oilers,0,0,0,0,0,Blackhawks,1,1,2,0,4,20151217,1,2,4,4,4,4,2015,0,3,1437,0
Kings,0,2,1,0,3,Canadiens,0,0,0,0,0,20151217,0,2,3,3,3,-3,2015,0,3,2448,0
Predators,1,0,0,0,1,Blues,0,0,2,0,2,20151217,-1,-1,1,1,3,1,2015,0,3,253,0
Sharks,2,0,2,1,5,Maple Leafs,1,2,1,0,4,20151217,1,-1,0,1,9,-1,2015,1,3,2249,0
Canucks,0,0,0,0,0,Flyers,1,0,1,0,2,20151217,1,1,2,2,2,2,2015,0,3,2404,0
Panthers,2,1,2,0,5,Devils,0,0,1,0,1,20151217,2,3,4,4,6,-4,2015,0,3,1090,0
Ducks,0,0,0,0,0,Sabres,0,2,1,0,3,20151217,0,2,3,3,3,3,2015,0,3,2193,0
Rangers,0,1,1,0,2,Wild,1,1,3,0,5,20151217,1,1,3,3,7,3,2015,0,3,1016,0
Rangers,1,1,0,0,2,Jets,3,1,1,0,5,20151218,2,2,3,3,7,3,2015,0,4,1287,0
Lightning,1,2,0,0,3,Capitals,0,1,4,0,5,20151218,-1,-2,2,2,8,2,2015,0,4,818,0
Sharks,0,1,1,0,2,Senators,0,1,3,0,4,20151218,0,0,2,2,6,2,2015,0,4,2408,0
Panthers,0,0,2,0,2,Hurricanes,0,0,0,0,0,20151218,0,0,2,2,2,-2,2015,0,4,696,0
Bruins,1,2,3,0,6,Penguins,1,1,0,0,2,20151218,0,1,4,4,8,-4,2015,0,4,481,0
Canucks,1,1,1,1,4,Red Wings,0,1,2,0,3,20151218,1,1,0,1,7,-1,2015,1,4,1967,0
Blackhawks,1,0,1,1,3,Sabres,0,1,1,0,2,20151219,1,0,0,1,5,-1,2015,1,5,453,0
Flames,0,0,2,0,2,Blues,2,1,0,0,3,20151219,2,3,1,1,5,1,2015,0,5,1440,0
Kings,0,0,0,0,0,Maple Leafs,1,0,4,0,5,20151219,1,1,5,5,5,5,2015,0,5,2170,0
Ducks,2,0,0,0,2,Devils,0,0,1,0,1,20151219,2,2,1,1,3,-1,2015,0,5,2436,0
Hurricanes,2,0,0,0,2,Penguins,0,1,0,0,1,20151219,2,1,1,1,3,-1,2015,0,5,330,0
Flyers,0,0,2,0,2,Blue Jackets,1,1,0,1,3,20151219,1,2,0,1,5,1,2015,1,5,414,0
Canadiens,0,1,1,0,2,Stars,1,3,2,0,6,20151219,1,3,4,4,8,4,2015,0,5,1505,0
Wild,0,1,1,0,2,Predators,2,1,0,0,3,20151219,2,2,1,1,5,1,2015,0,5,696,0
Islanders,0,0,0,0,0,Coyotes,1,0,0,0,1,20151219,1,1,1,1,1,1,2015,0,5,2139,0
Oilers,0,0,1,0,1,Avalanche,2,1,2,0,5,20151219,2,3,4,4,6,4,2015,0,5,1036,0
Sharks,2,1,0,0,3,Blackhawks,2,0,1,1,4,20151220,0,-1,0,1,7,1,2015,1,6,1837,0
Senators,1,1,0,0,2,Lightning,2,1,2,0,5,20151220,1,1,3,3,7,3,2015,0,6,1251,0
Flames,0,1,1,0,2,Red Wings,0,3,1,0,4,20151220,0,2,2,2,6,2,2015,0,6,1573,0
Canucks,2,2,0,0,4,Panthers,2,2,0,1,5,20151220,0,0,0,1,9,1,2015,1,6,2803,0
Devils,0,1,0,0,1,Bruins,1,0,0,1,2,20151220,1,0,0,1,3,1,2015,1,6,196,0
Capitals,1,4,2,0,7,Rangers,3,0,0,0,3,20151220,-2,2,4,4,10,-4,2015,0,6,204,0
Ducks,1,0,1,0,2,Islanders,3,0,2,0,5,20151221,2,2,3,3,7,3,2015,0,0,2445,0
Blues,2,1,0,0,3,Flyers,0,2,2,0,4,20151221,-2,-1,1,1,7,1,2015,0,0,808,0
Blue Jackets,1,0,1,0,2,Penguins,0,4,1,0,5,20151221,-1,3,3,3,7,3,2015,0,0,161,0
Capitals,1,1,0,0,2,Hurricanes,0,0,1,0,1,20151221,1,2,1,1,3,-1,2015,0,0,233,0
Canadiens,0,0,1,0,1,Predators,1,1,3,0,5,20151221,1,2,4,4,6,4,2015,0,0,937,0
Stars,0,3,3,0,6,Wild,2,0,1,0,3,20151221,-2,1,3,3,9,-3,2015,0,0,863,0
Maple Leafs,2,1,4,0,7,Avalanche,1,2,1,0,4,20151221,1,0,3,3,11,-3,2015,0,0,1341,0
Jets,0,1,0,0,1,Oilers,2,1,0,0,3,20151221,2,2,2,2,4,2,2015,0,0,738,0
Sharks,1,1,3,0,5,Kings,2,1,0,0,3,20151222,-1,-1,2,2,8,-2,2015,0,1,305,0
Maple Leafs,1,1,0,0,2,Coyotes,2,0,1,0,3,20151222,1,0,1,1,5,1,2015,0,1,1885,0
Blackhawks,0,0,0,0,0,Stars,0,1,3,0,4,20151222,0,1,4,4,4,4,2015,0,1,802,0
Jets,1,0,0,0,1,Flames,2,0,2,0,4,20151222,1,1,3,3,5,3,2015,0,1,740,0
Senators,0,0,1,0,1,Panthers,0,1,0,1,2,20151222,0,1,0,1,3,1,2015,1,1,1370,0
Canucks,1,0,1,0,2,Lightning,0,1,0,0,1,20151222,1,0,1,1,3,-1,2015,0,1,2598,0
Devils,3,0,1,0,4,Red Wings,1,1,1,0,3,20151222,2,1,1,1,7,-1,2015,0,1,471,0
Blues,0,0,2,0,2,Bruins,0,0,0,0,0,20151222,0,0,2,2,2,-2,2015,0,1,1035,0
Ducks,1,0,1,0,2,Rangers,1,0,1,1,3,20151222,0,0,0,1,5,1,2015,1,1,2445,0
Canadiens,0,0,1,0,1,Wild,1,0,1,0,2,20151222,1,1,1,1,3,1,2015,0,1,938,0
Oilers,1,0,0,0,1,Canucks,0,1,0,1,2,20151226,-1,0,0,1,3,1,2015,1,5,514,0
Kings,0,0,3,1,4,Coyotes,1,0,2,0,3,20151226,-1,-1,0,1,7,-1,2015,1,5,356,0
Penguins,0,3,0,0,3,Wild,0,1,0,0,1,20151226,0,2,2,2,4,-2,2015,0,5,741,0
Red Wings,1,1,1,0,3,Predators,1,1,0,0,2,20151226,0,0,1,1,5,-1,2015,0,5,470,0
Devils,0,0,1,0,1,Hurricanes,0,1,2,0,3,20151226,0,1,2,2,4,2,2015,0,5,419,0
Canadiens,0,1,0,0,1,Capitals,1,1,1,0,3,20151226,1,1,2,2,4,2,2015,0,5,495,0
Blue Jackets,1,1,0,0,2,Lightning,1,3,1,0,5,20151226,0,2,3,3,7,3,2015,0,5,830,0
Sabres,0,1,5,0,6,Bruins,0,2,1,0,3,20151226,0,-1,3,3,9,-3,2015,0,5,399,0
Stars,0,2,0,0,2,Blues,0,1,1,1,3,20151226,0,-1,0,1,5,1,2015,1,5,547,0
Oilers,2,1,0,0,3,Flames,0,4,1,0,5,20151227,-2,1,2,2,8,2,2015,0,6,171,0
Coyotes,0,0,1,1,2,Avalanche,1,0,0,0,1,20151227,-1,-1,0,1,3,-1,2015,1,6,585,0
Flyers,1,1,0,0,2,Ducks,1,1,2,0,4,20151227,0,0,2,2,6,2,2015,0,6,2388,0
Hurricanes,0,1,1,0,2,Blackhawks,0,0,1,0,1,20151227,0,1,1,1,3,-1,2015,0,6,641,0
Bruins,0,1,0,0,1,Senators,1,1,1,0,3,20151227,1,1,2,2,4,2,2015,0,6,320,0
Blues,0,0,0,0,0,Stars,1,0,2,0,3,20151227,1,1,3,3,3,3,2015,0,6,547,0
Blue Jackets,0,1,1,0,2,Panthers,2,0,1,0,3,20151227,2,1,1,1,5,1,2015,0,6,993,0
Maple Leafs,0,2,1,0,3,Islanders,0,0,1,0,1,20151227,0,2,2,2,4,-2,2015,0,6,341,0
Penguins,0,0,0,0,0,Jets,1,0,0,0,1,20151227,1,1,1,1,1,1,2015,0,6,1060,0
Capitals,0,2,0,0,2,Sabres,0,0,0,0,0,20151228,0,2,2,2,2,-2,2015,0,0,292,0
Canadiens,1,1,1,1,4,Lightning,0,1,2,0,3,20151228,1,1,0,1,7,-1,2015,1,0,1311,0
Rangers,0,1,2,0,3,Predators,1,1,3,0,5,20151228,1,1,2,2,8,2,2015,0,0,758,0
Red Wings,0,0,1,0,1,Wild,1,0,2,0,3,20151228,1,1,2,2,4,2,2015,0,0,542,0
Kings,1,2,2,0,5,Canucks,0,0,0,0,0,20151228,1,3,5,5,5,-5,2015,0,0,1076,0
Avalanche,2,1,3,0,6,Sharks,1,1,1,0,3,20151228,1,1,3,3,9,-3,2015,0,0,927,0
Blackhawks,3,2,2,0,7,Coyotes,2,0,3,0,5,20151229,1,3,2,2,12,-2,2015,0,1,1450,0
Kings,0,4,1,0,5,Oilers,0,1,1,0,2,20151229,0,3,3,3,7,-3,2015,0,1,1368,0
Ducks,0,1,0,0,1,Flames,0,0,0,0,0,20151229,0,1,1,1,1,-1,2015,0,1,1197,0
Hurricanes,0,2,0,0,2,Devils,0,1,2,0,3,20151229,0,-1,1,1,5,1,2015,0,1,419,0
Predators,1,0,2,0,3,Blues,1,1,1,1,4,20151229,0,1,0,1,7,1,2015,1,1,253,0
Canadiens,1,0,0,0,1,Panthers,1,1,1,0,3,20151229,0,1,2,2,4,2,2015,0,1,1418,0
Stars,1,1,1,0,3,Blue Jackets,3,1,2,0,6,20151229,2,2,3,3,9,3,2015,0,1,912,0
Islanders,3,3,0,0,6,Maple Leafs,1,1,1,0,3,20151229,2,4,3,3,9,-3,2015,0,1,341,0
Senators,1,1,1,0,3,Bruins,2,1,4,0,7,20151229,1,1,4,4,10,4,2015,0,1,320,0
Red Wings,0,0,1,0,1,Jets,2,2,0,0,4,20151229,2,4,3,3,5,3,2015,0,1,855,0
Flyers,0,1,1,0,2,Sharks,0,1,3,0,4,20151230,0,0,2,2,6,2,2015,0,2,2499,0
Sabres,1,1,0,0,2,Capitals,0,1,4,0,5,20151230,-1,-1,3,3,7,3,2015,0,2,292,0
Maple Leafs,1,1,0,1,3,Penguins,1,1,0,0,2,20151230,0,0,0,1,5,-1,2015,1,2,222,0
Devils,2,0,1,0,3,Senators,0,0,0,0,0,20151230,2,2,3,3,3,-3,2015,0,2,330,0
Rangers,1,1,3,0,5,Lightning,1,1,0,0,2,20151230,0,0,3,3,7,-3,2015,0,2,1004,0
Islanders,0,1,1,0,2,Sabres,0,0,1,0,1,20151231,0,1,1,1,3,-1,2015,0,3,292,0
Ducks,1,0,0,0,1,Oilers,0,0,0,0,0,20151231,1,1,1,1,1,-1,2015,0,3,1368,0
Kings,1,2,1,0,4,Flames,0,0,1,0,1,20151231,1,3,3,3,5,-3,2015,0,3,1197,0
Jets,1,0,1,0,2,Coyotes,1,0,3,0,4,20151231,0,0,2,2,6,2,2015,0,3,1365,0
Blackhawks,1,2,0,1,4,Avalanche,1,1,1,0,3,20151231,0,1,0,1,7,-1,2015,1,3,916,0
Wild,0,1,2,0,3,Blues,0,1,0,0,1,20151231,0,0,2,2,4,-2,2015,0,3,466,0
Capitals,0,1,1,0,2,Hurricanes,0,1,3,0,4,20151231,0,0,2,2,6,2,2015,0,3,233,0
Penguins,0,2,3,0,5,Red Wings,2,0,0,0,2,20151231,-2,0,3,3,7,-3,2015,0,3,205,0
Predators,0,1,0,0,1,Stars,0,2,3,0,5,20151231,0,1,4,4,6,4,2015,0,3,616,0
Canadiens,1,2,2,0,5,Bruins,0,0,1,0,1,20160101,1,3,4,4,6,-4,2015,0,4,270,0
Ducks,0,1,0,0,1,Canucks,0,0,1,1,2,20160101,0,-1,0,1,3,1,2015,1,4,1076,0
Capitals,2,1,1,0,4,Blue Jackets,2,0,2,1,5,20160102,0,-1,0,1,9,1,2015,1,5,326,0
Jets,1,2,1,0,4,Sharks,0,1,0,0,1,20160102,1,2,3,3,5,-3,2015,0,5,1496,0
Flames,1,3,0,0,4,Avalanche,0,0,0,0,0,20160102,1,4,4,4,4,-4,2015,0,5,898,0
Predators,0,1,0,1,2,Hurricanes,1,0,0,0,1,20160102,-1,0,0,1,3,-1,2015,1,5,456,0
Wild,1,0,1,0,2,Lightning,1,1,0,1,3,20160102,0,1,0,1,5,1,2015,1,5,1318,0
Stars,0,0,2,0,2,Devils,0,2,0,1,3,20160102,0,2,0,1,5,1,2015,1,5,1362,0
Coyotes,1,1,1,0,3,Oilers,2,0,1,1,4,20160102,1,0,0,1,7,1,2015,1,5,1392,0
Red Wings,1,1,2,0,4,Sabres,0,2,1,0,3,20160102,1,0,1,1,7,-1,2015,0,5,215,0
Islanders,0,1,1,0,2,Penguins,2,3,0,0,5,20160102,2,4,3,3,7,3,2015,0,5,314,0
Blues,0,1,0,0,1,Maple Leafs,0,1,3,0,4,20160102,0,0,3,3,5,3,2015,0,5,659,0
Rangers,0,0,0,0,0,Panthers,1,2,0,0,3,20160102,1,3,3,3,3,3,2015,0,5,1091,0
Flyers,0,0,1,0,1,Kings,2,0,0,0,2,20160102,2,2,1,1,3,1,2015,0,5,2388,0
Stars,2,0,3,0,5,Islanders,2,3,1,0,6,20160103,0,3,1,1,11,1,2015,0,6,1370,0
Wild,0,1,0,0,1,Panthers,1,0,1,0,2,20160103,1,0,1,1,3,1,2015,0,6,1513,0
Senators,0,0,0,0,0,Blackhawks,0,1,2,0,3,20160103,0,1,3,3,3,3,2015,0,6,628,0
Jets,0,1,0,0,1,Ducks,2,2,0,0,4,20160103,2,3,3,3,5,3,2015,0,6,1527,0
Senators,0,1,1,1,3,Blues,1,1,0,0,2,20160104,-1,-1,0,1,5,-1,2015,1,0,860,0
Kings,0,1,0,0,1,Avalanche,0,2,2,0,4,20160104,0,1,3,3,5,3,2015,0,0,830,0
Hurricanes,0,0,0,0,0,Oilers,0,0,0,1,1,20160104,0,0,0,1,1,1,2015,1,0,2076,0
Coyotes,0,2,1,0,3,Canucks,0,1,1,0,2,20160104,0,1,1,1,5,-1,2015,0,0,1228,0
Red Wings,1,0,0,0,1,Devils,0,0,0,0,0,20160104,1,1,1,1,1,-1,2015,0,0,471,0
Jets,1,1,2,0,4,Predators,0,0,1,0,1,20160105,1,2,3,3,5,-3,2015,0,1,1084,0
Lightning,0,0,1,0,1,Flames,1,1,1,0,3,20160105,1,2,2,2,4,2,2015,0,1,2289,0
Canadiens,1,1,1,0,3,Flyers,1,2,1,0,4,20160105,0,1,1,1,7,1,2015,0,1,400,0
Blackhawks,0,2,0,1,3,Penguins,0,0,2,0,2,20160105,0,2,0,1,5,-1,2015,1,1,409,0
Stars,1,0,1,0,2,Rangers,2,1,3,0,6,20160105,1,2,4,4,8,4,2015,0,1,1370,0
Capitals,1,1,1,0,3,Bruins,0,1,1,0,2,20160105,1,1,1,1,5,-1,2015,0,1,394,0
Wild,1,1,2,0,4,Blue Jackets,0,1,1,0,2,20160105,1,1,2,2,6,-2,2015,0,1,626,0
Panthers,1,1,3,0,5,Sabres,0,1,0,0,1,20160105,1,1,4,4,6,-4,2015,0,1,1184,0
Devils,0,0,1,0,1,Canadiens,1,1,0,0,2,20160106,1,2,1,1,3,1,2015,0,2,342,0
Penguins,0,1,0,0,1,Blackhawks,1,0,2,0,3,20160106,1,0,2,2,4,2,2015,0,2,409,0
Blues,2,1,0,0,3,Avalanche,1,1,1,1,4,20160106,-1,-1,0,1,7,1,2015,1,2,794,0
Hurricanes,0,1,1,0,2,Canucks,0,1,2,0,3,20160106,0,0,1,1,5,1,2015,0,2,2409,0
Maple Leafs,1,2,1,0,4,Ducks,0,0,0,0,0,20160106,1,3,4,4,4,-4,2015,0,2,2170,0
Red Wings,1,0,1,0,2,Sharks,1,0,0,0,1,20160107,0,0,1,1,3,-1,2015,0,3,2071,0
Maple Leafs,0,0,1,0,1,Kings,0,0,2,0,2,20160107,0,0,1,1,3,1,2015,0,3,2170,0
Panthers,2,0,1,0,3,Senators,0,1,1,0,2,20160107,2,1,1,1,5,-1,2015,0,3,1370,0
Jets,0,1,0,0,1,Stars,1,0,0,1,2,20160107,1,0,0,1,3,1,2015,1,3,1183,0
Flyers,1,2,0,1,4,Wild,1,1,1,0,3,20160107,0,1,0,1,7,-1,2015,1,3,983,0
Capitals,2,1,1,0,4,Islanders,0,1,0,0,1,20160107,2,2,3,3,5,-3,2015,0,3,204,0
Coyotes,1,0,1,0,2,Flames,1,0,0,0,1,20160107,0,0,1,1,3,-1,2015,0,3,1224,0
Blues,0,3,0,0,3,Ducks,1,1,1,1,4,20160108,1,-1,0,1,7,1,2015,1,4,1586,0
Blue Jackets,0,1,0,0,1,Hurricanes,1,1,2,0,4,20160108,1,1,3,3,5,3,2015,0,4,374,0
Predators,1,2,0,0,3,Avalanche,2,1,2,0,5,20160108,1,0,2,2,8,2,2015,0,4,1019,0
Sabres,0,0,1,0,1,Blackhawks,1,0,2,0,3,20160108,1,1,2,2,4,2,2015,0,4,453,0
Lightning,0,0,3,0,3,Oilers,1,1,0,0,2,20160108,-1,-2,1,1,5,-1,2015,0,4,2367,0
Bruins,1,2,1,0,4,Devils,0,1,0,0,1,20160108,1,2,3,3,5,-3,2015,0,4,196,0
Bruins,0,1,0,0,1,Senators,1,0,0,1,2,20160109,1,0,0,1,3,1,2015,1,5,320,0
Hurricanes,1,2,0,1,4,Blue Jackets,0,1,2,0,3,20160109,1,2,0,1,7,-1,2015,1,5,374,0
Maple Leafs,0,0,0,0,0,Sharks,0,4,3,0,7,20160109,0,4,7,7,7,7,2015,0,5,2249,0
Wild,0,2,0,0,2,Stars,0,0,1,0,1,20160109,0,2,1,1,3,-1,2015,0,5,863,0
Predators,0,0,0,0,0,Coyotes,0,1,3,0,4,20160109,0,1,4,4,4,4,2015,0,5,1442,0
Islanders,0,0,0,0,0,Flyers,0,2,2,0,4,20160109,0,2,4,4,4,4,2015,0,5,80,0
Blues,0,1,0,1,2,Kings,0,1,0,0,1,20160109,0,0,0,1,3,-1,2015,1,5,1586,0
Capitals,1,1,1,1,4,Rangers,0,0,3,0,3,20160109,1,2,0,1,7,-1,2015,1,5,204,0
Penguins,0,2,1,0,3,Canadiens,0,1,0,0,1,20160109,0,1,2,2,4,-2,2015,0,5,474,0
Lightning,1,0,1,1,3,Canucks,1,0,1,0,2,20160109,0,0,0,1,5,-1,2015,1,5,2598,0
Sabres,2,0,2,0,4,Jets,1,1,0,0,2,20160110,1,0,2,2,6,-2,2015,0,6,996,0
Senators,0,1,0,0,1,Capitals,2,3,2,0,7,20160110,2,4,6,6,8,6,2015,0,6,446,0
Avalanche,0,2,1,0,3,Blackhawks,2,4,0,0,6,20160110,2,4,3,3,9,3,2015,0,6,916,0
Devils,0,0,2,0,2,Wild,0,0,1,0,1,20160110,0,0,1,1,3,-1,2015,0,6,1007,0
Red Wings,1,0,1,0,2,Ducks,1,0,0,0,1,20160110,0,0,1,1,3,-1,2015,0,6,1979,0
Panthers,2,0,0,0,2,Oilers,1,0,0,0,1,20160110,1,1,1,1,3,-1,2015,0,6,2569,0
Sharks,2,1,2,0,5,Flames,1,2,1,0,4,20160111,1,0,1,1,9,-1,2015,0,0,1027,0
Red Wings,2,0,0,0,2,Kings,1,1,2,0,4,20160111,-1,0,2,2,6,2,2015,0,0,1979,0
Bruins,0,1,0,0,1,Rangers,0,0,2,0,2,20160111,0,-1,1,1,3,1,2015,0,0,190,0
Panthers,2,0,0,0,2,Canucks,0,1,1,1,3,20160111,-2,-1,0,1,5,1,2015,1,0,2803,0
Blue Jackets,1,1,0,0,2,Islanders,2,1,2,0,5,20160112,1,1,3,3,7,3,2015,0,1,476,0
Penguins,0,1,1,0,2,Hurricanes,0,2,0,1,3,20160112,0,1,0,1,5,1,2015,1,1,330,0
Devils,2,0,0,0,2,Blues,1,2,2,0,5,20160112,-1,1,3,3,7,3,2015,0,1,863,0
Sabres,3,0,0,0,3,Wild,0,1,1,0,2,20160112,3,2,1,1,5,-1,2015,0,1,729,0
Sharks,2,0,2,0,4,Jets,1,0,0,0,1,20160112,1,1,3,3,5,-3,2015,0,1,1496,0
Predators,0,1,1,0,2,Blackhawks,1,2,0,0,3,20160112,1,2,1,1,5,1,2015,0,1,395,0
Lightning,1,2,1,0,4,Avalanche,0,0,0,0,0,20160112,1,3,4,4,4,-4,2015,0,1,1521,0
Oilers,1,1,1,0,3,Coyotes,0,1,2,1,4,20160112,-1,-1,0,1,7,1,2015,1,1,1392,0
Blue Jackets,1,1,1,0,3,Maple Leafs,0,0,1,0,1,20160113,1,2,2,2,4,-2,2015,0,2,313,0
Panthers,0,0,0,0,0,Flames,4,1,1,0,6,20160113,4,5,6,6,6,6,2015,0,2,2493,0
Bruins,0,2,0,0,2,Flyers,1,0,2,0,3,20160113,1,-1,1,1,5,1,2015,0,2,270,0
Senators,0,1,0,0,1,Ducks,0,1,3,0,4,20160113,0,0,3,3,5,3,2015,0,2,2345,0
Oilers,0,1,0,0,1,Sharks,1,0,0,1,2,20160114,1,0,0,1,3,1,2015,1,3,1190,0
Red Wings,0,0,2,1,3,Coyotes,0,2,0,0,2,20160114,0,-2,0,1,5,-1,2015,1,3,1687,0
Hurricanes,0,1,3,0,4,Blues,0,0,1,0,1,20160114,0,1,3,3,5,-3,2015,0,3,665,0
Predators,1,0,3,0,4,Jets,0,3,1,1,5,20160114,-1,2,0,1,9,1,2015,1,3,1084,0
Blackhawks,2,0,0,0,2,Canadiens,1,0,0,0,1,20160114,1,1,1,1,3,-1,2015,0,3,732,0
Rangers,0,1,0,0,1,Islanders,0,0,3,0,3,20160114,0,-1,2,2,4,2,2015,0,3,0,0
Canucks,0,0,1,0,1,Capitals,0,2,2,0,4,20160114,0,2,3,3,5,3,2015,0,3,2359,0
Devils,0,0,0,0,0,Avalanche,1,1,1,0,3,20160114,1,2,3,3,3,3,2015,0,3,1618,0
Bruins,0,1,3,0,4,Sabres,1,0,0,0,1,20160115,-1,0,3,3,5,-3,2015,0,4,399,0
Blackhawks,0,2,2,0,4,Maple Leafs,0,0,1,0,1,20160115,0,2,3,3,5,-3,2015,0,4,436,0
Canucks,1,1,0,1,3,Hurricanes,1,0,1,0,2,20160115,0,1,0,1,5,-1,2015,1,4,2409,0
Penguins,1,1,2,0,4,Lightning,1,2,1,1,5,20160115,0,1,0,1,9,1,2015,1,4,874,0
Jets,1,0,0,0,1,Wild,0,0,0,0,0,20160115,1,1,1,1,1,-1,2015,0,4,388,0
Stars,0,1,1,0,2,Ducks,4,0,0,0,4,20160115,4,3,2,2,6,2,2015,0,4,1237,0
Flames,1,0,0,0,1,Oilers,0,0,1,1,2,20160116,-1,-1,0,1,3,1,2015,1,5,171,0
Wild,0,0,0,0,0,Predators,1,0,2,0,3,20160116,1,1,3,3,3,3,2015,0,5,696,0
Canadiens,0,2,1,0,3,Blues,1,1,1,1,4,20160116,1,0,0,1,7,1,2015,1,5,962,0
Stars,1,0,2,0,3,Sharks,0,2,1,1,4,20160116,-1,1,0,1,7,1,2015,1,5,1449,0
Capitals,0,0,1,0,1,Sabres,2,2,0,0,4,20160116,2,4,3,3,5,3,2015,0,5,292,0
Maple Leafs,1,1,0,0,2,Bruins,1,1,1,0,3,20160116,0,0,1,1,5,1,2015,0,5,430,0
Senators,0,1,4,0,5,Kings,1,1,1,0,3,20160116,-1,-1,2,2,8,-2,2015,0,5,2345,0
Rangers,1,1,0,1,3,Flyers,1,0,1,0,2,20160116,0,1,0,1,5,-1,2015,1,5,80,0
Devils,1,0,1,0,2,Coyotes,0,0,0,0,0,20160116,1,1,2,2,2,-2,2015,0,5,2131,0
Avalanche,0,1,0,0,1,Blue Jackets,1,0,1,0,2,20160116,1,0,1,1,3,1,2015,0,5,1163,0
Flyers,0,0,1,1,2,Red Wings,0,1,0,0,1,20160117,0,-1,0,1,3,-1,2015,1,6,441,0
Kings,0,3,0,0,3,Ducks,0,1,1,0,2,20160117,0,2,1,1,5,-1,2015,0,6,0,0
Rangers,1,1,0,0,2,Capitals,1,2,2,0,5,20160117,0,1,3,3,7,3,2015,0,6,204,0
Panthers,0,0,1,0,1,Lightning,0,2,1,0,3,20160117,0,2,2,2,4,2,2015,0,6,205,0
Canucks,0,1,0,1,2,Islanders,0,0,1,0,1,20160117,0,1,0,1,3,-1,2015,1,6,2429,0
Hurricanes,0,0,0,0,0,Penguins,2,1,2,0,5,20160117,2,3,5,5,5,5,2015,0,6,330,0
Canadiens,1,0,1,0,2,Blackhawks,1,2,2,0,5,20160117,0,2,3,3,7,3,2015,0,6,732,0
Oilers,2,1,1,0,4,Panthers,0,0,2,0,2,20160118,2,3,2,2,6,-2,2015,0,0,2569,0
Penguins,1,1,0,0,2,Blues,1,1,3,0,5,20160118,0,0,3,3,7,3,2015,0,0,557,0
Avalanche,0,2,0,0,2,Jets,0,0,1,0,1,20160118,0,2,1,1,3,-1,2015,0,0,797,0
Sabres,0,2,0,0,2,Coyotes,0,0,1,0,1,20160118,0,2,1,1,3,-1,2015,0,0,1902,0
Senators,1,1,1,1,4,Sharks,0,1,2,0,3,20160118,1,1,0,1,7,-1,2015,1,0,2408,0
Stars,2,0,0,0,2,Kings,2,0,1,0,3,20160119,0,0,1,1,5,1,2015,0,1,1237,0
Oilers,2,0,2,0,4,Lightning,2,2,2,0,6,20160119,0,2,2,2,10,2,2015,0,1,2367,0
Blackhawks,1,2,1,0,4,Predators,0,1,0,0,1,20160119,1,2,3,3,5,-3,2015,0,1,395,0
Flames,1,1,0,0,2,Devils,1,2,1,0,4,20160119,0,1,2,2,6,2,2015,0,1,2015,0
Maple Leafs,1,1,1,0,3,Flyers,1,0,1,0,2,20160119,0,1,1,1,5,-1,2015,0,1,334,0
Canucks,1,1,0,0,2,Rangers,0,1,1,1,3,20160119,-1,-1,0,1,5,1,2015,1,1,2429,0
Bruins,1,1,2,0,4,Canadiens,0,1,0,0,1,20160119,1,1,3,3,5,-3,2015,0,1,270,0
Capitals,2,3,1,0,6,Blue Jackets,1,1,1,0,3,20160119,1,3,3,3,9,-3,2015,0,1,326,0
Wild,1,0,0,0,1,Ducks,1,0,2,0,3,20160120,0,0,2,2,4,2,2015,0,2,1521,0
Sabres,0,1,0,0,1,Avalanche,0,0,2,0,2,20160120,0,-1,1,1,3,1,2015,0,2,1366,0
Blues,1,0,1,0,2,Red Wings,0,0,1,0,1,20160120,1,1,1,1,3,-1,2015,0,2,454,0
Flames,1,1,2,0,4,Blue Jackets,0,2,0,0,2,20160121,1,0,2,2,6,-2,2015,0,3,1670,0
Hurricanes,0,0,0,1,1,Maple Leafs,0,0,0,0,0,20160121,0,0,0,1,1,-1,2015,1,3,544,0
Blackhawks,1,0,0,0,1,Lightning,1,1,0,0,2,20160121,0,1,1,1,3,1,2015,0,3,1004,0
Predators,1,1,2,0,4,Jets,1,0,0,0,1,20160121,0,1,3,3,5,-3,2015,0,3,1084,0
Oilers,0,1,1,0,2,Stars,1,2,0,0,3,20160121,1,2,1,1,5,1,2015,0,3,1655,0
Sharks,2,0,1,0,3,Coyotes,0,0,1,0,1,20160121,2,2,2,2,4,-2,2015,0,3,614,0
Wild,0,2,1,0,3,Kings,0,0,0,0,0,20160121,0,2,3,3,3,-3,2015,0,3,1521,0
Flyers,2,0,1,0,3,Penguins,0,3,1,0,4,20160121,-2,1,1,1,7,1,2015,0,3,257,0
Senators,0,1,2,0,3,Devils,5,0,1,0,6,20160121,5,4,3,3,9,3,2015,0,3,330,0
Canucks,1,0,3,0,4,Bruins,0,1,1,0,2,20160121,1,0,2,2,6,-2,2015,0,3,2504,0
Blues,0,1,0,0,1,Avalanche,0,0,1,1,2,20160122,0,-1,0,1,3,1,2015,1,4,794,0
Rangers,2,2,0,0,4,Hurricanes,0,1,0,0,1,20160122,2,3,3,3,5,-3,2015,0,4,423,0
Islanders,1,1,3,0,5,Senators,0,2,0,0,2,20160122,1,0,3,3,7,-3,2015,0,4,334,0
Red Wings,0,0,3,0,3,Sabres,0,0,0,0,0,20160122,0,0,3,3,3,-3,2015,0,4,215,0
Blackhawks,0,0,0,0,0,Panthers,3,1,0,0,4,20160122,3,4,4,4,4,4,2015,0,4,1189,0
Kings,0,2,0,0,2,Coyotes,1,1,1,0,3,20160123,1,0,1,1,5,1,2015,0,5,356,0
Predators,1,1,2,0,4,Oilers,1,0,0,0,1,20160123,0,1,3,3,5,-3,2015,0,5,1758,0
Avalanche,1,1,1,0,3,Stars,0,1,0,0,1,20160123,1,1,2,2,4,-2,2015,0,5,661,0
Blue Jackets,0,2,0,0,2,Bruins,0,2,0,1,3,20160123,0,0,0,1,5,1,2015,1,5,642,0
Lightning,0,0,2,0,2,Panthers,0,4,1,0,5,20160123,0,4,3,3,7,3,2015,0,5,205,0
Ducks,2,0,2,0,4,Red Wings,1,1,1,0,3,20160123,1,0,1,1,7,-1,2015,0,5,1979,0
Canadiens,2,0,0,1,3,Maple Leafs,0,1,1,0,2,20160123,2,1,0,1,5,-1,2015,1,5,303,0
Wild,2,0,1,0,3,Sharks,1,2,1,0,4,20160123,-1,1,1,1,7,1,2015,0,5,1570,0
Devils,1,1,1,0,3,Jets,0,0,1,0,1,20160123,1,2,2,2,4,-2,2015,0,5,1280,0
Canucks,2,0,2,0,4,Penguins,0,1,4,0,5,20160123,-2,-1,1,1,9,1,2015,0,5,2168,0
Rangers,0,0,0,0,0,Senators,0,1,2,0,3,20160124,0,1,3,3,3,3,2015,0,6,334,0
Flames,0,1,1,0,2,Hurricanes,2,1,2,0,5,20160124,2,2,3,3,7,3,2015,0,6,2038,0
Blues,0,0,0,0,0,Blackhawks,0,1,1,0,2,20160124,0,1,2,2,2,2,2015,0,6,260,0
Kings,0,0,2,1,3,Sharks,0,1,1,0,2,20160124,0,-1,0,1,5,-1,2015,1,6,305,0
Coyotes,0,0,1,1,2,Wild,0,0,1,0,1,20160125,0,0,0,1,3,-1,2015,1,0,1278,0
Flames,0,0,1,0,1,Stars,0,2,0,0,2,20160125,0,2,1,1,3,1,2015,0,0,1536,0
Canadiens,1,1,0,0,2,Blue Jackets,1,1,3,0,5,20160125,0,0,3,3,7,3,2015,0,0,605,0
Sabres,1,0,2,0,3,Rangers,1,1,4,0,6,20160125,0,1,3,3,9,3,2015,0,0,292,0
Bruins,2,0,1,0,3,Flyers,0,1,1,0,2,20160125,2,1,1,1,5,-1,2015,0,0,270,0
Red Wings,1,2,1,0,4,Islanders,1,0,1,0,2,20160125,0,2,2,2,6,-2,2015,0,0,480,0
Ducks,2,2,2,0,6,Bruins,1,0,1,0,2,20160126,1,3,4,4,8,-4,2015,0,1,2590,0
Devils,0,0,0,0,0,Penguins,1,1,0,0,2,20160126,1,2,2,2,2,2,2015,0,1,306,0
Blackhawks,0,0,0,0,0,Hurricanes,3,2,0,0,5,20160126,3,5,5,5,5,5,2015,0,1,641,0
Blue Jackets,2,1,2,0,5,Canadiens,0,1,1,0,2,20160126,2,2,3,3,7,-3,2015,0,1,605,0
Sabres,1,1,1,0,3,Senators,1,1,0,0,2,20160126,0,0,1,1,5,-1,2015,0,1,219,0
Maple Leafs,1,0,0,0,1,Panthers,0,3,2,0,5,20160126,-1,2,4,4,6,4,2015,0,1,1234,0
Coyotes,0,1,1,0,2,Jets,2,3,0,0,5,20160126,2,4,3,3,7,3,2015,0,1,1365,0
Predators,1,0,1,0,2,Canucks,1,0,0,0,1,20160126,0,0,1,1,3,-1,2015,0,1,2030,0
Avalanche,0,0,1,0,1,Sharks,2,2,2,0,6,20160126,2,4,5,5,7,5,2015,0,1,927,0
Maple Leafs,0,0,0,0,0,Lightning,1,0,0,0,1,20160127,1,1,1,1,1,1,2015,0,2,1096,0
Predators,1,1,0,0,2,Flames,0,0,1,0,1,20160127,1,2,1,1,3,-1,2015,0,2,1692,0
Flyers,2,1,0,1,4,Capitals,0,2,1,0,3,20160127,2,1,0,1,7,-1,2015,1,2,123,0
Avalanche,0,2,2,0,4,Kings,2,1,0,0,3,20160127,-2,-1,1,1,7,-1,2015,0,2,830,0
Sharks,0,2,0,0,2,Ducks,1,2,0,0,3,20160202,1,1,1,1,5,1,2015,0,1,305,0
Blue Jackets,1,0,0,0,1,Oilers,0,4,1,0,5,20160202,-1,3,4,4,6,4,2015,0,1,1703,0
Kings,0,4,2,0,6,Coyotes,1,1,0,0,2,20160202,-1,2,4,4,8,-4,2015,0,1,356,0
Blackhawks,2,0,0,0,2,Avalanche,1,0,0,0,1,20160202,1,1,1,1,3,-1,2015,0,1,916,0
Canadiens,1,1,0,0,2,Flyers,2,0,2,0,4,20160202,1,0,2,2,6,2,2015,0,1,400,0
Blues,0,0,1,0,1,Predators,0,0,0,0,0,20160202,0,0,1,1,1,-1,2015,0,1,253,0
Panthers,2,2,1,0,5,Capitals,0,0,2,0,2,20160202,2,4,3,3,7,-3,2015,0,1,924,0
Senators,2,2,1,0,5,Penguins,3,2,1,0,6,20160202,1,1,1,1,11,1,2015,0,1,392,0
Wild,1,1,1,0,3,Islanders,0,3,2,0,5,20160202,-1,1,2,2,8,2,2015,0,1,1016,0
Rangers,1,0,1,0,2,Devils,0,1,2,0,3,20160202,-1,0,1,1,5,1,2015,0,1,8,0
Maple Leafs,0,1,2,1,4,Bruins,1,0,2,0,3,20160202,-1,0,0,1,7,-1,2015,1,1,430,0
Stars,0,3,2,0,5,Jets,1,1,1,0,3,20160202,-1,1,2,2,8,-2,2015,0,1,1183,0
Sabres,1,0,3,0,4,Canadiens,0,2,0,0,2,20160203,1,-1,2,2,6,-2,2015,0,2,311,0
Red Wings,0,1,0,0,1,Lightning,0,2,1,0,3,20160203,0,1,2,2,4,2,2015,0,2,994,0
Hurricanes,1,0,0,0,1,Flames,1,2,1,0,4,20160203,0,2,3,3,5,3,2015,0,2,2038,0
Ducks,2,2,0,0,4,Kings,0,1,1,0,2,20160204,2,3,2,2,6,-2,2015,0,3,0,0
Blackhawks,0,3,1,1,5,Coyotes,1,2,1,0,4,20160204,-1,0,0,1,9,-1,2015,1,3,1450,0
Flyers,2,2,2,0,6,Predators,0,2,1,0,3,20160204,2,2,3,3,9,-3,2015,0,3,683,0
Blue Jackets,0,0,1,1,2,Canucks,1,0,0,0,1,20160204,-1,-1,0,1,3,-1,2015,1,3,2050,0
Red Wings,1,1,1,0,3,Panthers,3,1,2,0,6,20160204,2,2,3,3,9,3,2015,0,3,1155,0
Bruins,0,1,1,1,3,Sabres,1,1,0,0,2,20160204,-1,-1,0,1,5,-1,2015,1,3,399,0
Sharks,0,2,1,0,3,Blues,0,1,0,0,1,20160204,0,1,2,2,4,-2,2015,0,3,1719,0
Wild,2,0,0,0,2,Rangers,0,2,2,0,4,20160204,-2,0,2,2,6,2,2015,0,3,1016,0
Stars,1,1,1,1,4,Avalanche,2,1,0,0,3,20160204,-1,-1,0,1,7,-1,2015,1,3,661,0
Devils,1,0,1,0,2,Maple Leafs,1,0,1,1,3,20160204,0,0,0,1,5,1,2015,1,3,333,0
Islanders,1,0,1,0,2,Capitals,1,1,1,0,3,20160204,0,1,1,1,5,1,2015,0,3,204,0
Oilers,3,1,3,0,7,Senators,1,1,0,0,2,20160204,2,2,5,5,9,-5,2015,0,3,1754,0
Penguins,1,1,1,0,3,Lightning,2,2,2,0,6,20160205,1,2,3,3,9,3,2015,0,4,874,0
Hurricanes,4,0,1,0,5,Jets,0,1,2,0,3,20160205,4,3,2,2,8,-2,2015,0,4,1350,0
Blue Jackets,0,1,1,0,2,Flames,1,0,0,0,1,20160205,-1,0,1,1,3,-1,2015,0,4,1670,0
Coyotes,1,1,0,0,2,Ducks,0,2,3,0,5,20160205,-1,0,3,3,7,3,2015,0,4,356,0
Flames,0,1,3,0,4,Canucks,0,0,1,0,1,20160206,0,1,3,3,5,-3,2015,0,5,426,0
Blackhawks,3,2,0,0,5,Stars,1,0,0,0,1,20160206,2,4,4,4,6,-4,2015,0,5,802,0
Sharks,0,1,1,0,2,Predators,1,2,3,0,6,20160206,1,2,4,4,8,4,2015,0,5,1934,0
Wild,0,1,0,0,1,Blues,0,3,1,0,4,20160206,0,2,3,3,5,3,2015,0,5,466,0
Jets,1,2,1,0,4,Avalanche,1,1,0,0,2,20160206,0,1,2,2,6,-2,2015,0,5,797,0
Maple Leafs,0,0,1,0,1,Senators,3,1,2,0,6,20160206,3,4,5,5,7,5,2015,0,5,203,0
Sabres,0,1,0,0,1,Bruins,1,0,0,1,2,20160206,1,0,0,1,3,1,2015,1,5,399,0
Capitals,0,1,1,1,3,Devils,0,0,2,0,2,20160206,0,1,0,1,5,-1,2015,1,5,198,0
Islanders,0,0,1,0,1,Red Wings,2,2,1,0,5,20160206,2,4,4,4,6,4,2015,0,5,480,0
Rangers,0,0,2,1,3,Flyers,0,1,1,0,2,20160206,0,-1,0,1,5,-1,2015,1,5,80,0
Penguins,0,0,2,1,3,Panthers,0,1,1,0,2,20160206,0,-1,0,1,5,-1,2015,1,5,1013,0
Oilers,0,0,1,0,1,Canadiens,2,2,1,0,5,20160206,2,4,4,4,6,4,2015,0,5,1826,0
Flyers,1,0,1,0,2,Capitals,0,2,1,0,3,20160207,-1,1,1,1,5,1,2015,0,6,123,0
Hurricanes,1,0,0,0,1,Canadiens,0,1,0,1,2,20160207,-1,0,0,1,3,1,2015,1,6,727,0
Oilers,0,1,0,0,1,Islanders,3,4,1,0,8,20160207,3,6,7,7,9,7,2015,0,6,2024,0
Ducks,1,1,0,0,2,Penguins,3,1,2,0,6,20160208,2,2,4,4,8,4,2015,0,0,2132,0
Lightning,1,0,0,0,1,Senators,2,2,1,0,5,20160208,1,3,4,4,6,4,2015,0,0,1251,0
Devils,0,0,1,0,1,Rangers,0,1,1,0,2,20160208,0,1,1,1,3,1,2015,0,0,8,0
Panthers,0,0,0,0,0,Red Wings,0,0,3,0,3,20160208,0,0,3,3,3,3,2015,0,0,1155,0
Stars,1,2,0,1,4,Wild,2,0,1,0,3,20160209,-1,1,0,1,7,-1,2015,1,1,863,0
Canucks,0,2,1,0,3,Avalanche,0,1,0,0,1,20160209,0,1,2,2,4,-2,2015,0,1,1105,0
Sharks,0,1,1,0,2,Blackhawks,0,0,0,0,0,20160209,0,1,2,2,2,-2,2015,0,1,1837,0
Capitals,1,1,3,0,5,Predators,0,1,2,0,3,20160209,1,1,2,2,8,-2,2015,0,1,566,0
Maple Leafs,1,1,1,0,3,Flames,2,2,0,0,4,20160209,1,2,1,1,7,1,2015,0,1,1682,0
Oilers,1,0,0,0,1,Devils,1,0,1,0,2,20160209,0,0,1,1,3,1,2015,0,1,2016,0
Lightning,0,1,1,0,2,Canadiens,1,2,1,0,4,20160209,1,2,2,2,6,2,2015,0,1,1311,0
Islanders,1,0,1,1,3,Blue Jackets,2,0,0,0,2,20160209,-1,-1,0,1,5,-1,2015,1,1,476,0
Ducks,2,1,1,0,4,Flyers,0,0,1,0,1,20160209,2,3,3,3,5,-3,2015,0,1,2388,0
Kings,2,4,3,0,9,Bruins,1,0,1,0,2,20160209,1,5,7,7,11,-7,2015,0,1,2590,0
Panthers,3,3,1,0,7,Sabres,0,2,2,0,4,20160209,3,4,3,3,11,-3,2015,0,1,1184,0
Jets,0,1,0,1,2,Blues,0,1,0,0,1,20160209,0,0,0,1,3,-1,2015,1,1,853,0
Rangers,1,0,2,0,3,Penguins,0,0,0,0,0,20160210,1,1,3,3,3,-3,2015,0,2,314,0
Senators,0,0,1,0,1,Red Wings,1,0,2,0,3,20160210,1,1,2,2,4,2,2015,0,2,406,0
Canucks,1,1,0,0,2,Coyotes,0,1,0,0,1,20160210,1,1,1,1,3,-1,2015,0,2,1228,0
Sabres,0,0,1,0,1,Flyers,0,4,1,0,5,20160211,0,4,4,4,6,4,2015,0,3,279,0
Ducks,1,1,1,0,3,Blue Jackets,0,1,2,1,4,20160211,-1,-1,0,1,7,1,2015,1,3,1973,0
Avalanche,1,2,1,0,4,Senators,0,2,1,0,3,20160211,1,1,1,1,7,-1,2015,0,3,1515,0
Capitals,0,3,1,0,4,Wild,0,1,2,0,3,20160211,0,2,1,1,7,-1,2015,0,3,931,0
Bruins,3,0,3,0,6,Jets,2,0,0,0,2,20160211,1,1,4,4,8,-4,2015,0,3,1349,0
Stars,4,0,0,0,4,Blackhawks,0,0,2,0,2,20160211,4,4,2,2,6,-2,2015,0,3,802,0
Maple Leafs,1,1,0,0,2,Oilers,1,2,2,0,5,20160211,0,1,3,3,7,3,2015,0,3,1683,0
Flames,4,0,1,1,6,Sharks,1,2,2,0,5,20160211,3,1,0,1,11,-1,2015,1,3,1027,0
Kings,0,1,1,0,2,Islanders,3,1,1,0,5,20160211,3,3,3,3,7,3,2015,0,3,2445,0
Flames,0,0,1,0,1,Coyotes,1,2,1,0,4,20160212,1,3,3,3,5,3,2015,0,4,1224,0
Blues,3,1,1,0,5,Panthers,1,1,1,0,3,20160212,2,2,2,2,8,-2,2015,0,4,1061,0
Avalanche,1,0,1,1,3,Red Wings,0,1,1,0,2,20160212,1,0,0,1,5,-1,2015,1,4,1154,0
Penguins,0,1,0,1,2,Hurricanes,0,0,1,0,1,20160212,0,1,0,1,3,-1,2015,1,4,330,0
Canadiens,1,3,0,0,4,Sabres,2,3,1,0,6,20160212,1,1,2,2,10,2,2015,0,4,311,0
Kings,2,1,1,1,5,Rangers,1,2,1,0,4,20160212,1,0,0,1,9,-1,2015,1,4,2445,0
Predators,1,0,2,0,3,Lightning,0,2,1,1,4,20160212,-1,1,0,1,7,1,2015,1,4,621,0
Coyotes,0,1,0,0,1,Sharks,2,0,2,0,4,20160213,2,1,3,3,5,3,2015,0,5,614,0
Ducks,0,0,2,1,3,Blackhawks,0,1,1,0,2,20160213,0,-1,0,1,5,-1,2015,1,5,1741,0
Capitals,0,0,3,0,3,Stars,0,4,0,0,4,20160213,0,4,1,1,7,1,2015,0,5,1181,0
Jets,0,1,0,1,2,Oilers,0,0,1,0,1,20160213,0,1,0,1,3,-1,2015,1,5,738,0
Senators,0,0,2,0,2,Blue Jackets,1,1,2,0,4,20160213,1,2,2,2,6,2,2015,0,5,512,0
Islanders,0,2,1,0,3,Hurricanes,1,5,0,0,6,20160213,1,4,3,3,9,3,2015,0,5,423,0
Bruins,1,1,2,0,4,Wild,0,1,1,0,2,20160213,1,1,2,2,6,-2,2015,0,5,1120,0
Devils,1,0,0,1,2,Flyers,0,0,1,0,1,20160213,1,1,0,1,3,-1,2015,1,5,75,0
Maple Leafs,0,2,3,0,5,Canucks,0,1,1,0,2,20160213,0,1,3,3,7,-3,2015,0,5,2090,0
Predators,2,1,2,0,5,Panthers,0,0,0,0,0,20160213,2,3,5,5,5,-5,2015,0,5,816,0
Avalanche,0,1,0,0,1,Sabres,3,0,1,0,4,20160214,3,2,3,3,5,3,2015,0,6,1366,0
Kings,0,0,0,0,0,Devils,1,0,0,0,1,20160214,1,1,1,1,1,1,2015,0,6,2436,0
Bruins,3,1,1,0,5,Red Wings,2,3,1,0,6,20160214,-1,1,1,1,11,1,2015,0,6,611,0
Blues,0,1,1,0,2,Lightning,0,0,1,0,1,20160214,0,1,1,1,3,-1,2015,0,6,861,0
Flyers,0,0,1,0,1,Rangers,1,0,2,0,3,20160214,1,1,2,2,4,2,2015,0,6,80,0
Wild,2,2,1,0,5,Canucks,1,1,0,0,2,20160215,1,2,3,3,7,-3,2015,0,0,1427,0
Canadiens,1,1,0,0,2,Coyotes,2,3,1,0,6,20160215,1,3,4,4,8,4,2015,0,0,2175,0
Maple Leafs,0,0,2,0,2,Blackhawks,2,1,4,0,7,20160215,2,3,5,5,9,5,2015,0,0,436,0
Ducks,2,3,1,0,6,Flames,3,1,0,0,4,20160215,-1,1,2,2,10,-2,2015,0,0,1197,0
Red Wings,0,0,1,0,1,Islanders,0,3,1,0,4,20160215,0,3,3,3,5,3,2015,0,0,480,0
Penguins,0,0,1,0,1,Panthers,1,0,0,1,2,20160215,1,1,0,1,3,1,2015,1,0,1013,0
Stars,0,2,0,1,3,Predators,1,1,0,0,2,20160215,-1,0,0,1,5,-1,2015,1,0,616,0
Bruins,1,0,0,1,2,Blue Jackets,1,0,0,0,1,20160216,0,0,0,1,3,-1,2015,1,1,642,0
Sabres,1,0,0,0,1,Senators,1,0,0,1,2,20160216,0,0,0,1,3,1,2015,1,1,219,0
Sharks,0,2,2,0,4,Lightning,1,1,0,0,2,20160216,-1,0,2,2,6,-2,2015,0,1,2365,0
Stars,0,0,1,0,1,Blues,0,1,0,1,2,20160216,0,1,0,1,3,1,2015,1,1,547,0
Ducks,1,1,3,0,5,Oilers,0,2,1,0,3,20160216,1,0,2,2,8,-2,2015,0,1,1368,0
Flyers,1,1,4,0,6,Devils,1,0,2,0,3,20160216,0,1,3,3,9,-3,2015,0,1,75,0
Jets,0,0,1,0,1,Hurricanes,1,1,0,0,2,20160216,1,2,1,1,3,1,2015,0,1,1350,0
Kings,1,0,0,0,1,Capitals,0,1,2,0,3,20160216,-1,0,2,2,4,2,2015,0,1,2294,0
Blackhawks,1,1,3,0,5,Rangers,0,1,2,0,3,20160217,1,1,2,2,8,-2,2015,0,2,711,0
Canadiens,1,1,0,0,2,Avalanche,0,2,1,0,3,20160217,-1,0,1,1,5,1,2015,0,2,1618,0
Wild,2,2,1,0,5,Flames,0,2,1,0,3,20160217,2,2,2,2,8,-2,2015,0,2,1043,0
Stars,1,1,1,0,3,Coyotes,0,3,3,0,6,20160218,-1,1,3,3,9,3,2015,0,3,884,0
Wild,2,2,1,0,5,Oilers,2,0,0,0,2,20160218,0,2,3,3,7,-3,2015,0,3,1083,0
Bruins,0,0,0,0,0,Predators,2,0,0,0,2,20160218,2,2,2,2,2,2,2015,0,3,941,0
Ducks,0,2,3,0,5,Canucks,0,0,2,0,2,20160218,0,2,3,3,7,-3,2015,0,3,1076,0
Sharks,0,0,1,1,2,Panthers,0,0,1,0,1,20160218,0,0,0,1,3,-1,2015,1,3,2558,0
Jets,0,1,4,0,5,Lightning,3,0,2,1,6,20160218,3,2,0,1,11,1,2015,1,3,1705,0
Hurricanes,1,1,0,0,2,Senators,1,1,2,0,4,20160218,0,0,2,2,6,2,2015,0,3,673,0
Rangers,0,2,2,0,4,Maple Leafs,1,0,1,0,2,20160218,-1,1,2,2,6,-2,2015,0,3,341,0
Capitals,0,2,0,1,3,Islanders,1,0,1,0,2,20160218,-1,1,0,1,5,-1,2015,1,3,204,0
Kings,0,0,1,0,1,Blues,1,0,0,1,2,20160218,1,1,0,1,3,1,2015,1,3,1586,0
Red Wings,1,1,1,0,3,Penguins,2,2,2,0,6,20160218,1,2,3,3,9,3,2015,0,3,205,0
Islanders,1,0,0,0,1,Devils,0,0,0,0,0,20160219,1,1,1,1,1,-1,2015,0,4,8,0
Sharks,1,0,1,0,2,Hurricanes,1,1,3,0,5,20160219,0,1,3,3,7,3,2015,0,4,2382,0
Sabres,2,0,2,0,4,Blue Jackets,0,0,0,0,0,20160219,2,2,4,4,4,-4,2015,0,4,293,0
Flyers,1,0,1,0,2,Canadiens,1,0,1,1,3,20160219,0,0,0,1,5,1,2015,1,4,400,0
Canucks,2,0,0,0,2,Flames,1,3,1,0,5,20160219,-1,2,3,3,7,3,2015,0,4,426,0
Avalanche,1,1,1,0,3,Oilers,1,0,1,0,2,20160220,0,1,1,1,5,-1,2015,0,5,1036,0
Blues,4,0,2,0,6,Coyotes,1,1,2,0,4,20160220,3,2,2,2,10,-2,2015,0,5,1270,0
Bruins,1,3,3,0,7,Stars,3,0,0,0,3,20160220,-2,1,4,4,10,-4,2015,0,5,1548,0
Flyers,2,1,1,1,5,Maple Leafs,1,1,2,0,4,20160220,1,1,0,1,9,-1,2015,1,5,334,0
Devils,2,0,1,0,3,Capitals,1,1,2,0,4,20160220,-1,0,1,1,7,1,2015,0,5,198,0
Jets,1,0,0,0,1,Panthers,0,1,2,0,3,20160220,-1,0,2,2,4,2,2015,0,5,1899,0
Red Wings,0,2,0,0,2,Senators,0,1,1,1,3,20160220,0,-1,0,1,5,1,2015,1,5,406,0
Lightning,2,2,0,0,4,Penguins,0,2,0,0,2,20160220,2,2,2,2,6,-2,2015,0,5,874,0
Kings,1,0,0,1,2,Predators,1,0,0,0,1,20160220,0,0,0,1,3,-1,2015,1,5,1776,0
Flames,0,1,1,0,2,Ducks,1,1,3,0,5,20160221,1,1,3,3,7,3,2015,0,6,1197,0
Avalanche,0,0,1,0,1,Canucks,2,1,2,0,5,20160221,2,3,4,4,6,4,2015,0,6,1105,0
Penguins,1,2,1,0,4,Sabres,1,0,2,0,3,20160221,0,2,1,1,7,-1,2015,0,6,178,0
Red Wings,0,0,0,0,0,Rangers,0,0,0,1,1,20160221,0,0,0,1,1,1,2015,1,6,480,0
Lightning,0,2,2,0,4,Hurricanes,1,1,0,0,2,20160221,-1,0,2,2,6,-2,2015,0,6,585,0
Blackhawks,0,0,1,0,1,Wild,2,2,2,0,6,20160221,2,4,5,5,7,5,2015,0,6,355,0
Sharks,3,1,2,0,6,Blues,1,1,1,0,3,20160222,2,2,3,3,9,-3,2015,0,0,1719,0
Coyotes,0,1,1,0,2,Capitals,0,1,2,0,3,20160222,0,0,1,1,5,1,2015,0,0,1977,0
Blue Jackets,1,3,2,0,6,Bruins,1,1,2,0,4,20160222,0,2,2,2,10,-2,2015,0,0,642,0
Predators,1,0,0,1,2,Canadiens,1,0,0,0,1,20160222,0,0,0,1,3,-1,2015,1,0,937,0
Rangers,2,0,0,0,2,Devils,1,2,2,0,5,20160223,-1,1,3,3,7,3,2015,0,1,8,0
Flyers,1,0,0,0,1,Hurricanes,0,2,1,0,3,20160223,-1,1,2,2,4,2,2015,0,1,345,0
Predators,1,2,0,0,3,Maple Leafs,0,0,2,0,2,20160223,1,3,1,1,5,-1,2015,0,1,646,0
Coyotes,0,0,1,0,1,Lightning,1,1,0,0,2,20160223,1,2,1,1,3,1,2015,0,1,1793,0
Islanders,2,0,2,0,4,Wild,0,1,0,0,1,20160223,2,1,3,3,5,-3,2015,0,1,1016,0
Stars,1,1,3,0,5,Jets,0,2,1,0,3,20160223,1,0,2,2,8,-2,2015,0,1,1183,0
Senators,1,1,2,0,4,Oilers,0,1,0,0,1,20160223,1,1,3,3,5,-3,2015,0,1,1754,0
Flames,0,1,0,0,1,Kings,0,2,0,0,2,20160223,0,1,1,1,3,1,2015,0,1,1197,0
Blue Jackets,1,0,0,0,1,Red Wings,0,1,0,1,2,20160223,-1,0,0,1,3,1,2015,1,1,163,0
Sabres,0,0,0,0,0,Ducks,0,1,0,0,1,20160224,0,1,1,1,1,1,2015,0,2,2193,0
Penguins,0,1,0,0,1,Bruins,1,1,3,0,5,20160224,1,1,4,4,6,4,2015,0,2,481,0
Canadiens,2,2,0,0,4,Capitals,0,1,2,0,3,20160224,2,3,1,1,7,-1,2015,0,2,495,0
Sharks,1,0,2,0,3,Avalanche,1,0,2,1,4,20160224,0,0,0,1,7,1,2015,1,2,927,0
Wild,0,2,0,0,2,Flyers,1,1,1,0,3,20160225,1,0,1,1,5,1,2015,0,3,983,0
Oilers,0,1,0,0,1,Kings,0,0,2,0,2,20160225,0,-1,1,1,3,1,2015,0,3,1368,0
Islanders,0,0,1,1,2,Flames,1,0,0,0,1,20160225,-1,-1,0,1,3,-1,2015,1,3,2023,0
Senators,1,2,0,0,3,Canucks,1,1,3,0,5,20160225,0,-1,2,2,8,2,2015,0,3,2191,0
Predators,0,1,2,0,3,Blackhawks,0,1,0,0,1,20160225,0,0,2,2,4,-2,2015,0,3,395,0
Rangers,1,0,1,0,2,Blues,0,1,0,0,1,20160225,1,0,1,1,3,-1,2015,0,3,871,0
Coyotes,1,0,1,0,2,Panthers,1,1,1,0,3,20160225,0,1,1,1,5,1,2015,0,3,1978,0
Hurricanes,1,0,0,0,1,Maple Leafs,1,1,1,0,3,20160225,0,1,2,2,4,2,2015,0,3,544,0
Jets,3,0,3,0,6,Stars,0,2,1,0,3,20160225,3,1,3,3,9,-3,2015,0,3,1183,0
Devils,0,1,0,0,1,Blue Jackets,3,2,1,0,6,20160225,3,4,5,5,7,5,2015,0,3,467,0
Lightning,1,2,1,0,4,Devils,0,0,0,0,0,20160226,1,3,4,4,4,-4,2015,0,4,1000,0
Wild,1,1,0,0,2,Capitals,0,1,2,0,3,20160226,-1,-1,1,1,5,1,2015,0,4,931,0
Bruins,2,0,2,0,4,Hurricanes,0,0,1,0,1,20160226,2,2,3,3,5,-3,2015,0,4,609,0
Oilers,0,0,1,0,1,Ducks,0,0,1,1,2,20160226,0,0,0,1,3,1,2015,1,4,1368,0
Sabres,0,1,2,0,3,Sharks,1,0,0,0,1,20160226,-1,0,2,2,4,-2,2015,0,4,2279,0
Senators,1,1,4,0,6,Flames,2,2,0,0,4,20160227,-1,-2,2,2,10,-2,2015,0,5,1773,0
Sabres,0,0,0,0,0,Kings,0,1,1,0,2,20160227,0,1,2,2,2,2,2015,0,5,2193,0
Red Wings,1,0,4,0,5,Avalanche,2,0,1,0,3,20160227,-1,-1,2,2,8,-2,2015,0,5,1154,0
Panthers,1,1,1,0,3,Blue Jackets,0,1,2,1,4,20160227,-1,-1,0,1,7,1,2015,1,5,993,0
Rangers,0,1,2,0,3,Stars,0,1,1,0,2,20160227,0,0,1,1,5,-1,2015,0,5,1370,0
Jets,0,1,0,0,1,Penguins,0,2,2,0,4,20160227,0,1,3,3,5,3,2015,0,5,1060,0
Maple Leafs,1,0,0,0,1,Canadiens,1,1,2,0,4,20160227,0,1,3,3,5,3,2015,0,5,303,0
Coyotes,1,0,1,0,2,Flyers,3,0,1,0,4,20160227,2,2,2,2,6,2,2015,0,5,2078,0
Blues,0,0,0,0,0,Predators,1,3,1,0,5,20160227,1,4,5,5,5,5,2015,0,5,253,0
Panthers,0,1,0,0,1,Wild,1,0,2,0,3,20160228,1,0,2,2,4,2,2015,0,6,1513,0
Blues,1,2,2,0,5,Hurricanes,2,0,0,0,2,20160228,-1,1,3,3,7,-3,2015,0,6,665,0
Islanders,0,1,0,0,1,Oilers,0,0,3,0,3,20160228,0,-1,2,2,4,2,2015,0,6,2024,0
Capitals,1,0,1,0,2,Blackhawks,1,1,1,0,3,20160228,0,1,1,1,5,1,2015,0,6,594,0
Lightning,2,2,0,0,4,Bruins,1,0,0,0,1,20160228,1,3,3,3,5,-3,2015,0,6,1183,0
Sharks,0,0,4,0,4,Canucks,0,1,0,0,1,20160228,0,-1,3,3,5,-3,2015,0,6,821,0
Kings,1,1,0,0,2,Ducks,1,1,2,0,4,20160228,0,0,2,2,6,2,2015,0,6,0,0
Blue Jackets,0,0,1,0,1,Rangers,1,0,1,0,2,20160229,1,1,1,1,3,1,2015,0,0,476,0
Flames,1,0,2,0,3,Flyers,1,3,1,0,5,20160229,0,3,2,2,8,2,2015,0,0,2003,0
Coyotes,0,0,0,0,0,Penguins,2,2,2,0,6,20160229,2,4,6,6,6,6,2015,0,0,1824,0
Lightning,0,2,0,0,2,Maple Leafs,0,0,1,0,1,20160229,0,2,1,1,3,-1,2015,0,0,1096,0
Red Wings,0,1,1,1,3,Stars,0,1,1,0,2,20160229,0,0,0,1,5,-1,2015,1,0,999,0
Canadiens,1,1,0,0,2,Sharks,2,1,3,0,6,20160229,1,1,4,4,8,4,2015,0,0,2508,0
Islanders,1,1,1,0,3,Canucks,1,0,1,0,2,20160301,0,1,1,1,5,-1,2015,0,1,2429,0
Panthers,1,0,2,0,3,Jets,0,2,0,0,2,20160301,1,-1,1,1,5,-1,2015,0,1,1899,0
Avalanche,1,2,0,0,3,Wild,3,0,3,0,6,20160301,2,0,3,3,9,3,2015,0,1,698,0
Stars,1,1,1,0,3,Predators,1,3,1,0,5,20160301,0,2,2,2,8,2,2015,0,1,616,0
Oilers,1,0,0,1,2,Sabres,0,0,1,0,1,20160301,1,1,0,1,3,-1,2015,1,1,1734,0
Hurricanes,0,1,2,0,3,Devils,1,0,0,0,1,20160301,-1,0,2,2,4,-2,2015,0,1,419,0
Flames,0,0,1,0,1,Bruins,1,0,1,0,2,20160301,1,1,1,1,3,1,2015,0,1,2089,0
Penguins,1,1,0,0,2,Capitals,0,2,1,0,3,20160301,-1,0,1,1,5,1,2015,0,1,190,0
Blues,2,1,0,1,4,Senators,0,1,2,0,3,20160301,2,2,0,1,7,-1,2015,1,1,860,0
Maple Leafs,0,1,1,0,2,Capitals,2,0,1,0,3,20160302,2,1,1,1,5,1,2015,0,2,349,0
Blackhawks,1,2,2,0,5,Red Wings,0,0,2,0,2,20160302,1,3,3,3,7,-3,2015,0,2,238,0
Canadiens,0,1,1,0,2,Ducks,0,1,1,1,3,20160302,0,0,0,1,5,1,2015,1,2,2448,0
Panthers,1,1,0,0,2,Avalanche,2,1,0,0,3,20160303,1,1,1,1,5,1,2015,0,3,1724,0
Canadiens,1,0,1,0,2,Kings,2,0,1,0,3,20160303,1,1,1,1,5,1,2015,0,3,2448,0
Sharks,0,1,2,0,3,Canucks,2,0,0,0,2,20160303,-2,-1,1,1,5,-1,2015,0,3,821,0
Ducks,2,3,0,0,5,Coyotes,0,1,0,0,1,20160303,2,4,4,4,6,-4,2015,0,3,356,0
Lightning,0,2,2,0,4,Senators,0,0,1,0,1,20160303,0,2,3,3,5,-3,2015,0,3,1251,0
Blackhawks,1,1,0,0,2,Bruins,2,2,0,0,4,20160303,1,2,2,2,6,2,2015,0,3,849,0
Devils,1,1,2,1,5,Predators,2,1,1,0,4,20160303,-1,-1,0,1,9,-1,2015,1,3,750,0
Flames,0,2,1,0,3,Sabres,0,3,3,0,6,20160303,0,1,3,3,9,3,2015,0,3,1731,0
Islanders,0,1,2,1,4,Jets,1,0,2,0,3,20160303,-1,0,0,1,7,-1,2015,1,3,1287,0
Wild,0,1,1,0,2,Maple Leafs,0,1,0,0,1,20160303,0,0,1,1,3,-1,2015,0,3,691,0
Oilers,1,2,1,0,4,Flyers,0,0,0,0,0,20160303,1,3,4,4,4,-4,2015,0,3,2011,0
Rangers,0,1,0,0,1,Penguins,0,3,1,0,4,20160303,0,2,3,3,5,3,2015,0,3,314,0
Rangers,2,0,1,0,3,Capitals,0,2,0,0,2,20160304,2,0,1,1,5,-1,2015,0,4,204,0
Oilers,0,2,1,0,3,Blue Jackets,2,3,1,0,6,20160304,2,3,3,3,9,3,2015,0,4,1703,0
Devils,0,1,1,0,2,Stars,1,2,1,0,4,20160304,1,2,2,2,6,2,2015,0,4,1362,0
Canucks,1,1,2,0,4,Sharks,1,0,1,0,2,20160305,0,1,2,2,6,-2,2015,0,5,821,0
Canadiens,0,1,1,0,2,Jets,0,1,3,0,4,20160305,0,0,2,2,6,2,2015,0,5,1115,0
Blue Jackets,0,0,0,0,0,Flyers,2,2,2,0,6,20160305,2,4,6,6,6,6,2015,0,5,414,0
Panthers,0,1,0,0,1,Coyotes,0,2,3,0,5,20160305,0,1,4,4,6,4,2015,0,5,1978,0
Senators,1,0,2,0,3,Maple Leafs,1,1,0,0,2,20160305,0,-1,1,1,5,-1,2015,0,5,203,0
Capitals,0,1,0,1,2,Bruins,1,0,0,0,1,20160305,-1,0,0,1,3,-1,2015,1,5,394,0
Ducks,0,2,1,0,3,Kings,0,1,1,0,2,20160305,0,1,1,1,5,-1,2015,0,5,0,0
Predators,0,1,4,0,5,Avalanche,1,1,0,0,2,20160305,-1,-1,3,3,7,-3,2015,0,5,1019,0
Flames,1,2,1,0,4,Penguins,1,1,0,0,2,20160305,0,1,2,2,6,-2,2015,0,5,1777,0
Wild,1,0,1,1,3,Sabres,0,2,0,0,2,20160305,1,-1,0,1,5,-1,2015,1,5,729,0
Hurricanes,0,1,2,0,3,Lightning,1,1,1,1,4,20160305,1,1,0,1,7,1,2015,1,5,585,0
Oilers,0,2,0,0,2,Jets,0,1,0,0,1,20160306,0,1,1,1,3,-1,2015,0,6,738,0
Blues,2,1,1,0,4,Wild,0,0,2,0,2,20160306,2,3,2,2,6,-2,2015,0,6,466,0
Islanders,4,0,2,0,6,Rangers,3,0,1,0,4,20160306,1,1,2,2,10,-2,2015,0,6,0,0
Penguins,2,2,2,0,6,Devils,0,1,0,0,1,20160306,2,3,5,5,7,-5,2015,0,6,306,0
Red Wings,1,0,0,0,1,Blackhawks,2,0,2,0,4,20160306,1,1,3,3,5,3,2015,0,6,238,0
Stars,0,1,1,0,2,Senators,0,1,0,0,1,20160306,0,0,1,1,3,-1,2015,0,6,1404,0
Lightning,1,0,1,0,2,Flyers,0,1,3,0,4,20160307,-1,0,2,2,6,2,2015,0,0,928,0
Sabres,0,1,2,1,4,Maple Leafs,2,1,0,0,3,20160307,-2,-2,0,1,7,-1,2015,1,0,57,0
Bruins,4,0,0,1,5,Panthers,1,2,1,0,4,20160307,3,1,0,1,9,-1,2015,1,0,1257,0
Coyotes,0,0,1,0,1,Avalanche,1,1,1,0,3,20160307,1,2,2,2,4,2,2015,0,0,585,0
Sharks,1,0,0,1,2,Flames,0,0,1,0,1,20160307,1,1,0,1,3,-1,2015,1,0,1027,0
Capitals,0,0,1,1,2,Ducks,1,0,0,0,1,20160307,-1,-1,0,1,3,-1,2015,1,0,2294,0
Canucks,0,1,0,0,1,Kings,0,2,3,0,5,20160307,0,1,4,4,6,4,2015,0,0,1076,0
Sharks,2,1,0,0,3,Oilers,0,0,0,0,0,20160308,2,3,3,3,3,-3,2015,0,1,1190,0
Predators,2,0,2,0,4,Jets,1,0,1,0,2,20160308,1,1,2,2,6,-2,2015,0,1,1084,0
Senators,2,1,0,0,3,Hurricanes,0,2,1,1,4,20160308,-2,-1,0,1,7,1,2015,1,1,673,0
Stars,1,2,0,0,3,Canadiens,1,2,0,1,4,20160308,0,0,0,1,7,1,2015,1,1,1505,0
Penguins,1,0,0,0,1,Islanders,1,0,1,0,2,20160308,0,0,1,1,3,1,2015,0,1,314,0
Rangers,1,2,1,0,4,Sabres,0,2,0,0,2,20160308,1,1,2,2,6,-2,2015,0,1,292,0
Bruins,0,0,0,1,1,Lightning,0,0,0,0,0,20160308,0,0,0,1,1,-1,2015,1,1,1183,0
Red Wings,0,1,2,0,3,Blue Jackets,0,2,3,0,5,20160308,0,1,2,2,8,2,2015,0,1,163,0
Islanders,1,1,1,0,3,Maple Leafs,1,1,1,1,4,20160309,0,0,0,1,7,1,2015,1,2,341,0
Blackhawks,0,1,1,0,2,Blues,0,0,2,1,3,20160309,0,-1,0,1,5,1,2015,1,2,260,0
Predators,0,0,2,0,2,Flames,2,0,0,1,3,20160309,2,2,0,1,5,1,2015,1,2,1692,0
Ducks,0,0,0,0,0,Avalanche,1,2,0,0,3,20160309,1,3,3,3,3,3,2015,0,2,830,0
Coyotes,0,2,0,0,2,Canucks,0,2,0,1,3,20160309,0,0,0,1,5,1,2015,1,2,1228,0
Capitals,0,0,3,0,3,Kings,3,0,0,1,4,20160309,3,3,0,1,7,1,2015,1,2,2294,0
Devils,0,1,2,0,3,Sharks,0,0,0,0,0,20160310,0,1,3,3,3,-3,2015,0,3,2540,0
Oilers,1,0,1,0,2,Wild,0,1,0,0,1,20160310,1,0,1,1,3,-1,2015,0,3,1083,0
Senators,1,1,0,0,2,Panthers,1,3,2,0,6,20160310,0,2,4,4,8,4,2015,0,3,1370,0
Jets,2,0,0,0,2,Red Wings,0,2,1,0,3,20160310,-2,0,1,1,5,1,2015,0,3,855,0
Sabres,0,1,1,0,2,Canadiens,0,2,1,0,3,20160310,0,1,1,1,5,1,2015,0,3,311,0
Hurricanes,1,1,0,1,3,Bruins,0,1,1,0,2,20160310,1,1,0,1,5,-1,2015,1,3,609,0
Penguins,1,2,0,0,3,Blue Jackets,1,1,0,0,2,20160311,0,1,1,1,5,-1,2015,0,4,161,0
Flyers,1,2,0,0,3,Lightning,0,0,1,0,1,20160311,1,3,2,2,4,-2,2015,0,4,928,0
Ducks,0,1,1,0,2,Blues,0,1,4,0,5,20160311,0,0,3,3,7,3,2015,0,4,1586,0
Blackhawks,0,1,1,0,2,Stars,1,3,1,0,5,20160311,1,3,3,3,7,3,2015,0,4,802,0
Coyotes,0,1,3,0,4,Flames,0,1,0,0,1,20160311,0,0,3,3,5,-3,2015,0,4,1224,0
Capitals,0,2,0,0,2,Sharks,1,1,3,0,5,20160312,1,0,3,3,7,3,2015,0,5,2416,0
Devils,1,0,0,1,2,Kings,0,1,0,0,1,20160312,1,0,0,1,3,-1,2015,1,5,2436,0
Predators,0,2,0,0,2,Canucks,2,1,1,0,4,20160312,2,1,2,2,6,2,2015,0,5,2030,0
Coyotes,1,2,1,0,4,Oilers,0,0,0,0,0,20160312,1,3,4,4,4,-4,2015,0,5,1392,0
Wild,2,1,1,0,4,Canadiens,1,0,0,0,1,20160312,1,2,3,3,5,-3,2015,0,5,938,0
Avalanche,0,2,0,0,2,Jets,0,1,2,0,3,20160312,0,-1,1,1,5,1,2015,0,5,797,0
Flyers,1,1,2,0,4,Panthers,1,1,2,1,5,20160312,0,0,0,1,9,1,2015,1,5,1021,0
Maple Leafs,0,0,0,0,0,Senators,1,1,2,0,4,20160312,1,2,4,4,4,4,2015,0,5,203,0
Islanders,0,1,0,0,1,Bruins,1,1,1,0,3,20160312,1,1,2,2,4,2,2015,0,5,190,0
Hurricanes,0,1,1,0,2,Sabres,0,1,1,1,3,20160312,0,0,0,1,5,1,2015,1,5,491,0
Blues,1,3,0,1,5,Stars,1,1,2,0,4,20160312,0,2,0,1,9,-1,2015,1,5,547,0
Rangers,1,0,1,0,2,Red Wings,0,0,2,1,3,20160312,-1,-1,0,1,5,1,2015,1,5,480,0
Penguins,1,2,2,0,5,Rangers,1,1,1,0,3,20160313,0,1,2,2,8,-2,2015,0,6,314,0
Lightning,0,1,3,0,4,Blue Jackets,0,0,0,0,0,20160313,0,1,4,4,4,-4,2015,0,6,830,0
Maple Leafs,0,1,0,0,1,Red Wings,0,0,0,0,0,20160313,0,1,1,1,1,-1,2015,0,6,205,0
Devils,0,1,0,0,1,Ducks,0,4,3,0,7,20160314,0,3,6,6,8,6,2015,0,0,2436,0
Kings,2,1,2,0,5,Blackhawks,0,0,0,0,0,20160314,2,3,5,5,5,-5,2015,0,0,1741,0
Predators,1,1,1,0,3,Oilers,1,1,0,0,2,20160314,0,0,1,1,5,-1,2015,0,0,1758,0
Blues,2,0,2,0,4,Flames,2,3,2,0,7,20160314,0,3,3,3,11,3,2015,0,0,1440,0
Panthers,1,1,0,0,2,Islanders,0,0,3,0,3,20160314,-1,-2,1,1,5,1,2015,0,0,1091,0
Jets,2,1,2,0,5,Canucks,0,0,2,0,2,20160314,2,3,3,3,7,-3,2015,0,0,1157,0
Kings,3,2,0,0,5,Stars,1,1,0,0,2,20160315,2,3,3,3,7,-3,2015,0,1,1237,0
Wild,1,0,1,0,2,Senators,0,1,1,1,3,20160315,-1,0,0,1,5,1,2015,1,1,838,0
Bruins,2,0,0,0,2,Sharks,1,1,1,0,3,20160315,-1,0,1,1,5,1,2015,0,1,2678,0
Lightning,0,0,1,0,1,Maple Leafs,0,1,3,0,4,20160315,0,1,3,3,5,3,2015,0,1,1096,0
Islanders,0,0,1,0,1,Penguins,1,0,0,1,2,20160315,1,1,0,1,3,1,2015,1,1,314,0
Panthers,1,2,1,0,4,Canadiens,0,1,0,0,1,20160315,1,2,3,3,5,-3,2015,0,1,1418,0
Red Wings,0,2,1,0,3,Flyers,2,2,0,0,4,20160315,2,2,1,1,7,1,2015,0,1,441,0
Hurricanes,0,1,0,0,1,Capitals,0,1,0,1,2,20160315,0,0,0,1,3,1,2015,1,1,233,0
Canadiens,0,2,0,1,3,Sabres,1,0,1,0,2,20160316,-1,1,0,1,5,-1,2015,1,2,311,0
Flyers,1,1,1,0,3,Blackhawks,1,1,0,0,2,20160316,0,0,1,1,5,-1,2015,0,2,664,0
Blues,1,1,2,0,4,Oilers,2,3,1,0,6,20160316,1,3,2,2,10,2,2015,0,2,1508,0
Jets,0,1,0,0,1,Flames,3,0,1,0,4,20160316,3,2,3,3,5,3,2015,0,2,740,0
Avalanche,1,0,2,0,3,Canucks,1,0,0,0,1,20160316,0,0,2,2,4,-2,2015,0,2,1105,0
Rangers,0,1,1,0,2,Ducks,1,0,0,0,1,20160316,-1,0,1,1,3,-1,2015,0,2,2445,0
Rangers,1,1,1,0,3,Kings,1,0,2,1,4,20160317,0,-1,0,1,7,1,2015,1,3,2445,0
Lightning,1,2,0,0,3,Stars,1,1,2,0,4,20160317,0,-1,1,1,7,1,2015,0,3,916,0
Sharks,0,1,0,0,1,Coyotes,1,0,2,0,3,20160317,1,0,2,2,4,2,2015,0,3,614,0
Panthers,0,2,2,0,4,Maple Leafs,0,1,0,0,1,20160317,0,1,3,3,5,-3,2015,0,3,1234,0
Red Wings,1,0,2,0,3,Blue Jackets,0,0,1,0,1,20160317,1,1,2,2,4,-2,2015,0,3,163,0
Hurricanes,2,0,0,0,2,Penguins,1,2,1,0,4,20160317,-1,1,2,2,6,2,2015,0,3,330,0
Wild,1,1,2,0,4,Devils,3,3,1,0,7,20160317,2,4,3,3,11,3,2015,0,3,1007,0
Islanders,0,1,1,0,2,Predators,1,2,1,0,4,20160317,1,2,2,2,6,2,2015,0,3,758,0
Senators,1,0,0,0,1,Sabres,2,1,0,0,3,20160318,1,2,2,2,4,2,2015,0,4,219,0
Predators,0,1,0,0,1,Capitals,0,3,1,0,4,20160318,0,2,3,3,5,3,2015,0,4,566,0
Blackhawks,0,2,2,0,4,Jets,0,0,0,0,0,20160318,0,2,4,4,4,-4,2015,0,4,722,0
Avalanche,1,1,1,1,4,Flames,1,2,0,0,3,20160318,0,-1,0,1,7,-1,2015,1,4,898,0
Canucks,0,0,0,0,0,Oilers,0,1,1,0,2,20160318,0,1,2,2,2,2,2015,0,4,514,0
Bruins,0,0,0,0,0,Ducks,2,0,2,0,4,20160318,2,2,4,4,4,4,2015,0,4,2590,0
Blues,0,1,2,0,3,Canucks,0,0,0,0,0,20160319,0,1,3,3,3,-3,2015,0,5,1778,0
Bruins,0,1,0,0,1,Kings,1,1,0,0,2,20160319,1,1,1,1,3,1,2015,0,5,2590,0
Lightning,1,0,1,0,2,Coyotes,0,0,0,0,0,20160319,1,1,2,2,2,-2,2015,0,5,1793,0
Islanders,0,0,0,0,0,Stars,0,1,2,0,3,20160319,0,1,3,3,3,3,2015,0,5,1370,0
Rangers,0,1,0,0,1,Sharks,0,1,3,0,4,20160319,0,0,3,3,5,3,2015,0,5,2549,0
Red Wings,1,1,3,0,5,Panthers,1,2,0,0,3,20160319,0,-1,2,2,8,-2,2015,0,5,1155,0
Canadiens,0,0,0,0,0,Senators,1,1,3,0,5,20160319,1,2,5,5,5,5,2015,0,5,104,0
Sabres,1,0,0,0,1,Maple Leafs,0,1,3,0,4,20160319,-1,0,3,3,5,3,2015,0,5,57,0
Penguins,0,3,1,0,4,Flyers,0,1,0,0,1,20160319,0,2,3,3,5,-3,2015,0,5,257,0
Hurricanes,0,1,1,0,2,Wild,0,1,1,1,3,20160319,0,0,0,1,5,1,2015,1,5,995,0
Devils,0,2,1,0,3,Blue Jackets,2,1,3,0,6,20160319,2,1,3,3,9,3,2015,0,5,467,0
Avalanche,0,2,1,0,3,Oilers,0,0,2,0,2,20160320,0,2,1,1,5,-1,2015,0,6,1036,0
Coyotes,0,0,0,0,0,Sharks,1,1,1,0,3,20160320,1,2,3,3,3,3,2015,0,6,614,0
Flames,0,2,2,0,4,Canadiens,0,0,1,0,1,20160320,0,2,3,3,5,-3,2015,0,6,1852,0
Capitals,0,2,0,0,2,Penguins,2,1,3,0,6,20160320,2,1,4,4,8,4,2015,0,6,190,0
Blue Jackets,0,1,0,0,1,Devils,1,0,1,0,2,20160320,1,0,1,1,3,1,2015,0,6,467,0
Ducks,1,1,0,1,3,Jets,1,1,0,0,2,20160320,0,0,0,1,5,-1,2015,1,6,1527,0
Wild,0,2,0,1,3,Blackhawks,0,2,0,0,2,20160320,0,0,0,1,5,-1,2015,1,6,355,0
Panthers,0,0,2,0,2,Rangers,1,1,2,0,4,20160321,1,2,2,2,6,2,2015,0,0,1091,0
Flyers,0,2,2,0,4,Islanders,0,1,0,0,1,20160321,0,1,3,3,5,-3,2015,0,0,80,0
Flames,0,2,0,0,2,Maple Leafs,1,1,3,0,5,20160321,1,0,3,3,7,3,2015,0,0,1682,0
Kings,0,0,2,0,2,Predators,0,3,2,0,5,20160321,0,3,3,3,7,3,2015,0,0,1776,0
Oilers,1,1,0,0,2,Coyotes,1,2,1,0,4,20160322,0,1,2,2,6,2,2015,0,1,1392,0
Blues,0,0,1,0,1,Sharks,0,0,0,0,0,20160322,0,0,1,1,1,-1,2015,0,1,1719,0
Stars,4,1,1,0,6,Blackhawks,0,1,1,0,2,20160322,4,4,4,4,8,-4,2015,0,1,802,0
Flyers,1,0,1,0,2,Blue Jackets,0,0,2,1,3,20160322,-1,-1,0,1,5,1,2015,1,1,414,0
Canucks,0,0,0,0,0,Jets,0,0,2,0,2,20160322,0,0,2,2,2,2,2015,0,1,1157,0
Red Wings,0,2,0,0,2,Lightning,2,2,2,0,6,20160322,2,2,4,4,8,4,2015,0,1,994,0
Capitals,3,0,1,0,4,Senators,0,1,1,0,2,20160322,3,2,2,2,6,-2,2015,0,1,446,0
Sabres,1,0,2,0,3,Hurricanes,0,1,1,0,2,20160322,1,0,1,1,5,-1,2015,0,1,491,0
Kings,0,1,0,0,1,Wild,1,1,0,0,2,20160322,1,1,1,1,3,1,2015,0,1,1521,0
Ducks,1,2,0,0,3,Canadiens,1,2,1,0,4,20160322,0,0,1,1,7,1,2015,0,1,2448,0
Senators,0,0,1,0,1,Islanders,0,3,0,0,3,20160323,0,3,2,2,4,2,2015,0,2,334,0
Bruins,0,1,1,0,2,Rangers,2,1,2,0,5,20160323,2,2,3,3,7,3,2015,0,2,190,0
Oilers,0,4,2,0,6,Sharks,2,1,0,0,3,20160324,-2,1,3,3,9,-3,2015,0,3,1190,0
Stars,1,0,0,0,1,Coyotes,1,1,1,0,3,20160324,0,1,2,2,4,2,2015,0,3,884,0
Kings,0,1,0,0,1,Jets,0,1,3,0,4,20160324,0,0,3,3,5,3,2015,0,3,1527,0
Flyers,0,1,3,0,4,Avalanche,0,1,1,0,2,20160324,0,0,2,2,6,-2,2015,0,3,1574,0
Canucks,2,0,0,0,2,Predators,0,0,2,1,3,20160324,-2,-2,0,1,5,1,2015,1,3,2030,0
Canadiens,0,0,3,0,3,Red Wings,1,3,0,0,4,20160324,1,4,1,1,7,1,2015,0,3,508,0
Ducks,1,2,2,0,5,Maple Leafs,2,2,1,1,6,20160324,1,1,0,1,11,1,2015,1,3,2170,0
Hurricanes,0,0,3,0,3,Blue Jackets,0,1,1,0,2,20160324,0,-1,1,1,5,-1,2015,0,3,374,0
Devils,2,0,1,0,3,Penguins,0,0,0,0,0,20160324,2,2,3,3,3,-3,2015,0,3,306,0
Panthers,0,2,2,0,4,Bruins,0,1,0,0,1,20160324,0,1,3,3,5,-3,2015,0,3,1257,0
Flames,1,1,0,0,2,Wild,3,1,2,0,6,20160324,2,2,4,4,8,4,2015,0,3,1043,0
Capitals,0,0,0,1,1,Devils,0,0,0,0,0,20160325,0,0,0,1,1,-1,2015,1,4,198,0
Islanders,1,2,1,0,4,Lightning,2,1,4,0,7,20160325,1,0,3,3,11,3,2015,0,4,1004,0
Canucks,0,0,0,0,0,Blues,2,1,1,0,4,20160325,2,3,4,4,4,4,2015,0,4,1778,0
Blue Jackets,1,0,0,0,1,Predators,2,2,1,0,5,20160326,1,3,4,4,6,4,2015,0,5,333,0
Oilers,2,0,2,0,4,Kings,2,3,1,0,6,20160326,0,3,2,2,10,2,2015,0,5,1368,0
Flyers,0,0,1,0,1,Coyotes,0,2,0,0,2,20160326,0,2,1,1,3,1,2015,0,5,2078,0
Blackhawks,0,2,2,0,4,Flames,0,1,0,0,1,20160326,0,1,3,3,5,-3,2015,0,5,1397,0
Islanders,2,0,1,1,4,Hurricanes,0,3,0,0,3,20160326,2,-1,0,1,7,-1,2015,1,5,423,0
Penguins,0,4,3,0,7,Red Wings,1,0,1,0,2,20160326,-1,3,5,5,9,-5,2015,0,5,205,0
Panthers,2,1,2,0,5,Lightning,1,0,1,0,2,20160326,1,2,3,3,7,-3,2015,0,5,205,0
Ducks,0,0,3,1,4,Senators,1,2,0,0,3,20160326,-1,-3,0,1,7,-1,2015,1,5,2345,0
Rangers,1,4,0,0,5,Canadiens,1,1,0,0,2,20160326,0,3,3,3,7,-3,2015,0,5,343,0
Bruins,0,2,1,0,3,Maple Leafs,1,0,0,0,1,20160326,-1,1,2,2,4,-2,2015,0,5,430,0
Stars,1,2,1,0,4,Sharks,0,0,2,0,2,20160326,1,3,2,2,6,-2,2015,0,5,1449,0
Wild,0,2,2,0,4,Avalanche,0,0,0,0,0,20160326,0,2,4,4,4,-4,2015,0,5,698,0
Jets,2,0,0,0,2,Sabres,1,0,2,0,3,20160326,-1,-1,1,1,5,1,2015,0,5,996,0
Blues,0,3,1,0,4,Capitals,0,0,0,0,0,20160326,0,3,4,4,4,-4,2015,0,5,708,0
Devils,0,2,0,0,2,Hurricanes,2,1,0,0,3,20160327,2,1,1,1,5,1,2015,0,6,419,0
Penguins,1,1,0,1,3,Rangers,1,1,0,0,2,20160327,0,0,0,1,5,-1,2015,1,6,314,0
Blackhawks,1,0,2,0,3,Canucks,0,1,1,0,2,20160327,1,0,1,1,5,-1,2015,0,6,1775,0
Kings,1,1,0,0,2,Sharks,1,1,3,0,5,20160328,0,0,3,3,7,3,2015,0,0,305,0
Ducks,1,1,0,0,2,Oilers,0,0,1,0,1,20160328,1,2,1,1,3,-1,2015,0,0,1368,0
Flames,1,2,2,0,5,Coyotes,0,2,0,0,2,20160328,1,1,3,3,7,-3,2015,0,0,1224,0
Maple Leafs,0,0,0,0,0,Lightning,2,1,0,0,3,20160328,2,3,3,3,3,3,2015,0,0,1096,0
Sabres,0,0,2,0,2,Red Wings,1,1,1,0,3,20160328,1,2,1,1,5,1,2015,0,0,215,0
Blue Jackets,1,0,0,0,1,Capitals,1,0,3,0,4,20160328,0,0,3,3,5,3,2015,0,0,326,0
Jets,0,1,1,0,2,Flyers,0,2,0,1,3,20160328,0,1,0,1,5,1,2015,1,0,1273,0
Avalanche,3,0,1,0,4,Predators,1,0,2,0,3,20160328,2,2,1,1,7,-1,2015,0,0,1019,0
Sharks,0,2,2,0,4,Canucks,0,1,0,0,1,20160329,0,1,3,3,5,-3,2015,0,1,821,0
Avalanche,1,0,0,0,1,Blues,1,2,0,0,3,20160329,0,2,2,2,4,2,2015,0,1,794,0
Predators,1,1,0,0,2,Stars,1,2,2,0,5,20160329,0,1,3,3,7,3,2015,0,1,616,0
Maple Leafs,1,2,2,0,5,Panthers,0,1,1,0,2,20160329,1,2,3,3,7,-3,2015,0,1,1234,0
Red Wings,0,3,0,0,3,Canadiens,2,0,2,0,4,20160329,2,-1,1,1,7,1,2015,0,1,508,0
Sabres,3,0,1,0,4,Penguins,0,4,0,1,5,20160329,-3,1,0,1,9,1,2015,1,1,178,0
Hurricanes,0,1,0,0,1,Islanders,0,0,1,1,2,20160329,0,-1,0,1,3,1,2015,1,1,423,0
Bruins,0,1,0,0,1,Devils,1,0,1,0,2,20160329,1,0,1,1,3,1,2015,0,1,196,0
Blackhawks,1,0,0,0,1,Wild,1,0,3,0,4,20160329,0,0,3,3,5,3,2015,0,1,355,0
Senators,1,0,1,0,2,Jets,0,0,1,0,1,20160330,1,1,1,1,3,-1,2015,0,2,1033,0
Capitals,0,0,1,0,1,Flyers,0,0,1,1,2,20160330,0,0,0,1,3,1,2015,1,2,123,0
Flames,0,3,0,0,3,Ducks,3,4,1,0,8,20160330,3,4,5,5,11,5,2015,0,2,1197,0
Canucks,2,0,2,0,4,Sharks,0,1,1,0,2,20160331,2,1,2,2,6,-2,2015,0,3,821,0
Flames,0,0,0,0,0,Kings,0,2,1,0,3,20160331,0,2,3,3,3,3,2015,0,3,1197,0
Senators,0,2,1,0,3,Wild,0,1,1,0,2,20160331,0,1,1,1,5,-1,2015,0,3,838,0
Coyotes,1,0,0,0,1,Stars,1,2,1,0,4,20160331,0,2,3,3,5,3,2015,0,3,884,0
Canadiens,1,1,1,0,3,Lightning,0,0,0,0,0,20160331,1,2,3,3,3,-3,2015,0,3,1311,0
Rangers,0,3,0,0,3,Hurricanes,1,1,2,0,4,20160331,1,-1,1,1,7,1,2015,0,3,423,0
Predators,1,1,0,0,2,Penguins,1,3,1,0,5,20160331,0,2,3,3,7,3,2015,0,3,471,0
Maple Leafs,0,1,0,0,1,Sabres,2,1,1,0,4,20160331,2,2,3,3,5,3,2015,0,3,57,0
Blue Jackets,1,1,1,0,3,Islanders,3,0,1,0,4,20160331,2,1,1,1,7,1,2015,0,3,476,0
Devils,1,0,1,0,2,Panthers,0,1,2,0,3,20160331,-1,0,1,1,5,1,2015,0,3,1090,0
Wild,0,1,1,0,2,Red Wings,1,1,1,0,3,20160401,1,1,1,1,5,1,2015,0,4,542,0
Bruins,2,3,1,0,6,Blues,1,1,3,0,5,20160401,1,3,1,1,11,-1,2015,0,4,1035,0
Blackhawks,2,1,1,1,5,Jets,1,1,2,0,4,20160401,1,1,0,1,9,-1,2015,1,4,722,0
Capitals,0,3,1,0,4,Avalanche,0,1,1,0,2,20160401,0,2,2,2,6,-2,2015,0,4,1489,0
Canucks,0,1,2,0,3,Ducks,1,0,1,0,2,20160401,-1,0,1,1,5,-1,2015,0,4,1076,0
Capitals,0,0,0,0,0,Coyotes,0,0,3,0,3,20160402,0,0,3,3,3,3,2015,0,5,1977,0
Flames,1,1,3,0,5,Oilers,0,0,0,0,0,20160402,1,2,5,5,5,-5,2015,0,5,171,0
Sharks,0,0,2,1,3,Predators,1,1,0,0,2,20160402,-1,-2,0,1,5,-1,2015,1,5,1934,0
Blue Jackets,1,3,1,0,5,Hurricanes,1,0,0,0,1,20160402,0,3,4,4,6,-4,2015,0,5,374,0
Red Wings,2,0,1,0,3,Maple Leafs,0,1,1,0,2,20160402,2,1,1,1,5,-1,2015,0,5,205,0
Canadiens,1,2,0,0,3,Panthers,0,2,2,0,4,20160402,-1,-1,1,1,7,1,2015,0,5,1418,0
Devils,0,1,0,0,1,Lightning,0,1,2,0,3,20160402,0,0,2,2,4,2,2015,0,5,1000,0
Stars,1,0,2,0,3,Kings,1,1,0,0,2,20160402,0,-1,1,1,5,-1,2015,0,5,1237,0
Senators,0,1,1,0,2,Flyers,0,2,1,0,3,20160402,0,1,1,1,5,1,2015,0,5,373,0
Penguins,1,2,2,0,5,Islanders,0,0,0,0,0,20160402,1,3,5,5,5,-5,2015,0,5,314,0
Sabres,2,2,0,0,4,Rangers,0,2,1,0,3,20160402,2,2,1,1,7,-1,2015,0,5,292,0
Stars,0,0,1,0,1,Ducks,0,1,2,0,3,20160403,0,1,2,2,4,2,2015,0,6,1237,0
Flyers,0,1,1,0,2,Penguins,2,1,3,0,6,20160403,2,2,4,4,8,4,2015,0,6,257,0
Bruins,0,2,2,0,4,Blackhawks,2,4,0,0,6,20160403,2,4,2,2,10,2,2015,0,6,849,0
Wild,0,0,1,0,1,Jets,1,1,3,0,5,20160403,1,2,4,4,6,4,2015,0,6,388,0
Blues,3,1,1,0,5,Avalanche,0,0,1,0,1,20160403,3,4,4,4,6,-4,2015,0,6,794,0
Kings,1,1,0,0,2,Canucks,1,2,0,0,3,20160404,0,1,1,1,5,1,2015,0,0,1076,0
Lightning,0,2,0,0,2,Islanders,1,3,1,0,5,20160404,1,2,3,3,7,3,2015,0,0,1004,0
Panthers,0,3,1,0,4,Maple Leafs,0,0,3,0,3,20160404,0,3,1,1,7,-1,2015,0,0,1234,0
Rangers,1,2,1,0,4,Blue Jackets,0,1,1,0,2,20160404,1,2,2,2,6,-2,2015,0,0,476,0
Coyotes,2,0,0,0,2,Blues,0,1,4,0,5,20160404,-2,-1,3,3,7,3,2015,0,0,1270,0
Jets,0,0,1,1,2,Ducks,1,0,0,0,1,20160405,-1,-1,0,1,3,-1,2015,1,1,1527,0
Kings,1,1,2,1,5,Flames,1,1,2,0,4,20160405,0,0,0,1,9,-1,2015,1,1,1197,0
Coyotes,0,0,2,0,2,Blackhawks,2,3,1,0,6,20160405,2,5,4,4,8,4,2015,0,1,1450,0
Sharks,1,1,1,0,3,Wild,0,0,0,0,0,20160405,1,2,3,3,3,-3,2015,0,1,1570,0
Hurricanes,1,0,0,1,2,Bruins,0,0,1,0,1,20160405,1,1,0,1,3,-1,2015,1,1,609,0
Penguins,0,2,3,0,5,Senators,1,2,0,0,3,20160405,-1,-1,2,2,8,-2,2015,0,1,392,0
Avalanche,1,1,1,0,3,Predators,2,0,2,0,4,20160405,1,0,1,1,7,1,2015,0,1,1019,0
Sabres,0,1,2,0,3,Devils,0,0,1,0,1,20160405,0,1,2,2,4,-2,2015,0,1,284,0
Islanders,0,1,2,1,4,Capitals,1,0,2,0,3,20160405,-1,0,0,1,7,-1,2015,1,1,204,0
Panthers,1,1,2,0,4,Canadiens,0,1,0,0,1,20160405,1,1,3,3,5,-3,2015,0,1,1418,0
Lightning,2,0,0,0,2,Rangers,0,1,2,0,3,20160405,-2,-1,1,1,5,1,2015,0,1,1004,0
Canucks,0,0,2,0,2,Oilers,0,3,3,0,6,20160406,0,3,4,4,8,4,2015,0,2,514,0
Flyers,0,0,0,0,0,Red Wings,1,1,1,0,3,20160406,1,2,3,3,3,3,2015,0,2,441,0
Blue Jackets,0,2,3,0,5,Maple Leafs,0,1,0,0,1,20160406,0,1,4,4,6,-4,2015,0,2,313,0
Jets,0,3,2,0,5,Sharks,1,2,1,0,4,20160407,-1,0,1,1,9,-1,2015,0,3,1496,0
Ducks,1,0,0,0,1,Kings,0,2,0,0,2,20160407,-1,1,1,1,3,1,2015,0,3,0,0
Canucks,2,1,0,0,3,Flames,2,3,2,0,7,20160407,0,2,4,4,10,4,2015,0,3,426,0
Blues,0,0,1,1,2,Blackhawks,0,1,0,0,1,20160407,0,-1,0,1,3,-1,2015,1,3,260,0
Avalanche,0,0,2,0,2,Stars,1,2,1,0,4,20160407,1,3,2,2,6,2,2015,0,3,661,0
Panthers,0,0,1,0,1,Senators,1,1,1,0,3,20160407,1,2,2,2,4,2,2015,0,3,1370,0
Canadiens,1,2,1,0,4,Hurricanes,1,1,0,0,2,20160407,0,1,2,2,6,-2,2015,0,3,727,0
Penguins,1,2,0,1,4,Capitals,0,1,2,0,3,20160407,1,2,0,1,7,-1,2015,1,3,190,0
Maple Leafs,2,1,0,1,4,Flyers,0,1,2,0,3,20160407,2,2,0,1,7,-1,2015,1,3,334,0
Islanders,0,3,1,0,4,Rangers,0,0,1,0,1,20160407,0,3,3,3,5,-3,2015,0,3,0,0
Lightning,1,1,2,0,4,Devils,0,1,1,0,2,20160407,1,1,2,2,6,-2,2015,0,3,1000,0
Red Wings,0,1,1,0,2,Bruins,2,1,2,0,5,20160407,2,2,3,3,7,3,2015,0,3,611,0
Coyotes,1,1,0,0,2,Predators,0,0,2,1,3,20160407,-1,-2,0,1,5,1,2015,1,3,1442,0
Blue Jackets,1,2,1,0,4,Sabres,0,1,0,0,1,20160408,1,2,3,3,5,-3,2015,0,4,293,0
Coyotes,0,0,0,0,0,Sharks,0,0,1,0,1,20160409,0,0,1,1,1,1,2015,0,5,614,0
Jets,0,2,1,1,4,Kings,2,1,0,0,3,20160409,-2,-1,0,1,7,-1,2015,1,5,1527,0
Predators,1,1,0,0,2,Stars,0,2,1,0,3,20160409,-1,0,1,1,5,1,2015,0,5,616,0
Capitals,2,2,1,0,5,Blues,1,0,0,0,1,20160409,1,3,4,4,6,-4,2015,0,5,708,0
Sabres,0,2,1,1,4,Islanders,0,1,2,0,3,20160409,0,1,0,1,7,-1,2015,1,5,292,0
Oilers,0,1,2,0,3,Canucks,1,0,2,1,4,20160409,1,0,0,1,7,1,2015,1,5,514,0
Maple Leafs,1,0,0,0,1,Devils,1,2,2,0,5,20160409,0,2,4,4,6,4,2015,0,5,333,0
Senators,0,4,2,0,6,Bruins,1,0,0,0,1,20160409,-1,3,5,5,7,-5,2015,0,5,320,0
Blackhawks,3,0,1,0,4,Blue Jackets,0,3,1,1,5,20160409,-3,0,0,1,9,1,2015,1,5,275,0
Red Wings,0,1,1,0,2,Rangers,1,0,2,0,3,20160409,1,0,1,1,5,1,2015,0,5,480,0
Flames,0,0,2,0,2,Wild,0,1,0,0,1,20160409,0,-1,1,1,3,-1,2015,0,5,1043,0
Ducks,2,1,2,0,5,Avalanche,0,2,1,0,3,20160409,2,1,2,2,8,-2,2015,0,5,830,0
Hurricanes,0,1,1,0,2,Panthers,3,1,1,0,5,20160409,3,3,3,3,7,3,2015,0,5,696,0
Penguins,1,0,0,0,1,Flyers,1,1,1,0,3,20160409,0,1,2,2,4,2,2015,0,5,257,0
Lightning,0,0,2,0,2,Canadiens,2,2,1,0,5,20160409,2,4,3,3,7,3,2015,0,5,1311,0
Flyers,2,1,2,0,5,Islanders,2,0,0,0,2,20160410,0,1,3,3,7,-3,2015,0,6,80,0
Ducks,0,2,0,0,2,Capitals,0,0,0,0,0,20160410,0,2,2,2,2,-2,2015,0,6,2294,0
Red Wings,0,2,0,0,2,Lightning,1,1,1,0,3,20160413,1,0,1,1,5,1,2015,0,2,994,1
Rangers,0,0,2,0,2,Penguins,1,1,3,0,5,20160413,1,2,3,3,7,3,2015,0,2,314,1
Blackhawks,0,0,0,0,0,Blues,0,0,0,1,1,20160413,0,0,0,1,1,1,2015,1,2,260,1
Flyers,0,0,0,0,0,Capitals,0,1,1,0,2,20160414,0,1,2,2,2,2,2015,0,3,123,1
Islanders,2,1,2,0,5,Panthers,2,1,1,0,4,20160414,0,0,1,1,9,-1,2015,0,3,1091,1
Wild,0,0,0,0,0,Stars,0,2,2,0,4,20160414,0,2,4,4,4,4,2015,0,3,863,1
Sharks,1,2,1,0,4,Kings,1,2,0,0,3,20160414,0,0,1,1,7,-1,2015,0,3,305,1
Predators,1,1,1,0,3,Ducks,1,1,0,0,2,20160415,0,0,1,1,5,-1,2015,0,4,1776,1
Islanders,0,0,1,0,1,Panthers,1,1,1,0,3,20160415,1,2,2,2,4,2,2015,0,4,1091,1
Red Wings,0,1,1,0,2,Lightning,1,1,3,0,5,20160415,1,1,3,3,7,3,2015,0,4,994,1
Blackhawks,0,1,2,0,3,Blues,0,1,1,0,2,20160415,0,0,1,1,5,-1,2015,0,4,260,1
Rangers,0,3,1,0,4,Penguins,0,1,1,0,2,20160416,0,2,2,2,6,-2,2015,0,5,314,1
Flyers,0,1,0,0,1,Capitals,1,2,1,0,4,20160416,1,2,3,3,5,3,2015,0,5,123,1
Sharks,1,1,0,0,2,Kings,0,0,1,0,1,20160416,1,2,1,1,3,-1,2015,0,5,305,1
Wild,0,0,1,0,1,Stars,0,1,1,0,2,20160416,0,1,1,1,3,1,2015,0,5,863,1
Lightning,0,0,0,0,0,Red Wings,0,2,0,0,2,20160417,0,2,2,2,2,2,2015,0,6,994,1
Panthers,1,2,0,0,3,Islanders,0,3,0,1,4,20160417,-1,0,0,1,7,1,2015,1,6,1091,1
Predators,1,2,0,0,3,Ducks,1,0,1,0,2,20160417,0,2,1,1,5,-1,2015,0,6,1776,1
Blues,1,0,2,0,3,Blackhawks,1,1,0,0,2,20160417,0,-1,1,1,5,-1,2015,0,6,260,1
Stars,2,0,1,0,3,Wild,1,2,2,0,5,20160418,-1,1,2,2,8,2,2015,0,0,863,1
Kings,1,0,0,1,2,Sharks,1,0,0,0,1,20160418,0,0,0,1,3,-1,2015,1,0,305,1
Capitals,1,1,4,0,6,Flyers,1,0,0,0,1,20160418,0,1,5,5,7,-5,2015,0,0,123,1
Penguins,0,1,2,0,3,Rangers,0,1,0,0,1,20160419,0,0,2,2,4,-2,2015,0,1,314,1
Lightning,1,1,1,0,3,Red Wings,0,2,0,0,2,20160419,1,0,1,1,5,-1,2015,0,1,994,1
Blues,1,1,2,0,4,Blackhawks,0,2,1,0,3,20160419,1,0,1,1,7,-1,2015,0,1,260,1
Ducks,1,2,0,0,3,Predators,0,0,0,0,0,20160419,1,3,3,3,3,-3,2015,0,1,1776,1
Stars,0,3,0,0,3,Wild,0,2,0,0,2,20160420,0,1,1,1,5,-1,2015,0,2,863,1
Panthers,0,1,1,0,2,Islanders,0,1,0,0,1,20160420,0,0,1,1,3,-1,2015,0,2,1091,1
Capitals,0,0,1,0,1,Flyers,1,1,0,0,2,20160420,1,2,1,1,3,1,2015,0,2,123,1
Kings,0,0,2,0,2,Sharks,0,2,1,0,3,20160420,0,2,1,1,5,1,2015,0,2,305,1
Penguins,3,1,1,0,5,Rangers,0,0,0,0,0,20160421,3,4,5,5,5,-5,2015,0,3,314,1
Blackhawks,0,3,0,1,4,Blues,0,1,2,0,3,20160421,0,2,0,1,7,-1,2015,1,3,260,1
Red Wings,0,0,0,0,0,Lightning,0,0,1,0,1,20160421,0,0,1,1,1,1,2015,0,3,994,1
Ducks,1,2,1,0,4,Predators,0,1,0,0,1,20160421,1,2,3,3,5,-3,2015,0,3,1776,1
Flyers,0,1,1,0,2,Capitals,0,0,0,0,0,20160422,0,1,2,2,2,-2,2015,0,4,123,1
Wild,2,0,2,1,5,Stars,1,0,3,0,4,20160422,1,1,0,1,9,-1,2015,1,4,863,1
Islanders,1,0,0,1,2,Panthers,0,0,1,0,1,20160422,1,1,0,1,3,-1,2015,1,4,1091,1
Sharks,2,1,3,0,6,Kings,0,3,0,0,3,20160422,2,0,3,3,9,-3,2015,0,4,305,1
Rangers,2,0,1,0,3,Penguins,2,4,0,0,6,20160423,0,4,3,3,9,3,2015,0,5,314,1
Predators,0,1,1,0,2,Ducks,0,2,3,0,5,20160423,0,1,3,3,7,3,2015,0,5,1776,1
Blues,3,0,0,0,3,Blackhawks,1,3,2,0,6,20160423,-2,1,3,3,9,3,2015,0,5,260,1
Capitals,0,1,0,0,1,Flyers,0,0,0,0,0,20160424,0,1,1,1,1,-1,2015,0,6,123,1
Stars,3,1,1,0,5,Wild,0,0,4,0,4,20160424,3,4,1,1,9,-1,2015,0,6,863,1
Panthers,1,0,0,0,1,Islanders,0,0,1,1,2,20160424,-1,-1,0,1,3,1,2015,1,6,1091,1
Ducks,0,1,0,0,1,Predators,0,2,1,0,3,20160425,0,1,2,2,4,2,2015,0,0,1776,1
Blackhawks,1,1,0,0,2,Blues,2,0,1,0,3,20160425,1,0,1,1,5,1,2015,0,0,260,1
Islanders,3,1,1,0,5,Lightning,1,0,2,0,3,20160427,2,3,2,2,8,-2,2015,0,2,1004,1
Predators,2,0,0,0,2,Ducks,0,0,1,0,1,20160427,2,2,1,1,3,-1,2015,0,2,1776,1
Penguins,0,2,1,0,3,Capitals,1,1,1,1,4,20160428,1,0,0,1,7,1,2015,1,3,190,1
Blues,0,0,1,0,1,Stars,0,1,1,0,2,20160429,0,1,1,1,3,1,2015,0,4,547,1
Predators,0,1,1,0,2,Sharks,0,0,5,0,5,20160429,0,-1,3,3,7,3,2015,0,4,1934,1
Islanders,1,0,0,0,1,Lightning,2,1,1,0,4,20160430,1,2,3,3,5,3,2015,0,5,1004,1
Penguins,0,1,1,0,2,Capitals,0,0,1,0,1,20160430,0,1,1,1,3,-1,2015,0,5,190,1
Predators,0,0,2,0,2,Sharks,0,1,2,0,3,20160501,0,1,1,1,5,1,2015,0,6,1934,1
Blues,3,0,0,1,4,Stars,1,0,2,0,3,20160501,2,2,0,1,7,-1,2015,1,6,547,1
Capitals,0,0,2,0,2,Penguins,2,1,0,0,3,20160502,2,3,1,1,5,1,2015,0,0,190,1
Lightning,1,1,2,1,5,Islanders,1,1,2,0,4,20160503,0,0,0,1,9,-1,2015,1,1,1004,1
Sharks,1,0,0,0,1,Predators,0,2,2,0,4,20160503,-1,1,3,3,5,3,2015,0,1,1934,1
Stars,1,0,0,0,1,Blues,2,3,1,0,6,20160503,1,4,5,5,7,5,2015,0,1,547,1
Capitals,1,1,0,0,2,Penguins,1,1,0,1,3,20160504,0,0,0,1,5,1,2015,1,2,190,1
Stars,0,2,0,1,3,Blues,1,1,0,0,2,20160505,-1,0,0,1,5,-1,2015,1,3,547,1
Sharks,1,1,1,0,3,Predators,2,0,1,1,4,20160505,1,0,0,1,7,1,2015,1,3,1934,1
Lightning,0,0,1,1,2,Islanders,1,0,0,0,1,20160506,-1,-1,0,1,3,-1,2015,1,4,1004,1
Blues,1,2,1,0,4,Stars,1,0,0,0,1,20160507,0,2,3,3,5,-3,2015,0,5,547,1
Penguins,1,0,0,0,1,Capitals,1,2,0,0,3,20160507,0,2,2,2,4,2,2015,0,5,190,1
Predators,1,0,0,0,1,Sharks,2,2,1,0,5,20160507,1,3,4,4,6,4,2015,0,5,1934,1
Islanders,0,0,0,0,0,Lightning,2,1,1,0,4,20160508,2,3,4,4,4,4,2015,0,6,1004,1
Sharks,2,0,1,0,3,Predators,1,1,1,1,4,20160509,-1,0,0,1,7,1,2015,1,0,1934,1
Stars,3,0,0,0,3,Blues,0,1,1,0,2,20160509,3,2,1,1,5,-1,2015,0,0,547,1
Capitals,0,1,2,0,3,Penguins,1,2,0,1,4,20160510,1,2,0,1,7,1,2015,1,1,190,1
Blues,3,2,1,0,6,Stars,0,0,1,0,1,20160511,3,5,5,5,7,-5,2015,0,2,547,1
Predators,0,0,0,0,0,Sharks,2,1,2,0,5,20160512,2,3,5,5,5,5,2015,0,3,1934,1
Lightning,1,2,0,0,3,Penguins,0,1,0,0,1,20160513,1,2,2,2,4,-2,2015,0,4,874,1
Sharks,1,0,0,0,1,Blues,1,1,0,0,2,20160515,0,1,1,1,3,1,2015,0,6,1719,1
Lightning,2,0,0,0,2,Penguins,2,0,0,1,3,20160516,0,0,0,1,5,1,2015,1,0,874,1
Sharks,1,1,2,0,4,Blues,0,0,0,0,0,20160517,1,2,4,4,4,-4,2015,0,1,1719,1
Penguins,0,1,3,0,4,Lightning,0,0,2,0,2,20160518,0,1,2,2,6,-2,2015,0,2,874,1
Blues,0,0,0,0,0,Sharks,1,1,1,0,3,20160519,1,2,3,3,3,3,2015,0,3,1719,1
Penguins,0,0,3,0,3,Lightning,2,2,0,0,4,20160520,2,4,1,1,7,1,2015,0,4,874,1
Blues,2,2,2,0,6,Sharks,0,0,3,0,3,20160521,2,4,3,3,9,-3,2015,0,5,1719,1
Lightning,0,2,1,1,4,Penguins,1,2,0,0,3,20160522,-1,-1,0,1,7,-1,2015,1,6,874,1
Sharks,1,2,3,0,6,Blues,2,1,0,0,3,20160523,-1,0,3,3,9,-3,2015,0,0,1719,1
Penguins,1,2,2,0,5,Lightning,0,0,2,0,2,20160524,1,3,3,3,7,-3,2015,0,1,874,1
Blues,0,0,2,0,2,Sharks,1,1,3,0,5,20160525,1,2,3,3,7,3,2015,0,2,1719,1
Lightning,0,1,0,0,1,Penguins,0,2,0,0,2,20160526,0,1,1,1,3,1,2015,0,3,874,1
Sharks,0,2,0,0,2,Penguins,2,0,1,0,3,20160530,2,0,1,1,5,1,2015,0,0,2242,1
Sharks,0,0,1,0,1,Penguins,0,1,0,1,2,20160601,0,1,0,1,3,1,2015,1,2,2242,1
Penguins,1,1,0,0,2,Sharks,1,0,1,1,3,20160604,0,-1,0,1,5,1,2015,1,5,2242,1
Penguins,1,1,1,0,3,Sharks,0,0,1,0,1,20160606,1,2,2,2,4,-2,2015,0,0,2242,1
Sharks,3,0,1,0,4,Penguins,2,0,0,0,2,20160609,1,1,2,2,6,-2,2015,0,3,2242,1
Penguins,1,1,1,0,3,Sharks,0,1,0,0,1,20160612,1,1,2,2,4,-2,2015,0,6,2242,1
Blues,0,2,3,0,5,Blackhawks,1,1,0,0,2,20161012,-1,0,3,3,7,-3,2016,0,2,260,0
Flames,1,2,1,0,4,Oilers,3,2,2,0,7,20161012,2,2,3,3,11,3,2016,0,2,171,0
Kings,1,0,0,0,1,Sharks,1,0,1,0,2,20161012,0,0,1,1,3,1,2016,0,2,305,0
Maple Leafs,2,2,0,0,4,Senators,2,1,1,1,5,20161012,0,-1,0,1,9,1,2016,1,2,203,0
Canadiens,1,1,2,0,4,Sabres,0,0,1,0,1,20161013,1,2,3,3,5,-3,2016,0,3,311,0
Islanders,0,0,3,0,3,Rangers,1,1,3,0,5,20161013,1,2,2,2,8,2,2016,0,3,0,0
Bruins,0,3,3,0,6,Blue Jackets,2,1,0,0,3,20161013,-2,0,3,3,9,-3,2016,0,3,642,0
Red Wings,2,1,1,0,4,Lightning,0,2,4,0,6,20161013,-2,-1,2,2,10,2,2016,0,3,994,0
Devils,1,0,0,0,1,Panthers,1,0,0,1,2,20161013,0,0,0,1,3,1,2016,1,3,1090,0
Capitals,1,0,1,0,2,Penguins,0,2,0,1,3,20161013,-1,1,0,1,5,1,2016,1,3,190,0
Wild,0,1,1,0,2,Blues,1,1,1,0,3,20161013,1,1,1,1,5,1,2016,0,3,466,0
Hurricanes,1,2,1,0,4,Jets,1,0,3,1,5,20161013,0,-2,0,1,9,1,2016,1,3,1350,0
Ducks,1,0,1,0,2,Stars,1,1,2,0,4,20161013,0,1,2,2,6,2,2016,0,3,1237,0
Blackhawks,2,0,0,0,2,Predators,2,1,0,0,3,20161014,0,1,1,1,5,1,2016,0,4,395,0
Flyers,0,4,0,0,4,Kings,0,1,1,0,2,20161014,0,3,2,2,6,-2,2016,0,4,2388,0
Oilers,1,1,3,0,5,Flames,2,0,1,0,3,20161014,-1,0,2,2,8,-2,2016,0,4,171,0
Canadiens,0,1,2,0,3,Senators,2,0,1,1,4,20161015,2,1,0,1,7,1,2016,1,5,104,0
Devils,2,0,0,0,2,Lightning,0,2,1,0,3,20161015,-2,0,1,1,5,1,2016,0,5,1000,0
Red Wings,1,0,0,0,1,Panthers,2,0,2,0,4,20161015,1,1,3,3,5,3,2016,0,5,1155,0
Ducks,1,1,0,0,2,Penguins,1,2,0,0,3,20161015,0,1,1,1,5,1,2016,0,5,2132,0
Islanders,1,0,0,0,1,Capitals,1,1,0,0,2,20161015,0,1,1,1,3,1,2016,0,5,204,0
Sharks,2,0,1,0,3,Blue Jackets,0,0,2,0,2,20161015,2,2,1,1,5,-1,2016,0,5,2090,0
Jets,2,0,1,0,3,Wild,0,3,1,0,4,20161015,-2,1,1,1,7,1,2016,0,5,388,0
Rangers,1,1,0,0,2,Blues,2,1,0,0,3,20161015,1,1,1,1,5,1,2016,0,5,871,0
Predators,1,1,1,0,3,Blackhawks,3,0,2,0,5,20161015,2,1,2,2,8,2,2016,0,5,395,0
Stars,2,2,1,0,5,Avalanche,2,3,1,0,6,20161015,0,1,1,1,11,1,2016,0,5,661,0
Flyers,1,1,1,0,3,Coyotes,2,1,0,1,4,20161015,1,1,0,1,7,1,2016,1,5,2078,0
Flames,1,0,0,0,1,Canucks,0,0,1,1,2,20161015,-1,-1,0,1,3,1,2016,1,5,426,0
Bruins,1,0,0,0,1,Maple Leafs,3,0,1,0,4,20161015,2,2,3,3,5,3,2016,0,5,430,0
Ducks,0,0,2,0,2,Islanders,1,0,1,1,3,20161016,1,1,0,1,5,1,2016,1,6,2445,0
Hurricanes,2,1,0,0,3,Canucks,0,1,2,1,4,20161016,-2,-2,0,1,7,1,2016,1,6,2409,0
Sabres,2,2,2,0,6,Oilers,2,0,0,0,2,20161016,0,2,4,4,8,-4,2016,0,6,1734,0
Avalanche,2,0,1,1,4,Penguins,2,0,1,0,3,20161017,0,0,0,1,7,-1,2016,1,0,1317,0
Senators,0,1,0,0,1,Red Wings,3,0,2,0,5,20161017,3,2,4,4,6,4,2016,0,0,406,0
Bruins,1,1,2,0,4,Jets,1,0,0,0,1,20161017,0,1,3,3,5,-3,2016,0,0,1349,0
Sharks,1,0,3,0,4,Rangers,1,2,4,0,7,20161017,0,2,3,3,11,3,2016,0,0,2549,0
Sabres,1,1,1,0,3,Flames,1,0,2,1,4,20161018,0,-1,0,1,7,1,2016,1,1,1731,0
Blues,0,1,0,0,1,Canucks,0,0,1,1,2,20161018,0,-1,0,1,3,1,2016,1,1,1778,0
Hurricanes,0,0,2,0,2,Oilers,2,1,0,0,3,20161018,2,3,1,1,5,1,2016,0,1,2076,0
Flyers,0,1,3,0,4,Blackhawks,3,1,3,0,7,20161018,3,3,3,3,11,3,2016,0,1,664,0
Ducks,1,0,0,0,1,Devils,0,2,0,0,2,20161018,-1,1,1,1,3,1,2016,0,1,2436,0
Stars,0,1,1,0,2,Predators,0,1,0,0,1,20161018,0,0,1,1,3,-1,2016,0,1,616,0
Panthers,0,1,2,0,3,Lightning,0,2,1,1,4,20161018,0,1,0,1,7,1,2016,1,1,205,0
Coyotes,1,0,3,0,4,Senators,2,1,4,0,7,20161018,1,2,3,3,11,3,2016,0,1,2071,0
Penguins,0,0,0,0,0,Canadiens,1,1,2,0,4,20161018,1,2,4,4,4,4,2016,0,1,474,0
Avalanche,0,0,0,0,0,Capitals,1,1,1,0,3,20161018,1,2,3,3,3,3,2016,0,1,1489,0
Sharks,1,1,1,0,3,Islanders,0,2,0,0,2,20161018,1,0,1,1,5,-1,2016,0,1,2549,0
Kings,1,0,2,0,3,Wild,2,3,1,0,6,20161018,1,4,3,3,9,3,2016,0,1,1521,0
Red Wings,0,1,1,0,2,Rangers,1,0,0,0,1,20161019,-1,0,1,1,3,-1,2016,0,2,480,0
Maple Leafs,2,2,0,0,4,Jets,0,1,3,1,5,20161019,-2,-3,0,1,9,1,2016,1,2,946,0
Hurricanes,2,1,1,0,4,Flames,0,1,1,0,2,20161020,2,2,2,2,6,-2,2016,0,3,2038,0
Sabres,0,0,1,0,1,Canucks,0,1,1,0,2,20161020,0,1,1,1,3,1,2016,0,3,2137,0
Blues,0,1,0,0,1,Oilers,0,1,2,0,3,20161020,0,0,2,2,4,2,2016,0,3,1508,0
Kings,1,2,0,1,4,Stars,1,1,1,0,3,20161020,0,1,0,1,7,-1,2016,1,3,1237,0
Sharks,0,2,0,0,2,Penguins,0,0,3,0,3,20161020,0,-2,1,1,5,1,2016,0,3,2242,0
Capitals,2,0,2,0,4,Panthers,1,1,0,0,2,20161020,1,0,2,2,6,-2,2016,0,3,924,0
Avalanche,1,1,2,0,4,Lightning,0,0,0,0,0,20161020,1,2,4,4,4,-4,2016,0,3,1521,0
Coyotes,0,2,0,0,2,Canadiens,1,3,1,0,5,20161020,1,2,3,3,7,3,2016,0,3,2175,0
Devils,0,0,1,0,1,Bruins,0,0,2,0,2,20161020,0,0,1,1,3,1,2016,0,3,196,0
Ducks,1,1,1,0,3,Flyers,0,2,0,0,2,20161020,1,0,1,1,5,-1,2016,0,3,2388,0
Maple Leafs,0,2,0,0,2,Wild,0,1,2,0,3,20161020,0,-1,1,1,5,1,2016,0,3,691,0
Coyotes,2,0,0,0,2,Islanders,2,0,1,0,3,20161021,0,0,1,1,5,1,2016,0,4,2139,0
Blackhawks,0,1,1,0,2,Blue Jackets,1,2,0,0,3,20161021,1,2,1,1,5,1,2016,0,4,275,0
Predators,0,2,1,0,3,Red Wings,0,2,3,0,5,20161021,0,0,2,2,8,2,2016,0,4,470,0
Canucks,0,2,1,0,3,Kings,2,1,0,1,4,20161022,2,1,0,1,7,1,2016,1,5,1076,0
Blues,1,3,2,0,6,Flames,0,2,2,0,4,20161022,1,2,2,2,10,-2,2016,0,5,1440,0
Blue Jackets,0,1,2,0,3,Stars,0,0,0,0,0,20161022,0,1,3,3,3,-3,2016,0,5,912,0
Maple Leafs,1,2,1,0,4,Blackhawks,1,1,2,1,5,20161022,0,-1,0,1,9,1,2016,1,5,436,0
Penguins,1,0,0,0,1,Predators,1,4,0,0,5,20161022,0,4,4,4,6,4,2016,0,5,471,0
Hurricanes,0,3,0,0,3,Flyers,0,4,2,0,6,20161022,0,1,3,3,9,3,2016,0,5,345,0
Wild,0,1,0,0,1,Devils,0,0,1,1,2,20161022,0,-1,0,1,3,1,2016,1,5,1007,0
Avalanche,1,0,1,0,2,Panthers,0,2,3,0,5,20161022,-1,1,3,3,7,3,2016,0,5,1724,0
Sharks,0,0,0,0,0,Red Wings,0,2,1,0,3,20161022,0,2,3,3,3,3,2016,0,5,2071,0
Lightning,0,2,2,0,4,Senators,0,1,0,0,1,20161022,0,1,3,3,5,-3,2016,0,5,1251,0
Canadiens,0,2,2,0,4,Bruins,0,0,2,0,2,20161022,0,2,2,2,6,-2,2016,0,5,270,0
Rangers,0,3,1,0,4,Capitals,2,0,0,0,2,20161022,-2,1,2,2,6,-2,2016,0,5,204,0
Oilers,0,3,0,0,3,Jets,0,0,0,0,0,20161023,0,3,3,3,3,-3,2016,0,6,738,0
Wild,0,2,1,0,3,Islanders,0,3,3,0,6,20161023,0,1,3,3,9,3,2016,0,6,1016,0
Coyotes,1,1,0,0,2,Rangers,1,1,1,0,3,20161023,0,0,1,1,5,1,2016,0,6,2139,0
Canucks,1,0,1,0,2,Ducks,1,1,2,0,4,20161023,0,1,2,2,6,2,2016,0,6,1076,0
Flyers,0,1,0,0,1,Canadiens,0,1,2,0,3,20161024,0,0,2,2,4,2,2016,0,0,400,0
Flames,1,1,0,1,3,Blackhawks,0,1,1,0,2,20161024,1,1,0,1,5,-1,2016,1,0,1397,0
Senators,1,0,2,0,3,Canucks,0,0,0,0,0,20161025,1,1,3,3,3,-3,2016,0,1,2191,0
Ducks,0,1,0,0,1,Sharks,1,0,0,1,2,20161025,1,0,0,1,3,1,2016,1,1,305,0
Jets,0,1,1,0,2,Stars,1,1,1,0,3,20161025,1,1,1,1,5,1,2016,0,1,1183,0
Blue Jackets,0,2,0,0,2,Kings,0,1,1,1,3,20161025,0,-1,0,1,5,1,2016,1,1,1973,0
Hurricanes,0,2,0,0,2,Red Wings,3,1,0,0,4,20161025,3,2,2,2,6,2,2016,0,1,511,0
Wild,0,4,1,0,5,Bruins,0,0,0,0,0,20161025,0,4,5,5,5,-5,2016,0,1,1120,0
Coyotes,1,0,2,0,3,Devils,1,2,2,0,5,20161025,0,2,2,2,8,2,2016,0,1,2131,0
Flames,2,1,1,0,4,Blues,0,0,1,0,1,20161025,2,3,3,3,5,-3,2016,0,1,1440,0
Sabres,0,3,0,0,3,Flyers,0,0,3,1,4,20161025,0,-3,0,1,7,1,2016,1,1,279,0
Lightning,3,1,3,0,7,Maple Leafs,0,1,2,0,3,20161025,3,3,4,4,10,-4,2016,0,1,1096,0
Panthers,1,1,0,0,2,Penguins,0,1,2,0,3,20161025,-1,-1,1,1,5,1,2016,0,1,1013,0
Canadiens,0,1,2,0,3,Islanders,0,1,1,0,2,20161026,0,0,1,1,5,-1,2016,0,2,343,0
Bruins,2,0,0,0,2,Rangers,0,3,2,0,5,20161026,-2,1,3,3,7,3,2016,0,2,190,0
Predators,0,0,1,0,1,Ducks,1,5,0,0,6,20161026,1,6,5,5,7,5,2016,0,2,1776,0
Capitals,0,0,1,0,1,Oilers,0,2,2,0,4,20161026,0,2,3,3,5,3,2016,0,2,1985,0
Wild,2,0,2,0,4,Sabres,0,0,0,0,0,20161027,2,2,4,4,4,-4,2016,0,3,729,0
Coyotes,2,0,3,0,5,Flyers,0,2,2,0,4,20161027,2,0,1,1,9,-1,2016,0,3,2078,0
Islanders,0,1,1,0,2,Penguins,1,0,3,0,4,20161027,1,0,2,2,6,2,2016,0,3,314,0
Panthers,1,1,0,0,2,Maple Leafs,1,2,0,0,3,20161027,0,1,1,1,5,1,2016,0,3,1234,0
Lightning,0,1,0,0,1,Canadiens,0,0,3,0,3,20161027,0,-1,2,2,4,2,2016,0,3,1311,0
Red Wings,0,1,0,1,2,Blues,0,1,0,0,1,20161027,0,0,0,1,3,-1,2016,1,3,454,0
Stars,0,0,1,0,1,Jets,2,1,1,0,4,20161027,2,3,3,3,5,3,2016,0,3,1183,0
Predators,0,1,1,0,2,Kings,0,1,1,1,3,20161027,0,0,0,1,5,1,2016,1,3,1776,0
Blue Jackets,0,0,1,0,1,Sharks,1,0,2,0,3,20161027,1,1,2,2,4,2,2016,0,3,2090,0
Blue Jackets,4,0,0,0,4,Ducks,0,0,0,0,0,20161028,4,4,4,4,4,-4,2016,0,4,1973,0
Oilers,0,1,1,0,2,Canucks,0,0,0,0,0,20161028,0,1,2,2,2,-2,2016,0,4,514,0
Jets,0,1,0,0,1,Avalanche,0,0,0,0,0,20161028,0,1,1,1,1,-1,2016,0,4,797,0
Blackhawks,0,1,1,1,3,Devils,1,0,1,0,2,20161028,-1,0,0,1,5,-1,2016,1,4,703,0
Senators,2,0,0,0,2,Flames,1,2,2,0,5,20161028,-1,1,3,3,7,3,2016,0,4,1773,0
Rangers,1,1,0,0,2,Hurricanes,1,2,0,0,3,20161028,0,1,1,1,5,1,2016,0,4,423,0
Panthers,0,0,0,0,0,Sabres,1,1,1,0,3,20161029,1,2,3,3,3,3,2016,0,5,1184,0
Maple Leafs,0,0,1,0,1,Canadiens,0,1,1,0,2,20161029,0,1,1,1,3,1,2016,0,5,303,0
Bruins,0,1,0,0,1,Red Wings,0,0,0,0,0,20161029,0,1,1,1,1,-1,2016,0,5,611,0
Lightning,0,0,1,0,1,Devils,2,1,0,0,3,20161029,2,3,2,2,4,2,2016,0,5,1000,0
Penguins,3,1,1,0,5,Flyers,2,2,0,0,4,20161029,1,0,1,1,9,-1,2016,0,5,257,0
Kings,0,0,0,0,0,Blues,0,0,1,0,1,20161029,0,0,1,1,1,1,2016,0,5,1586,0
Stars,0,0,0,0,0,Wild,1,0,3,0,4,20161029,1,1,4,4,4,4,2016,0,5,863,0
Avalanche,0,1,2,0,3,Coyotes,1,0,1,0,2,20161029,-1,0,1,1,5,-1,2016,0,5,585,0
Capitals,2,1,2,0,5,Canucks,1,1,0,0,2,20161029,1,1,3,3,7,-3,2016,0,5,2359,0
Predators,0,1,0,0,1,Sharks,1,2,1,0,4,20161029,1,2,3,3,5,3,2016,0,5,1934,0
Senators,0,1,1,0,2,Oilers,0,0,0,0,0,20161030,0,1,2,2,2,-2,2016,0,6,1754,0
Capitals,2,0,1,0,3,Flames,1,0,0,0,1,20161030,1,1,2,2,4,-2,2016,0,6,1967,0
Kings,0,0,0,0,0,Blackhawks,1,1,1,0,3,20161030,1,2,3,3,3,3,2016,0,6,1741,0
Maple Leafs,0,0,1,0,1,Islanders,2,0,3,0,5,20161030,2,2,4,4,6,4,2016,0,6,341,0
Flyers,1,2,1,0,4,Hurricanes,0,3,0,0,3,20161030,1,0,1,1,7,-1,2016,0,6,345,0
Panthers,3,2,0,0,5,Red Wings,0,1,1,0,2,20161030,3,4,3,3,7,-3,2016,0,6,1155,0
Lightning,0,0,1,0,1,Rangers,0,4,2,0,6,20161030,0,4,5,5,7,5,2016,0,6,1004,0
Sabres,2,1,0,0,3,Jets,0,0,1,0,1,20161030,2,3,2,2,4,-2,2016,0,6,996,0
Ducks,1,3,0,0,4,Kings,0,0,0,0,0,20161101,1,4,4,4,4,-4,2016,0,1,0,0
Sharks,1,0,1,0,2,Coyotes,0,3,0,0,3,20161101,-1,2,1,1,5,1,2016,0,1,614,0
Flames,0,1,0,0,1,Blackhawks,1,0,4,0,5,20161101,1,0,4,4,6,4,2016,0,1,1397,0
Capitals,1,1,1,0,3,Jets,0,0,2,0,2,20161101,1,2,1,1,5,-1,2016,0,1,1247,0
Predators,2,1,2,0,5,Avalanche,1,0,0,0,1,20161101,1,2,4,4,6,-4,2016,0,1,1019,0
Bruins,1,1,0,0,2,Panthers,0,0,1,0,1,20161101,1,2,1,1,3,-1,2016,0,1,1257,0
Hurricanes,1,0,0,0,1,Senators,1,0,0,1,2,20161101,0,0,0,1,3,1,2016,1,1,673,0
Oilers,1,0,1,0,2,Maple Leafs,1,1,0,1,3,20161101,0,1,0,1,5,1,2016,1,1,1683,0
Lightning,3,3,0,0,6,Islanders,0,1,0,0,1,20161101,3,5,5,5,7,-5,2016,0,1,1004,0
Stars,0,1,1,0,2,Blue Jackets,0,1,1,1,3,20161101,0,0,0,1,5,1,2016,1,1,912,0
Blues,0,0,0,0,0,Rangers,2,3,0,0,5,20161101,2,5,5,5,5,5,2016,0,1,871,0
Sabres,1,0,1,0,2,Wild,0,1,0,0,1,20161101,1,0,1,1,3,-1,2016,0,1,729,0
Canucks,0,0,0,0,0,Canadiens,0,2,1,0,3,20161102,0,2,3,3,3,3,2016,0,2,2273,0
Red Wings,2,0,1,0,3,Flyers,0,1,2,1,4,20161102,-2,-1,0,1,7,1,2016,1,2,441,0
Penguins,2,1,2,0,5,Ducks,1,0,0,0,1,20161102,1,2,4,4,6,-4,2016,0,2,2132,0
Blues,0,1,1,0,2,Stars,0,2,4,0,6,20161103,0,1,4,4,8,4,2016,0,3,547,0
Flames,0,2,1,0,3,Sharks,0,0,2,0,2,20161103,0,2,1,1,5,-1,2016,0,3,1027,0
Penguins,1,0,1,0,2,Kings,0,1,1,1,3,20161103,-1,0,0,1,5,1,2016,1,3,2132,0
Predators,1,1,0,0,2,Coyotes,1,0,1,1,3,20161103,0,-1,0,1,5,1,2016,1,3,1442,0
Avalanche,0,0,0,0,0,Blackhawks,2,0,2,0,4,20161103,2,2,4,4,4,4,2016,0,3,916,0
Flyers,0,1,1,1,3,Islanders,0,1,1,0,2,20161103,0,0,0,1,5,-1,2016,1,3,80,0
Bruins,2,1,0,1,4,Lightning,1,1,1,0,3,20161103,1,1,0,1,7,-1,2016,1,3,1183,0
Canucks,0,0,0,0,0,Senators,0,1,0,0,1,20161103,0,1,1,1,1,1,2016,0,3,2191,0
Jets,0,0,3,0,3,Capitals,1,2,0,1,4,20161103,1,3,0,1,7,1,2016,1,3,1247,0
Oilers,1,1,1,0,3,Rangers,1,1,3,0,5,20161103,0,0,2,2,8,2,2016,0,3,2024,0
Maple Leafs,1,1,0,0,2,Sabres,0,1,0,0,1,20161103,1,1,1,1,3,-1,2016,0,3,57,0
Devils,0,1,2,0,3,Panthers,1,1,1,1,4,20161103,1,1,0,1,7,1,2016,1,3,1090,0
Canadiens,0,0,0,0,0,Blue Jackets,3,5,2,0,10,20161104,3,8,10,10,10,10,2016,0,4,605,0
Jets,1,0,4,0,5,Red Wings,1,1,1,0,3,20161104,0,-1,2,2,8,-2,2016,0,4,855,0
Coyotes,0,1,0,0,1,Ducks,3,1,1,0,5,20161104,3,3,4,4,6,4,2016,0,4,356,0
Penguins,2,3,0,0,5,Sharks,0,0,0,0,0,20161105,2,5,5,5,5,-5,2016,0,5,2242,0
Hurricanes,0,1,1,1,3,Predators,1,1,0,0,2,20161105,-1,-1,0,1,5,-1,2016,1,5,456,0
Flames,0,0,0,0,0,Kings,2,2,1,0,5,20161105,2,4,5,5,5,5,2016,0,5,1197,0
Blackhawks,1,2,0,0,3,Stars,2,0,0,0,2,20161105,-1,1,1,1,5,-1,2016,0,5,802,0
Blue Jackets,0,1,0,0,1,Blues,0,0,1,1,2,20161105,0,-1,0,1,3,1,2016,1,5,395,0
Canucks,1,1,1,0,3,Maple Leafs,2,1,3,0,6,20161105,1,1,3,3,9,3,2016,0,5,2090,0
Oilers,2,1,0,1,4,Islanders,2,1,0,0,3,20161105,0,0,0,1,7,-1,2016,1,5,2024,0
Panthers,1,0,1,0,2,Capitals,0,1,3,0,4,20161105,-1,0,2,2,6,2,2016,0,5,924,0
Rangers,2,1,2,0,5,Bruins,1,0,1,0,2,20161105,1,2,3,3,7,-3,2016,0,5,190,0
Wild,0,0,0,0,0,Avalanche,0,0,1,0,1,20161105,0,0,1,1,1,1,2016,0,5,698,0
Sabres,0,0,2,0,2,Senators,0,1,0,0,1,20161105,0,-1,1,1,3,-1,2016,0,5,219,0
Flyers,2,0,2,0,4,Canadiens,2,1,2,0,5,20161105,0,1,1,1,9,1,2016,0,5,400,0
Devils,1,0,0,0,1,Lightning,0,2,2,0,4,20161105,-1,1,3,3,5,3,2016,0,5,1000,0
Oilers,1,1,0,0,2,Red Wings,1,0,0,0,1,20161106,0,1,1,1,3,-1,2016,0,6,1592,0
Avalanche,0,1,0,0,1,Blues,2,3,0,0,5,20161106,2,4,4,4,6,4,2016,0,6,794,0
Devils,0,2,2,0,4,Hurricanes,0,0,1,0,1,20161106,0,2,3,3,5,-3,2016,0,6,419,0
Jets,1,1,0,0,2,Rangers,1,4,0,0,5,20161106,0,3,3,3,7,3,2016,0,6,1287,0
Stars,1,1,1,0,3,Blackhawks,0,1,2,1,4,20161106,-1,-1,0,1,7,1,2016,1,6,802,0
Flames,1,0,0,0,1,Ducks,1,2,1,0,4,20161106,0,2,3,3,5,3,2016,0,6,1197,0
Canucks,1,1,0,0,2,Islanders,1,1,2,0,4,20161107,0,0,2,2,6,2,2016,0,0,2429,0
Sabres,0,0,0,0,0,Bruins,0,3,1,0,4,20161107,0,3,4,4,4,4,2016,0,0,399,0
Lightning,0,0,1,0,1,Panthers,1,0,2,0,3,20161107,1,1,2,2,4,2,2016,0,0,205,0
Canucks,0,1,4,0,5,Rangers,0,1,2,0,3,20161108,0,0,2,2,8,-2,2016,0,1,2429,0
Red Wings,1,0,1,1,3,Flyers,1,0,1,0,2,20161108,0,0,0,1,5,-1,2016,1,1,441,0
Oilers,2,1,0,0,3,Penguins,1,1,2,0,4,20161108,-1,-1,1,1,7,1,2016,0,1,1797,0
Sharks,0,2,1,0,3,Capitals,0,0,0,0,0,20161108,0,2,3,3,3,-3,2016,0,1,2416,0
Kings,1,4,2,0,7,Maple Leafs,0,0,0,0,0,20161108,1,5,7,7,7,-7,2016,0,1,2170,0
Bruins,0,1,1,0,2,Canadiens,0,2,1,0,3,20161108,0,1,1,1,5,1,2016,0,1,270,0
Senators,0,0,1,0,1,Predators,0,2,1,0,3,20161108,0,2,2,2,4,2,2016,0,1,845,0
Stars,0,1,1,0,2,Jets,2,4,2,0,8,20161108,2,5,6,6,10,6,2016,0,1,1183,0
Coyotes,1,2,1,0,4,Avalanche,0,2,0,0,2,20161108,1,1,2,2,6,-2,2016,0,1,585,0
Hurricanes,0,2,0,0,2,Devils,1,0,1,1,3,20161108,1,-1,0,1,5,1,2016,1,1,419,0
Ducks,0,1,1,0,2,Blue Jackets,2,0,0,1,3,20161109,2,1,0,1,5,1,2016,1,2,1973,0
Blackhawks,0,1,0,1,2,Blues,0,0,1,0,1,20161109,0,1,0,1,3,-1,2016,1,2,260,0
Senators,0,1,0,1,2,Sabres,1,0,0,0,1,20161109,-1,0,0,1,3,-1,2016,1,2,219,0
Blue Jackets,1,0,1,0,2,Bruins,4,1,0,0,5,20161110,3,4,3,3,7,3,2016,0,3,642,0
Wild,1,1,2,0,4,Penguins,1,1,0,0,2,20161110,0,0,2,2,6,-2,2016,0,3,741,0
Ducks,0,3,1,0,4,Hurricanes,0,1,1,0,2,20161110,0,2,2,2,6,-2,2016,0,3,2231,0
Kings,0,0,1,0,1,Canadiens,2,1,1,0,4,20161110,2,3,3,3,5,3,2016,0,3,2448,0
Canucks,0,0,1,0,1,Red Wings,2,0,1,0,3,20161110,2,2,2,2,4,2,2016,0,3,1967,0
Islanders,0,1,0,0,1,Lightning,2,1,1,0,4,20161110,2,2,3,3,5,3,2016,0,3,1004,0
Sharks,1,1,2,0,4,Panthers,2,0,0,0,2,20161110,-1,0,2,2,6,-2,2016,0,3,2558,0
Blues,1,0,0,0,1,Predators,0,1,2,0,3,20161110,-1,0,2,2,4,2,2016,0,3,253,0
Stars,2,0,2,0,4,Flames,0,2,0,0,2,20161110,2,0,2,2,6,-2,2016,0,3,1536,0
Jets,1,1,1,0,3,Coyotes,1,0,1,0,2,20161110,0,1,1,1,5,-1,2016,0,3,1365,0
Stars,2,1,0,0,3,Oilers,2,0,0,0,2,20161111,0,1,1,1,5,-1,2016,0,4,1655,0
Jets,0,2,0,0,2,Avalanche,0,2,0,1,3,20161111,0,0,0,1,5,1,2016,1,4,797,0
Devils,0,0,1,1,2,Sabres,1,0,0,0,1,20161111,-1,-1,0,1,3,-1,2016,1,4,284,0
Kings,0,1,0,0,1,Senators,0,0,2,0,2,20161111,0,-1,1,1,3,1,2016,0,4,2345,0
Flyers,2,1,0,0,3,Maple Leafs,2,0,4,0,6,20161111,0,-1,3,3,9,3,2016,0,4,334,0
Capitals,2,0,0,1,3,Blackhawks,1,0,1,0,2,20161111,1,1,0,1,5,-1,2016,1,4,594,0
Ducks,0,0,0,0,0,Predators,1,3,1,0,5,20161112,1,4,5,5,5,5,2016,0,5,1776,0
Rangers,2,2,0,0,4,Flames,0,0,1,0,1,20161112,2,4,3,3,5,-3,2016,0,5,2023,0
Bruins,0,2,0,0,2,Coyotes,0,0,1,0,1,20161112,0,2,1,1,3,-1,2016,0,5,2295,0
Blues,1,1,2,0,4,Blue Jackets,3,4,1,0,8,20161112,2,5,4,4,12,4,2016,0,5,395,0
Sharks,2,1,0,0,3,Lightning,0,0,1,0,1,20161112,2,3,2,2,4,-2,2016,0,5,2365,0
Maple Leafs,1,0,0,0,1,Penguins,0,2,2,0,4,20161112,-1,1,3,3,5,3,2016,0,5,222,0
Wild,1,1,0,0,2,Flyers,1,1,1,0,3,20161112,0,0,1,1,5,1,2016,0,5,983,0
Sabres,0,1,1,0,2,Devils,1,2,1,0,4,20161112,1,2,2,2,6,2,2016,0,5,284,0
Islanders,1,1,0,0,2,Panthers,0,0,2,1,3,20161112,-1,-2,0,1,5,1,2016,1,5,1091,0
Red Wings,0,0,0,0,0,Canadiens,3,2,0,0,5,20161112,3,5,5,5,5,5,2016,0,5,508,0
Capitals,1,0,0,0,1,Hurricanes,2,2,1,0,5,20161112,1,3,4,4,6,4,2016,0,5,233,0
Rangers,2,1,0,0,3,Oilers,1,0,0,0,1,20161113,1,2,2,2,4,-2,2016,0,6,2024,0
Bruins,1,0,1,0,2,Avalanche,0,0,0,0,0,20161113,1,1,2,2,2,-2,2016,0,6,1765,0
Wild,1,0,0,1,2,Senators,0,0,1,0,1,20161113,1,1,0,1,3,-1,2016,1,6,838,0
Stars,2,1,1,0,4,Canucks,1,0,3,1,5,20161113,-1,-2,0,1,9,1,2016,1,6,1766,0
Kings,1,0,1,0,2,Jets,2,0,0,1,3,20161113,1,1,0,1,5,1,2016,1,6,1527,0
Canadiens,0,2,0,0,2,Blackhawks,1,2,0,0,3,20161113,1,1,1,1,5,1,2016,0,6,732,0
Lightning,2,2,0,0,4,Islanders,0,0,0,0,0,20161114,2,4,4,4,4,-4,2016,0,0,1004,0
Oilers,0,1,0,0,1,Ducks,1,2,1,0,4,20161115,1,2,3,3,5,3,2016,0,1,1368,0
Rangers,1,2,4,0,7,Canucks,0,1,1,0,2,20161115,1,2,5,5,9,-5,2016,0,1,2429,0
Kings,0,1,0,0,1,Avalanche,0,2,2,0,4,20161115,0,1,3,3,5,3,2016,0,1,830,0
Devils,1,0,0,1,2,Stars,1,0,0,0,1,20161115,0,0,0,1,3,-1,2016,1,1,1362,0
Flames,1,0,0,0,1,Wild,0,0,0,0,0,20161115,1,1,1,1,1,-1,2016,0,1,1043,0
Blackhawks,0,0,0,0,0,Jets,1,0,3,0,4,20161115,1,1,4,4,4,4,2016,0,1,722,0
Lightning,2,0,2,0,4,Red Wings,1,0,2,0,3,20161115,1,1,1,1,7,-1,2016,0,1,994,0
Panthers,2,1,0,1,4,Canadiens,1,1,1,0,3,20161115,1,1,0,1,7,-1,2016,1,1,1418,0
Predators,1,1,0,0,2,Maple Leafs,2,1,3,0,6,20161115,1,1,4,4,8,4,2016,0,1,646,0
Capitals,0,1,0,0,1,Blue Jackets,0,0,1,1,2,20161115,0,-1,0,1,3,1,2016,1,1,326,0
Sharks,0,0,0,0,0,Hurricanes,0,0,1,0,1,20161115,0,0,1,1,1,1,2016,0,1,2382,0
Senators,0,1,1,1,3,Flyers,1,1,0,0,2,20161115,-1,-1,0,1,5,-1,2016,1,1,373,0
Sabres,1,0,0,0,1,Blues,1,0,3,0,4,20161115,0,0,3,3,5,3,2016,0,1,660,0
Penguins,0,0,1,0,1,Capitals,3,1,3,0,7,20161116,3,4,6,6,8,6,2016,0,2,190,0
Coyotes,0,1,0,0,1,Flames,0,0,1,1,2,20161116,0,-1,0,1,3,1,2016,1,2,1224,0
Oilers,0,2,0,0,2,Kings,2,1,1,0,4,20161117,2,1,2,2,6,2,2016,0,3,1368,0
Devils,0,2,0,0,2,Ducks,0,2,1,0,3,20161117,0,0,1,1,5,1,2016,0,3,2436,0
Coyotes,0,2,0,0,2,Canucks,0,2,0,1,3,20161117,0,0,0,1,5,1,2016,1,3,1228,0
Avalanche,0,1,1,0,2,Stars,3,0,0,0,3,20161117,3,2,1,1,5,1,2016,0,3,661,0
Panthers,1,0,0,0,1,Maple Leafs,3,2,1,0,6,20161117,2,4,5,5,7,5,2016,0,3,1234,0
Sharks,1,1,0,0,2,Blues,1,2,0,0,3,20161117,0,1,1,1,5,1,2016,0,3,1719,0
Predators,2,1,2,0,5,Senators,1,0,0,0,1,20161117,1,2,4,4,6,-4,2016,0,3,845,0
Jets,0,2,0,0,2,Flyers,2,1,2,0,5,20161117,2,1,3,3,7,3,2016,0,3,1273,0
Lightning,1,2,1,0,4,Sabres,0,1,0,0,1,20161117,1,2,3,3,5,-3,2016,0,3,1051,0
Bruins,0,0,0,0,0,Wild,0,0,1,0,1,20161117,0,0,1,1,1,1,2016,0,3,1120,0
Blackhawks,1,1,1,0,3,Flames,0,2,0,0,2,20161118,1,0,1,1,5,-1,2016,0,4,1397,0
Penguins,1,1,0,1,3,Islanders,0,2,0,0,2,20161118,1,0,0,1,5,-1,2016,1,4,314,0
Rangers,0,1,1,0,2,Blue Jackets,1,1,2,0,4,20161118,1,1,2,2,6,2,2016,0,4,476,0
Red Wings,0,0,0,0,0,Capitals,0,0,1,0,1,20161118,0,0,1,1,1,1,2016,0,4,394,0
Canadiens,0,1,1,0,2,Hurricanes,0,0,3,0,3,20161118,0,-1,1,1,5,1,2016,0,4,727,0
Blackhawks,0,0,3,1,4,Canucks,1,2,0,0,3,20161119,-1,-3,0,1,7,-1,2016,1,5,1775,0
Avalanche,0,0,3,0,3,Wild,1,1,0,0,2,20161119,-1,-2,1,1,5,-1,2016,0,5,698,0
Predators,0,1,0,0,1,Blues,0,1,2,0,3,20161119,0,0,2,2,4,2,2016,0,5,253,0
Oilers,2,2,1,0,5,Stars,0,2,0,0,2,20161119,2,2,3,3,7,-3,2016,0,5,1655,0
Sharks,0,0,2,0,2,Coyotes,1,1,0,1,3,20161119,1,2,0,1,5,1,2016,1,5,614,0
Maple Leafs,0,1,0,0,1,Canadiens,1,1,0,0,2,20161119,1,1,1,1,3,1,2016,0,5,303,0
Penguins,0,0,1,0,1,Sabres,1,0,0,1,2,20161119,1,1,0,1,3,1,2016,1,5,178,0
Jets,0,0,1,0,1,Bruins,0,3,1,0,4,20161119,0,3,3,3,5,3,2016,0,5,1349,0
Devils,1,0,1,0,2,Kings,0,2,2,0,4,20161119,-1,1,2,2,6,2,2016,0,5,2436,0
Lightning,1,1,1,0,3,Flyers,0,0,0,0,0,20161119,1,2,3,3,3,-3,2016,0,5,928,0
Panthers,2,1,1,0,4,Senators,0,0,1,0,1,20161119,2,3,3,3,5,-3,2016,0,5,1370,0
Blue Jackets,0,1,2,0,3,Capitals,1,1,0,0,2,20161120,-1,-1,1,1,5,-1,2016,0,6,326,0
Jets,0,0,1,0,1,Hurricanes,1,0,2,0,3,20161120,1,1,2,2,4,2,2016,0,6,1350,0
Panthers,0,1,1,1,3,Rangers,1,0,1,0,2,20161120,-1,0,0,1,5,-1,2016,1,6,1091,0
Flames,0,1,2,0,3,Red Wings,1,0,1,0,2,20161120,-1,0,1,1,5,-1,2016,0,6,1573,0
Kings,0,3,0,0,3,Ducks,0,0,2,0,2,20161120,0,3,1,1,5,-1,2016,0,6,0,0
Devils,0,0,0,0,0,Sharks,2,1,1,0,4,20161121,2,3,4,4,4,4,2016,0,0,2540,0
Blackhawks,0,0,0,0,0,Oilers,2,1,2,0,5,20161121,2,3,5,5,5,5,2016,0,0,1437,0
Flames,1,0,1,0,2,Sabres,0,3,1,0,4,20161121,-1,2,2,2,6,2,2016,0,0,1731,0
Lightning,0,0,1,0,1,Predators,1,2,0,0,3,20161121,1,3,2,2,4,2,2016,0,0,621,0
Avalanche,0,2,0,1,3,Blue Jackets,1,0,1,0,2,20161121,-1,1,0,1,5,-1,2016,1,0,1163,0
Rangers,0,3,2,0,5,Penguins,2,0,0,0,2,20161121,-2,1,3,3,7,-3,2016,0,0,314,0
Wild,0,1,1,0,2,Stars,0,1,1,1,3,20161121,0,0,0,1,5,1,2016,1,0,863,0
Blues,0,3,1,0,4,Bruins,1,1,0,0,2,20161122,-1,1,2,2,6,-2,2016,0,1,1035,0
Hurricanes,1,1,0,0,2,Maple Leafs,1,0,0,0,1,20161122,0,1,1,1,3,-1,2016,0,1,544,0
Senators,0,2,2,0,4,Canadiens,0,2,1,0,3,20161122,0,0,1,1,7,-1,2016,0,1,104,0
Flyers,1,1,1,0,3,Panthers,0,0,1,0,1,20161122,1,2,2,2,4,-2,2016,0,1,1021,0
Islanders,2,0,0,1,3,Ducks,1,0,1,0,2,20161122,1,1,0,1,5,-1,2016,1,1,2445,0
Oilers,2,0,4,0,6,Avalanche,2,1,0,0,3,20161123,0,-1,3,3,9,-3,2016,0,2,1036,0
Islanders,0,0,2,0,2,Kings,1,0,3,0,4,20161123,1,1,2,2,6,2,2016,0,2,2445,0
Blackhawks,0,1,0,0,1,Sharks,2,0,0,0,2,20161123,2,1,1,1,3,1,2016,0,2,1837,0
Stars,0,0,2,0,2,Predators,1,1,3,0,5,20161123,1,2,3,3,7,3,2016,0,2,616,0
Canucks,1,3,0,0,4,Coyotes,0,1,0,0,1,20161123,1,3,3,3,5,-3,2016,0,2,1228,0
Jets,0,0,1,0,1,Wild,0,1,2,0,3,20161123,0,1,2,2,4,2,2016,0,2,388,0
Flames,0,1,1,0,2,Blue Jackets,0,0,0,0,0,20161123,0,1,2,2,2,-2,2016,0,2,1670,0
Red Wings,0,1,0,1,2,Sabres,0,0,1,0,1,20161123,0,1,0,1,3,-1,2016,1,2,215,0
Blues,0,1,2,0,3,Capitals,1,1,2,0,4,20161123,1,1,1,1,7,1,2016,0,2,708,0
Penguins,0,5,1,0,6,Rangers,1,0,0,0,1,20161123,-1,4,5,5,7,-5,2016,0,2,314,0
Flyers,0,2,0,0,2,Lightning,1,0,3,0,4,20161123,1,-1,2,2,6,2,2016,0,2,928,0
Maple Leafs,3,1,0,0,4,Devils,0,3,1,1,5,20161123,-3,-1,0,1,9,1,2016,1,2,333,0
Hurricanes,1,0,0,0,1,Canadiens,1,0,1,0,2,20161124,0,0,1,1,3,1,2016,0,3,727,0
Bruins,1,0,0,0,1,Senators,0,1,2,0,3,20161124,-1,0,2,2,4,2,2016,0,3,320,0
Oilers,2,0,0,0,2,Coyotes,1,0,1,1,3,20161125,-1,-1,0,1,5,1,2016,1,4,1392,0
Canucks,1,0,0,0,1,Stars,0,2,0,0,2,20161125,-1,1,1,1,3,1,2016,0,4,1766,0
Red Wings,2,1,1,1,5,Devils,1,2,1,0,4,20161125,1,0,0,1,9,-1,2016,1,4,471,0
Blue Jackets,2,1,2,0,5,Lightning,0,2,1,0,3,20161125,2,1,2,2,8,-2,2016,0,4,830,0
Sabres,0,0,1,0,1,Capitals,1,1,1,0,3,20161125,1,2,2,2,4,2,2016,0,4,292,0
Jets,1,0,0,0,1,Predators,0,3,2,0,5,20161125,-1,2,4,4,6,4,2016,0,4,1084,0
Islanders,1,0,1,0,2,Sharks,0,2,1,0,3,20161125,-1,1,1,1,5,1,2016,0,4,2549,0
Blackhawks,1,2,0,0,3,Ducks,0,1,1,0,2,20161125,1,2,1,1,5,-1,2016,0,4,1741,0
Penguins,1,0,1,0,2,Wild,3,2,1,0,6,20161125,2,4,4,4,8,4,2016,0,4,741,0
Rangers,2,1,0,0,3,Flyers,0,0,2,0,2,20161125,2,3,1,1,5,-1,2016,0,4,80,0
Flames,1,0,1,0,2,Bruins,0,0,1,0,1,20161125,1,1,1,1,3,-1,2016,0,4,2089,0
Blackhawks,1,0,0,0,1,Kings,0,1,0,1,2,20161126,-1,0,0,1,3,1,2016,1,5,1741,0
Ducks,2,1,0,0,3,Sharks,1,1,0,0,2,20161126,1,1,1,1,5,-1,2016,0,5,305,0
Canucks,1,0,1,1,3,Avalanche,0,1,1,0,2,20161126,1,0,0,1,5,-1,2016,1,5,1105,0
Canadiens,0,0,1,1,2,Red Wings,0,0,1,0,1,20161126,0,0,0,1,3,-1,2016,1,5,508,0
Devils,1,2,0,0,3,Penguins,0,2,1,1,4,20161126,-1,-1,0,1,7,1,2016,1,5,306,0
Blue Jackets,0,0,1,0,1,Panthers,1,0,0,1,2,20161126,1,1,0,1,3,1,2016,1,5,993,0
Hurricanes,1,0,0,0,1,Senators,0,1,1,0,2,20161126,-1,0,1,1,3,1,2016,0,5,673,0
Capitals,0,0,2,0,2,Maple Leafs,1,1,2,0,4,20161126,1,2,2,2,6,2,2016,0,5,349,0
Wild,1,1,1,0,3,Blues,0,1,2,1,4,20161126,-1,-1,0,1,7,1,2016,1,5,466,0
Senators,0,2,0,0,2,Rangers,0,0,0,0,0,20161127,0,2,2,2,2,-2,2016,0,6,334,0
Flames,1,0,2,0,3,Flyers,1,3,1,0,5,20161127,0,3,2,2,8,2,2016,0,6,2003,0
Coyotes,1,0,1,0,2,Oilers,0,0,1,0,1,20161127,1,1,1,1,3,-1,2016,0,6,1392,0
Predators,0,0,0,0,0,Jets,0,1,2,0,3,20161127,0,1,3,3,3,3,2016,0,6,1084,0
Lightning,0,0,1,0,1,Bruins,0,3,1,0,4,20161127,0,3,3,3,5,3,2016,0,6,1183,0
Panthers,2,0,0,0,2,Hurricanes,0,3,0,0,3,20161127,-2,1,1,1,5,1,2016,0,6,696,0
Flames,0,0,1,0,1,Islanders,1,0,0,1,2,20161128,1,1,0,1,3,1,2016,1,0,2023,0
Stars,0,1,2,0,3,Blues,1,1,1,1,4,20161128,1,1,0,1,7,1,2016,1,0,547,0
Coyotes,0,1,0,0,1,Sharks,0,1,0,1,2,20161129,0,0,0,1,3,1,2016,1,1,614,0
Canadiens,0,0,1,0,1,Ducks,1,1,0,0,2,20161129,1,2,1,1,3,1,2016,0,1,2448,0
Maple Leafs,1,3,0,0,4,Oilers,0,1,1,0,2,20161129,1,3,2,2,6,-2,2016,0,1,1683,0
Wild,1,1,2,0,4,Canucks,0,2,3,0,5,20161129,-1,0,1,1,9,1,2016,0,1,1427,0
Predators,1,2,2,0,5,Avalanche,1,1,1,0,3,20161129,0,1,2,2,8,-2,2016,0,1,1019,0
Sabres,3,1,1,0,5,Senators,1,2,1,0,4,20161129,2,1,1,1,9,-1,2016,0,1,219,0
Devils,0,0,2,0,2,Jets,0,2,1,0,3,20161129,0,2,1,1,5,1,2016,0,1,1280,0
Stars,1,0,0,0,1,Red Wings,1,1,1,0,3,20161129,0,1,2,2,4,2,2016,0,1,999,0
Bruins,0,0,2,0,2,Flyers,2,0,0,1,3,20161129,2,2,0,1,5,1,2016,1,1,270,0
Lightning,0,0,1,0,1,Blue Jackets,1,2,2,0,5,20161129,1,3,4,4,6,4,2016,0,1,830,0
Panthers,0,0,1,0,1,Blackhawks,1,0,0,1,2,20161129,1,1,0,1,3,1,2016,1,1,1189,0
Hurricanes,2,0,0,0,2,Rangers,0,1,2,0,3,20161129,-2,-1,1,1,5,1,2016,0,1,423,0
Penguins,0,0,3,0,3,Islanders,1,2,2,0,5,20161130,1,3,2,2,8,2,2016,0,2,314,0
Maple Leafs,0,0,0,0,0,Flames,3,0,0,0,3,20161130,3,3,3,3,3,3,2016,0,2,1682,0
Sharks,3,0,1,0,4,Kings,0,1,0,0,1,20161130,3,2,3,3,5,-3,2016,0,2,305,0
Kings,1,1,2,0,4,Coyotes,2,0,1,0,3,20161201,-1,0,1,1,7,-1,2016,0,3,356,0
Blue Jackets,2,0,1,0,3,Avalanche,0,2,0,0,2,20161201,2,0,1,1,5,-1,2016,0,3,1163,0
Devils,1,1,1,0,3,Blackhawks,0,3,0,1,4,20161201,-1,1,0,1,7,1,2016,1,3,703,0
Oilers,1,3,2,0,6,Jets,2,0,1,0,3,20161201,-1,2,3,3,9,-3,2016,0,3,738,0
Ducks,0,2,1,0,3,Canucks,0,0,1,0,1,20161201,0,2,2,2,4,-2,2016,0,3,1076,0
Panthers,1,0,0,1,2,Red Wings,1,0,0,0,1,20161201,0,0,0,1,3,-1,2016,1,3,1155,0
Flyers,0,2,0,1,3,Senators,1,1,0,0,2,20161201,-1,0,0,1,5,-1,2016,1,3,373,0
Islanders,0,0,3,0,3,Capitals,0,0,0,0,0,20161201,0,0,3,3,3,-3,2016,0,3,204,0
Stars,1,1,0,0,2,Penguins,1,2,3,0,6,20161201,0,1,4,4,8,4,2016,0,3,1069,0
Hurricanes,0,1,0,0,1,Bruins,0,0,1,1,2,20161201,0,-1,0,1,3,1,2016,1,3,609,0
Rangers,1,2,0,0,3,Sabres,1,1,2,0,4,20161201,0,-1,1,1,7,1,2016,0,3,292,0
Lightning,1,1,2,0,4,Blues,3,1,1,0,5,20161201,2,2,1,1,9,1,2016,0,3,861,0
Wild,1,0,1,0,2,Flames,2,0,0,1,3,20161202,1,1,0,1,5,1,2016,1,4,1043,0
Canadiens,0,0,1,0,1,Sharks,2,0,0,0,2,20161202,2,2,1,1,3,1,2016,0,4,2508,0
Ducks,0,1,1,0,2,Oilers,0,2,0,1,3,20161203,0,1,0,1,5,1,2016,1,5,1368,0
Stars,1,1,1,0,3,Avalanche,0,0,0,0,0,20161203,1,2,3,3,3,-3,2016,0,5,661,0
Blue Jackets,1,0,1,1,3,Coyotes,0,2,0,0,2,20161203,1,-1,0,1,5,-1,2016,1,5,1664,0
Maple Leafs,0,1,1,0,2,Canucks,1,1,0,1,3,20161203,1,1,0,1,5,1,2016,1,5,2090,0
Jets,1,1,0,1,3,Blues,0,2,0,0,2,20161203,1,0,0,1,5,-1,2016,1,5,853,0
Panthers,0,0,0,0,0,Senators,2,0,0,0,2,20161203,2,2,2,2,2,2,2016,0,5,1370,0
Capitals,0,0,1,0,1,Lightning,0,1,0,1,2,20161203,0,1,0,1,3,1,2016,1,5,818,0
Devils,1,0,3,1,5,Predators,2,2,0,0,4,20161203,-1,-3,0,1,9,-1,2016,1,5,750,0
Blackhawks,1,0,0,0,1,Flyers,0,3,0,0,3,20161203,-1,2,2,2,4,2,2016,0,5,664,0
Hurricanes,0,1,1,0,2,Rangers,1,0,3,0,4,20161203,1,0,2,2,6,2,2016,0,5,423,0
Bruins,1,0,1,0,2,Sabres,0,0,1,0,1,20161203,1,1,1,1,3,-1,2016,0,5,399,0
Red Wings,1,2,0,0,3,Penguins,0,1,4,0,5,20161203,-1,-2,2,2,8,2,2016,0,5,205,0
Wild,1,0,0,1,2,Oilers,1,0,0,0,1,20161204,0,0,0,1,3,-1,2016,1,6,1083,0
Ducks,0,1,2,0,3,Flames,1,5,2,0,8,20161204,1,5,5,5,11,5,2016,0,6,1197,0
Lightning,0,0,0,0,0,Hurricanes,0,0,0,1,1,20161204,0,0,0,1,1,1,2016,1,6,585,0
Flyers,1,2,1,0,4,Predators,0,2,0,0,2,20161204,1,1,2,2,6,-2,2016,0,6,683,0
Red Wings,1,1,1,1,4,Islanders,1,0,2,0,3,20161204,0,1,0,1,7,-1,2016,1,6,480,0
Jets,0,1,1,0,2,Blackhawks,0,0,1,0,1,20161204,0,1,1,1,3,-1,2016,0,6,722,0
Canadiens,1,2,1,1,5,Kings,0,4,0,0,4,20161204,1,-1,0,1,9,-1,2016,1,6,2448,0
Panthers,0,1,2,0,3,Bruins,1,1,1,1,4,20161205,1,1,0,1,7,1,2016,1,0,1257,0
Senators,2,2,1,0,5,Penguins,2,3,3,0,8,20161205,0,1,3,3,13,3,2016,0,0,392,0
Sabres,1,1,0,0,2,Capitals,0,1,1,1,3,20161205,-1,-1,0,1,5,1,2016,1,0,292,0
Coyotes,1,0,0,0,1,Blue Jackets,1,1,2,0,4,20161205,0,1,3,3,5,3,2016,0,0,1664,0
Flames,0,1,1,0,2,Stars,1,0,0,0,1,20161206,-1,0,1,1,3,-1,2016,0,1,1536,0
Coyotes,0,0,0,0,0,Blackhawks,1,2,1,0,4,20161206,1,3,4,4,4,4,2016,0,1,1450,0
Red Wings,1,2,0,1,4,Jets,3,0,0,0,3,20161206,-2,0,0,1,7,-1,2016,1,1,855,0
Rangers,0,2,0,0,2,Islanders,2,1,1,0,4,20161206,2,1,2,2,6,2,2016,0,1,0,0
Canadiens,1,1,0,0,2,Blues,0,0,2,1,3,20161206,-1,-2,0,1,5,1,2016,1,1,962,0
Panthers,1,0,1,0,2,Flyers,1,1,0,1,3,20161206,0,1,0,1,5,1,2016,1,1,1021,0
Canucks,0,1,1,0,2,Devils,1,2,0,0,3,20161206,1,2,1,1,5,1,2016,0,1,2421,0
Oilers,0,2,1,0,3,Sabres,2,0,1,1,4,20161206,2,0,0,1,7,1,2016,1,1,1734,0
Avalanche,1,2,0,0,3,Predators,2,1,1,0,4,20161206,1,0,1,1,7,1,2016,0,1,1019,0
Senators,2,0,2,0,4,Sharks,0,1,1,0,2,20161207,2,1,2,2,6,-2,2016,0,2,2408,0
Wild,2,1,0,0,3,Maple Leafs,1,1,0,0,2,20161207,1,1,1,1,5,-1,2016,0,2,691,0
Bruins,0,2,1,0,3,Capitals,2,1,0,1,4,20161207,2,1,0,1,7,1,2016,1,2,394,0
Hurricanes,1,2,2,0,5,Ducks,1,1,3,1,6,20161207,0,-1,0,1,11,1,2016,1,2,2231,0
Avalanche,2,2,0,0,4,Bruins,0,2,0,0,2,20161208,2,2,2,2,6,-2,2016,0,3,1765,0
Blues,1,1,0,0,2,Islanders,2,0,1,0,3,20161208,1,0,1,1,5,1,2016,0,3,871,0
Oilers,1,2,2,0,5,Flyers,0,3,3,0,6,20161208,-1,0,1,1,11,1,2016,0,3,2011,0
Devils,1,0,1,0,2,Canadiens,2,1,2,0,5,20161208,1,2,3,3,7,3,2016,0,3,342,0
Canucks,2,2,1,0,5,Lightning,0,1,0,0,1,20161208,2,3,4,4,6,-4,2016,0,3,2598,0
Penguins,3,0,2,0,5,Panthers,0,1,0,0,1,20161208,3,2,4,4,6,-4,2016,0,3,1013,0
Rangers,1,0,1,0,2,Jets,0,1,0,0,1,20161208,1,0,1,1,3,-1,2016,0,3,1287,0
Predators,1,0,1,0,2,Stars,2,3,0,0,5,20161208,1,4,3,3,7,3,2016,0,3,616,0
Flames,1,0,0,1,2,Coyotes,1,0,0,0,1,20161208,0,0,0,1,3,-1,2016,1,3,1224,0
Hurricanes,1,1,1,0,3,Kings,0,0,1,0,1,20161208,1,2,2,2,4,-2,2016,0,3,2231,0
Rangers,0,0,0,1,1,Blackhawks,0,0,0,0,0,20161209,0,0,0,1,1,-1,2016,1,4,711,0
Sharks,1,1,0,0,2,Ducks,2,0,1,0,3,20161209,1,0,1,1,5,1,2016,0,4,305,0
Blues,1,2,1,0,4,Devils,0,1,0,0,1,20161209,1,2,3,3,5,-3,2016,0,4,863,0
Blue Jackets,1,2,1,0,4,Red Wings,0,1,0,0,1,20161209,1,2,3,3,5,-3,2016,0,4,163,0
Oilers,1,0,1,0,2,Wild,0,1,1,1,3,20161209,-1,0,0,1,5,1,2016,1,4,1083,0
Capitals,0,2,2,0,4,Sabres,0,0,1,0,1,20161209,0,2,3,3,5,-3,2016,0,4,292,0
Hurricanes,1,1,1,0,3,Sharks,2,2,0,0,4,20161210,1,2,1,1,7,1,2016,0,5,2382,0
Jets,0,0,2,0,2,Flames,0,4,2,0,6,20161210,0,4,4,4,8,4,2016,0,5,740,0
Predators,1,0,0,0,1,Coyotes,2,1,1,0,4,20161210,1,2,3,3,5,3,2016,0,5,1442,0
Islanders,1,1,0,0,2,Blue Jackets,1,1,4,0,6,20161210,0,0,4,4,8,4,2016,0,5,476,0
Penguins,1,1,2,0,4,Lightning,1,2,0,0,3,20161210,0,-1,1,1,7,-1,2016,0,5,874,0
Avalanche,1,0,0,0,1,Canadiens,6,3,1,0,10,20161210,5,8,9,9,11,9,2016,0,5,1618,0
Maple Leafs,0,2,2,0,4,Bruins,0,1,0,0,1,20161210,0,1,3,3,5,-3,2016,0,5,430,0
Senators,0,1,0,0,1,Kings,2,1,1,0,4,20161210,2,2,3,3,5,3,2016,0,5,2345,0
Stars,1,0,1,0,2,Flyers,1,0,3,0,4,20161210,0,0,2,2,6,2,2016,0,5,1297,0
Canucks,0,0,2,0,2,Panthers,1,1,2,0,4,20161210,1,2,2,2,6,2,2016,0,5,2803,0
Stars,0,1,0,0,1,Blackhawks,0,2,1,0,3,20161211,0,1,2,2,4,2,2016,0,6,802,0
Jets,1,1,0,0,2,Oilers,0,1,2,0,3,20161211,-1,-1,1,1,5,1,2016,0,6,738,0
Devils,0,0,0,0,0,Rangers,1,2,2,0,5,20161211,1,3,5,5,5,5,2016,0,6,8,0
Flyers,0,0,0,1,1,Red Wings,0,0,0,0,0,20161211,0,0,0,1,1,-1,2016,1,6,441,0
Blues,0,1,0,0,1,Wild,0,2,1,0,3,20161211,0,1,2,2,4,2,2016,0,6,466,0
Canucks,0,0,0,0,0,Capitals,1,0,2,0,3,20161211,1,1,3,3,3,3,2016,0,6,2359,0
Senators,1,0,0,0,1,Ducks,3,1,1,0,5,20161211,2,3,4,4,6,4,2016,0,6,2345,0
Avalanche,1,0,2,0,3,Maple Leafs,0,0,1,0,1,20161211,1,1,2,2,4,-2,2016,0,6,1341,0
Coyotes,0,0,0,0,0,Penguins,1,4,2,0,7,20161212,1,5,7,7,7,7,2016,0,0,1824,0
Bruins,0,1,0,1,2,Canadiens,0,0,1,0,1,20161212,0,1,0,1,3,-1,2016,1,0,270,0
Panthers,0,0,1,0,1,Wild,1,2,2,0,5,20161213,1,3,4,4,6,4,2016,0,1,1513,0
Blue Jackets,0,1,2,0,3,Oilers,1,0,0,0,1,20161213,-1,0,2,2,4,-2,2016,0,1,1703,0
Ducks,0,1,1,0,2,Stars,0,1,5,0,6,20161213,0,0,4,4,8,4,2016,0,1,1237,0
Blues,2,1,0,0,3,Predators,0,2,4,0,6,20161213,-2,-1,3,3,9,3,2016,0,1,253,0
Capitals,0,2,2,0,4,Islanders,1,1,0,0,2,20161213,-1,0,2,2,6,-2,2016,0,1,204,0
Sharks,0,0,2,1,3,Maple Leafs,1,1,0,0,2,20161213,-1,-2,0,1,5,-1,2016,1,1,2249,0
Canucks,1,4,1,0,6,Hurricanes,2,0,6,0,8,20161213,1,-3,2,2,14,2,2016,0,1,2409,0
Blackhawks,0,2,0,0,2,Rangers,0,1,0,0,1,20161213,0,1,1,1,3,-1,2016,0,1,711,0
Kings,1,1,1,0,3,Sabres,0,4,2,0,6,20161213,-1,2,3,3,9,3,2016,0,1,2193,0
Coyotes,2,1,1,0,4,Red Wings,1,0,0,0,1,20161213,1,2,3,3,5,-3,2016,0,1,1687,0
Sharks,1,1,1,1,4,Senators,1,1,1,0,3,20161214,0,0,0,1,7,-1,2016,1,2,2408,0
Bruins,1,1,1,0,3,Penguins,1,1,1,1,4,20161214,0,0,0,1,7,1,2016,1,2,481,0
Lightning,2,2,2,0,6,Flames,1,0,2,0,3,20161214,1,3,3,3,9,-3,2016,0,2,2289,0
Flyers,0,2,2,0,4,Avalanche,0,2,1,0,3,20161214,0,0,1,1,7,-1,2016,0,2,1574,0
Rangers,0,0,2,0,2,Stars,0,0,0,0,0,20161215,0,0,2,2,2,-2,2016,0,3,1370,0
Panthers,0,3,0,0,3,Jets,1,1,1,1,4,20161215,1,-1,0,1,7,1,2016,1,3,1899,0
Wild,3,0,2,0,5,Predators,1,1,0,0,2,20161215,2,1,3,3,7,-3,2016,0,3,696,0
Coyotes,0,2,0,1,3,Maple Leafs,1,1,0,0,2,20161215,-1,0,0,1,5,-1,2016,1,3,1885,0
Kings,1,1,2,0,4,Red Wings,1,0,0,0,1,20161215,0,1,3,3,5,-3,2016,0,3,1979,0
Blackhawks,3,1,1,0,5,Islanders,3,1,0,0,4,20161215,0,0,1,1,9,-1,2016,0,3,711,0
Ducks,2,2,0,0,4,Bruins,2,1,0,0,3,20161215,0,1,1,1,7,-1,2016,0,3,2590,0
Devils,2,0,0,0,2,Blues,1,2,2,0,5,20161215,-1,1,3,3,7,3,2016,0,3,863,0
Lightning,1,0,1,0,2,Canucks,0,2,2,0,4,20161216,-1,1,2,2,6,2,2016,0,4,2598,0
Blue Jackets,2,2,0,0,4,Flames,1,0,0,0,1,20161216,1,3,3,3,5,-3,2016,0,4,1670,0
Sharks,3,1,0,0,4,Canadiens,0,0,2,0,2,20161216,3,4,2,2,6,-2,2016,0,4,2508,0
Capitals,0,2,1,1,4,Hurricanes,1,1,1,0,3,20161216,-1,0,0,1,7,-1,2016,1,4,233,0
Panthers,0,1,2,0,3,Avalanche,0,1,0,0,1,20161216,0,0,2,2,4,-2,2016,0,4,1724,0
Islanders,1,1,0,0,2,Sabres,0,1,1,1,3,20161216,-1,-1,0,1,5,1,2016,1,4,292,0
Kings,0,0,0,1,1,Penguins,0,0,0,0,0,20161216,0,0,0,1,1,-1,2016,1,4,2132,0
Coyotes,0,0,1,0,1,Wild,1,1,2,0,4,20161217,1,2,3,3,5,3,2016,0,5,1278,0
Penguins,1,0,0,0,1,Maple Leafs,1,0,0,1,2,20161217,0,0,0,1,3,1,2016,1,5,222,0
Devils,1,0,0,0,1,Senators,1,1,1,0,3,20161217,0,1,2,2,4,2,2016,0,5,330,0
Ducks,2,1,1,0,4,Red Wings,1,3,2,0,6,20161217,-1,1,2,2,10,2,2016,0,5,1979,0
Canadiens,1,1,0,0,2,Capitals,0,1,0,0,1,20161217,1,1,1,1,3,-1,2016,0,5,495,0
Sabres,0,0,1,0,1,Hurricanes,1,0,0,1,2,20161217,1,1,0,1,3,1,2016,1,5,491,0
Blackhawks,1,2,3,0,6,Blues,1,3,0,0,4,20161217,0,-1,2,2,10,-2,2016,0,5,260,0
Rangers,1,0,0,1,2,Predators,0,1,0,0,1,20161217,1,0,0,1,3,-1,2016,1,5,758,0
Lightning,0,1,1,0,2,Oilers,0,1,1,1,3,20161217,0,0,0,1,5,1,2016,1,5,2367,0
Flyers,1,0,0,0,1,Stars,0,1,2,0,3,20161217,-1,0,2,2,4,2,2016,0,5,1297,0
Sharks,0,1,0,0,1,Blackhawks,0,1,3,0,4,20161218,0,0,3,3,5,3,2016,0,6,1837,0
Devils,0,1,1,0,2,Rangers,0,0,2,1,3,20161218,0,-1,0,1,5,1,2016,1,6,8,0
Blue Jackets,0,2,1,1,4,Canucks,0,0,3,0,3,20161218,0,2,0,1,7,-1,2016,1,6,2050,0
Avalanche,0,0,1,0,1,Jets,0,1,3,0,4,20161218,0,1,3,3,5,3,2016,0,6,797,0
Senators,2,1,3,0,6,Islanders,0,2,0,0,2,20161218,2,1,4,4,8,-4,2016,0,6,334,0
Kings,0,0,0,0,0,Bruins,1,0,0,0,1,20161218,1,1,1,1,1,1,2016,0,6,2590,0
Flames,0,1,3,0,4,Coyotes,1,0,1,0,2,20161219,-1,0,2,2,6,-2,2016,0,0,1224,0
Ducks,0,1,2,0,3,Maple Leafs,0,1,1,0,2,20161219,0,0,1,1,5,-1,2016,0,0,2170,0
Predators,0,0,1,1,2,Flyers,1,0,0,0,1,20161219,-1,-1,0,1,3,-1,2016,1,0,683,0
Oilers,1,0,1,1,3,Blues,2,0,0,0,2,20161219,-1,-1,0,1,5,-1,2016,1,0,1508,0
Islanders,2,1,1,0,4,Bruins,0,0,2,0,2,20161220,2,3,2,2,6,-2,2016,0,1,190,0
Predators,2,1,2,0,5,Devils,0,0,1,0,1,20161220,2,3,4,4,6,-4,2016,0,1,750,0
Rangers,1,0,1,0,2,Penguins,1,2,4,0,7,20161220,0,2,5,5,9,5,2016,0,1,314,0
Ducks,1,0,0,0,1,Canadiens,1,1,3,0,5,20161220,0,1,4,4,6,4,2016,0,1,2448,0
Red Wings,0,0,1,0,1,Lightning,1,3,0,0,4,20161220,1,4,3,3,5,3,2016,0,1,994,0
Sabres,0,2,1,0,3,Panthers,1,1,1,1,4,20161220,1,0,0,1,7,1,2016,1,1,1184,0
Avalanche,0,0,0,0,0,Wild,1,1,0,0,2,20161220,1,2,2,2,2,2,2016,0,1,698,0
Senators,1,3,0,0,4,Blackhawks,1,1,1,0,3,20161220,0,2,1,1,7,-1,2016,0,1,628,0
Blues,1,1,0,1,3,Stars,1,1,0,0,2,20161220,0,0,0,1,5,-1,2016,1,1,547,0
Jets,1,0,0,0,1,Canucks,0,1,3,0,4,20161220,-1,0,3,3,5,3,2016,0,1,1157,0
Flames,0,0,1,0,1,Sharks,0,4,0,0,4,20161220,0,4,3,3,5,3,2016,0,1,1027,0
Kings,0,1,1,0,2,Blue Jackets,0,1,1,1,3,20161220,0,0,0,1,5,1,2016,1,1,1973,0
Oilers,2,1,0,0,3,Coyotes,0,1,1,0,2,20161221,2,2,1,1,5,-1,2016,0,2,1392,0
Capitals,1,1,0,0,2,Flyers,0,2,0,1,3,20161221,-1,0,0,1,5,1,2016,1,2,123,0
Flyers,0,0,0,0,0,Devils,2,1,1,0,4,20161222,2,3,4,4,4,4,2016,0,3,75,0
Penguins,1,0,0,0,1,Blue Jackets,1,2,4,0,7,20161222,0,2,6,6,8,6,2016,0,3,161,0
Wild,0,2,2,0,4,Canadiens,0,2,0,0,2,20161222,0,0,2,2,6,-2,2016,0,3,938,0
Ducks,0,1,0,0,1,Senators,0,1,0,1,2,20161222,0,0,0,1,3,1,2016,1,3,2345,0
Blues,2,0,0,0,2,Lightning,0,2,3,0,5,20161222,-2,0,3,3,7,3,2016,0,3,861,0
Bruins,0,2,1,0,3,Panthers,0,0,1,0,1,20161222,0,2,2,2,4,-2,2016,0,3,1257,0
Kings,1,0,3,0,4,Predators,0,0,0,0,0,20161222,1,1,4,4,4,-4,2016,0,3,1776,0
Maple Leafs,3,2,1,0,6,Avalanche,0,0,0,0,0,20161222,3,5,6,6,6,-6,2016,0,3,1341,0
Jets,0,1,3,0,4,Canucks,1,0,0,0,1,20161222,-1,0,3,3,5,-3,2016,0,3,1157,0
Hurricanes,2,0,1,0,3,Sabres,0,0,1,0,1,20161222,2,2,2,2,4,-2,2016,0,3,491,0
Oilers,0,0,2,0,2,Sharks,0,1,1,1,3,20161223,0,1,0,1,5,1,2016,1,4,1190,0
Maple Leafs,1,1,2,0,4,Coyotes,0,1,0,0,1,20161223,1,1,3,3,5,-3,2016,0,4,1885,0
Canucks,1,0,0,0,1,Flames,0,3,1,0,4,20161223,-1,2,3,3,5,3,2016,0,4,426,0
Kings,1,0,1,0,2,Stars,0,1,1,1,3,20161223,-1,0,0,1,5,1,2016,1,4,1237,0
Avalanche,0,0,1,1,2,Blackhawks,0,1,0,0,1,20161223,0,-1,0,1,3,-1,2016,1,4,916,0
Red Wings,0,1,2,1,4,Panthers,1,2,0,0,3,20161223,-1,-2,0,1,7,-1,2016,1,4,1155,0
Canadiens,0,0,1,0,1,Blue Jackets,1,1,0,0,2,20161223,1,2,1,1,3,1,2016,0,4,605,0
Lightning,0,0,0,0,0,Capitals,2,1,1,0,4,20161223,2,3,4,4,4,4,2016,0,4,818,0
Devils,0,1,0,0,1,Penguins,1,2,1,0,4,20161223,1,2,3,3,5,3,2016,0,4,306,0
Wild,1,5,1,0,7,Rangers,1,2,1,0,4,20161223,0,3,3,3,11,-3,2016,0,4,1016,0
Sabres,0,0,1,0,1,Islanders,1,2,2,0,5,20161223,1,3,4,4,6,4,2016,0,4,292,0
Bruins,1,1,0,0,2,Hurricanes,0,1,1,1,3,20161223,-1,-1,0,1,5,1,2016,1,4,609,0
Sharks,1,1,0,1,3,Ducks,0,1,1,0,2,20161227,1,1,0,1,5,-1,2016,1,1,305,0
Stars,0,2,1,0,3,Coyotes,0,1,1,0,2,20161227,0,1,1,1,5,-1,2016,0,1,884,0
Flames,0,4,2,0,6,Avalanche,1,1,1,0,3,20161227,-1,2,3,3,9,-3,2016,0,1,898,0
Jets,2,0,1,0,3,Blackhawks,0,1,0,0,1,20161227,2,1,2,2,4,-2,2016,0,1,722,0
Bruins,2,1,0,0,3,Blue Jackets,3,0,1,0,4,20161227,1,0,1,1,7,1,2016,0,1,642,0
Sabres,2,1,1,0,4,Red Wings,0,2,1,0,3,20161227,2,1,1,1,7,-1,2016,0,1,215,0
Senators,3,0,0,0,3,Rangers,1,2,1,0,4,20161227,-2,0,1,1,7,1,2016,0,1,334,0
Capitals,1,0,2,0,3,Islanders,1,1,2,0,4,20161227,0,1,1,1,7,1,2016,0,1,204,0
Penguins,1,2,2,0,5,Devils,2,0,0,0,2,20161227,-1,1,3,3,7,-3,2016,0,1,306,0
Wild,1,1,0,1,3,Predators,0,2,0,0,2,20161227,1,0,0,1,5,-1,2016,1,1,696,0
Flyers,1,1,1,0,3,Blues,2,0,4,0,6,20161228,1,0,3,3,9,3,2016,0,2,808,0
Kings,0,0,1,0,1,Canucks,1,1,0,0,2,20161228,1,2,1,1,3,1,2016,0,2,1076,0
Hurricanes,1,1,0,0,2,Penguins,0,1,2,0,3,20161228,-1,-1,1,1,5,1,2016,0,2,330,0
Canadiens,2,1,0,0,3,Lightning,1,0,2,1,4,20161228,-1,-2,0,1,7,1,2016,1,2,1311,0
Maple Leafs,1,1,0,1,3,Panthers,0,0,2,0,2,20161228,1,2,0,1,5,-1,2016,1,2,1234,0
Rangers,2,1,3,0,6,Coyotes,1,1,1,0,3,20161229,1,1,3,3,9,-3,2016,0,3,2139,0
Ducks,0,1,2,0,3,Flames,1,0,0,0,1,20161229,-1,0,2,2,4,-2,2016,0,3,1197,0
Avalanche,1,0,1,0,2,Stars,2,1,1,0,4,20161229,1,2,2,2,6,2,2016,0,3,661,0
Blue Jackets,2,1,2,0,5,Jets,1,0,2,0,3,20161229,1,2,2,2,8,-2,2016,0,3,975,0
Kings,0,0,1,0,1,Oilers,0,1,2,0,3,20161229,0,1,2,2,4,2,2016,0,3,1368,0
Blackhawks,1,0,2,0,3,Predators,1,0,1,0,2,20161229,0,0,1,1,5,-1,2016,0,3,395,0
Red Wings,1,1,0,1,3,Senators,1,1,0,0,2,20161229,0,0,0,1,5,-1,2016,1,3,406,0
Canadiens,0,1,1,1,3,Panthers,1,1,0,0,2,20161229,-1,-1,0,1,5,-1,2016,1,3,1418,0
Maple Leafs,1,1,0,1,3,Lightning,0,2,0,0,2,20161229,1,0,0,1,5,-1,2016,1,3,1096,0
Devils,0,1,0,1,2,Capitals,0,0,1,0,1,20161229,0,1,0,1,3,-1,2016,1,3,198,0
Bruins,0,2,2,0,4,Sabres,2,0,0,0,2,20161229,-2,0,2,2,6,-2,2016,0,3,399,0
Islanders,1,1,2,0,4,Wild,1,3,2,0,6,20161229,0,2,2,2,10,2,2016,0,3,1016,0
Blackhawks,1,0,1,0,2,Hurricanes,2,0,1,0,3,20161230,1,1,1,1,5,1,2016,0,4,641,0
Predators,0,3,1,0,4,Blues,0,0,0,0,0,20161230,0,3,4,4,4,-4,2016,0,4,253,0
Ducks,1,1,0,0,2,Canucks,0,1,1,1,3,20161230,-1,-1,0,1,5,1,2016,1,4,1076,0
Flyers,0,0,0,0,0,Sharks,1,0,1,0,2,20161230,1,1,2,2,2,2,2016,0,4,2499,0
Sharks,0,0,2,0,2,Kings,1,1,1,0,3,20161231,1,2,1,1,5,1,2016,0,5,305,0
Canucks,0,1,1,1,3,Oilers,0,1,1,0,2,20161231,0,0,0,1,5,-1,2016,1,5,514,0
Coyotes,0,1,1,0,2,Flames,4,0,0,0,4,20161231,4,3,2,2,6,2,2016,0,5,1224,0
Panthers,3,0,0,0,3,Stars,0,1,0,0,1,20161231,3,2,2,2,4,-2,2016,0,5,1110,0
Rangers,2,2,2,0,6,Avalanche,2,0,0,0,2,20161231,0,2,4,4,8,-4,2016,0,5,1627,0
Canadiens,1,1,1,0,3,Penguins,0,2,1,1,4,20161231,-1,0,0,1,7,1,2016,1,5,474,0
Hurricanes,0,1,0,0,1,Lightning,2,1,0,0,3,20161231,2,2,2,2,4,2,2016,0,5,585,0
Blue Jackets,1,3,0,0,4,Wild,0,1,1,0,2,20161231,1,3,2,2,6,-2,2016,0,5,626,0
Capitals,2,3,1,0,6,Devils,0,1,1,0,2,20161231,2,4,4,4,8,-4,2016,0,5,198,0
Islanders,2,2,2,0,6,Jets,0,1,1,0,2,20161231,2,3,4,4,8,-4,2016,0,5,1287,0
Sabres,0,1,0,0,1,Bruins,1,2,0,0,3,20161231,1,2,2,2,4,2,2016,0,5,399,0
Red Wings,0,1,3,0,4,Maple Leafs,0,0,4,1,5,20170101,0,-1,0,1,9,1,2016,1,6,205,0
Senators,0,1,0,0,1,Capitals,0,1,1,0,2,20170101,0,0,1,1,3,1,2016,0,6,446,0
Flyers,1,2,0,0,3,Ducks,2,1,0,1,4,20170101,1,0,0,1,7,1,2016,1,6,2388,0
Avalanche,0,1,1,0,2,Canucks,0,2,1,0,3,20170102,0,1,1,1,5,1,2016,0,0,1105,0
Blackhawks,1,0,0,0,1,Blues,0,1,3,0,4,20170102,-1,0,3,3,5,3,2016,0,0,260,0
Bruins,0,0,0,0,0,Devils,1,0,2,0,3,20170102,1,1,3,3,3,3,2016,0,0,196,0
Sabres,2,1,1,0,4,Rangers,0,1,0,0,1,20170103,2,2,3,3,5,-3,2016,0,1,292,0
Maple Leafs,3,1,1,0,5,Capitals,2,0,3,1,6,20170103,-1,-2,0,1,11,1,2016,1,1,349,0
Devils,0,1,2,0,3,Hurricanes,0,0,1,0,1,20170103,0,1,2,2,4,-2,2016,0,1,419,0
Oilers,0,1,0,0,1,Blue Jackets,1,1,1,0,3,20170103,1,1,2,2,4,2,2016,0,1,1703,0
Jets,1,3,2,0,6,Lightning,0,1,3,0,4,20170103,1,3,2,2,10,-2,2016,0,1,1705,0
Canadiens,0,0,1,1,2,Predators,0,1,0,0,1,20170103,0,-1,0,1,3,-1,2016,1,1,937,0
Kings,0,0,1,1,2,Sharks,0,1,0,0,1,20170103,0,-1,0,1,3,-1,2016,1,1,305,0
Red Wings,0,0,0,0,0,Ducks,1,0,1,0,2,20170104,1,1,2,2,2,2,2016,0,2,1979,0
Coyotes,0,0,0,0,0,Canucks,1,0,2,0,3,20170104,1,1,3,3,3,3,2016,0,2,1228,0
Canadiens,1,0,2,1,4,Stars,1,1,1,0,3,20170104,0,-1,0,1,7,-1,2016,1,2,1505,0
Jets,0,2,2,0,4,Panthers,0,1,0,0,1,20170104,0,1,3,3,5,-3,2016,0,2,1899,0
Rangers,0,1,4,0,5,Flyers,0,0,2,0,2,20170104,0,1,3,3,7,-3,2016,0,2,80,0
Avalanche,0,0,1,0,1,Flames,1,1,2,0,4,20170104,1,2,3,3,5,3,2016,0,2,898,0
Wild,0,1,4,0,5,Sharks,0,2,2,0,4,20170105,0,-1,1,1,9,-1,2016,0,3,1570,0
Oilers,1,1,2,0,4,Bruins,1,1,1,0,3,20170105,0,0,1,1,7,-1,2016,0,3,2074,0
Blue Jackets,0,0,0,0,0,Capitals,2,2,1,0,5,20170105,2,4,5,5,5,5,2016,0,3,326,0
Predators,1,3,2,0,6,Lightning,0,1,0,0,1,20170105,1,3,5,5,7,-5,2016,0,3,621,0
Hurricanes,1,1,2,0,4,Blues,0,2,0,0,2,20170105,1,0,2,2,6,-2,2016,0,3,665,0
Sabres,1,1,1,0,3,Blackhawks,1,1,1,1,4,20170105,0,0,0,1,7,1,2016,1,3,453,0
Red Wings,3,0,1,0,4,Kings,0,0,0,0,0,20170105,3,3,4,4,4,-4,2016,0,3,1979,0
Coyotes,0,1,1,0,2,Ducks,1,1,0,1,3,20170106,1,1,0,1,5,1,2016,1,4,356,0
Flames,1,0,1,0,2,Canucks,2,1,1,0,4,20170106,1,2,2,2,6,2,2016,0,4,426,0
Maple Leafs,4,0,0,0,4,Devils,0,0,2,0,2,20170106,4,4,2,2,6,-2,2016,0,4,333,0
Hurricanes,0,1,0,0,1,Blackhawks,1,1,0,0,2,20170106,1,1,1,1,3,1,2016,0,4,641,0
Predators,0,0,1,0,1,Panthers,1,0,1,0,2,20170106,1,1,1,1,3,1,2016,0,4,816,0
Islanders,0,1,0,0,1,Avalanche,1,0,0,1,2,20170106,1,0,0,1,3,1,2016,1,4,1627,0
Islanders,0,1,0,0,1,Coyotes,0,0,1,1,2,20170107,0,-1,0,1,3,1,2016,1,5,2139,0
Stars,1,2,0,0,3,Blues,2,1,1,0,4,20170107,1,0,1,1,7,1,2016,0,5,547,0
Red Wings,1,0,2,0,3,Sharks,3,0,3,0,6,20170107,2,2,3,3,9,3,2016,0,5,2071,0
Canucks,0,1,0,0,1,Flames,2,0,1,0,3,20170107,2,1,2,2,4,2,2016,0,5,426,0
Rangers,1,1,3,0,5,Blue Jackets,3,1,0,0,4,20170107,-2,-2,1,1,9,-1,2016,0,5,476,0
Jets,1,2,0,0,3,Sabres,1,0,3,0,4,20170107,0,-2,1,1,7,1,2016,0,5,996,0
Bruins,1,2,1,0,4,Panthers,0,0,0,0,0,20170107,1,3,4,4,4,-4,2016,0,5,1257,0
Capitals,1,0,0,0,1,Senators,0,0,0,0,0,20170107,1,1,1,1,1,-1,2016,0,5,446,0
Canadiens,3,1,1,0,5,Maple Leafs,2,1,0,0,3,20170107,1,1,2,2,8,-2,2016,0,5,303,0
Wild,2,0,1,0,3,Kings,0,2,1,1,4,20170107,-2,0,0,1,7,1,2016,1,5,1521,0
Lightning,1,1,0,0,2,Flyers,0,4,0,0,4,20170107,-1,2,2,2,6,2,2016,0,5,928,0
Oilers,0,0,1,1,2,Devils,1,0,0,0,1,20170107,-1,-1,0,1,3,-1,2016,1,5,2016,0
Wild,0,2,0,0,2,Ducks,1,0,0,0,1,20170108,-1,1,1,1,3,-1,2016,0,6,1521,0
Predators,1,0,1,0,2,Blackhawks,2,0,3,0,5,20170108,1,1,3,3,7,3,2016,0,6,395,0
Lightning,0,1,1,0,2,Penguins,0,2,4,0,6,20170108,0,1,4,4,8,4,2016,0,6,874,0
Flyers,0,0,1,0,1,Blue Jackets,0,1,0,1,2,20170108,0,1,0,1,3,1,2016,1,6,414,0
Bruins,1,0,2,0,3,Hurricanes,0,2,1,1,4,20170108,-1,1,0,1,7,1,2016,1,6,609,0
Oilers,0,3,0,0,3,Senators,2,2,1,0,5,20170108,2,1,2,2,8,2,2016,0,6,1754,0
Panthers,1,0,2,0,3,Devils,0,0,0,0,0,20170109,1,1,3,3,3,-3,2016,0,0,1090,0
Capitals,1,0,3,0,4,Canadiens,0,0,1,0,1,20170109,1,1,3,3,5,-3,2016,0,0,495,0
Flames,0,0,0,0,0,Jets,1,0,1,0,2,20170109,1,1,2,2,2,2,2016,0,0,740,0
Stars,1,2,3,0,6,Kings,0,1,3,0,4,20170109,1,2,2,2,10,-2,2016,0,0,1237,0
Stars,0,0,0,0,0,Ducks,0,1,1,0,2,20170110,0,1,2,2,2,2,2016,0,1,1237,0
Red Wings,0,3,0,0,3,Blackhawks,2,1,0,1,4,20170110,2,0,0,1,7,1,2016,1,1,238,0
Sharks,2,2,1,0,5,Oilers,1,0,2,0,3,20170110,1,3,2,2,8,-2,2016,0,1,1190,0
Bruins,3,1,1,0,5,Blues,0,1,2,0,3,20170110,3,3,2,2,8,-2,2016,0,1,1035,0
Blue Jackets,1,2,0,0,3,Hurricanes,0,3,2,0,5,20170110,-1,0,2,2,8,2,2016,0,1,374,0
Flyers,0,0,1,0,1,Sabres,0,3,1,0,4,20170110,0,3,3,3,5,3,2016,0,1,279,0
Canucks,0,0,1,0,1,Predators,0,1,0,1,2,20170110,0,1,0,1,3,1,2016,1,1,2030,0
Panthers,1,1,0,0,2,Islanders,1,0,0,0,1,20170111,0,1,1,1,3,-1,2016,0,2,1091,0
Canadiens,3,2,2,0,7,Jets,2,1,1,0,4,20170111,1,2,3,3,11,-3,2016,0,2,1115,0
Penguins,0,0,2,0,2,Capitals,1,1,3,0,5,20170111,1,2,3,3,7,3,2016,0,2,190,0
Sharks,2,0,0,0,2,Flames,1,1,1,0,3,20170111,-1,0,1,1,5,1,2016,0,2,1027,0
Blues,0,1,0,0,1,Kings,2,3,0,0,5,20170112,2,4,4,4,6,4,2016,0,3,1586,0
Devils,1,1,0,0,2,Oilers,0,1,1,1,3,20170112,-1,-1,0,1,5,1,2016,1,3,2016,0
Red Wings,2,0,0,0,2,Stars,1,3,1,0,5,20170112,-1,2,3,3,7,3,2016,0,3,999,0
Ducks,2,1,1,0,4,Avalanche,1,0,0,0,1,20170112,1,2,3,3,5,-3,2016,0,3,830,0
Bruins,0,1,0,0,1,Predators,0,2,0,0,2,20170112,0,1,1,1,3,1,2016,0,3,941,0
Canadiens,0,0,1,0,1,Wild,1,3,3,0,7,20170112,1,4,6,6,8,6,2016,0,3,938,0
Penguins,0,1,0,0,1,Senators,2,1,1,0,4,20170112,2,2,3,3,5,3,2016,0,3,392,0
Sabres,1,0,1,0,2,Lightning,1,2,1,0,4,20170112,0,2,2,2,6,2,2016,0,3,1051,0
Canucks,1,3,0,0,4,Flyers,1,2,1,1,5,20170112,0,-1,0,1,9,1,2016,1,3,2404,0
Maple Leafs,2,1,1,0,4,Rangers,0,1,1,0,2,20170113,2,2,2,2,6,-2,2016,0,4,341,0
Blackhawks,0,0,0,0,0,Capitals,3,1,2,0,6,20170113,3,4,6,6,6,6,2016,0,4,594,0
Islanders,2,1,2,0,5,Panthers,1,0,1,0,2,20170113,1,2,3,3,7,-3,2016,0,4,1091,0
Sabres,1,1,0,0,2,Hurricanes,0,3,2,0,5,20170113,-1,1,3,3,7,3,2016,0,4,491,0
Blue Jackets,0,1,2,0,3,Lightning,1,0,0,0,1,20170113,-1,0,2,2,4,-2,2016,0,4,830,0
Devils,2,0,0,0,2,Flames,0,1,0,0,1,20170113,2,1,1,1,3,-1,2016,0,4,2015,0
Jets,1,0,2,0,3,Coyotes,4,0,0,0,4,20170113,3,3,1,1,7,1,2016,0,4,1365,0
Jets,0,1,1,0,2,Kings,1,0,1,1,3,20170114,1,0,0,1,5,1,2016,1,5,1527,0
Flames,0,1,0,0,1,Oilers,0,1,0,1,2,20170114,0,0,0,1,3,1,2016,1,5,171,0
Blues,0,2,2,0,4,Sharks,0,0,0,0,0,20170114,0,2,4,4,4,-4,2016,0,5,1719,0
Ducks,1,0,2,0,3,Coyotes,0,0,0,0,0,20170114,1,1,3,3,3,-3,2016,0,5,356,0
Rangers,1,2,1,0,4,Canadiens,0,2,3,0,5,20170114,-1,-1,1,1,9,1,2016,0,5,343,0
Blue Jackets,2,0,1,0,3,Panthers,1,2,1,0,4,20170114,-1,1,1,1,7,1,2016,0,5,993,0
Penguins,1,2,0,0,3,Red Wings,0,3,3,0,6,20170114,-1,0,3,3,9,3,2016,0,5,205,0
Maple Leafs,1,1,2,0,4,Senators,0,2,0,0,2,20170114,1,0,2,2,6,-2,2016,0,5,203,0
Flyers,1,2,0,0,3,Bruins,1,4,1,0,6,20170114,0,2,3,3,9,3,2016,0,5,270,0
Islanders,2,1,1,0,4,Hurricanes,1,3,3,0,7,20170114,-1,1,3,3,11,3,2016,0,5,423,0
Predators,0,1,2,0,3,Avalanche,1,1,0,0,2,20170114,-1,-1,1,1,5,-1,2016,0,5,1019,0
Wild,4,0,1,0,5,Stars,1,2,1,0,4,20170114,3,1,1,1,9,-1,2016,0,5,863,0
Flyers,0,0,0,0,0,Capitals,0,1,4,0,5,20170115,0,1,5,5,5,5,2016,0,6,123,0
Wild,0,2,1,0,3,Blackhawks,1,1,0,0,2,20170115,-1,0,1,1,5,-1,2016,0,6,355,0
Devils,0,1,0,1,2,Canucks,0,1,0,0,1,20170115,0,0,0,1,3,-1,2016,1,6,2421,0
Blues,0,1,0,1,2,Ducks,0,0,1,0,1,20170115,0,1,0,1,3,-1,2016,1,6,1586,0
Coyotes,0,1,0,0,1,Oilers,1,2,0,0,3,20170116,1,2,2,2,4,2,2016,0,0,1392,0
Islanders,0,3,1,0,4,Bruins,0,0,0,0,0,20170116,0,3,4,4,4,-4,2016,0,0,190,0
Stars,1,0,0,0,1,Sabres,2,1,1,0,4,20170116,1,2,3,3,5,3,2016,0,0,1197,0
Canadiens,0,0,0,0,0,Red Wings,0,1,0,0,1,20170116,0,1,1,1,1,1,2016,0,0,508,0
Lightning,1,1,0,0,2,Kings,1,0,0,0,1,20170116,0,1,1,1,3,-1,2016,0,0,2149,0
Jets,0,0,2,0,2,Sharks,1,2,2,0,5,20170116,1,3,3,3,7,3,2016,0,0,1496,0
Capitals,2,3,2,0,7,Penguins,0,6,1,1,8,20170116,-2,1,0,1,15,1,2016,1,0,190,0
Lightning,0,1,0,0,1,Ducks,0,1,0,1,2,20170117,0,0,0,1,3,1,2016,1,1,2149,0
Predators,0,0,0,0,0,Canucks,0,0,1,0,1,20170117,0,0,1,1,1,1,2016,0,1,2030,0
Panthers,2,0,0,0,2,Flames,1,3,1,0,5,20170117,-1,2,3,3,7,3,2016,0,1,2493,0
Blackhawks,2,1,3,0,6,Avalanche,1,3,0,0,4,20170117,1,-1,2,2,10,-2,2016,0,1,916,0
Devils,0,1,3,0,4,Wild,1,1,1,0,3,20170117,-1,-1,1,1,7,-1,2016,0,1,1007,0
Sabres,2,0,1,0,3,Maple Leafs,0,3,1,0,4,20170117,-2,1,1,1,7,1,2016,0,1,57,0
Hurricanes,1,0,0,0,1,Blue Jackets,2,2,0,0,4,20170117,1,3,3,3,5,3,2016,0,1,374,0
Stars,3,4,0,0,7,Rangers,1,2,3,0,6,20170117,2,4,1,1,13,-1,2016,0,1,1370,0
Senators,1,2,3,0,6,Blues,1,1,2,0,4,20170117,0,1,2,2,10,-2,2016,0,1,860,0
Sharks,2,1,0,0,3,Kings,1,1,0,0,2,20170118,1,1,1,1,5,-1,2016,0,2,305,0
Panthers,1,1,1,0,3,Oilers,2,0,1,1,4,20170118,1,0,0,1,7,1,2016,1,2,2569,0
Bruins,4,1,0,0,5,Red Wings,1,3,1,1,6,20170118,-3,-1,0,1,11,1,2016,1,2,611,0
Coyotes,2,0,1,0,3,Jets,1,3,2,0,6,20170118,-1,2,3,3,9,3,2016,0,2,1365,0
Penguins,1,2,1,0,4,Canadiens,0,1,0,0,1,20170118,1,2,3,3,5,-3,2016,0,2,474,0
Predators,1,2,1,0,4,Flames,0,0,3,0,3,20170119,1,3,1,1,7,-1,2016,0,3,1692,0
Avalanche,0,1,0,0,1,Ducks,0,0,2,0,2,20170119,0,-1,1,1,3,1,2016,0,3,830,0
Lightning,0,1,0,0,1,Sharks,0,1,1,0,2,20170119,0,0,1,1,3,1,2016,0,3,2365,0
Coyotes,1,2,0,0,3,Wild,2,1,1,0,4,20170119,1,0,1,1,7,1,2016,0,3,1278,0
Stars,0,0,0,0,0,Islanders,1,0,2,0,3,20170119,1,1,3,3,3,3,2016,0,3,1370,0
Rangers,2,1,2,0,5,Maple Leafs,1,1,0,0,2,20170119,1,1,3,3,7,-3,2016,0,3,341,0
Senators,1,1,0,0,2,Blue Jackets,0,0,0,0,0,20170119,1,2,2,2,2,-2,2016,0,3,512,0
Capitals,2,4,1,0,7,Blues,0,1,2,0,3,20170119,2,5,4,4,10,-4,2016,0,3,708,0
Blackhawks,0,0,1,0,1,Bruins,0,0,0,0,0,20170120,0,0,1,1,1,-1,2016,0,4,849,0
Red Wings,1,0,1,0,2,Sabres,0,1,1,1,3,20170120,-1,0,0,1,5,1,2016,1,4,215,0
Penguins,1,4,2,0,7,Hurricanes,0,0,1,0,1,20170120,1,5,6,6,8,-6,2016,0,4,330,0
Canadiens,1,0,2,0,3,Devils,1,0,0,0,1,20170120,0,0,2,2,4,-2,2016,0,4,342,0
Predators,0,1,1,1,3,Oilers,0,1,1,0,2,20170120,0,0,0,1,5,-1,2016,1,4,1758,0
Panthers,0,1,0,0,1,Canucks,0,1,1,0,2,20170120,0,0,1,1,3,1,2016,0,4,2803,0
Avalanche,0,1,1,0,2,Sharks,1,1,0,1,3,20170121,1,1,0,1,5,1,2016,1,5,927,0
Capitals,1,0,2,1,4,Stars,1,2,0,0,3,20170121,0,-2,0,1,7,-1,2016,1,5,1181,0
Oilers,3,3,1,0,7,Flames,0,1,2,0,3,20170121,3,5,4,4,10,-4,2016,0,5,171,0
Ducks,2,1,0,0,3,Wild,1,1,3,0,5,20170121,-1,-1,2,2,8,2,2016,0,5,1521,0
Lightning,1,0,2,0,3,Coyotes,2,3,0,0,5,20170121,1,4,2,2,8,2,2016,0,5,1793,0
Devils,1,2,1,0,4,Flyers,1,0,0,0,1,20170121,0,2,3,3,5,-3,2016,0,5,75,0
Blues,1,0,2,0,3,Jets,1,1,3,0,5,20170121,0,1,2,2,8,2,2016,0,5,853,0
Sabres,0,1,1,1,3,Canadiens,0,2,0,0,2,20170121,0,-1,0,1,5,-1,2016,1,5,311,0
Senators,1,0,1,1,3,Maple Leafs,0,1,1,0,2,20170121,1,0,0,1,5,-1,2016,1,5,203,0
Hurricanes,0,2,0,0,2,Blue Jackets,2,0,1,0,3,20170121,2,0,1,1,5,1,2016,0,5,374,0
Kings,0,0,2,0,2,Islanders,1,1,2,0,4,20170121,1,2,2,2,6,2,2016,0,5,2445,0
Predators,0,1,3,0,4,Wild,2,0,0,0,2,20170122,-2,-1,2,2,6,-2,2016,0,6,696,0
Canucks,0,0,2,0,2,Blackhawks,2,0,2,0,4,20170122,2,2,2,2,6,2,2016,0,6,1775,0
Blue Jackets,2,1,3,1,7,Senators,2,3,1,0,6,20170122,0,-2,0,1,13,-1,2016,1,6,512,0
Flyers,0,1,1,1,3,Islanders,1,1,0,0,2,20170122,-1,-1,0,1,5,-1,2016,1,6,80,0
Rangers,0,0,0,1,1,Red Wings,0,0,0,0,0,20170122,0,0,0,1,1,-1,2016,1,6,480,0
Bruins,0,1,0,0,1,Penguins,0,2,3,0,5,20170122,0,1,4,4,6,4,2016,0,6,481,0
Kings,0,1,1,0,2,Rangers,1,1,1,0,3,20170123,1,1,1,1,5,1,2016,0,0,2445,0
Hurricanes,1,0,0,0,1,Capitals,2,2,2,0,6,20170123,1,3,5,5,7,5,2016,0,0,233,0
Flames,0,0,0,0,0,Maple Leafs,1,2,1,0,4,20170123,1,3,4,4,4,4,2016,0,0,1682,0
Ducks,2,0,1,0,3,Jets,1,0,1,0,2,20170123,1,1,1,1,5,-1,2016,0,0,1527,0
Sharks,1,0,4,0,5,Avalanche,0,1,1,0,2,20170123,1,0,3,3,7,-3,2016,0,0,927,0
Panthers,1,1,0,0,2,Coyotes,0,2,0,1,3,20170123,-1,0,0,1,5,1,2016,1,0,1978,0
Flames,0,0,1,0,1,Canadiens,1,2,2,0,5,20170124,1,3,4,4,6,4,2016,0,1,1852,0
Wild,1,1,0,1,3,Stars,0,2,0,0,2,20170124,1,0,0,1,5,-1,2016,1,1,863,0
Lightning,1,0,4,0,5,Blackhawks,1,1,0,0,2,20170124,0,-1,3,3,7,-3,2016,0,1,1004,0
Sharks,1,1,2,0,4,Jets,1,1,1,0,3,20170124,0,0,1,1,7,-1,2016,0,1,1496,0
Sabres,0,2,2,1,5,Predators,1,1,2,0,4,20170124,-1,0,0,1,9,-1,2016,1,1,626,0
Capitals,0,0,0,0,0,Senators,2,1,0,0,3,20170124,2,3,3,3,3,3,2016,0,1,446,0
Blue Jackets,1,0,1,0,2,Islanders,0,2,2,0,4,20170124,-1,1,2,2,6,2,2016,0,1,476,0
Kings,3,0,0,0,3,Devils,0,0,1,0,1,20170124,3,3,2,2,4,-2,2016,0,1,2436,0
Red Wings,1,2,0,0,3,Bruins,2,0,1,1,4,20170124,1,-1,0,1,7,1,2016,1,1,611,0
Blues,1,1,1,0,3,Penguins,0,0,0,0,0,20170124,1,2,3,3,3,-3,2016,0,1,557,0
Oilers,0,3,1,0,4,Ducks,0,0,0,0,0,20170125,0,3,4,4,4,-4,2016,0,2,1368,0
Maple Leafs,1,1,2,0,4,Red Wings,0,0,0,0,0,20170125,1,2,4,4,4,-4,2016,0,2,205,0
Flyers,0,0,2,0,2,Rangers,0,0,0,0,0,20170125,0,0,2,2,2,-2,2016,0,2,80,0
Canucks,1,1,1,0,3,Avalanche,0,1,1,0,2,20170125,1,1,1,1,5,-1,2016,0,2,1105,0
Jets,2,0,3,0,5,Blackhawks,1,2,0,0,3,20170126,1,-1,2,2,8,-2,2016,0,3,722,0
Sabres,2,1,0,0,3,Stars,1,3,0,0,4,20170126,-1,1,1,1,7,1,2016,0,3,1197,0
Oilers,1,1,2,0,4,Sharks,1,0,0,0,1,20170126,0,1,3,3,5,-3,2016,0,3,1190,0
Blues,0,1,0,0,1,Wild,0,3,2,0,5,20170126,0,2,4,4,6,4,2016,0,3,466,0
Canucks,0,0,0,0,0,Coyotes,0,1,2,0,3,20170126,0,1,3,3,3,3,2016,0,3,1228,0
Lightning,1,0,0,0,1,Panthers,1,0,0,1,2,20170126,0,0,0,1,3,1,2016,1,3,205,0
Blue Jackets,1,0,2,0,3,Predators,0,2,2,0,4,20170126,-1,1,1,1,7,1,2016,0,3,333,0
Kings,0,0,3,0,3,Hurricanes,0,0,0,0,0,20170126,0,0,3,3,3,-3,2016,0,3,2231,0
Maple Leafs,0,1,0,0,1,Flyers,1,0,1,0,2,20170126,1,0,1,1,3,1,2016,0,3,334,0
Canadiens,0,1,0,0,1,Islanders,1,0,2,0,3,20170126,1,0,2,2,4,2,2016,0,3,343,0
Capitals,2,2,1,0,5,Devils,0,2,0,0,2,20170126,2,2,3,3,7,-3,2016,0,3,198,0
Penguins,2,0,1,0,3,Bruins,0,3,1,0,4,20170126,-2,1,1,1,7,1,2016,0,3,481,0
Flames,0,2,0,1,3,Senators,0,0,2,0,2,20170126,0,2,0,1,5,-1,2016,1,3,1773,0
Blackhawks,0,1,0,0,1,Sharks,0,1,2,0,3,20170131,0,0,2,2,4,2,2016,0,1,1837,0
Avalanche,0,1,0,0,1,Ducks,1,1,3,0,5,20170131,1,1,4,4,6,4,2016,0,1,830,0
Kings,1,1,1,0,3,Coyotes,1,1,0,0,2,20170131,0,0,1,1,5,-1,2016,0,1,356,0
Wild,2,2,1,0,5,Oilers,0,2,0,0,2,20170131,2,2,3,3,7,-3,2016,0,1,1083,0
Maple Leafs,1,2,0,0,3,Stars,5,1,0,0,6,20170131,4,3,3,3,9,3,2016,0,1,1201,0
Jets,1,2,2,0,5,Blues,1,1,1,0,3,20170131,0,1,2,2,8,-2,2016,0,1,853,0
Senators,3,1,1,0,5,Panthers,2,2,2,0,6,20170131,-1,0,1,1,11,1,2016,0,1,1370,0
Bruins,0,2,2,0,4,Lightning,0,1,2,0,3,20170131,0,1,1,1,7,-1,2016,0,1,1183,0
Sabres,0,0,2,0,2,Canadiens,1,3,1,0,5,20170131,1,4,3,3,7,3,2016,0,1,311,0
Flyers,0,0,1,0,1,Hurricanes,2,2,1,0,5,20170131,2,4,4,4,6,4,2016,0,1,345,0
Predators,1,0,1,0,2,Penguins,1,3,0,0,4,20170131,0,3,2,2,6,2,2016,0,1,471,0
Blue Jackets,1,4,1,0,6,Rangers,0,0,4,0,4,20170131,1,5,2,2,10,-2,2016,0,1,476,0
Capitals,1,0,1,0,2,Islanders,0,1,2,0,3,20170131,-1,0,1,1,5,1,2016,0,1,204,0
Devils,2,1,1,0,4,Red Wings,0,1,2,0,3,20170131,2,2,1,1,7,-1,2016,0,1,471,0
Bruins,1,1,1,0,3,Capitals,2,1,2,0,5,20170201,1,1,2,2,8,2,2016,0,2,394,0
Wild,0,1,0,0,1,Flames,2,0,3,0,5,20170201,2,1,4,4,6,4,2016,0,2,1043,0
Avalanche,0,0,0,0,0,Kings,3,0,2,0,5,20170201,3,3,5,5,5,5,2016,0,2,830,0
Maple Leafs,1,0,0,0,1,Blues,1,3,1,0,5,20170202,0,3,4,4,6,4,2016,0,3,659,0
Sharks,2,0,2,0,4,Canucks,0,0,1,0,1,20170202,2,2,3,3,5,-3,2016,0,3,821,0
Blackhawks,3,1,0,0,4,Coyotes,0,3,0,0,3,20170202,3,1,1,1,7,-1,2016,0,3,1450,0
Oilers,0,0,0,0,0,Predators,0,2,0,0,2,20170202,0,2,2,2,2,2,2016,0,3,1758,0
Jets,2,2,0,0,4,Stars,2,1,0,0,3,20170202,0,1,1,1,7,-1,2016,0,3,1183,0
Rangers,0,1,0,1,2,Sabres,0,0,1,0,1,20170202,0,1,0,1,3,-1,2016,1,3,292,0
Canadiens,1,0,0,0,1,Flyers,0,1,2,0,3,20170202,-1,0,2,2,4,2,2016,0,3,400,0
Senators,0,2,3,0,5,Lightning,0,1,1,0,2,20170202,0,1,3,3,7,-3,2016,0,3,1251,0
Blue Jackets,0,1,2,0,3,Penguins,2,1,0,1,4,20170203,2,2,0,1,7,1,2016,1,4,161,0
Islanders,2,1,1,0,4,Red Wings,1,3,1,0,5,20170203,-1,1,1,1,9,1,2016,0,4,480,0
Ducks,1,0,0,0,1,Panthers,1,1,0,0,2,20170203,0,1,1,1,3,1,2016,0,4,2335,0
Flames,1,1,1,1,4,Devils,0,3,0,0,3,20170203,1,-1,0,1,7,-1,2016,1,4,2015,0
Oilers,0,1,0,0,1,Hurricanes,1,0,1,0,2,20170203,1,0,1,1,3,1,2016,0,4,2076,0
Devils,1,2,2,0,5,Blue Jackets,0,0,1,0,1,20170204,1,3,4,4,6,-4,2016,0,5,467,0
Coyotes,0,1,1,1,3,Sharks,0,1,1,0,2,20170204,0,0,0,1,5,-1,2016,1,5,614,0
Wild,2,3,1,0,6,Canucks,1,2,0,0,3,20170204,1,2,3,3,9,-3,2016,0,5,1427,0
Blackhawks,0,2,3,0,5,Stars,0,1,2,0,3,20170204,0,1,2,2,8,-2,2016,0,5,802,0
Red Wings,1,0,0,0,1,Predators,0,0,0,0,0,20170204,1,1,1,1,1,-1,2016,0,5,470,0
Penguins,1,2,1,0,4,Blues,0,0,1,0,1,20170204,1,3,3,3,5,-3,2016,0,5,557,0
Hurricanes,1,3,0,1,5,Islanders,1,2,1,0,4,20170204,0,1,0,1,9,-1,2016,1,5,423,0
Maple Leafs,1,3,2,0,6,Bruins,1,2,2,0,5,20170204,0,1,1,1,11,-1,2016,0,5,430,0
Senators,0,0,0,0,0,Sabres,1,1,2,0,4,20170204,1,2,4,4,4,4,2016,0,5,219,0
Jets,1,1,0,0,2,Avalanche,2,1,2,0,5,20170204,1,1,3,3,7,3,2016,0,5,797,0
Kings,0,0,0,1,1,Flyers,0,0,0,0,0,20170204,0,0,0,1,1,-1,2016,1,5,2388,0
Capitals,1,1,1,0,3,Canadiens,1,0,1,0,2,20170204,0,1,1,1,5,-1,2016,0,5,495,0
Ducks,1,0,1,0,2,Lightning,1,1,0,1,3,20170204,0,1,0,1,5,1,2016,1,5,2149,0
Oilers,0,0,0,1,1,Canadiens,0,0,0,0,0,20170205,0,0,0,1,1,-1,2016,1,6,1826,0
Kings,0,0,0,0,0,Capitals,2,2,1,0,5,20170205,2,4,5,5,5,5,2016,0,6,2294,0
Flames,1,0,2,0,3,Rangers,1,0,3,0,4,20170205,0,0,1,1,7,1,2016,0,6,2023,0
Blues,0,1,1,0,2,Flyers,0,0,0,0,0,20170206,0,1,2,2,2,-2,2016,0,0,808,0
Maple Leafs,2,2,1,0,5,Islanders,2,1,2,1,6,20170206,0,-1,0,1,11,1,2016,1,0,341,0
Sabres,0,0,1,0,1,Devils,0,1,1,0,2,20170206,0,1,1,1,3,1,2016,0,0,284,0
Wild,2,1,1,0,4,Jets,0,2,0,0,2,20170207,2,1,2,2,6,-2,2016,0,1,388,0
Blue Jackets,2,0,0,1,3,Red Wings,1,1,0,0,2,20170207,1,0,0,1,5,-1,2016,1,1,163,0
Canadiens,0,0,0,0,0,Avalanche,2,1,1,0,4,20170207,2,3,4,4,4,4,2016,0,1,1618,0
Canucks,1,0,1,0,2,Predators,2,0,2,0,4,20170207,1,1,2,2,6,2,2016,0,1,2030,0
Kings,0,0,0,0,0,Lightning,1,3,1,0,5,20170207,1,4,5,5,5,5,2016,0,1,2149,0
Blues,0,2,4,0,6,Senators,0,0,0,0,0,20170207,0,2,6,6,6,-6,2016,0,1,860,0
Sharks,2,1,1,0,4,Sabres,1,0,3,1,5,20170207,-1,-2,0,1,9,1,2016,1,1,2279,0
Hurricanes,0,0,0,0,0,Capitals,2,0,3,0,5,20170207,2,2,5,5,5,5,2016,0,1,233,0
Flames,0,2,0,1,3,Penguins,0,0,2,0,2,20170207,0,2,0,1,5,-1,2016,1,1,1777,0
Ducks,0,1,0,0,1,Rangers,1,1,2,0,4,20170207,1,1,3,3,5,3,2016,0,1,2445,0
Stars,0,0,1,0,1,Maple Leafs,1,1,1,0,3,20170207,1,2,2,2,4,2,2016,0,1,1201,0
Blackhawks,1,2,0,1,4,Wild,0,2,1,0,3,20170208,1,1,0,1,7,-1,2016,1,2,355,0
Canadiens,2,0,2,1,5,Coyotes,0,3,1,0,4,20170209,2,-1,0,1,9,-1,2016,1,3,2175,0
Penguins,1,2,1,0,4,Avalanche,0,0,1,0,1,20170209,1,3,3,3,5,-3,2016,0,3,1317,0
Kings,3,3,0,0,6,Panthers,1,0,2,0,3,20170209,2,5,3,3,9,-3,2016,0,3,2335,0
Stars,0,2,0,0,2,Senators,2,0,1,0,3,20170209,2,0,1,1,5,1,2016,0,3,1404,0
Blues,1,0,0,1,2,Maple Leafs,0,1,0,0,1,20170209,1,0,0,1,3,-1,2016,1,3,659,0
Canucks,0,2,1,0,3,Blue Jackets,0,0,0,0,0,20170209,0,2,3,3,3,-3,2016,0,3,2050,0
Islanders,1,1,1,0,3,Flyers,1,0,0,0,1,20170209,0,1,2,2,4,-2,2016,0,3,80,0
Predators,1,1,1,0,3,Rangers,0,2,2,0,4,20170209,-1,0,1,1,7,1,2016,0,3,758,0
Ducks,1,0,4,0,5,Sabres,0,1,1,0,2,20170209,1,0,3,3,7,-3,2016,0,3,2193,0
Sharks,1,1,1,0,3,Bruins,3,2,1,0,6,20170209,2,3,3,3,9,3,2016,0,3,2678,0
Red Wings,2,0,1,0,3,Capitals,2,1,3,0,6,20170209,0,1,3,3,9,3,2016,0,3,394,0
Blackhawks,1,1,3,0,5,Jets,0,1,1,0,2,20170210,1,1,3,3,7,-3,2016,0,4,722,0
Lightning,0,1,0,0,1,Wild,0,1,0,1,2,20170210,0,0,0,1,3,1,2016,1,4,1318,0
Avalanche,1,1,0,0,2,Rangers,1,0,3,0,4,20170211,0,-1,2,2,6,2,2016,0,5,1627,0
Lightning,2,1,1,0,4,Jets,0,0,1,0,1,20170211,2,3,3,3,5,-3,2016,0,5,1705,0
Penguins,0,1,2,0,3,Coyotes,0,2,1,1,4,20170211,0,1,0,1,7,1,2016,1,5,1824,0
Blues,1,2,1,0,4,Canadiens,1,1,0,0,2,20170211,0,1,2,2,6,-2,2016,0,5,962,0
Ducks,0,2,2,0,4,Capitals,3,1,2,0,6,20170211,3,2,2,2,10,2,2016,0,5,2294,0
Sabres,3,0,0,0,3,Maple Leafs,0,1,0,0,1,20170211,3,2,2,2,4,-2,2016,0,5,57,0
Blackhawks,2,2,1,0,5,Oilers,1,0,0,0,1,20170211,1,3,4,4,6,-4,2016,0,5,1437,0
Hurricanes,0,1,1,0,2,Stars,3,1,1,0,5,20170211,3,3,3,3,7,3,2016,0,5,1055,0
Panthers,1,4,2,0,7,Predators,1,2,1,0,4,20170211,0,2,3,3,11,-3,2016,0,5,816,0
Sharks,0,0,1,0,1,Flyers,0,0,1,1,2,20170211,0,0,0,1,3,1,2016,1,5,2499,0
Islanders,0,0,0,0,0,Senators,1,2,0,0,3,20170211,1,3,3,3,3,3,2016,0,5,334,0
Canucks,1,1,1,0,3,Bruins,2,0,2,0,4,20170211,1,0,1,1,7,1,2016,0,5,2504,0
Red Wings,1,0,0,0,1,Blue Jackets,1,1,0,0,2,20170211,0,1,1,1,3,1,2016,0,5,163,0
Sharks,0,3,1,0,4,Devils,1,0,0,0,1,20170212,-1,2,3,3,5,-3,2016,0,6,2540,0
Red Wings,0,2,1,0,3,Wild,2,1,3,0,6,20170212,2,1,3,3,9,3,2016,0,6,542,0
Avalanche,1,0,0,0,1,Islanders,1,1,3,0,5,20170212,0,1,4,4,6,4,2016,0,6,1627,0
Stars,2,1,0,0,3,Predators,0,1,4,0,5,20170212,-2,-2,2,2,8,2,2016,0,6,616,0
Canadiens,0,0,0,0,0,Bruins,1,2,1,0,4,20170212,1,3,4,4,4,4,2016,0,6,270,0
Canucks,2,2,0,0,4,Sabres,2,0,0,0,2,20170212,0,2,2,2,6,-2,2016,0,6,2137,0
Rangers,0,1,2,0,3,Blue Jackets,1,0,1,0,2,20170213,-1,0,1,1,5,-1,2016,0,0,476,0
Coyotes,1,3,1,0,5,Flames,0,0,0,0,0,20170213,1,4,5,5,5,-5,2016,0,0,1224,0
Avalanche,0,2,0,0,2,Devils,1,2,0,0,3,20170214,1,1,1,1,5,1,2016,0,1,1618,0
Canucks,0,0,0,0,0,Penguins,0,1,3,0,4,20170214,0,1,4,4,4,4,2016,0,1,2168,0
Islanders,0,1,0,0,1,Maple Leafs,2,1,4,0,7,20170214,2,2,6,6,8,6,2016,0,1,341,0
Sabres,1,0,2,0,3,Senators,1,1,0,0,2,20170214,0,-1,1,1,5,-1,2016,0,1,219,0
Ducks,1,0,0,0,1,Wild,0,0,0,0,0,20170214,1,1,1,1,1,-1,2016,0,1,1521,0
Stars,0,2,0,0,2,Jets,1,1,3,0,5,20170214,1,0,3,3,7,3,2016,0,1,1183,0
Coyotes,1,1,0,0,2,Oilers,0,3,2,0,5,20170214,-1,1,3,3,7,3,2016,0,1,1392,0
Maple Leafs,0,1,1,0,2,Blue Jackets,2,2,1,0,5,20170215,2,3,3,3,7,3,2016,0,2,313,0
Blues,1,0,1,0,2,Red Wings,0,0,0,0,0,20170215,1,1,2,2,2,-2,2016,0,2,454,0
Flyers,1,0,0,0,1,Flames,1,1,1,0,3,20170215,0,1,2,2,4,2,2016,0,2,2003,0
Panthers,3,0,2,1,6,Sharks,2,1,2,0,5,20170215,1,0,0,1,11,-1,2016,1,2,2558,0
Stars,0,0,1,0,1,Wild,1,1,1,0,3,20170216,1,2,2,2,4,2,2016,0,3,863,0
Coyotes,2,0,3,0,5,Kings,0,0,3,0,3,20170216,2,2,2,2,8,-2,2016,0,3,356,0
Flyers,0,2,1,0,3,Oilers,2,3,1,0,6,20170216,2,3,3,3,9,3,2016,0,3,2011,0
Canucks,1,1,1,0,3,Blues,2,0,2,0,4,20170216,1,0,1,1,7,1,2016,0,3,1778,0
Senators,0,1,2,0,3,Devils,0,0,0,0,0,20170216,0,1,3,3,3,-3,2016,0,3,330,0
Jets,0,1,2,0,3,Penguins,2,0,1,1,4,20170216,2,1,0,1,7,1,2016,1,3,1060,0
Rangers,1,0,1,0,2,Islanders,0,2,2,0,4,20170216,-1,1,2,2,6,2,2016,0,3,0,0
Avalanche,0,0,0,0,0,Sabres,0,1,1,0,2,20170216,0,1,2,2,2,2,2016,0,3,1366,0
Penguins,0,1,0,0,1,Blue Jackets,0,1,0,1,2,20170217,0,0,0,1,3,1,2016,1,4,161,0
Avalanche,1,0,0,1,2,Hurricanes,1,0,0,0,1,20170217,0,0,0,1,3,-1,2016,1,4,1459,0
Panthers,0,3,1,0,4,Ducks,0,1,0,0,1,20170217,0,2,3,3,5,-3,2016,0,4,2335,0
Panthers,1,1,1,0,3,Kings,0,2,0,0,2,20170218,1,0,1,1,5,-1,2016,0,5,2335,0
Flames,0,0,1,0,1,Canucks,1,0,0,1,2,20170218,1,1,0,1,3,1,2016,1,5,426,0
Sharks,2,1,1,0,4,Coyotes,0,0,1,0,1,20170218,2,3,3,3,5,-3,2016,0,5,614,0
Predators,0,0,2,0,2,Wild,1,1,3,0,5,20170218,1,2,3,3,7,3,2016,0,5,696,0
Lightning,2,1,0,0,3,Stars,2,0,1,1,4,20170218,0,-1,0,1,7,1,2016,1,5,916,0
Oilers,0,1,2,0,3,Blackhawks,0,0,1,0,1,20170218,0,1,2,2,4,-2,2016,0,5,1437,0
Islanders,0,0,2,0,2,Devils,1,1,1,0,3,20170218,1,2,1,1,5,1,2016,0,5,8,0
Capitals,0,1,1,0,2,Red Wings,1,1,0,1,3,20170218,1,1,0,1,5,1,2016,1,5,394,0
Jets,0,1,2,0,3,Canadiens,1,0,0,0,1,20170218,-1,0,2,2,4,-2,2016,0,5,1115,0
Blues,1,0,1,0,2,Sabres,1,2,0,0,3,20170218,0,2,1,1,5,1,2016,0,5,660,0
Senators,2,0,4,0,6,Maple Leafs,0,2,1,0,3,20170218,2,0,3,3,9,-3,2016,0,5,203,0
Maple Leafs,0,2,2,0,4,Hurricanes,0,0,0,0,0,20170219,0,2,4,4,4,-4,2016,0,6,544,0
Flyers,1,2,0,0,3,Canucks,0,2,0,0,2,20170219,1,1,1,1,5,-1,2016,0,6,2404,0
Kings,0,0,0,0,0,Ducks,0,1,0,0,1,20170219,0,1,1,1,1,1,2016,0,6,0,0
Bruins,1,0,0,1,2,Sharks,0,1,0,0,1,20170219,1,0,0,1,3,-1,2016,1,6,2678,0
Lightning,1,1,0,1,3,Avalanche,0,0,2,0,2,20170219,1,2,0,1,5,-1,2016,1,6,1521,0
Predators,1,2,1,0,4,Blue Jackets,0,2,1,0,3,20170219,1,1,1,1,7,-1,2016,0,6,333,0
Jets,2,0,1,0,3,Senators,0,1,1,0,2,20170219,2,1,1,1,5,-1,2016,0,6,1033,0
Blackhawks,1,2,2,0,5,Sabres,1,0,0,0,1,20170219,0,2,4,4,6,-4,2016,0,6,453,0
Capitals,0,1,0,0,1,Rangers,1,0,1,0,2,20170219,1,0,1,1,3,1,2016,0,6,204,0
Devils,1,2,1,0,4,Islanders,1,3,2,0,6,20170219,0,1,2,2,10,2,2016,0,6,8,0
Red Wings,2,0,3,0,5,Penguins,1,0,1,0,2,20170219,1,1,3,3,7,-3,2016,0,6,205,0
Panthers,1,0,1,0,2,Blues,0,0,1,0,1,20170220,1,1,1,1,3,-1,2016,0,0,1061,0
Ducks,0,1,1,0,2,Coyotes,3,0,0,0,3,20170220,3,2,1,1,5,1,2016,0,0,356,0
Senators,0,1,1,0,2,Devils,0,0,1,0,1,20170221,0,1,1,1,3,-1,2016,0,1,330,0
Canadiens,1,1,0,1,3,Rangers,1,1,0,0,2,20170221,0,0,0,1,5,-1,2016,1,1,343,0
Penguins,1,1,1,0,3,Hurricanes,1,0,0,0,1,20170221,0,1,2,2,4,-2,2016,0,1,330,0
Jets,2,2,0,0,4,Maple Leafs,1,2,1,1,5,20170221,-1,-1,0,1,9,1,2016,1,1,946,0
Islanders,1,1,1,0,3,Red Wings,1,0,0,0,1,20170221,0,1,2,2,4,-2,2016,0,1,480,0
Oilers,0,1,0,0,1,Lightning,1,1,2,0,4,20170221,1,1,3,3,5,3,2016,0,1,2367,0
Flames,3,1,1,1,6,Predators,1,4,0,0,5,20170221,2,-1,0,1,11,-1,2016,1,1,1692,0
Blackhawks,0,2,3,0,5,Wild,0,1,2,0,3,20170221,0,1,2,2,8,-2,2016,0,1,355,0
Kings,0,2,0,0,2,Avalanche,0,1,0,0,1,20170221,0,1,1,1,3,-1,2016,0,1,830,0
Bruins,1,1,1,0,3,Ducks,0,3,2,0,5,20170222,-1,1,2,2,8,2,2016,0,2,2590,0
Capitals,2,1,1,0,4,Flyers,0,1,0,0,1,20170222,2,2,3,3,5,-3,2016,0,2,123,0
Oilers,1,2,1,0,4,Panthers,0,3,0,0,3,20170222,1,0,1,1,7,-1,2016,0,2,2569,0
Rangers,0,0,1,1,2,Maple Leafs,1,0,0,0,1,20170223,-1,-1,0,1,3,-1,2016,1,3,341,0
Islanders,1,1,1,0,3,Canadiens,0,0,0,0,0,20170223,1,2,3,3,3,-3,2016,0,3,343,0
Flames,0,2,1,0,3,Lightning,1,0,1,0,2,20170223,-1,1,1,1,5,-1,2016,0,3,2289,0
Avalanche,1,1,0,0,2,Predators,1,2,1,0,4,20170223,0,1,2,2,6,2,2016,0,3,1019,0
Coyotes,3,0,0,0,3,Blackhawks,3,2,1,0,6,20170223,0,2,3,3,9,3,2016,0,3,1450,0
Bruins,1,1,2,0,4,Kings,1,0,0,0,1,20170223,0,1,3,3,5,-3,2016,0,3,2590,0
Oilers,0,1,0,0,1,Capitals,1,0,1,0,2,20170224,1,0,1,1,3,1,2016,0,4,1985,0
Flames,3,1,0,0,4,Panthers,2,0,0,0,2,20170224,1,2,2,2,6,-2,2016,0,4,2493,0
Senators,0,0,0,0,0,Hurricanes,1,2,0,0,3,20170224,1,3,3,3,3,3,2016,0,4,673,0
Coyotes,1,1,0,0,2,Stars,1,1,3,0,5,20170224,0,0,3,3,7,3,2016,0,4,884,0
Flyers,0,1,1,0,2,Penguins,1,1,2,0,4,20170225,1,1,2,2,6,2,2016,0,5,257,0
Sharks,0,2,2,0,4,Canucks,0,1,0,0,1,20170225,0,1,3,3,5,-3,2016,0,5,821,0
Sabres,1,2,0,0,3,Avalanche,3,1,1,0,5,20170225,2,1,2,2,8,2,2016,0,5,1366,0
Canadiens,0,2,0,1,3,Maple Leafs,1,0,1,0,2,20170225,-1,1,0,1,5,-1,2016,1,5,303,0
Islanders,0,0,0,0,0,Blue Jackets,3,2,2,0,7,20170225,3,5,7,7,7,7,2016,0,5,476,0
Capitals,1,0,1,0,2,Predators,0,3,2,0,5,20170225,-1,2,3,3,7,3,2016,0,5,566,0
Rangers,2,0,1,1,4,Devils,0,1,2,0,3,20170225,2,1,0,1,7,-1,2016,1,5,8,0
Ducks,1,0,0,0,1,Kings,0,0,4,0,4,20170225,-1,-1,3,3,5,3,2016,0,5,0,0
Sabres,1,1,0,0,2,Coyotes,0,0,3,0,3,20170226,-1,-2,1,1,5,1,2016,0,6,1902,0
Senators,1,1,0,0,2,Panthers,1,0,0,0,1,20170226,0,1,1,1,3,-1,2016,0,6,1370,0
Oilers,1,3,0,0,4,Predators,2,2,1,0,5,20170226,1,0,1,1,9,1,2016,0,6,1758,0
Blues,1,1,0,0,2,Blackhawks,2,0,2,0,4,20170226,1,0,2,2,6,2,2016,0,6,260,0
Flames,0,2,1,0,3,Hurricanes,1,0,0,0,1,20170226,-1,1,2,2,4,-2,2016,0,6,2038,0
Bruins,2,2,2,0,6,Stars,0,2,1,0,3,20170226,2,2,3,3,9,-3,2016,0,6,1548,0
Blue Jackets,2,1,2,0,5,Rangers,1,0,1,0,2,20170226,1,2,3,3,7,-3,2016,0,6,476,0
Canadiens,0,0,3,1,4,Devils,1,0,2,0,3,20170227,-1,-1,0,1,7,-1,2016,1,0,342,0
Senators,1,0,0,0,1,Lightning,0,4,1,0,5,20170227,-1,3,4,4,6,4,2016,0,0,1251,0
Kings,2,1,1,0,4,Wild,1,2,1,1,5,20170227,-1,0,0,1,9,1,2016,1,0,1521,0
Wild,3,2,1,0,6,Jets,1,2,2,0,5,20170228,2,2,1,1,11,-1,2016,0,1,388,0
Maple Leafs,0,1,0,0,1,Sharks,0,1,2,0,3,20170228,0,0,2,2,4,2,2016,0,1,2249,0
Red Wings,2,0,0,1,3,Canucks,0,1,1,0,2,20170228,2,1,0,1,5,-1,2016,1,1,1967,0
Kings,1,0,0,0,1,Flames,0,1,0,1,2,20170228,-1,0,0,1,3,1,2016,1,1,1197,0
Penguins,1,1,0,0,2,Stars,0,0,3,0,3,20170228,-1,-2,1,1,5,1,2016,0,1,1069,0
Oilers,1,1,0,0,2,Blues,1,0,0,0,1,20170228,0,1,1,1,3,-1,2016,0,1,1508,0
Predators,1,1,2,1,5,Sabres,2,1,1,0,4,20170228,-1,-1,0,1,9,-1,2016,1,1,626,0
Blue Jackets,0,0,0,0,0,Canadiens,0,0,0,1,1,20170228,0,0,0,1,1,1,2016,1,1,605,0
Avalanche,0,0,0,0,0,Flyers,3,1,0,0,4,20170228,3,4,4,4,4,4,2016,0,1,1574,0
Capitals,0,2,2,0,4,Rangers,1,0,0,0,1,20170228,-1,1,3,3,5,-3,2016,0,1,204,0
Coyotes,0,1,0,0,1,Bruins,1,3,0,0,4,20170228,1,3,3,3,5,3,2016,0,1,2295,0
Hurricanes,0,1,1,0,2,Panthers,2,0,0,1,3,20170228,2,1,0,1,5,1,2016,1,1,696,0
Hurricanes,2,0,1,0,3,Lightning,1,0,2,1,4,20170301,-1,-1,0,1,7,1,2016,1,2,585,0
Penguins,0,1,0,0,1,Blackhawks,0,2,2,0,4,20170301,0,1,3,3,5,3,2016,0,2,409,0
Predators,1,0,0,0,1,Canadiens,0,0,2,0,2,20170302,-1,-1,1,1,3,1,2016,0,3,937,0
Maple Leafs,1,1,0,0,2,Kings,0,0,2,1,3,20170302,-1,-2,0,1,5,1,2016,1,3,2170,0
Islanders,1,1,3,0,5,Stars,1,2,1,0,4,20170302,0,-1,1,1,9,-1,2016,0,3,1370,0
Avalanche,0,0,1,0,1,Senators,1,1,0,0,2,20170302,1,2,1,1,3,1,2016,0,3,1515,0
Canucks,1,0,0,0,1,Sharks,1,2,0,0,3,20170302,0,2,2,2,4,2,2016,0,3,821,0
Devils,0,0,0,0,0,Capitals,0,0,1,0,1,20170302,0,0,1,1,1,1,2016,0,3,198,0
Panthers,0,1,0,0,1,Flyers,0,0,1,1,2,20170302,0,-1,0,1,3,1,2016,1,3,1021,0
Coyotes,1,1,1,0,3,Sabres,1,2,3,0,6,20170302,0,1,3,3,9,3,2016,0,3,1902,0
Rangers,0,0,2,0,2,Bruins,0,0,1,0,1,20170302,0,0,1,1,3,-1,2016,0,3,190,0
Wild,0,0,0,0,0,Blue Jackets,0,0,1,0,1,20170302,0,0,1,1,1,1,2016,0,3,626,0
Lightning,0,1,1,0,2,Penguins,0,2,3,0,5,20170303,0,1,3,3,7,3,2016,0,4,874,0
Coyotes,2,0,2,0,4,Hurricanes,1,1,0,0,2,20170303,1,0,2,2,6,-2,2016,0,4,1898,0
Blues,0,0,0,0,0,Jets,1,0,2,0,3,20170303,1,1,3,3,3,3,2016,0,4,853,0
Islanders,0,1,0,0,1,Blackhawks,0,0,1,1,2,20170303,0,-1,0,1,3,1,2016,1,4,711,0
Red Wings,1,0,1,0,2,Flames,2,0,0,1,3,20170303,1,1,0,1,5,1,2016,1,4,1573,0
Maple Leafs,1,1,0,0,2,Ducks,1,2,2,0,5,20170303,0,1,3,3,7,3,2016,0,4,2170,0
Canucks,2,2,0,0,4,Kings,0,1,2,0,3,20170304,2,3,1,1,7,-1,2016,0,5,1076,0
Red Wings,1,0,2,0,3,Oilers,2,0,2,0,4,20170304,1,1,1,1,7,1,2016,0,5,1592,0
Blackhawks,1,2,2,0,5,Predators,0,2,1,0,3,20170304,1,1,2,2,8,-2,2016,0,5,395,0
Flyers,0,0,1,0,1,Capitals,0,0,1,1,2,20170304,0,0,0,1,3,1,2016,1,5,123,0
Avalanche,0,0,1,0,1,Jets,3,2,1,0,6,20170304,3,5,5,5,7,5,2016,0,5,797,0
Stars,1,0,1,0,2,Panthers,1,0,0,0,1,20170304,0,0,1,1,3,-1,2016,0,5,1110,0
Blue Jackets,1,0,1,0,2,Senators,1,1,1,0,3,20170304,0,1,1,1,5,1,2016,0,5,512,0
Lightning,0,1,0,1,2,Sabres,1,0,0,0,1,20170304,-1,0,0,1,3,-1,2016,1,5,1051,0
Devils,0,1,1,0,2,Bruins,0,2,1,0,3,20170304,0,1,1,1,5,1,2016,0,5,196,0
Canadiens,1,2,1,0,4,Rangers,0,0,1,0,1,20170304,1,3,3,3,5,-3,2016,0,5,343,0
Hurricanes,0,1,1,0,2,Coyotes,0,1,0,0,1,20170305,0,0,1,1,3,-1,2016,0,6,1898,0
Islanders,0,1,1,0,2,Flames,4,0,1,0,5,20170305,4,3,3,3,7,3,2016,0,6,2023,0
Blue Jackets,0,2,1,0,3,Devils,0,0,0,0,0,20170305,0,2,3,3,3,-3,2016,0,6,467,0
Sabres,3,0,0,0,3,Penguins,0,2,2,0,4,20170305,-3,-1,1,1,7,1,2016,0,6,178,0
Sharks,1,0,0,0,1,Wild,2,0,1,0,3,20170305,1,1,2,2,4,2,2016,0,6,1570,0
Blues,2,1,0,0,3,Avalanche,0,0,0,0,0,20170305,2,3,3,3,3,-3,2016,0,6,794,0
Canucks,1,1,0,0,2,Ducks,0,0,1,0,1,20170305,1,2,1,1,3,-1,2016,0,6,1076,0
Rangers,0,0,0,1,1,Lightning,0,0,0,0,0,20170306,0,0,0,1,1,-1,2016,1,0,1004,0
Bruins,1,0,1,0,2,Senators,2,0,2,0,4,20170306,1,1,2,2,6,2,2016,0,0,320,0
Sharks,1,0,2,0,3,Jets,1,0,1,0,2,20170306,0,0,1,1,5,-1,2016,0,0,1496,0
Stars,1,2,1,0,4,Capitals,0,1,1,0,2,20170306,1,2,2,2,6,-2,2016,0,0,1181,0
Canadiens,1,0,0,1,2,Canucks,0,0,1,0,1,20170307,1,1,0,1,3,-1,2016,1,1,2273,0
Devils,0,0,0,0,0,Blue Jackets,0,0,2,0,2,20170307,0,0,2,2,2,2,2016,0,1,467,0
Flyers,1,3,2,0,6,Sabres,1,1,1,0,3,20170307,0,2,3,3,9,-3,2016,0,1,279,0
Red Wings,0,1,1,0,2,Maple Leafs,2,1,0,0,3,20170307,2,2,1,1,5,1,2016,0,1,205,0
Rangers,2,2,1,0,5,Panthers,0,1,1,0,2,20170307,2,3,3,3,7,-3,2016,0,1,1091,0
Blues,1,0,1,0,2,Wild,0,0,1,0,1,20170307,1,1,1,1,3,-1,2016,0,1,466,0
Hurricanes,1,0,0,0,1,Avalanche,0,2,1,0,3,20170307,-1,1,2,2,4,2,2016,0,1,1459,0
Islanders,1,1,2,0,4,Oilers,0,1,0,0,1,20170307,1,1,3,3,5,-3,2016,0,1,2024,0
Predators,2,1,0,0,3,Ducks,1,2,0,1,4,20170307,-1,0,0,1,7,1,2016,1,1,1776,0
Red Wings,0,1,0,0,1,Bruins,4,1,1,0,6,20170308,4,4,5,5,7,5,2016,0,2,611,0
Senators,2,2,1,0,5,Stars,0,1,1,0,2,20170308,2,3,3,3,7,-3,2016,0,2,1404,0
Penguins,2,4,1,0,7,Jets,3,0,1,0,4,20170308,-1,3,3,3,11,-3,2016,0,2,1060,0
Islanders,1,2,0,1,4,Canucks,0,2,1,0,3,20170309,1,1,0,1,7,-1,2016,1,3,2429,0
Wild,0,0,1,0,1,Lightning,2,1,1,0,4,20170309,2,3,3,3,5,3,2016,0,3,1318,0
Senators,0,1,1,1,3,Coyotes,0,2,0,0,2,20170309,0,-1,0,1,5,-1,2016,1,3,2071,0
Capitals,1,1,0,0,2,Sharks,1,2,1,0,4,20170309,0,1,2,2,6,2,2016,0,3,2416,0
Predators,1,0,1,0,2,Kings,0,1,1,1,3,20170309,-1,0,0,1,5,1,2016,1,3,1776,0
Canadiens,0,0,0,0,0,Flames,1,3,1,0,5,20170309,1,4,5,5,5,5,2016,0,3,1852,0
Rangers,1,2,0,0,3,Hurricanes,2,0,2,0,4,20170309,1,-1,1,1,7,1,2016,0,3,423,0
Ducks,0,1,0,0,1,Blackhawks,0,0,0,0,0,20170309,0,1,1,1,1,-1,2016,0,3,1741,0
Flyers,1,0,1,0,2,Maple Leafs,1,1,2,0,4,20170309,0,1,2,2,6,2,2016,0,3,334,0
Devils,0,0,2,0,2,Avalanche,0,1,2,0,3,20170309,0,1,1,1,5,1,2016,0,3,1618,0
Penguins,2,0,0,1,3,Oilers,0,1,1,0,2,20170310,2,1,0,1,5,-1,2016,1,4,1797,0
Sabres,1,1,1,0,3,Blue Jackets,2,1,1,0,4,20170310,1,1,1,1,7,1,2016,0,4,293,0
Blackhawks,1,1,0,0,2,Red Wings,2,1,1,0,4,20170310,1,1,2,2,6,2,2016,0,4,238,0
Wild,1,2,4,0,7,Panthers,2,1,1,0,4,20170310,-1,0,3,3,11,-3,2016,0,4,1513,0
Ducks,2,0,1,0,3,Blues,1,1,2,0,4,20170310,-1,0,1,1,7,1,2016,0,4,1586,0
Islanders,0,1,2,0,3,Blues,1,3,0,0,4,20170311,1,3,1,1,7,1,2016,0,5,871,0
Devils,0,2,2,0,4,Coyotes,3,1,1,0,5,20170311,3,2,1,1,9,1,2016,0,5,2131,0
Capitals,1,1,0,0,2,Kings,1,1,2,0,4,20170311,0,0,2,2,6,2,2016,0,5,2294,0
Senators,0,3,1,0,4,Avalanche,1,0,1,0,2,20170311,-1,2,2,2,6,-2,2016,0,5,1515,0
Penguins,0,1,2,0,3,Canucks,0,0,0,0,0,20170311,0,1,3,3,3,-3,2016,0,5,2168,0
Flames,1,1,1,0,3,Jets,0,0,0,0,0,20170311,1,2,3,3,3,-3,2016,0,5,740,0
Maple Leafs,1,1,0,1,3,Hurricanes,1,1,0,0,2,20170311,0,0,0,1,5,-1,2016,1,5,544,0
Panthers,2,0,0,0,2,Lightning,0,2,1,0,3,20170311,-2,0,1,1,5,1,2016,0,5,205,0
Blue Jackets,3,0,0,0,3,Sabres,0,3,2,0,5,20170311,-3,0,2,2,8,2,2016,0,5,293,0
Predators,1,1,1,0,3,Sharks,1,0,0,0,1,20170311,0,1,2,2,4,-2,2016,0,5,1934,0
Flyers,0,1,0,0,1,Bruins,1,0,1,0,2,20170311,1,0,1,1,3,1,2016,0,5,270,0
Wild,1,0,1,0,2,Blackhawks,2,1,1,0,4,20170312,1,2,2,2,6,2,2016,0,6,355,0
Rangers,1,2,1,0,4,Red Wings,0,1,0,0,1,20170312,1,2,3,3,5,-3,2016,0,6,480,0
Canadiens,0,0,4,0,4,Oilers,0,1,0,0,1,20170312,0,-1,3,3,5,-3,2016,0,6,1826,0
Capitals,0,1,1,0,2,Ducks,0,3,2,0,5,20170312,0,2,3,3,7,3,2016,0,6,2294,0
Stars,1,0,0,0,1,Sharks,2,2,1,0,5,20170312,1,3,4,4,6,4,2016,0,6,1449,0
Blues,0,1,2,0,3,Kings,0,0,1,0,1,20170313,0,1,2,2,4,-2,2016,0,0,1586,0
Avalanche,0,0,0,0,0,Coyotes,0,1,0,0,1,20170313,0,1,1,1,1,1,2016,0,0,585,0
Bruins,1,1,4,0,6,Canucks,2,1,0,0,3,20170313,-1,-1,3,3,9,-3,2016,0,0,2504,0
Penguins,2,0,1,0,3,Flames,1,1,1,1,4,20170313,-1,0,0,1,7,1,2016,1,0,1777,0
Lightning,1,1,1,0,3,Rangers,1,1,0,0,2,20170313,0,0,1,1,5,-1,2016,0,0,1004,0
Hurricanes,2,4,2,0,8,Islanders,2,2,0,0,4,20170313,0,2,4,4,12,-4,2016,0,0,423,0
Blue Jackets,2,1,2,0,5,Flyers,1,2,0,0,3,20170313,1,0,2,2,8,-2,2016,0,0,414,0
Jets,2,2,0,0,4,Predators,2,1,1,1,5,20170313,0,-1,0,1,9,1,2016,1,0,1084,0
Stars,0,1,0,0,1,Oilers,2,3,2,0,7,20170314,2,4,6,6,8,6,2016,0,1,1655,0
Sabres,1,0,0,0,1,Sharks,0,2,2,0,4,20170314,-1,1,3,3,5,3,2016,0,1,2279,0
Coyotes,0,0,2,1,3,Kings,0,1,1,0,2,20170314,0,-1,0,1,5,-1,2016,1,1,356,0
Maple Leafs,1,1,0,0,2,Panthers,3,3,1,0,7,20170314,2,4,5,5,9,5,2016,0,1,1234,0
Lightning,1,0,0,1,2,Senators,0,1,0,0,1,20170314,1,0,0,1,3,-1,2016,1,1,1251,0
Blackhawks,1,1,2,0,4,Canadiens,0,0,2,0,2,20170314,1,2,2,2,6,-2,2016,0,1,732,0
Islanders,0,2,0,1,3,Hurricanes,1,1,0,0,2,20170314,-1,0,0,1,5,-1,2016,1,1,423,0
Wild,0,0,2,0,2,Capitals,1,2,1,0,4,20170314,1,3,2,2,6,2,2016,0,1,931,0
Penguins,0,0,0,0,0,Flyers,0,2,2,0,4,20170315,0,2,4,4,4,4,2016,0,2,257,0
Bruins,1,2,2,0,5,Flames,1,1,0,0,2,20170315,0,1,3,3,7,-3,2016,0,2,2089,0
Red Wings,1,0,0,0,1,Avalanche,0,1,2,0,3,20170315,-1,0,2,2,4,2,2016,0,2,1154,0
Blues,0,0,1,0,1,Ducks,1,1,0,0,2,20170315,1,2,1,1,3,1,2016,0,2,1586,0
Sabres,0,0,0,0,0,Kings,0,0,2,0,2,20170316,0,0,2,2,2,2,2016,0,3,2193,0
Red Wings,1,1,2,1,5,Coyotes,0,2,2,0,4,20170316,1,0,0,1,9,-1,2016,1,3,1687,0
Stars,2,0,2,0,4,Canucks,1,1,0,0,2,20170316,1,0,2,2,6,-2,2016,0,3,1766,0
Bruins,2,2,0,0,4,Oilers,4,3,0,0,7,20170316,2,3,3,3,11,3,2016,0,3,2074,0
Maple Leafs,1,4,0,0,5,Lightning,0,0,0,0,0,20170316,1,5,5,5,5,-5,2016,0,3,1096,0
Blackhawks,0,0,2,0,2,Senators,0,0,1,0,1,20170316,0,0,1,1,3,-1,2016,0,3,628,0
Predators,0,1,0,1,2,Capitals,1,0,0,0,1,20170316,-1,0,0,1,3,-1,2016,1,3,566,0
Wild,1,0,0,0,1,Hurricanes,1,0,2,0,3,20170316,0,0,2,2,4,2,2016,0,3,995,0
Blues,1,1,2,0,4,Sharks,1,0,0,0,1,20170316,0,1,3,3,5,-3,2016,0,3,1719,0
Jets,2,2,0,0,4,Islanders,1,0,1,0,2,20170316,1,3,2,2,6,-2,2016,0,3,1287,0
Flyers,1,1,0,0,2,Devils,1,2,3,0,6,20170316,0,1,4,4,8,4,2016,0,3,75,0
Panthers,1,0,0,0,1,Blue Jackets,0,2,0,0,2,20170316,-1,1,1,1,3,1,2016,0,3,993,0
Sabres,0,1,0,1,2,Ducks,1,0,0,0,1,20170317,-1,0,0,1,3,-1,2016,1,4,2193,0
Stars,0,0,1,0,1,Flames,1,2,0,0,3,20170317,1,3,2,2,4,2,2016,0,4,1536,0
Devils,2,1,1,0,4,Penguins,3,1,2,0,6,20170317,1,1,2,2,10,2,2016,0,4,306,0
Panthers,0,2,1,1,4,Rangers,2,0,1,0,3,20170317,-2,0,0,1,7,-1,2016,1,4,1091,0
Ducks,1,1,0,0,2,Sharks,1,0,0,0,1,20170318,0,1,1,1,3,-1,2016,0,5,305,0
Canucks,0,0,0,0,0,Oilers,0,1,1,0,2,20170318,0,1,2,2,2,2,2016,0,5,514,0
Rangers,1,2,0,0,3,Wild,1,0,1,0,2,20170318,0,2,1,1,5,-1,2016,0,5,1016,0
Predators,0,1,1,0,2,Hurricanes,2,1,1,0,4,20170318,2,2,2,2,6,2,2016,0,5,456,0
Capitals,2,0,3,0,5,Lightning,2,0,1,0,3,20170318,0,0,2,2,8,-2,2016,0,5,818,0
Blues,1,1,1,0,3,Coyotes,0,0,0,0,0,20170318,1,2,3,3,3,-3,2016,0,5,1270,0
Blackhawks,0,1,0,1,2,Maple Leafs,1,0,0,0,1,20170318,-1,0,0,1,3,-1,2016,1,5,436,0
Blue Jackets,0,2,0,1,3,Islanders,1,0,1,0,2,20170318,-1,1,0,1,5,-1,2016,1,5,476,0
Avalanche,0,0,1,0,1,Red Wings,0,1,4,0,5,20170318,0,1,4,4,6,4,2016,0,5,1154,0
Canadiens,0,1,2,1,4,Senators,0,2,1,0,3,20170318,0,-1,0,1,7,-1,2016,1,5,104,0
Kings,1,1,0,0,2,Flames,2,2,1,0,5,20170319,1,2,3,3,7,3,2016,0,6,1197,0
Blue Jackets,2,1,1,0,4,Devils,1,0,0,0,1,20170319,1,2,3,3,5,-3,2016,0,6,467,0
Panthers,0,0,0,0,0,Penguins,1,2,1,0,4,20170319,1,3,4,4,4,4,2016,0,6,1013,0
Wild,0,4,0,0,4,Jets,3,1,1,0,5,20170319,3,0,1,1,9,1,2016,0,6,388,0
Avalanche,2,1,0,0,3,Blackhawks,1,0,5,0,6,20170319,-1,-2,3,3,9,3,2016,0,6,916,0
Hurricanes,0,2,1,0,3,Flyers,1,1,1,1,4,20170319,1,0,0,1,7,1,2016,1,6,345,0
Senators,1,0,0,0,1,Canadiens,2,0,2,0,4,20170319,1,1,3,3,5,3,2016,0,6,104,0
Kings,0,0,0,0,0,Oilers,2,0,0,0,2,20170320,2,2,2,2,2,2,2016,0,0,1368,0
Sharks,0,0,0,0,0,Stars,0,1,0,0,1,20170320,0,1,1,1,1,1,2016,0,0,1449,0
Coyotes,0,0,1,0,1,Predators,0,2,1,0,3,20170320,0,2,2,2,4,2,2016,0,0,1442,0
Bruins,1,0,1,0,2,Maple Leafs,1,0,3,0,4,20170320,0,0,2,2,6,2,2016,0,0,430,0
Sabres,1,1,0,0,2,Red Wings,0,1,0,0,1,20170320,1,1,1,1,3,-1,2016,0,0,215,0
Flyers,0,1,1,0,2,Jets,0,1,2,0,3,20170321,0,0,1,1,5,1,2016,0,1,1273,0
Blues,0,1,3,0,4,Avalanche,1,0,1,0,2,20170321,-1,0,2,2,6,-2,2016,0,1,794,0
Canucks,1,2,1,1,5,Blackhawks,0,1,3,0,4,20170321,1,2,0,1,9,-1,2016,1,1,1775,0
Sharks,0,2,0,0,2,Wild,1,2,0,0,3,20170321,1,1,1,1,5,1,2016,0,1,1570,0
Hurricanes,2,1,1,0,4,Panthers,2,1,0,0,3,20170321,0,0,1,1,7,-1,2016,0,1,696,0
Coyotes,1,1,3,0,5,Lightning,1,2,0,0,3,20170321,0,-1,2,2,8,-2,2016,0,1,1793,0
Flames,1,0,1,0,2,Capitals,1,2,1,0,4,20170321,0,2,2,2,6,2,2016,0,1,1967,0
Rangers,0,1,1,0,2,Devils,0,2,0,1,3,20170321,0,1,0,1,5,1,2016,1,1,8,0
Penguins,1,0,2,0,3,Sabres,0,0,1,0,1,20170321,1,1,2,2,4,-2,2016,0,1,178,0
Senators,1,1,1,0,3,Bruins,1,0,1,0,2,20170321,0,1,1,1,5,-1,2016,0,1,320,0
Red Wings,1,0,0,1,2,Canadiens,0,0,1,0,1,20170321,1,1,0,1,3,-1,2016,1,1,508,0
Oilers,2,0,1,0,3,Ducks,2,2,0,0,4,20170322,0,2,1,1,7,1,2016,0,2,1368,0
Maple Leafs,2,1,2,0,5,Blue Jackets,0,2,0,0,2,20170322,2,1,3,3,7,-3,2016,0,2,313,0
Islanders,0,1,2,0,3,Rangers,0,2,0,0,2,20170322,0,-1,1,1,5,-1,2016,0,2,0,0
Flyers,1,1,1,0,3,Wild,1,0,0,0,1,20170323,0,1,2,2,4,-2,2016,0,3,983,0
Stars,0,1,1,0,2,Blackhawks,1,0,1,1,3,20170323,1,0,0,1,5,1,2016,1,3,802,0
Jets,2,0,0,0,2,Kings,1,1,3,0,5,20170323,-1,0,3,3,7,3,2016,0,3,1527,0
Flames,0,1,0,0,1,Predators,0,2,1,0,3,20170323,0,1,2,2,4,2,2016,0,3,1692,0
Oilers,1,1,5,0,7,Avalanche,2,2,0,0,4,20170323,-1,-2,3,3,11,-3,2016,0,3,1036,0
Canucks,1,0,0,0,1,Blues,1,1,2,0,4,20170323,0,1,3,3,5,3,2016,0,3,1778,0
Devils,1,0,1,0,2,Maple Leafs,2,1,1,0,4,20170323,1,2,2,2,6,2,2016,0,3,333,0
Penguins,0,1,0,0,1,Senators,0,0,1,1,2,20170323,0,-1,0,1,3,1,2016,1,3,392,0
Lightning,0,3,3,0,6,Bruins,0,3,0,0,3,20170323,0,0,3,3,9,-3,2016,0,3,1183,0
Coyotes,1,0,0,0,1,Panthers,0,3,0,0,3,20170323,-1,2,2,2,4,2,2016,0,3,1978,0
Hurricanes,1,1,2,0,4,Canadiens,1,0,0,0,1,20170323,0,1,3,3,5,-3,2016,0,3,727,0
Blue Jackets,0,0,1,0,1,Capitals,0,0,1,1,2,20170323,0,0,0,1,3,1,2016,1,3,326,0
Islanders,0,3,0,1,4,Penguins,0,2,1,0,3,20170324,0,1,0,1,7,-1,2016,1,4,314,0
Lightning,0,0,1,1,2,Red Wings,0,1,0,0,1,20170324,0,-1,0,1,3,-1,2016,1,4,994,0
Sharks,0,1,0,0,1,Stars,1,3,2,0,6,20170324,1,3,5,5,7,5,2016,0,4,1449,0
Jets,0,1,0,0,1,Ducks,1,1,1,0,3,20170324,1,1,2,2,4,2,2016,0,4,1527,0
Avalanche,1,0,0,0,1,Oilers,2,0,2,0,4,20170325,1,1,3,3,5,3,2016,0,5,1036,0
Sharks,0,2,0,0,2,Predators,2,2,3,0,7,20170325,2,2,5,5,9,5,2016,0,5,1934,0
Flames,1,0,1,1,3,Blues,0,1,1,0,2,20170325,1,0,0,1,5,-1,2016,1,5,1440,0
Coyotes,0,0,1,0,1,Capitals,1,0,3,0,4,20170325,1,1,3,3,5,3,2016,0,5,1977,0
Bruins,1,0,1,0,2,Islanders,1,0,0,0,1,20170325,0,0,1,1,3,-1,2016,0,5,190,0
Rangers,0,1,2,0,3,Kings,0,0,0,0,0,20170325,0,1,3,3,3,-3,2016,0,5,2445,0
Blackhawks,0,0,0,0,0,Panthers,0,3,4,0,7,20170325,0,3,7,7,7,7,2016,0,5,1189,0
Senators,0,1,0,0,1,Canadiens,1,2,0,0,3,20170325,1,2,2,2,4,2,2016,0,5,104,0
Maple Leafs,1,1,0,0,2,Sabres,2,3,0,0,5,20170325,1,3,3,3,7,3,2016,0,5,57,0
Canucks,0,4,0,0,4,Wild,0,0,2,0,2,20170325,0,4,2,2,6,-2,2016,0,5,1427,0
Flyers,0,0,0,0,0,Blue Jackets,0,1,0,0,1,20170325,0,1,1,1,1,1,2016,0,5,414,0
Hurricanes,0,1,2,0,3,Devils,0,1,0,0,1,20170325,0,0,2,2,4,-2,2016,0,5,419,0
Canucks,1,0,0,0,1,Jets,0,1,1,0,2,20170326,-1,0,1,1,3,1,2016,0,6,1157,0
Flyers,1,1,4,0,6,Penguins,1,0,1,0,2,20170326,0,1,4,4,8,-4,2016,0,6,257,0
Rangers,2,1,0,0,3,Ducks,2,1,3,0,6,20170326,0,0,3,3,9,3,2016,0,6,2445,0
Wild,1,1,0,0,2,Red Wings,1,0,1,1,3,20170326,0,-1,0,1,5,1,2016,1,6,542,0
Stars,0,0,1,1,2,Devils,1,0,0,0,1,20170326,-1,-1,0,1,3,-1,2016,1,6,1362,0
Panthers,0,2,0,0,2,Sabres,2,2,0,0,4,20170327,2,2,2,2,6,2,2016,0,0,1184,0
Predators,1,1,1,0,3,Islanders,0,1,0,0,1,20170327,1,1,2,2,4,-2,2016,0,0,758,0
Red Wings,0,2,1,1,4,Hurricanes,1,1,1,0,3,20170327,-1,0,0,1,7,-1,2016,1,0,511,0
Blackhawks,3,1,0,0,4,Lightning,1,3,0,1,5,20170327,-2,0,0,1,9,1,2016,1,0,1004,0
Coyotes,0,0,1,0,1,Blues,0,2,2,0,4,20170327,0,2,3,3,5,3,2016,0,0,1270,0
Avalanche,0,0,2,0,2,Flames,1,1,2,0,4,20170327,1,2,2,2,6,2,2016,0,0,898,0
Capitals,1,2,1,1,5,Wild,0,2,2,0,4,20170328,1,1,0,1,9,-1,2016,1,1,931,0
Rangers,1,1,2,0,4,Sharks,2,1,1,1,5,20170328,1,1,0,1,9,1,2016,1,1,2549,0
Ducks,3,1,0,0,4,Canucks,0,0,1,0,1,20170328,3,4,3,3,5,-3,2016,0,1,1076,0
Kings,1,0,0,0,1,Oilers,1,1,0,0,2,20170328,0,1,1,1,3,1,2016,0,1,1368,0
Stars,1,0,0,0,1,Canadiens,0,1,3,0,4,20170328,-1,0,3,3,5,3,2016,0,1,1505,0
Sabres,0,1,0,0,1,Blue Jackets,2,0,1,0,3,20170328,2,1,2,2,4,2,2016,0,1,293,0
Jets,1,1,1,1,4,Devils,2,1,0,0,3,20170328,-1,-1,0,1,7,-1,2016,1,1,1280,0
Panthers,0,1,1,0,2,Maple Leafs,2,0,1,0,3,20170328,2,1,1,1,5,1,2016,0,1,1234,0
Predators,0,0,1,0,1,Bruins,2,0,2,0,4,20170328,2,2,3,3,5,3,2016,0,1,941,0
Red Wings,0,0,1,0,1,Hurricanes,2,1,1,0,4,20170328,2,3,3,3,5,3,2016,0,1,511,0
Senators,1,0,1,0,2,Flyers,1,0,1,1,3,20170328,0,0,0,1,5,1,2016,1,1,373,0
Blackhawks,4,0,1,0,5,Penguins,0,0,1,0,1,20170329,4,4,4,4,6,-4,2016,0,2,409,0
Kings,1,1,2,0,4,Flames,1,0,0,0,1,20170329,0,1,3,3,5,-3,2016,0,2,1197,0
Capitals,2,2,1,0,5,Avalanche,1,1,1,0,3,20170329,1,2,2,2,8,-2,2016,0,2,1489,0
Blues,1,1,1,0,3,Coyotes,0,0,1,0,1,20170329,1,2,2,2,4,-2,2016,0,2,1270,0
Ducks,2,1,0,0,3,Jets,1,0,2,1,4,20170330,-1,-2,0,1,7,1,2016,1,3,1527,0
Sharks,1,0,1,0,2,Oilers,2,0,1,0,3,20170330,1,1,1,1,5,1,2016,0,3,1190,0
Senators,1,0,0,0,1,Wild,1,2,2,0,5,20170330,0,2,4,4,6,4,2016,0,3,838,0
Red Wings,1,1,1,0,3,Lightning,1,3,1,0,5,20170330,0,2,2,2,8,2,2016,0,3,994,0
Maple Leafs,1,1,1,0,3,Predators,0,0,1,0,1,20170330,1,2,2,2,4,-2,2016,0,3,646,0
Stars,0,0,0,0,0,Bruins,1,1,0,0,2,20170330,1,2,2,2,2,2,2016,0,3,1548,0
Blue Jackets,0,1,0,0,1,Hurricanes,0,0,1,1,2,20170330,0,-1,0,1,3,1,2016,1,3,374,0
Islanders,0,1,2,0,3,Flyers,5,0,1,0,6,20170330,5,4,3,3,9,3,2016,0,3,80,0
Panthers,0,1,1,0,2,Canadiens,3,0,3,0,6,20170330,3,2,4,4,8,4,2016,0,3,1418,0
Penguins,0,2,1,1,4,Rangers,0,1,2,0,3,20170331,0,1,0,1,7,-1,2016,1,4,314,0
Devils,0,0,1,0,1,Islanders,1,1,0,0,2,20170331,1,2,1,1,3,1,2016,0,4,8,0
Blue Jackets,1,0,0,0,1,Blackhawks,2,0,1,0,3,20170331,1,1,2,2,4,2,2016,0,4,275,0
Blues,1,0,0,0,1,Avalanche,0,1,0,1,2,20170331,-1,0,0,1,3,1,2016,1,4,794,0
Sharks,0,1,1,0,2,Flames,1,3,1,0,5,20170331,1,3,3,3,7,3,2016,0,4,1027,0
Kings,0,2,0,0,2,Canucks,0,0,0,0,0,20170331,0,2,2,2,2,-2,2016,0,4,1076,0
Capitals,0,2,1,0,3,Coyotes,3,2,1,0,6,20170331,3,3,3,3,9,3,2016,0,4,1977,0
Ducks,0,1,1,0,2,Oilers,1,0,1,1,3,20170401,1,0,0,1,5,1,2016,1,5,1368,0
Senators,1,1,0,0,2,Jets,0,2,2,0,4,20170401,-1,0,2,2,6,2,2016,0,5,1033,0
Stars,0,1,2,0,3,Hurricanes,0,0,0,0,0,20170401,0,1,3,3,3,-3,2016,0,5,1055,0
Devils,0,0,0,0,0,Flyers,2,1,0,0,3,20170401,2,3,3,3,3,3,2016,0,5,75,0
Canadiens,0,1,0,1,2,Lightning,0,0,1,0,1,20170401,0,1,0,1,3,-1,2016,1,5,1311,0
Wild,0,0,0,0,0,Predators,0,2,1,0,3,20170401,0,2,3,3,3,3,2016,0,5,696,0
Maple Leafs,0,3,2,0,5,Red Wings,1,1,2,0,4,20170401,-1,1,1,1,9,-1,2016,0,5,205,0
Panthers,0,2,0,0,2,Bruins,1,2,2,0,5,20170401,1,1,3,3,7,3,2016,0,5,1257,0
Flyers,0,1,2,0,3,Rangers,0,2,2,0,4,20170402,0,1,1,1,7,1,2016,0,6,80,0
Bruins,2,0,1,0,3,Blackhawks,0,1,1,0,2,20170402,2,1,1,1,5,-1,2016,0,6,849,0
Islanders,1,1,2,0,4,Sabres,0,1,1,0,2,20170402,1,1,2,2,6,-2,2016,0,6,292,0
Predators,1,0,0,0,1,Blues,1,2,1,0,4,20170402,0,2,3,3,5,3,2016,0,6,253,0
Hurricanes,1,0,1,0,2,Penguins,1,1,1,0,3,20170402,0,1,1,1,5,1,2016,0,6,330,0
Stars,0,2,1,0,3,Lightning,1,1,4,0,6,20170402,1,0,3,3,9,3,2016,0,6,916,0
Capitals,0,3,0,0,3,Blue Jackets,0,0,2,0,2,20170402,0,3,1,1,5,-1,2016,0,6,326,0
Avalanche,1,1,0,0,2,Wild,3,2,0,0,5,20170402,2,3,3,3,7,3,2016,0,6,698,0
Sharks,2,0,1,0,3,Canucks,0,0,1,0,1,20170402,2,2,2,2,4,-2,2016,0,6,821,0
Ducks,2,1,1,0,4,Flames,0,2,1,0,3,20170402,2,1,1,1,7,-1,2016,0,6,1197,0
Coyotes,1,1,0,0,2,Kings,0,0,1,0,1,20170402,1,2,1,1,3,-1,2016,0,6,356,0
Canadiens,1,0,3,0,4,Panthers,0,1,0,0,1,20170403,1,0,3,3,5,-3,2016,0,0,1418,0
Senators,0,1,3,0,4,Red Wings,0,2,2,1,5,20170403,0,1,0,1,9,1,2016,1,0,406,0
Maple Leafs,3,0,1,0,4,Sabres,0,1,1,0,2,20170403,3,2,2,2,6,-2,2016,0,0,57,0
Blackhawks,0,3,0,0,3,Avalanche,0,2,1,1,4,20170404,0,-1,0,1,7,1,2016,1,1,916,0
Coyotes,1,0,1,0,2,Stars,2,0,0,1,3,20170404,1,1,0,1,5,1,2016,1,1,884,0
Hurricanes,3,0,0,0,3,Wild,3,1,1,0,5,20170404,0,1,2,2,8,2,2016,0,1,995,0
Flames,1,0,0,0,1,Ducks,0,2,1,0,3,20170404,-1,1,2,2,4,2,2016,0,1,1197,0
Islanders,0,0,1,1,2,Predators,0,1,0,0,1,20170404,0,-1,0,1,3,-1,2016,1,1,758,0
Blue Jackets,0,0,1,0,1,Penguins,1,2,1,0,4,20170404,1,3,3,3,5,3,2016,0,1,161,0
Red Wings,0,0,0,0,0,Senators,1,1,0,0,2,20170404,1,2,2,2,2,2,2016,0,1,406,0
Capitals,1,1,2,0,4,Maple Leafs,0,0,1,0,1,20170404,1,2,3,3,5,-3,2016,0,1,349,0
Flyers,0,0,0,0,0,Devils,0,0,0,1,1,20170404,0,0,0,1,1,1,2016,1,1,75,0
Lightning,0,0,0,0,0,Bruins,0,2,2,0,4,20170404,0,2,4,4,4,4,2016,0,1,1183,0
Oilers,2,1,1,0,4,Kings,0,3,3,0,6,20170404,-2,0,2,2,10,2,2016,0,1,1368,0
Jets,0,3,2,0,5,Blues,1,1,0,0,2,20170404,-1,1,3,3,7,-3,2016,0,1,853,0
Canucks,0,0,1,0,1,Sharks,2,0,1,0,3,20170404,2,2,2,2,4,2,2016,0,1,821,0
Rangers,0,0,0,0,0,Capitals,0,1,1,0,2,20170405,0,1,2,2,2,2,2016,0,2,204,0
Canadiens,0,0,1,0,1,Sabres,1,1,0,0,2,20170405,1,2,1,1,3,1,2016,0,2,311,0
Oilers,0,1,3,0,4,Sharks,1,1,0,0,2,20170406,-1,-1,2,2,6,-2,2016,0,3,1190,0
Wild,2,0,2,0,4,Avalanche,0,2,1,0,3,20170406,2,0,1,1,7,-1,2016,0,3,698,0
Flames,1,3,0,0,4,Kings,1,0,0,0,1,20170406,0,3,3,3,5,-3,2016,0,3,1197,0
Blackhawks,0,0,0,0,0,Ducks,1,1,2,0,4,20170406,1,2,4,4,4,4,2016,0,3,1741,0
Canucks,1,0,2,0,3,Coyotes,1,3,0,0,4,20170406,0,3,1,1,7,1,2016,0,3,1228,0
Predators,4,2,1,0,7,Stars,0,3,0,0,3,20170406,4,3,4,4,10,-4,2016,0,3,616,0
Senators,0,1,0,1,2,Bruins,1,0,0,0,1,20170406,-1,0,0,1,3,-1,2016,1,3,320,0
Lightning,0,2,2,0,4,Maple Leafs,0,1,0,0,1,20170406,0,1,3,3,5,-3,2016,0,3,1096,0
Jets,2,1,2,0,5,Blue Jackets,1,2,1,0,4,20170406,1,0,1,1,9,-1,2016,0,3,975,0
Islanders,2,1,0,0,3,Hurricanes,0,0,0,0,0,20170406,2,3,3,3,3,-3,2016,0,3,423,0
Penguins,2,3,2,0,7,Devils,1,3,0,0,4,20170406,1,1,3,3,11,-3,2016,0,3,306,0
Blues,1,1,4,0,6,Panthers,0,1,2,0,3,20170406,1,1,3,3,9,-3,2016,0,3,1061,0
Lightning,2,1,1,0,4,Canadiens,0,1,1,0,2,20170407,2,2,2,2,6,-2,2016,0,4,1311,0
Flames,0,1,0,0,1,Sharks,0,2,1,0,3,20170408,0,1,2,2,4,2,2016,0,5,1027,0
Oilers,0,1,2,0,3,Canucks,0,1,1,0,2,20170408,0,0,1,1,5,-1,2016,0,5,514,0
Wild,2,0,1,0,3,Coyotes,0,0,1,0,1,20170408,2,2,2,2,4,-2,2016,0,5,1278,0
Avalanche,0,1,2,0,3,Stars,1,1,1,1,4,20170408,1,1,0,1,7,1,2016,1,5,661,0
Predators,0,1,0,0,1,Jets,0,0,2,0,2,20170408,0,-1,1,1,3,1,2016,0,5,1084,0
Blues,1,2,1,1,5,Hurricanes,2,1,1,0,4,20170408,-1,0,0,1,9,-1,2016,1,5,665,0
Sabres,0,0,0,0,0,Panthers,0,2,1,0,3,20170408,0,2,3,3,3,3,2016,0,5,1184,0
Penguins,1,1,1,0,3,Maple Leafs,1,1,3,0,5,20170408,0,0,2,2,8,2,2016,0,5,222,0
Blackhawks,1,0,1,0,2,Kings,0,0,2,1,3,20170408,-1,-1,0,1,5,1,2016,1,5,1741,0
Islanders,0,2,2,0,4,Devils,0,0,2,0,2,20170408,0,2,2,2,6,-2,2016,0,5,8,0
Capitals,1,2,0,0,3,Bruins,0,1,0,0,1,20170408,1,2,2,2,4,-2,2016,0,5,394,0
Blue Jackets,0,2,0,0,2,Flyers,2,2,0,0,4,20170408,2,2,2,2,6,2,2016,0,5,414,0
Rangers,0,0,1,0,1,Senators,0,2,1,0,3,20170408,0,2,2,2,4,2,2016,0,5,334,0
Canadiens,0,2,0,1,3,Red Wings,1,1,0,0,2,20170408,-1,0,0,1,5,-1,2016,1,5,508,0
Hurricanes,1,0,2,1,4,Flyers,0,1,2,0,3,20170409,1,0,0,1,7,-1,2016,1,6,345,0
Kings,1,1,1,0,3,Ducks,1,1,1,1,4,20170409,0,0,0,1,7,1,2016,1,6,0,0
Panthers,0,1,1,0,2,Capitals,0,0,0,0,0,20170409,0,1,2,2,2,-2,2016,0,6,924,0
Canucks,0,1,1,0,2,Oilers,1,2,2,0,5,20170409,1,2,3,3,7,3,2016,0,6,514,0
Penguins,1,1,0,0,2,Rangers,2,0,1,0,3,20170409,1,0,1,1,5,1,2016,0,6,314,0
Blue Jackets,0,3,0,0,3,Maple Leafs,0,2,0,0,2,20170409,0,1,1,1,5,-1,2016,0,6,313,0
Senators,0,1,1,0,2,Islanders,1,2,1,0,4,20170409,1,2,2,2,6,2,2016,0,6,334,0
Sabres,1,0,1,0,2,Lightning,0,2,2,0,4,20170409,-1,1,2,2,6,2,2016,0,6,1051,0
Devils,0,0,1,0,1,Red Wings,2,1,1,0,4,20170409,2,3,3,3,5,3,2016,0,6,471,0
Avalanche,0,2,0,0,2,Blues,1,0,2,0,3,20170409,1,-1,1,1,5,1,2016,0,6,794,0
Rangers,1,0,1,0,2,Canadiens,0,0,0,0,0,20170412,1,1,2,2,2,-2,2016,0,2,343,1
Bruins,0,0,2,0,2,Senators,0,1,0,0,1,20170412,0,-1,1,1,3,-1,2016,0,2,320,1
Blue Jackets,0,0,1,0,1,Penguins,0,3,0,0,3,20170412,0,3,2,2,4,2,2016,0,2,161,1
Blues,0,1,0,1,2,Wild,0,0,1,0,1,20170412,0,1,0,1,3,-1,2016,1,2,466,1
Sharks,0,1,1,1,3,Oilers,2,0,0,0,2,20170412,-2,-1,0,1,5,-1,2016,1,2,1190,1
Maple Leafs,2,0,0,0,2,Capitals,1,1,0,1,3,20170413,-1,0,0,1,5,1,2016,1,3,349,1
Predators,1,0,0,0,1,Blackhawks,0,0,0,0,0,20170413,1,1,1,1,1,-1,2016,0,3,395,1
Flames,1,1,0,0,2,Ducks,1,2,0,0,3,20170413,0,1,1,1,5,1,2016,0,3,1197,1
Blues,0,1,1,0,2,Wild,0,1,0,0,1,20170414,0,0,1,1,3,-1,2016,0,4,466,1
Sharks,0,0,0,0,0,Oilers,0,1,1,0,2,20170414,0,1,2,2,2,2,2016,0,4,1190,1
Rangers,1,2,0,0,3,Canadiens,2,0,1,1,4,20170414,1,-1,0,1,7,1,2016,1,4,343,1
Blue Jackets,0,1,0,0,1,Penguins,1,1,2,0,4,20170414,1,1,3,3,5,3,2016,0,4,161,1
Bruins,0,3,0,0,3,Senators,0,1,2,1,4,20170415,0,-2,0,1,7,1,2016,1,5,320,1
Maple Leafs,1,2,0,1,4,Capitals,0,2,1,0,3,20170415,1,1,0,1,7,-1,2016,1,5,349,1
Predators,1,2,2,0,5,Blackhawks,0,0,0,0,0,20170415,1,3,5,5,5,-5,2016,0,5,395,1
Flames,1,1,0,0,2,Ducks,2,0,1,0,3,20170415,1,0,1,1,5,1,2016,0,5,1197,1
Canadiens,0,1,2,0,3,Rangers,0,0,1,0,1,20170416,0,1,2,2,4,-2,2016,0,6,343,1
Oilers,0,0,1,0,1,Sharks,0,0,0,0,0,20170416,0,0,1,1,1,-1,2016,0,6,1190,1
Wild,0,1,0,0,1,Blues,1,1,1,0,3,20170416,1,1,2,2,4,2,2016,0,6,466,1
Penguins,1,2,1,1,5,Blue Jackets,3,0,1,0,4,20170416,-2,0,0,1,9,-1,2016,1,6,161,1
Senators,2,1,0,1,4,Bruins,0,3,0,0,3,20170417,2,0,0,1,7,-1,2016,1,0,320,1
Capitals,2,1,0,0,3,Maple Leafs,1,2,0,1,4,20170417,-1,0,0,1,7,1,2016,1,0,349,1
Blackhawks,0,2,0,0,2,Predators,0,0,2,1,3,20170417,0,-2,0,1,5,1,2016,1,0,395,1
Ducks,1,1,2,1,5,Flames,2,2,0,0,4,20170417,-1,-2,0,1,9,-1,2016,1,0,1197,1
Canadiens,1,0,0,0,1,Rangers,1,1,0,0,2,20170418,0,1,1,1,3,1,2016,0,1,343,1
Penguins,0,2,2,0,4,Blue Jackets,2,1,2,0,5,20170418,2,1,1,1,9,1,2016,0,1,161,1
Oilers,0,0,0,0,0,Sharks,2,4,1,0,7,20170418,2,6,7,7,7,7,2016,0,1,1190,1
Ducks,2,0,1,0,3,Flames,0,1,0,0,1,20170419,2,1,2,2,4,-2,2016,0,2,1197,1
Wild,1,1,0,0,2,Blues,0,0,0,0,0,20170419,1,2,2,2,2,-2,2016,0,2,466,1
Capitals,4,0,1,0,5,Maple Leafs,1,1,2,0,4,20170419,3,2,1,1,9,-1,2016,0,2,349,1
Senators,0,0,1,0,1,Bruins,0,0,0,0,0,20170419,0,0,1,1,1,-1,2016,0,2,320,1
Rangers,1,1,0,1,3,Canadiens,2,0,0,0,2,20170420,-1,0,0,1,5,-1,2016,1,3,343,1
Blue Jackets,0,2,0,0,2,Penguins,1,2,2,0,5,20170420,1,1,3,3,7,3,2016,0,3,161,1
Blackhawks,0,0,1,0,1,Predators,0,1,3,0,4,20170420,0,1,3,3,5,3,2016,0,3,395,1
Sharks,2,1,0,0,3,Oilers,1,1,1,1,4,20170420,-1,-1,0,1,7,1,2016,1,3,1190,1
Maple Leafs,0,1,0,0,1,Capitals,1,0,0,1,2,20170421,1,0,0,1,3,1,2016,1,4,349,1
Bruins,0,2,0,1,3,Senators,1,1,0,0,2,20170421,-1,0,0,1,5,-1,2016,1,4,320,1
Blues,2,0,1,1,4,Wild,1,0,2,0,3,20170422,1,1,0,1,7,-1,2016,1,5,466,1
Canadiens,1,0,0,0,1,Rangers,0,2,1,0,3,20170422,-1,1,2,2,4,2,2016,0,5,343,1
Oilers,0,2,1,0,3,Sharks,0,0,1,0,1,20170422,0,2,2,2,4,-2,2016,0,5,1190,1
Senators,0,2,0,1,3,Bruins,1,0,1,0,2,20170423,-1,1,0,1,5,-1,2016,1,6,320,1
Capitals,0,0,1,1,2,Maple Leafs,0,0,1,0,1,20170423,0,0,0,1,3,-1,2016,1,6,349,1
Oilers,0,1,4,0,5,Ducks,0,1,2,0,3,20170426,0,0,2,2,8,-2,2016,0,2,1368,1
Predators,1,2,1,0,4,Blues,0,1,2,0,3,20170426,1,2,1,1,7,-1,2016,0,2,253,1
Penguins,0,2,1,0,3,Capitals,0,1,1,0,2,20170427,0,1,1,1,5,-1,2016,0,3,190,1
Rangers,0,1,0,0,1,Senators,0,1,1,0,2,20170427,0,0,1,1,3,1,2016,0,3,334,1
Predators,1,0,1,0,2,Blues,1,0,2,0,3,20170428,0,0,1,1,5,1,2016,0,4,253,1
Oilers,1,1,0,0,2,Ducks,0,1,0,0,1,20170428,1,1,1,1,3,-1,2016,0,4,1368,1
Rangers,1,3,1,0,5,Senators,1,1,3,1,6,20170429,0,-2,0,1,11,1,2016,1,5,334,1
Penguins,0,3,3,0,6,Capitals,0,1,1,0,2,20170429,0,2,4,4,8,-4,2016,0,5,190,1
Blues,0,1,0,0,1,Predators,1,1,1,0,3,20170430,1,1,2,2,4,2,2016,0,6,253,1
Ducks,3,1,2,0,6,Oilers,1,2,0,0,3,20170430,2,1,3,3,9,-3,2016,0,6,1368,1
Capitals,1,0,1,1,3,Penguins,0,0,2,0,2,20170501,1,1,0,1,5,-1,2016,1,0,190,1
Senators,0,1,0,0,1,Rangers,2,2,0,0,4,20170502,2,3,3,3,5,3,2016,0,1,334,1
Blues,0,0,1,0,1,Predators,0,0,2,0,2,20170502,0,0,1,1,3,1,2016,0,1,253,1
Capitals,0,2,0,0,2,Penguins,1,2,0,0,3,20170503,1,1,1,1,5,1,2016,0,2,190,1
Ducks,0,3,0,1,4,Oilers,2,0,1,0,3,20170503,-2,1,0,1,7,-1,2016,1,2,1368,1
Senators,0,0,1,0,1,Rangers,1,2,1,0,4,20170504,1,3,3,3,5,3,2016,0,3,334,1
Predators,0,1,0,0,1,Blues,0,1,1,0,2,20170505,0,0,1,1,3,1,2016,0,4,253,1
Oilers,0,3,0,0,3,Ducks,0,0,3,1,4,20170505,0,-3,0,1,7,1,2016,1,4,1368,1
Penguins,1,1,0,0,2,Capitals,1,0,3,0,4,20170506,0,-1,2,2,6,2,2016,0,5,190,1
Rangers,2,1,1,0,4,Senators,1,2,1,1,5,20170506,-1,0,0,1,9,1,2016,1,5,334,1
Blues,1,0,0,0,1,Predators,0,1,2,0,3,20170507,-1,0,2,2,4,2,2016,0,6,253,1
Ducks,0,1,0,0,1,Oilers,5,2,0,0,7,20170507,5,6,6,6,8,6,2016,0,6,1368,1
Capitals,1,1,3,0,5,Penguins,0,0,2,0,2,20170508,1,2,3,3,7,-3,2016,0,0,190,1
Senators,2,1,1,0,4,Rangers,0,1,1,0,2,20170509,2,2,2,2,6,-2,2016,0,1,334,1
Penguins,0,1,1,0,2,Capitals,0,0,0,0,0,20170510,0,1,2,2,2,-2,2016,0,2,190,1
Oilers,1,0,0,0,1,Ducks,0,1,1,0,2,20170510,-1,0,1,1,3,1,2016,0,2,1368,1
Predators,1,1,0,1,3,Ducks,1,0,1,0,2,20170512,0,1,0,1,5,-1,2016,1,4,1776,1
Senators,1,0,0,1,2,Penguins,0,0,1,0,1,20170513,1,1,0,1,3,-1,2016,1,5,392,1
Predators,2,1,0,0,3,Ducks,1,3,1,0,5,20170514,-1,1,2,2,8,2,2016,0,6,1776,1
Senators,0,0,0,0,0,Penguins,0,0,1,0,1,20170515,0,0,1,1,1,1,2016,0,0,392,1
Ducks,0,1,0,0,1,Predators,0,0,2,0,2,20170516,0,-1,1,1,3,1,2016,0,1,1776,1
Penguins,0,0,1,0,1,Senators,4,1,0,0,5,20170517,4,5,4,4,6,4,2016,0,2,392,1
Ducks,1,1,0,1,3,Predators,0,0,2,0,2,20170518,1,2,0,1,5,-1,2016,1,3,1776,1
Penguins,1,2,0,0,3,Senators,0,1,1,0,2,20170519,1,2,1,1,5,-1,2016,0,4,392,1
Predators,0,1,2,0,3,Ducks,0,1,0,0,1,20170520,0,0,2,2,4,-2,2016,0,5,1776,1
Senators,0,0,0,0,0,Penguins,4,1,2,0,7,20170521,4,5,7,7,7,7,2016,0,6,392,1
Ducks,0,1,2,0,3,Predators,2,0,4,0,6,20170522,2,1,3,3,9,3,2016,0,0,1776,1
Penguins,0,1,0,0,1,Senators,0,1,1,0,2,20170523,0,0,1,1,3,1,2016,0,1,392,1
Senators,0,1,1,0,2,Penguins,0,1,1,1,3,20170525,0,0,0,1,5,1,2016,1,3,392,1
Predators,0,1,2,0,3,Penguins,3,0,2,0,5,20170529,3,2,2,2,8,2,2016,0,0,471,1
Predators,1,0,0,0,1,Penguins,1,0,3,0,4,20170531,0,0,3,3,5,3,2016,0,2,471,1
Penguins,1,0,0,0,1,Predators,0,3,2,0,5,20170603,-1,2,4,4,6,4,2016,0,5,471,1
Penguins,1,0,0,0,1,Predators,1,2,1,0,4,20170605,0,2,3,3,5,3,2016,0,0,471,1
Predators,0,0,0,0,0,Penguins,3,3,0,0,6,20170608,3,6,6,6,6,6,2016,0,3,471,1
Penguins,0,0,2,0,2,Predators,0,0,0,0,0,20170611,0,0,2,2,2,-2,2016,0,6,471,1
Maple Leafs,3,1,3,0,7,Jets,0,0,2,0,2,20171004,3,4,5,5,9,-5,2017,0,2,946,0
Blues,2,1,1,1,5,Penguins,1,1,2,0,4,20171004,1,1,0,1,9,-1,2017,1,2,557,0
Flames,0,0,0,0,0,Oilers,1,0,2,0,3,20171004,1,1,3,3,3,3,2017,0,2,171,0
Flyers,2,1,2,0,5,Sharks,2,0,1,0,3,20171004,0,1,2,2,8,-2,2017,0,2,2499,0
Flyers,0,0,0,0,0,Kings,0,1,1,0,2,20171005,0,1,2,2,2,2,2017,0,3,2388,0
Coyotes,2,2,0,0,4,Ducks,1,2,2,0,5,20171005,-1,-1,1,1,9,1,2017,0,3,356,0
Penguins,0,1,0,0,1,Blackhawks,5,3,2,0,10,20171005,5,7,9,9,11,9,2017,0,3,409,0
Capitals,1,0,3,1,5,Senators,1,1,2,0,4,20171005,0,-1,0,1,9,-1,2017,1,3,446,0
Canadiens,1,0,1,1,3,Sabres,1,1,0,0,2,20171005,0,-1,0,1,5,-1,2017,1,3,311,0
Avalanche,2,1,1,0,4,Rangers,2,0,0,0,2,20171005,0,1,2,2,6,-2,2017,0,3,1627,0
Predators,1,0,2,0,3,Bruins,1,2,1,0,4,20171005,0,2,1,1,7,1,2017,0,3,941,0
Wild,0,0,2,0,2,Red Wings,0,2,2,0,4,20171005,0,2,2,2,6,2,2017,0,3,542,0
Islanders,0,0,0,0,0,Blue Jackets,2,3,0,0,5,20171006,2,5,5,5,5,5,2017,0,4,476,0
Panthers,0,2,1,0,3,Lightning,1,1,3,0,5,20171006,1,0,2,2,8,2,2017,0,4,205,0
Golden Knights,0,0,2,0,2,Stars,0,1,0,0,1,20171006,0,-1,1,1,3,-1,2017,0,4,1068,0
Kings,2,2,0,0,4,Sharks,1,0,0,0,1,20171007,1,3,3,3,5,-3,2017,0,5,305,0
Flyers,1,1,0,1,3,Ducks,1,0,1,0,2,20171007,0,1,0,1,5,-1,2017,1,5,2388,0
Oilers,1,0,1,0,2,Canucks,2,1,0,0,3,20171007,1,2,1,1,5,1,2017,0,5,514,0
Jets,3,0,0,0,3,Flames,1,4,1,0,6,20171007,-2,2,3,3,9,3,2017,0,5,740,0
Golden Knights,0,0,1,1,2,Coyotes,1,0,0,0,1,20171007,-1,-1,0,1,3,-1,2017,1,5,256,0
Blue Jackets,0,1,0,0,1,Blackhawks,2,2,1,0,5,20171007,2,3,4,4,6,4,2017,0,5,275,0
Wild,2,1,1,0,4,Hurricanes,1,1,2,1,5,20171007,-1,-1,0,1,9,1,2017,1,5,995,0
Stars,0,0,2,0,2,Blues,3,0,1,0,4,20171007,3,3,2,2,6,2,2017,0,5,547,0
Predators,0,0,0,0,0,Penguins,2,1,1,0,4,20171007,2,3,4,4,4,4,2017,0,5,471,0
Sabres,0,2,1,0,3,Islanders,1,3,2,0,6,20171007,1,2,3,3,9,3,2017,0,5,292,0
Lightning,2,1,1,0,4,Panthers,1,1,3,0,5,20171007,-1,-1,1,1,9,1,2017,0,5,205,0
Red Wings,0,0,1,1,2,Senators,0,0,1,0,1,20171007,0,0,0,1,3,-1,2017,1,5,406,0
Rangers,2,3,0,0,5,Maple Leafs,5,0,3,0,8,20171007,3,0,3,3,13,3,2017,0,5,341,0
Avalanche,0,1,0,0,1,Devils,1,2,1,0,4,20171007,1,2,3,3,5,3,2017,0,5,1618,0
Canadiens,0,1,0,0,1,Capitals,4,2,0,0,6,20171007,4,5,5,5,7,5,2017,0,5,495,0
Canadiens,0,0,0,0,0,Rangers,1,0,1,0,2,20171008,1,1,2,2,2,2,2017,0,6,343,0
Jets,2,2,1,0,5,Oilers,0,2,0,0,2,20171009,2,2,3,3,7,-3,2017,0,0,738,0
Avalanche,2,0,2,0,4,Bruins,0,0,0,0,0,20171009,2,2,4,4,4,-4,2017,0,0,1765,0
Blues,0,2,0,1,3,Islanders,0,0,2,0,2,20171009,0,2,0,1,5,-1,2017,1,0,871,0
Devils,2,4,0,0,6,Sabres,0,1,1,0,2,20171009,2,5,4,4,8,-4,2017,0,0,284,0
Blackhawks,2,0,1,0,3,Maple Leafs,0,1,2,1,4,20171009,-2,-1,0,1,7,1,2017,1,0,436,0
Capitals,2,1,0,0,3,Lightning,0,2,1,1,4,20171009,-2,-1,0,1,7,1,2017,1,0,818,0
Flames,0,1,1,0,2,Ducks,0,0,0,0,0,20171009,0,1,2,2,2,-2,2017,0,0,1197,0
Senators,1,0,1,1,3,Canucks,1,1,0,0,2,20171010,0,-1,0,1,5,-1,2017,1,1,2191,0
Coyotes,1,0,1,0,2,Golden Knights,4,1,0,0,5,20171010,3,4,3,3,7,3,2017,0,1,256,0
Flyers,0,3,2,0,5,Predators,1,2,3,0,6,20171010,1,0,1,1,11,1,2017,0,1,683,0
Red Wings,0,1,1,0,2,Stars,2,1,1,0,4,20171010,2,2,2,2,6,2,2017,0,1,999,0
Blackhawks,2,1,0,0,3,Canadiens,1,0,0,0,1,20171010,1,2,2,2,4,-2,2017,0,1,732,0
Blue Jackets,0,0,1,1,2,Hurricanes,0,0,1,0,1,20171010,0,0,0,1,3,-1,2017,1,1,374,0
Blues,2,0,1,0,3,Rangers,1,0,0,0,1,20171010,1,1,2,2,4,-2,2017,0,1,871,0
Devils,2,2,2,0,6,Maple Leafs,2,0,1,0,3,20171011,0,2,3,3,9,-3,2017,0,2,333,0
Penguins,1,1,1,0,3,Capitals,0,1,1,0,2,20171011,1,1,1,1,5,-1,2017,0,2,190,0
Bruins,1,0,2,0,3,Avalanche,1,3,2,0,6,20171011,0,3,3,3,9,3,2017,0,2,1765,0
Islanders,1,0,1,0,2,Ducks,1,1,1,0,3,20171011,0,1,1,1,5,1,2017,0,2,2445,0
Flames,2,0,1,1,4,Kings,0,1,2,0,3,20171011,2,1,0,1,7,-1,2017,1,2,1197,0
Red Wings,1,1,4,0,6,Golden Knights,0,3,0,0,3,20171013,1,-1,3,3,9,-3,2017,0,4,1757,0
Senators,1,1,4,0,6,Flames,0,0,0,0,0,20171013,1,2,6,6,6,-6,2017,0,4,1773,0
Rangers,1,0,0,0,1,Blue Jackets,0,1,2,0,3,20171013,-1,0,2,2,4,2,2017,0,4,476,0
Capitals,1,2,2,0,5,Devils,0,1,1,0,2,20171013,1,2,3,3,7,-3,2017,0,4,198,0
Ducks,0,0,1,0,1,Avalanche,1,0,2,0,3,20171013,1,1,2,2,4,2,2017,0,4,830,0
Predators,0,1,0,0,1,Blackhawks,0,0,1,1,2,20171014,0,-1,0,1,3,1,2017,1,5,395,0
Islanders,1,1,1,0,3,Sharks,1,0,0,0,1,20171014,0,1,2,2,4,-2,2017,0,5,2549,0
Sabres,1,0,1,0,2,Kings,0,1,3,0,4,20171014,-1,0,2,2,6,2,2017,0,5,2193,0
Flames,1,2,2,0,5,Canucks,1,0,1,0,2,20171014,0,2,3,3,7,-3,2017,0,5,426,0
Senators,2,1,3,0,6,Oilers,0,0,1,0,1,20171014,2,3,5,5,7,-5,2017,0,5,1754,0
Bruins,1,3,2,0,6,Coyotes,1,0,1,0,2,20171014,0,3,4,4,8,-4,2017,0,5,2295,0
Blue Jackets,1,1,2,1,5,Wild,1,2,1,0,4,20171014,0,-1,0,1,9,-1,2017,1,5,626,0
Panthers,0,2,1,0,3,Penguins,1,2,1,0,4,20171014,1,1,1,1,7,1,2017,0,5,1013,0
Hurricanes,1,0,0,0,1,Jets,1,0,1,0,2,20171014,0,0,1,1,3,1,2017,0,5,1350,0
Capitals,1,1,0,0,2,Flyers,2,3,3,0,8,20171014,1,3,6,6,10,6,2017,0,5,123,0
Devils,0,2,1,0,3,Rangers,0,1,1,0,2,20171014,0,1,1,1,5,-1,2017,0,5,8,0
Blues,0,0,1,0,1,Lightning,0,1,1,0,2,20171014,0,1,1,1,3,1,2017,0,5,861,0
Maple Leafs,2,1,0,1,4,Canadiens,2,1,0,0,3,20171014,0,0,0,1,7,-1,2017,1,5,303,0
Avalanche,0,0,1,0,1,Stars,0,2,1,0,3,20171014,0,2,2,2,4,2,2017,0,5,661,0
Bruins,0,0,1,0,1,Golden Knights,0,2,1,0,3,20171015,0,2,2,2,4,2,2017,0,6,2369,0
Sabres,1,1,1,0,3,Ducks,0,1,0,0,1,20171015,1,1,2,2,4,-2,2017,0,6,2193,0
Islanders,0,1,1,0,2,Kings,1,1,1,0,3,20171015,1,1,1,1,5,1,2017,0,6,2445,0
Lightning,2,0,1,0,3,Red Wings,0,2,0,0,2,20171016,2,0,1,1,5,-1,2017,0,0,994,0
Blue Jackets,0,4,1,0,5,Jets,0,1,1,0,2,20171017,0,3,3,3,7,-3,2017,0,1,975,0
Canadiens,1,1,0,0,2,Sharks,1,3,1,0,5,20171017,0,2,3,3,7,3,2017,0,1,2508,0
Sabres,1,0,3,0,4,Golden Knights,1,2,1,1,5,20171017,0,2,0,1,9,1,2017,1,1,1970,0
Coyotes,0,1,0,0,1,Stars,1,1,1,0,3,20171017,1,1,2,2,4,2,2017,0,1,884,0
Avalanche,0,1,0,0,1,Predators,0,3,1,0,4,20171017,0,2,3,3,5,3,2017,0,1,1019,0
Hurricanes,3,0,2,0,5,Oilers,0,1,2,0,3,20171017,3,2,2,2,8,-2,2017,0,1,2076,0
Lightning,2,2,0,0,4,Devils,3,0,1,1,5,20171017,1,-1,0,1,9,1,2017,1,1,1000,0
Maple Leafs,0,0,2,0,2,Capitals,0,0,0,0,0,20171017,0,0,2,2,2,-2,2017,0,1,349,0
Panthers,0,0,1,0,1,Flyers,0,4,1,0,5,20171017,0,4,4,4,6,4,2017,0,1,1021,0
Penguins,2,1,1,1,5,Rangers,0,3,1,0,4,20171017,2,0,0,1,9,-1,2017,1,1,314,0
Canucks,1,1,1,0,3,Senators,0,0,0,0,0,20171017,1,2,3,3,3,-3,2017,0,1,2191,0
Red Wings,1,2,0,0,3,Maple Leafs,4,1,1,0,6,20171018,3,2,3,3,9,3,2017,0,2,205,0
Blackhawks,0,0,2,0,2,Blues,1,2,2,0,5,20171018,1,3,3,3,7,3,2017,0,2,260,0
Canadiens,1,0,0,0,1,Kings,1,0,4,0,5,20171018,0,0,4,4,6,4,2017,0,2,2448,0
Stars,2,0,3,0,5,Coyotes,1,1,2,0,4,20171019,1,0,1,1,9,-1,2017,0,3,884,0
Hurricanes,0,1,1,0,2,Flames,0,0,1,0,1,20171019,0,1,1,1,3,-1,2017,0,3,2038,0
Blues,0,3,1,0,4,Avalanche,1,0,2,0,3,20171019,-1,2,1,1,7,-1,2017,0,3,794,0
Oilers,1,0,0,1,2,Blackhawks,1,0,0,0,1,20171019,0,0,0,1,3,-1,2017,1,3,1437,0
Islanders,2,1,0,1,4,Rangers,1,0,2,0,3,20171019,1,2,0,1,7,-1,2017,1,3,0,0
Lightning,1,1,0,0,2,Blue Jackets,0,0,0,0,0,20171019,1,2,2,2,2,-2,2017,0,3,830,0
Predators,0,0,1,0,1,Flyers,0,0,0,0,0,20171019,0,0,1,1,1,-1,2017,0,3,683,0
Canucks,1,2,0,0,3,Bruins,4,1,1,0,6,20171019,3,2,3,3,9,3,2017,0,3,2504,0
Devils,2,0,2,1,5,Senators,1,3,0,0,4,20171019,1,-2,0,1,9,-1,2017,1,3,330,0
Canadiens,0,2,0,0,2,Ducks,3,0,3,0,6,20171020,3,1,4,4,8,4,2017,0,4,2448,0
Penguins,0,3,1,0,4,Panthers,2,0,1,0,3,20171020,-2,1,1,1,7,-1,2017,0,4,1013,0
Wild,1,2,0,0,3,Jets,2,1,1,0,4,20171020,1,0,1,1,7,1,2017,0,4,388,0
Sharks,1,2,0,0,3,Devils,0,0,0,0,0,20171020,1,3,3,3,3,-3,2017,0,4,2540,0
Canucks,1,2,1,0,4,Sabres,2,0,0,0,2,20171020,-1,1,2,2,6,-2,2017,0,4,2137,0
Capitals,0,1,2,1,4,Red Wings,0,1,2,0,3,20171020,0,0,0,1,7,-1,2017,1,4,394,0
Blues,1,0,1,0,2,Golden Knights,0,2,0,1,3,20171021,-1,1,0,1,5,1,2017,1,5,1375,0
Wild,0,1,3,0,4,Flames,0,1,1,0,2,20171021,0,0,2,2,6,-2,2017,0,5,1043,0
Blackhawks,1,1,2,0,4,Coyotes,1,1,0,0,2,20171021,0,0,2,2,6,-2,2017,0,5,1450,0
Panthers,2,1,1,0,4,Capitals,0,1,0,0,1,20171021,2,2,3,3,5,-3,2017,0,5,924,0
Kings,2,2,2,0,6,Blue Jackets,3,1,0,0,4,20171021,-1,0,2,2,10,-2,2017,0,5,1973,0
Hurricanes,0,1,2,0,3,Stars,2,2,0,0,4,20171021,2,3,1,1,7,1,2017,0,5,1055,0
Penguins,0,0,1,0,1,Lightning,3,3,1,0,7,20171021,3,6,6,6,8,6,2017,0,5,874,0
Maple Leafs,0,0,3,0,3,Senators,1,2,3,0,6,20171021,1,3,3,3,9,3,2017,0,5,203,0
Sabres,0,2,2,1,5,Bruins,2,2,0,0,4,20171021,-2,-2,0,1,9,-1,2017,1,5,399,0
Oilers,0,1,0,0,1,Flyers,1,0,1,0,2,20171021,1,0,1,1,3,1,2017,0,5,2011,0
Predators,0,2,0,0,2,Rangers,2,1,1,0,4,20171021,2,1,2,2,6,2,2017,0,5,758,0
Sharks,0,2,1,0,3,Islanders,0,2,3,0,5,20171021,0,0,2,2,8,2,2017,0,5,2549,0
Canucks,1,3,0,0,4,Red Wings,1,0,0,0,1,20171022,0,3,3,3,5,-3,2017,0,6,1967,0
Kings,0,1,1,0,2,Maple Leafs,1,1,1,0,3,20171023,1,1,1,1,5,1,2017,0,0,2170,0
Sharks,2,1,1,0,4,Rangers,0,0,1,0,1,20171023,2,3,3,3,5,-3,2017,0,0,2549,0
Kings,1,0,1,1,3,Senators,1,0,1,0,2,20171024,0,0,0,1,5,-1,2017,1,1,2345,0
Blackhawks,1,0,1,0,2,Golden Knights,2,1,1,0,4,20171024,1,2,2,2,6,2,2017,0,1,1519,0
Canucks,0,0,1,0,1,Wild,0,0,0,0,0,20171024,0,0,1,1,1,-1,2017,0,1,1427,0
Flames,0,0,2,1,3,Predators,2,0,0,0,2,20171024,-2,-2,0,1,5,-1,2017,1,1,1692,0
Panthers,0,1,0,0,1,Canadiens,0,3,2,0,5,20171024,0,2,4,4,6,4,2017,0,1,1418,0
Stars,1,1,1,0,3,Avalanche,1,3,1,0,5,20171024,0,2,2,2,8,2,2017,0,1,661,0
Lightning,1,1,3,0,5,Hurricanes,0,0,1,0,1,20171024,1,2,4,4,6,-4,2017,0,1,585,0
Coyotes,1,0,2,0,3,Islanders,0,2,3,0,5,20171024,-1,1,2,2,8,2,2017,0,1,2139,0
Red Wings,0,0,0,0,0,Sabres,0,1,0,0,1,20171024,0,1,1,1,1,1,2017,0,1,215,0
Oilers,0,0,1,0,1,Penguins,0,0,1,1,2,20171024,0,0,0,1,3,1,2017,1,1,1797,0
Ducks,1,3,2,0,6,Flyers,1,0,1,0,2,20171024,0,3,4,4,8,-4,2017,0,1,2388,0
Sabres,0,0,1,0,1,Blue Jackets,1,3,1,0,5,20171025,1,4,4,4,6,4,2017,0,2,293,0
Flames,1,1,0,0,2,Blues,1,2,2,0,5,20171025,0,1,3,3,7,3,2017,0,2,1440,0
Kings,2,1,1,0,4,Canadiens,0,0,0,0,0,20171026,2,3,4,4,4,-4,2017,0,3,2448,0
Capitals,0,1,1,0,2,Canucks,3,2,1,0,6,20171026,3,4,4,4,8,4,2017,0,3,2359,0
Stars,1,2,1,0,4,Oilers,2,1,2,0,5,20171026,1,0,1,1,9,1,2017,0,3,1655,0
Islanders,1,1,2,0,4,Wild,3,1,2,0,6,20171026,2,2,2,2,10,2,2017,0,3,1016,0
Ducks,1,0,2,0,3,Panthers,3,3,2,0,8,20171026,2,5,5,5,11,5,2017,0,3,2335,0
Red Wings,1,0,1,0,2,Lightning,1,0,2,0,3,20171026,0,0,1,1,5,1,2017,0,3,994,0
Jets,1,0,0,0,1,Penguins,1,0,0,1,2,20171026,0,0,0,1,3,1,2017,1,3,1060,0
Coyotes,0,1,1,0,2,Rangers,2,2,1,0,5,20171026,2,3,3,3,7,3,2017,0,3,2139,0
Hurricanes,3,1,2,0,6,Maple Leafs,1,2,0,0,3,20171026,2,1,3,3,9,-3,2017,0,3,544,0
Sharks,0,1,0,0,1,Bruins,1,1,0,0,2,20171026,1,1,1,1,3,1,2017,0,3,2678,0
Flyers,0,2,2,0,4,Senators,3,1,1,0,5,20171026,3,2,1,1,9,1,2017,0,3,373,0
Blues,0,1,1,0,2,Hurricanes,0,1,0,0,1,20171027,0,0,1,1,3,-1,2017,0,4,665,0
Predators,0,2,0,0,2,Blackhawks,1,0,0,0,1,20171027,-1,1,1,1,3,-1,2017,0,4,395,0
Stars,0,1,1,0,2,Flames,0,1,0,0,1,20171027,0,0,1,1,3,-1,2017,0,4,1536,0
Jets,1,0,0,0,1,Blue Jackets,0,0,1,1,2,20171027,-1,-1,0,1,3,1,2017,1,4,975,0
Avalanche,0,0,0,0,0,Golden Knights,0,4,3,0,7,20171027,0,4,7,7,7,7,2017,0,4,604,0
Senators,2,0,2,0,4,Devils,1,2,1,1,5,20171027,-1,1,0,1,9,1,2017,1,4,330,0
Capitals,1,1,3,0,5,Oilers,2,0,0,0,2,20171028,-1,0,3,3,7,-3,2017,0,5,1985,0
Blackhawks,0,2,1,0,3,Avalanche,3,2,1,0,6,20171028,3,3,3,3,9,3,2017,0,5,916,0
Penguins,1,0,0,0,1,Wild,1,0,1,0,2,20171028,0,0,1,1,3,1,2017,0,5,741,0
Islanders,1,2,3,0,6,Predators,0,1,1,0,2,20171028,1,2,4,4,8,-4,2017,0,5,758,0
Coyotes,1,2,0,0,3,Devils,1,1,2,0,4,20171028,0,-1,1,1,7,1,2017,0,5,2131,0
Blue Jackets,0,0,1,0,1,Blues,1,1,2,0,4,20171028,1,2,3,3,5,3,2017,0,5,395,0
Ducks,0,3,1,0,4,Lightning,0,1,0,0,1,20171028,0,2,3,3,5,-3,2017,0,5,2149,0
Rangers,0,2,2,0,4,Canadiens,3,1,1,0,5,20171028,3,2,1,1,9,1,2017,0,5,343,0
Flyers,2,2,0,0,4,Maple Leafs,1,1,0,0,2,20171028,1,2,2,2,6,-2,2017,0,5,334,0
Kings,1,0,0,1,2,Bruins,1,0,0,0,1,20171028,0,0,0,1,3,-1,2017,1,5,2590,0
Sharks,1,1,1,0,3,Sabres,0,2,0,0,2,20171028,1,0,1,1,5,-1,2017,0,5,2279,0
Red Wings,1,1,0,1,3,Panthers,0,2,0,0,2,20171028,1,0,0,1,5,-1,2017,1,5,1155,0
Ducks,2,0,1,1,4,Hurricanes,1,2,0,0,3,20171029,1,-1,0,1,7,-1,2017,1,6,2231,0
Penguins,0,1,0,0,1,Jets,5,0,2,0,7,20171029,5,4,6,6,8,6,2017,0,6,1060,0
Capitals,0,0,1,0,1,Flames,0,1,1,0,2,20171029,0,1,1,1,3,1,2017,0,6,1967,0
Maple Leafs,1,0,1,0,2,Sharks,0,1,2,0,3,20171030,-1,0,1,1,5,1,2017,0,0,2249,0
Stars,0,1,0,1,2,Canucks,0,0,1,0,1,20171030,0,1,0,1,3,-1,2017,1,0,1766,0
Lightning,3,3,2,0,8,Panthers,2,1,2,0,5,20171030,1,3,3,3,13,-3,2017,0,0,205,0
Kings,0,2,0,0,2,Blues,0,3,1,0,4,20171030,0,1,2,2,6,2,2017,0,0,1586,0
Bruins,0,1,2,0,3,Blue Jackets,2,1,0,1,4,20171030,2,2,0,1,7,1,2017,1,0,642,0
Coyotes,2,0,1,1,4,Flyers,0,0,3,0,3,20171030,2,2,0,1,7,-1,2017,1,0,2078,0
Golden Knights,2,0,1,0,3,Islanders,1,2,3,0,6,20171030,-1,1,3,3,9,3,2017,0,0,2227,0
Canadiens,4,2,2,0,8,Senators,2,1,0,0,3,20171030,2,3,5,5,11,-5,2017,0,0,104,0
Golden Knights,2,2,0,0,4,Rangers,1,1,4,0,6,20171031,-1,-2,2,2,10,2,2017,0,1,2227,0
Coyotes,0,1,2,0,3,Red Wings,2,2,1,0,5,20171031,2,3,2,2,8,2,2017,0,1,1687,0
Jets,1,0,1,0,2,Wild,0,0,1,0,1,20171031,1,1,1,1,3,-1,2017,0,1,388,0
Predators,0,1,0,0,1,Sharks,1,2,1,0,4,20171101,1,2,3,3,5,3,2017,0,2,1934,0
Maple Leafs,1,0,2,0,3,Ducks,1,0,0,0,1,20171101,0,0,2,2,4,-2,2017,0,2,2170,0
Penguins,0,2,1,0,3,Oilers,0,2,0,0,2,20171101,0,0,1,1,5,-1,2017,0,2,1797,0
Flyers,0,0,0,0,0,Blackhawks,0,2,1,0,3,20171101,0,2,3,3,3,3,2017,0,2,664,0
Devils,0,1,1,0,2,Canucks,0,0,0,0,0,20171101,0,1,2,2,2,-2,2017,0,2,2421,0
Stars,1,1,0,0,2,Jets,3,0,2,0,5,20171102,2,1,3,3,7,3,2017,0,3,1183,0
Maple Leafs,0,2,1,0,3,Kings,3,2,0,0,5,20171102,3,3,2,2,8,2,2017,0,3,2170,0
Penguins,0,0,1,0,1,Flames,0,0,1,1,2,20171102,0,0,0,1,3,1,2017,1,3,1777,0
Hurricanes,2,1,0,0,3,Avalanche,2,3,0,0,5,20171102,0,2,2,2,8,2,2017,0,3,1459,0
Canadiens,0,1,2,0,3,Wild,3,1,2,0,6,20171102,3,3,3,3,9,3,2017,0,3,938,0
Sabres,1,2,2,0,5,Coyotes,1,0,3,0,4,20171102,0,2,1,1,9,-1,2017,0,3,1902,0
Blue Jackets,2,3,2,0,7,Panthers,1,2,0,0,3,20171102,1,2,4,4,10,-4,2017,0,3,993,0
Rangers,1,0,0,1,2,Lightning,0,1,0,0,1,20171102,1,0,0,1,3,-1,2017,1,3,1004,0
Red Wings,0,0,1,0,1,Senators,1,1,1,0,3,20171102,1,2,2,2,4,2,2017,0,3,406,0
Islanders,1,1,1,0,3,Capitals,2,1,1,0,4,20171102,1,1,1,1,7,1,2017,0,3,204,0
Golden Knights,0,1,0,0,1,Bruins,0,1,1,0,2,20171102,0,0,1,1,3,1,2017,0,3,2369,0
Flyers,0,1,1,0,2,Blues,0,0,0,0,0,20171102,0,1,2,2,2,-2,2017,0,3,808,0
Devils,1,1,1,0,3,Oilers,2,2,2,0,6,20171103,1,2,3,3,9,3,2017,0,4,2016,0
Predators,2,2,1,0,5,Ducks,0,2,1,0,3,20171103,2,2,2,2,8,-2,2017,0,4,1776,0
Ducks,1,0,0,0,1,Sharks,0,0,1,1,2,20171104,-1,-1,0,1,3,1,2017,1,5,305,0
Predators,2,1,0,1,4,Kings,0,0,3,0,3,20171104,2,3,0,1,7,-1,2017,1,5,1776,0
Penguins,1,0,1,0,2,Canucks,1,1,2,0,4,20171104,0,1,2,2,6,2,2017,0,5,2168,0
Hurricanes,0,0,1,0,1,Coyotes,0,1,0,1,2,20171104,0,1,0,1,3,1,2017,1,5,1898,0
Blackhawks,0,0,2,0,2,Wild,0,0,0,0,0,20171104,0,0,2,2,2,-2,2017,0,5,355,0
Sabres,0,1,0,0,1,Stars,4,1,0,0,5,20171104,4,4,4,4,6,4,2017,0,5,1197,0
Maple Leafs,1,0,3,0,4,Blues,0,3,3,0,6,20171104,-1,2,2,2,10,2,2017,0,5,659,0
Avalanche,1,2,1,1,5,Flyers,0,2,2,0,4,20171104,1,1,0,1,9,-1,2017,1,5,1574,0
Rangers,0,2,2,1,5,Panthers,0,2,2,0,4,20171104,0,0,0,1,9,-1,2017,1,5,1091,0
Blue Jackets,2,0,2,0,4,Lightning,2,2,0,1,5,20171104,0,2,0,1,9,1,2017,1,5,830,0
Capitals,2,1,0,0,3,Bruins,0,1,1,0,2,20171104,2,2,1,1,5,-1,2017,0,5,394,0
Golden Knights,1,2,2,0,5,Senators,0,2,2,0,4,20171104,1,1,1,1,9,-1,2017,0,5,2119,0
Canadiens,1,1,2,1,5,Jets,1,1,2,0,4,20171104,0,0,0,1,9,-1,2017,1,5,1115,0
Red Wings,2,1,1,0,4,Oilers,0,0,0,0,0,20171105,2,3,4,4,4,-4,2017,0,6,1592,0
Avalanche,0,2,2,0,4,Islanders,2,3,1,0,6,20171105,2,3,2,2,10,2,2017,0,6,1627,0
Canadiens,0,0,2,0,2,Blackhawks,0,0,0,0,0,20171105,0,0,2,2,2,-2,2017,0,6,732,0
Devils,1,2,1,0,4,Flames,1,2,1,1,5,20171105,0,0,0,1,9,1,2017,1,6,2015,0
Jets,3,0,1,0,4,Stars,0,1,0,0,1,20171106,3,2,3,3,5,-3,2017,0,0,1183,0
Red Wings,1,1,1,0,3,Canucks,0,0,2,0,2,20171106,1,2,1,1,5,-1,2017,0,0,1967,0
Coyotes,2,0,0,0,2,Capitals,1,1,0,1,3,20171106,-1,0,0,1,5,1,2017,1,0,1977,0
Golden Knights,1,1,1,0,3,Maple Leafs,3,0,0,1,4,20171106,2,1,0,1,7,1,2017,1,0,1946,0
Wild,1,0,2,0,3,Bruins,2,2,1,0,5,20171106,1,3,2,2,8,2,2017,0,0,1120,0
Blue Jackets,0,2,1,0,3,Rangers,0,1,4,0,5,20171106,0,-1,2,2,8,2,2017,0,0,476,0
Golden Knights,1,0,1,0,2,Canadiens,2,1,0,0,3,20171107,1,2,1,1,5,1,2017,0,1,2221,0
Capitals,0,1,0,0,1,Sabres,0,1,2,0,3,20171107,0,0,2,2,4,2,2017,0,1,292,0
Blues,0,1,2,0,3,Devils,1,0,0,0,1,20171107,-1,0,2,2,4,-2,2017,0,1,863,0
Oilers,0,1,0,1,2,Islanders,0,1,0,0,1,20171107,0,0,0,1,3,-1,2017,1,1,2024,0
Coyotes,0,0,1,0,1,Penguins,2,0,1,0,3,20171107,2,2,2,2,4,2,2017,0,1,1824,0
Panthers,0,1,0,0,1,Hurricanes,0,1,2,0,3,20171107,0,0,2,2,4,2,2017,0,1,696,0
Predators,0,1,2,0,3,Blue Jackets,0,0,1,0,1,20171107,0,1,2,2,4,-2,2017,0,1,333,0
Canucks,1,2,2,0,5,Flames,1,2,0,0,3,20171107,0,0,2,2,8,-2,2017,0,1,426,0
Kings,1,1,1,1,4,Ducks,2,1,0,0,3,20171107,-1,-1,0,1,7,-1,2017,1,1,0,0
Wild,1,0,1,0,2,Maple Leafs,1,1,2,0,4,20171108,0,1,2,2,6,2,2017,0,2,691,0
Bruins,1,0,1,0,2,Rangers,3,0,1,0,4,20171108,2,2,2,2,6,2,2017,0,2,190,0
Lightning,1,3,1,0,5,Sharks,1,0,0,0,1,20171108,0,3,4,4,6,-4,2017,0,2,2365,0
Canucks,1,0,0,0,1,Ducks,1,1,2,0,4,20171109,0,1,3,3,5,3,2017,0,3,1076,0
Wild,0,0,3,0,3,Canadiens,0,0,0,0,0,20171109,0,0,3,3,3,-3,2017,0,3,938,0
Lightning,4,0,1,0,5,Kings,0,1,1,0,2,20171109,4,3,3,3,7,-3,2017,0,3,2149,0
Red Wings,0,3,0,0,3,Flames,2,3,1,0,6,20171109,2,2,3,3,9,3,2017,0,3,1573,0
Oilers,0,1,1,1,3,Devils,1,1,0,0,2,20171109,-1,-1,0,1,5,-1,2017,1,3,2016,0
Blackhawks,0,1,0,0,1,Flyers,2,1,0,0,3,20171109,2,2,2,2,4,2,2017,0,3,664,0
Coyotes,0,2,0,0,2,Blues,0,1,1,1,3,20171109,0,-1,0,1,5,1,2017,1,3,1270,0
Jets,1,1,0,0,2,Golden Knights,2,3,0,0,5,20171110,1,3,3,3,7,3,2017,0,4,1303,0
Senators,2,1,0,1,4,Avalanche,1,1,1,0,3,20171110,1,1,0,1,7,-1,2017,1,4,1515,0
Panthers,0,1,3,0,4,Sabres,1,0,0,0,1,20171110,-1,0,3,3,5,-3,2017,0,4,1184,0
Bruins,0,1,1,0,2,Maple Leafs,0,1,1,1,3,20171110,0,0,0,1,5,1,2017,1,4,430,0
Penguins,0,1,0,0,1,Capitals,1,1,2,0,4,20171110,1,1,3,3,5,3,2017,0,4,190,0
Hurricanes,0,1,2,0,3,Blue Jackets,1,0,0,0,1,20171110,-1,0,2,2,4,-2,2017,0,4,374,0
Islanders,0,0,0,0,0,Stars,3,2,0,0,5,20171110,3,5,5,5,5,5,2017,0,4,1370,0
Penguins,1,1,2,0,4,Predators,0,3,1,1,5,20171111,-1,1,0,1,9,1,2017,1,5,471,0
Jets,0,1,3,0,4,Coyotes,1,0,0,0,1,20171111,-1,0,3,3,5,-3,2017,0,5,1365,0
Blackhawks,0,1,2,1,4,Hurricanes,2,1,0,0,3,20171111,-2,-2,0,1,7,-1,2017,1,5,641,0
Canucks,0,0,0,0,0,Sharks,1,1,3,0,5,20171111,1,2,5,5,5,5,2017,0,5,821,0
Wild,0,0,1,0,1,Flyers,0,0,0,0,0,20171111,0,0,1,1,1,-1,2017,0,5,983,0
Islanders,3,1,1,0,5,Blues,0,1,1,0,2,20171111,3,3,3,3,7,-3,2017,0,5,871,0
Blue Jackets,1,0,0,2,2,Red Wings,0,0,1,0,1,20171111,1,1,0,1,3,-1,2017,1,5,163,0
Sabres,1,0,0,0,1,Canadiens,0,0,1,1,2,20171111,-1,-1,0,1,3,1,2017,1,5,311,0
Maple Leafs,2,0,2,0,4,Bruins,1,0,0,0,1,20171111,1,1,3,3,5,-3,2017,0,5,430,0
Avalanche,1,2,0,0,3,Senators,0,2,2,0,4,20171111,-1,-1,1,1,7,1,2017,0,5,1515,0
Panthers,0,1,0,0,1,Devils,1,1,0,0,2,20171111,1,1,1,1,3,1,2017,0,5,1090,0
Oilers,1,1,0,0,2,Rangers,1,2,1,0,4,20171111,0,1,2,2,6,2,2017,0,5,2024,0
Oilers,0,0,1,0,1,Capitals,0,0,1,1,2,20171112,0,0,0,1,3,1,2017,1,6,1985,0
Devils,2,4,1,0,7,Blackhawks,4,1,0,0,5,20171112,-2,1,2,2,12,-2,2017,0,6,703,0
Lightning,0,1,1,0,2,Ducks,0,0,1,0,1,20171112,0,1,1,1,3,-1,2017,0,6,2149,0
Sharks,0,0,2,0,2,Kings,1,0,0,0,1,20171112,-1,-1,1,1,3,-1,2017,0,6,305,0
Stars,0,1,0,0,1,Hurricanes,1,0,4,0,5,20171113,1,0,4,4,6,4,2017,0,0,1055,0
Blues,2,0,2,0,4,Flames,2,0,5,0,7,20171113,0,0,3,3,11,3,2017,0,0,1440,0
Golden Knights,0,1,1,0,2,Oilers,3,1,4,0,8,20171114,3,3,6,6,10,6,2017,0,1,1204,0
Coyotes,0,0,1,0,1,Jets,1,3,0,0,4,20171114,1,4,3,3,5,3,2017,0,1,1365,0
Flyers,0,0,0,0,0,Wild,1,0,2,0,3,20171114,1,1,3,3,3,3,2017,0,1,983,0
Canucks,0,2,1,0,3,Kings,2,0,0,0,2,20171114,-2,0,1,1,5,-1,2017,0,1,1076,0
Stars,1,2,0,0,3,Panthers,2,0,1,1,4,20171114,1,-1,0,1,7,1,2017,1,1,1110,0
Blue Jackets,1,0,0,1,2,Canadiens,0,0,1,0,1,20171114,1,1,0,1,3,-1,2017,1,1,605,0
Sabres,2,2,0,0,4,Penguins,1,2,1,1,5,20171114,-1,-1,0,1,9,1,2017,1,1,178,0
Capitals,0,3,0,0,3,Predators,2,4,0,0,6,20171114,2,3,3,3,9,3,2017,0,1,566,0
Flames,1,1,0,0,2,Red Wings,4,2,2,0,8,20171115,3,4,6,6,10,6,2017,0,2,1573,0
Rangers,1,0,2,0,3,Blackhawks,0,1,5,0,6,20171115,-1,0,3,3,9,3,2017,0,2,711,0
Bruins,0,1,1,0,2,Ducks,1,2,1,0,4,20171115,1,2,2,2,6,2,2017,0,2,2590,0
Panthers,0,1,1,0,2,Sharks,0,0,0,0,0,20171116,0,1,2,2,2,-2,2017,0,3,2558,0
Bruins,1,1,0,0,2,Kings,0,1,0,0,1,20171116,1,1,1,1,3,-1,2017,0,3,2590,0
Golden Knights,2,0,3,0,5,Canucks,0,2,0,0,2,20171116,2,0,3,3,7,-3,2017,0,3,986,0
Blues,1,1,2,0,4,Oilers,1,0,0,0,1,20171116,0,1,3,3,5,-3,2017,0,3,1508,0
Capitals,0,1,1,0,2,Avalanche,2,1,3,0,6,20171116,2,2,4,4,8,4,2017,0,3,1489,0
Flyers,2,0,0,0,2,Jets,0,1,1,1,3,20171116,-2,-1,0,1,5,1,2017,1,3,1273,0
Stars,0,1,0,0,1,Lightning,0,3,3,0,6,20171116,0,2,5,5,7,5,2017,0,3,916,0
Penguins,0,2,1,0,3,Senators,0,0,1,0,1,20171116,0,2,2,2,4,-2,2017,0,3,392,0
Coyotes,0,3,2,0,5,Canadiens,2,2,0,0,4,20171116,-2,-1,1,1,9,-1,2017,0,3,2175,0
Hurricanes,1,3,0,0,4,Islanders,3,0,3,0,6,20171116,2,-1,2,2,10,2,2017,0,3,423,0
Devils,0,0,0,0,0,Maple Leafs,0,0,0,1,1,20171116,0,0,0,1,1,1,2017,1,3,333,0
Predators,1,2,1,0,4,Wild,0,2,4,0,6,20171116,-1,-1,2,2,10,2,2017,0,3,696,0
Rangers,0,0,0,0,0,Blue Jackets,0,1,1,0,2,20171117,0,1,2,2,2,2,2017,0,4,476,0
Sabres,0,0,1,0,1,Red Wings,0,1,2,0,3,20171117,0,1,2,2,4,2,2017,0,4,215,0
Blackhawks,1,0,1,0,2,Penguins,0,0,1,0,1,20171118,1,1,1,1,3,-1,2017,0,5,409,0
Avalanche,0,0,2,0,2,Predators,1,2,2,0,5,20171118,1,3,3,3,7,3,2017,0,5,1019,0
Bruins,2,0,1,0,3,Sharks,1,0,0,0,1,20171118,1,1,2,2,4,-2,2017,0,5,2678,0
Islanders,2,1,2,0,5,Lightning,0,0,3,0,3,20171118,2,3,2,2,8,-2,2017,0,5,1004,0
Blues,1,1,1,1,4,Canucks,1,2,0,0,3,20171118,0,-1,0,1,7,-1,2017,1,5,1778,0
Maple Leafs,0,2,4,0,6,Canadiens,0,0,0,0,0,20171118,0,2,6,6,6,-6,2017,0,5,303,0
Wild,1,0,0,0,1,Capitals,2,0,1,0,3,20171118,1,1,2,2,4,2,2017,0,5,931,0
Panthers,0,0,0,0,0,Kings,1,0,3,0,4,20171118,1,1,4,4,4,4,2017,0,5,2335,0
Flames,1,3,0,1,5,Flyers,3,1,0,0,4,20171118,-2,0,0,1,9,-1,2017,1,5,2003,0
Coyotes,1,0,1,1,3,Senators,1,1,0,0,2,20171118,0,-1,0,1,5,-1,2017,1,5,2071,0
Hurricanes,0,1,2,0,3,Sabres,0,0,1,0,1,20171118,0,1,2,2,4,-2,2017,0,5,491,0
Oilers,2,1,0,0,3,Stars,2,2,2,0,6,20171118,0,1,3,3,9,3,2017,0,5,1655,0
Devils,0,1,1,0,2,Jets,0,5,0,0,5,20171118,0,4,3,3,7,3,2017,0,5,1280,0
Islanders,1,0,1,0,2,Hurricanes,3,1,0,0,4,20171119,2,3,2,2,6,2,2017,0,6,423,0
Avalanche,1,0,2,1,4,Red Wings,1,1,1,0,3,20171119,0,-1,0,1,7,-1,2017,1,6,1154,0
Senators,0,0,0,0,0,Rangers,0,1,2,0,3,20171119,0,1,3,3,3,3,2017,0,6,334,0
Kings,0,1,1,0,2,Golden Knights,3,0,1,0,4,20171119,3,2,2,2,6,2,2017,0,6,228,0
Panthers,0,1,1,0,2,Ducks,1,1,1,0,3,20171119,1,1,1,1,5,1,2017,0,6,2335,0
Ducks,0,2,0,1,3,Sharks,1,0,1,0,2,20171120,-1,1,0,1,5,-1,2017,1,0,305,0
Jets,1,0,2,0,3,Predators,1,3,1,0,5,20171120,0,3,2,2,8,2,2017,0,0,1084,0
Devils,1,1,1,1,4,Wild,0,1,2,0,3,20171120,1,1,0,1,7,-1,2017,1,0,1007,0
Coyotes,1,1,2,0,4,Maple Leafs,0,1,0,0,1,20171120,1,1,3,3,5,-3,2017,0,0,1885,0
Blue Jackets,0,1,2,0,3,Sabres,0,0,2,0,2,20171120,0,1,1,1,5,-1,2017,0,0,293,0
Flames,1,1,2,0,4,Capitals,1,0,0,0,1,20171120,0,1,3,3,5,-3,2017,0,0,1967,0
Canucks,2,2,1,0,5,Flyers,1,0,1,0,2,20171121,1,3,3,3,7,-3,2017,0,1,2404,0
Oilers,0,0,3,0,3,Blues,2,2,4,0,8,20171121,2,4,5,5,11,5,2017,0,1,1508,0
Canadiens,0,1,0,0,1,Stars,0,2,1,0,3,20171121,0,1,2,2,4,2,2017,0,1,1505,0
Canadiens,1,0,1,0,2,Predators,1,0,1,1,3,20171122,0,0,0,1,5,1,2017,1,2,937,0
Stars,0,0,0,0,0,Avalanche,0,2,1,0,3,20171122,0,2,3,3,3,3,2017,0,2,661,0
Sharks,1,1,1,0,3,Coyotes,0,0,1,0,1,20171122,1,2,2,2,4,-2,2017,0,2,614,0
Maple Leafs,0,0,1,0,1,Panthers,0,1,0,1,2,20171122,0,1,0,1,3,1,2017,1,2,1234,0
Jets,1,1,0,0,2,Kings,0,0,1,0,1,20171122,1,2,1,1,3,-1,2017,0,2,1527,0
Blackhawks,2,0,0,0,2,Lightning,0,1,1,1,3,20171122,-2,-1,0,1,5,1,2017,1,2,1004,0
Golden Knights,0,1,3,0,4,Ducks,1,1,0,0,2,20171122,-1,-1,2,2,6,-2,2017,0,2,228,0
Flames,0,0,0,0,0,Blue Jackets,0,0,0,1,1,20171122,0,0,0,1,1,1,2017,1,2,1670,0
Wild,3,2,0,0,5,Sabres,1,2,1,0,4,20171122,2,2,1,1,9,-1,2017,0,2,729,0
Senators,0,1,1,0,2,Capitals,2,2,1,0,5,20171122,2,3,3,3,7,3,2017,0,2,446,0
Canucks,2,2,1,0,5,Penguins,1,0,1,0,2,20171122,1,3,3,3,7,-3,2017,0,2,2168,0
Flyers,1,2,0,0,3,Islanders,1,2,0,1,4,20171122,0,0,0,1,7,1,2017,1,2,80,0
Bruins,2,0,0,1,3,Devils,1,0,1,0,2,20171122,1,1,0,1,5,-1,2017,1,2,196,0
Oilers,2,3,1,0,6,Red Wings,2,0,0,0,2,20171122,0,3,4,4,8,-4,2017,0,2,1592,0
Rangers,3,0,3,0,6,Hurricanes,1,0,0,0,1,20171122,2,2,5,5,7,-5,2017,0,2,423,0
Canucks,0,1,1,0,2,Devils,0,3,0,0,3,20171124,0,2,1,1,5,1,2017,0,4,2421,0
Flames,0,3,1,0,4,Stars,1,2,3,0,6,20171124,1,0,2,2,10,2,2017,0,4,1536,0
Predators,1,0,1,0,2,Blues,0,0,0,0,0,20171124,1,1,2,2,2,-2,2017,0,4,253,0
Maple Leafs,0,4,1,0,5,Hurricanes,0,1,3,0,4,20171124,0,3,1,1,9,-1,2017,0,4,544,0
Senators,1,1,0,0,2,Blue Jackets,1,1,3,0,5,20171124,0,0,3,3,7,3,2017,0,4,512,0
Red Wings,0,0,1,0,1,Rangers,0,0,1,1,2,20171124,0,0,0,1,3,1,2017,1,4,480,0
Kings,0,1,1,0,2,Coyotes,1,1,0,1,3,20171124,1,1,0,1,5,1,2017,1,4,356,0
Oilers,0,0,1,0,1,Sabres,0,1,2,0,3,20171124,0,1,2,2,4,2,2017,0,4,1734,0
Lightning,1,0,0,0,1,Capitals,1,1,1,0,3,20171124,0,1,2,2,4,2,2017,0,4,818,0
Jets,2,1,1,0,4,Ducks,0,1,0,0,1,20171124,2,2,3,3,5,-3,2017,0,4,1527,0
Avalanche,2,0,0,0,2,Wild,1,1,0,1,3,20171124,-1,0,0,1,5,1,2017,1,4,698,0
Islanders,1,1,2,1,5,Flyers,0,4,0,0,4,20171124,1,-2,0,1,9,-1,2017,1,4,80,0
Penguins,0,3,0,0,3,Bruins,2,1,1,0,4,20171124,2,0,1,1,7,1,2017,0,4,481,0
Sharks,1,3,0,0,4,Golden Knights,2,2,0,1,5,20171124,1,0,0,1,9,1,2017,1,4,382,0
Ducks,1,0,0,0,1,Kings,0,0,1,1,2,20171125,-1,-1,0,1,3,1,2017,1,5,0,0
Jets,0,0,0,0,0,Sharks,2,1,1,0,4,20171125,2,3,4,4,4,4,2017,0,5,1496,0
Flames,1,2,0,0,3,Avalanche,0,1,1,0,2,20171125,1,2,1,1,5,-1,2017,0,5,898,0
Golden Knights,0,3,1,0,4,Coyotes,0,0,2,0,2,20171125,0,3,2,2,6,-2,2017,0,5,256,0
Wild,0,1,2,0,3,Blues,3,0,3,0,6,20171125,3,2,3,3,9,3,2017,0,5,466,0
Blackhawks,2,2,0,0,4,Panthers,0,1,0,0,1,20171125,2,3,3,3,5,-3,2017,0,5,1189,0
Devils,2,0,1,1,4,Red Wings,1,0,2,0,3,20171125,1,1,0,1,7,-1,2017,1,5,471,0
Islanders,0,1,1,0,2,Senators,0,0,1,0,1,20171125,0,1,1,1,3,-1,2017,0,5,334,0
Sabres,0,0,0,0,0,Canadiens,1,1,1,0,3,20171125,1,2,3,3,3,3,2017,0,5,311,0
Capitals,2,1,1,0,4,Maple Leafs,0,0,2,0,2,20171125,2,3,2,2,6,-2,2017,0,5,349,0
Lightning,0,1,1,0,2,Penguins,3,1,1,0,5,20171125,3,3,3,3,7,3,2017,0,5,874,0
Predators,1,1,1,0,3,Hurricanes,1,1,1,1,4,20171126,0,0,0,1,7,1,2017,1,6,456,0
Canucks,1,1,1,0,3,Rangers,0,1,2,1,4,20171126,-1,-1,0,1,7,1,2017,1,6,2429,0
Oilers,0,2,2,0,4,Bruins,1,1,0,0,2,20171126,-1,0,2,2,6,-2,2017,0,6,2074,0
Ducks,0,2,1,0,3,Blackhawks,3,3,1,0,7,20171127,3,4,4,4,10,4,2017,0,0,1741,0
Wild,2,0,0,0,2,Jets,2,2,3,0,7,20171127,0,2,5,5,9,5,2017,0,0,388,0
Panthers,0,1,2,0,3,Devils,0,0,2,0,2,20171127,0,1,1,1,5,-1,2017,0,0,1090,0
Flyers,0,3,1,0,4,Penguins,1,0,3,1,5,20171127,1,-2,0,1,9,1,2017,1,0,257,0
Blue Jackets,0,1,0,0,1,Canadiens,2,0,1,0,3,20171127,2,1,2,2,4,2,2017,0,0,605,0
Stars,0,3,0,0,3,Golden Knights,0,0,0,0,0,20171128,0,3,3,3,3,-3,2017,0,1,1068,0
Coyotes,1,1,0,0,2,Oilers,1,0,1,1,3,20171128,0,-1,0,1,5,1,2017,1,1,1392,0
Maple Leafs,1,1,2,0,4,Flames,0,0,1,0,1,20171128,1,2,3,3,5,-3,2017,0,1,1682,0
Kings,0,2,2,0,4,Red Wings,1,0,0,0,1,20171128,-1,1,3,3,5,-3,2017,0,1,1979,0
Blackhawks,1,0,1,0,2,Predators,1,1,1,0,3,20171128,0,1,1,1,5,1,2017,0,1,395,0
Sharks,2,1,0,0,3,Flyers,1,0,0,0,1,20171128,1,2,2,2,4,-2,2017,0,1,2499,0
Panthers,3,1,1,0,5,Rangers,0,3,1,0,4,20171128,3,1,1,1,9,-1,2017,0,1,1091,0
Canucks,1,1,0,0,2,Islanders,3,1,1,0,5,20171128,2,2,3,3,7,3,2017,0,1,2429,0
Lightning,1,1,0,0,2,Sabres,0,0,0,0,0,20171128,1,2,2,2,2,-2,2017,0,1,1051,0
Hurricanes,1,0,1,0,2,Blue Jackets,1,1,0,1,3,20171128,0,1,0,1,5,1,2017,1,1,374,0
Lightning,0,1,1,0,2,Bruins,2,1,0,0,3,20171129,2,2,1,1,5,1,2017,0,2,1183,0
Senators,1,0,0,0,1,Canadiens,0,2,0,0,2,20171129,-1,1,1,1,3,1,2017,0,2,104,0
Ducks,1,2,0,0,3,Blues,0,0,2,0,2,20171129,1,3,1,1,5,-1,2017,0,2,1586,0
Jets,1,0,1,0,2,Avalanche,1,0,1,1,3,20171129,0,0,0,1,5,1,2017,1,2,797,0
Stars,2,1,0,1,4,Blackhawks,1,1,1,0,3,20171130,1,1,0,1,7,-1,2017,1,3,802,0
Golden Knights,0,0,2,0,2,Wild,0,1,3,0,4,20171130,0,1,2,2,6,2,2017,0,3,1293,0
Coyotes,0,0,0,0,0,Flames,0,1,2,0,3,20171130,0,1,3,3,3,3,2017,0,3,1224,0
Canadiens,1,3,2,0,6,Red Wings,2,0,1,0,3,20171130,-1,2,3,3,9,-3,2017,0,3,508,0
Kings,1,2,2,0,5,Capitals,1,1,0,0,2,20171130,0,1,3,3,7,-3,2017,0,3,2294,0
Canucks,0,2,3,0,5,Predators,0,3,0,0,3,20171130,0,-1,2,2,8,-2,2017,0,3,2030,0
Maple Leafs,3,1,2,0,6,Oilers,1,2,1,0,4,20171130,2,1,2,2,10,-2,2017,0,3,1683,0
Golden Knights,2,0,2,0,4,Jets,1,1,5,0,7,20171201,-1,0,3,3,11,3,2017,0,4,1303,0
Devils,0,1,1,0,2,Avalanche,0,1,0,0,1,20171201,0,0,1,1,3,-1,2017,0,4,1618,0
Sharks,0,1,1,0,2,Panthers,1,0,0,0,1,20171201,-1,0,1,1,3,-1,2017,0,4,2558,0
Kings,2,1,1,0,4,Blues,0,1,0,0,1,20171201,2,2,3,3,5,-3,2017,0,4,1586,0
Hurricanes,1,0,0,0,1,Rangers,0,2,3,0,5,20171201,-1,1,4,4,6,4,2017,0,4,423,0
Senators,3,2,1,0,6,Islanders,2,3,0,0,5,20171201,1,0,1,1,11,-1,2017,0,4,334,0
Ducks,1,1,0,0,2,Blue Jackets,1,1,2,0,4,20171201,0,0,2,2,6,2,2017,0,4,1973,0
Penguins,3,1,0,0,4,Sabres,0,0,0,0,0,20171201,3,4,4,4,4,-4,2017,0,4,178,0
Blues,0,1,0,0,1,Wild,1,0,0,1,2,20171202,1,0,0,1,3,1,2017,1,5,466,0
Red Wings,0,0,1,0,1,Canadiens,2,4,4,0,10,20171202,2,6,9,9,11,9,2017,0,5,508,0
Sharks,1,0,1,0,2,Lightning,0,1,4,0,5,20171202,-1,0,3,3,7,3,2017,0,5,2365,0
Sabres,0,0,1,0,1,Penguins,1,2,2,0,5,20171202,1,3,4,4,6,4,2017,0,5,178,0
Blue Jackets,0,2,1,0,3,Capitals,2,1,1,0,4,20171202,2,1,1,1,7,1,2017,0,5,326,0
Maple Leafs,0,0,1,0,1,Canucks,2,0,0,0,2,20171202,2,2,1,1,3,1,2017,0,5,2090,0
Panthers,0,0,2,0,2,Hurricanes,1,0,1,1,3,20171202,1,1,0,1,5,1,2017,1,5,696,0
Ducks,0,1,1,0,2,Predators,0,1,1,1,3,20171202,0,0,0,1,5,1,2017,1,5,1776,0
Devils,0,0,0,0,0,Coyotes,2,1,2,0,5,20171202,2,3,5,5,5,5,2017,0,5,2131,0
Blackhawks,1,1,0,0,2,Stars,1,1,0,1,3,20171202,0,0,0,1,5,1,2017,1,5,802,0
Oilers,3,2,2,0,7,Flames,1,0,4,0,5,20171202,2,4,2,2,12,-2,2017,0,5,171,0
Bruins,1,2,0,0,3,Flyers,0,0,0,0,0,20171202,1,3,3,3,3,-3,2017,0,5,270,0
Coyotes,0,1,1,0,2,Golden Knights,0,1,1,1,3,20171203,0,0,0,1,5,1,2017,1,6,256,0
Kings,0,0,3,0,3,Blackhawks,0,0,1,0,1,20171203,0,0,2,2,4,-2,2017,0,6,1741,0
Senators,0,0,0,0,0,Jets,2,3,0,0,5,20171203,2,5,5,5,5,5,2017,0,6,1033,0
Stars,2,2,3,0,7,Avalanche,0,2,0,0,2,20171203,2,2,5,5,9,-5,2017,0,6,661,0
Sharks,0,1,0,0,1,Capitals,1,2,1,0,4,20171204,1,2,3,3,5,3,2017,0,0,2416,0
Islanders,1,3,0,1,5,Panthers,1,2,1,0,4,20171204,0,1,0,1,9,-1,2017,1,0,1091,0
Bruins,0,1,2,0,3,Predators,2,2,1,0,5,20171204,2,3,2,2,8,2,2017,0,0,941,0
Flyers,1,3,1,0,5,Flames,1,1,0,0,2,20171204,0,2,3,3,7,-3,2017,0,0,2003,0
Wild,0,2,0,0,2,Kings,0,1,4,0,5,20171205,0,-1,3,3,7,3,2017,0,1,1521,0
Ducks,0,3,0,0,3,Golden Knights,2,0,1,1,4,20171205,2,-1,0,1,7,1,2017,1,1,228,0
Hurricanes,0,0,0,0,0,Canucks,0,2,1,0,3,20171205,0,2,3,3,3,3,2017,0,1,2409,0
Sabres,0,2,2,0,4,Avalanche,0,1,1,0,2,20171205,0,1,2,2,6,-2,2017,0,1,1366,0
Blues,1,2,1,0,4,Canadiens,1,1,1,0,3,20171205,0,1,1,1,7,-1,2017,0,1,962,0
Islanders,0,2,0,0,2,Lightning,2,3,1,0,6,20171205,2,3,4,4,8,4,2017,0,1,1004,0
Jets,0,1,0,0,1,Red Wings,2,0,3,0,5,20171205,2,1,4,4,6,4,2017,0,1,855,0
Rangers,1,2,1,0,4,Penguins,1,1,1,0,3,20171205,0,1,1,1,7,-1,2017,0,1,314,0
Devils,1,2,1,0,4,Blue Jackets,1,0,0,0,1,20171205,0,2,3,3,5,-3,2017,0,1,467,0
Predators,1,4,0,0,5,Stars,0,0,2,0,2,20171205,1,5,3,3,7,-3,2017,0,1,616,0
Flames,1,0,0,0,1,Maple Leafs,0,1,0,1,2,20171206,-1,0,0,1,3,1,2017,1,2,1682,0
Blackhawks,1,0,1,0,2,Capitals,3,1,2,0,6,20171206,2,3,4,4,8,4,2017,0,2,594,0
Flyers,0,2,2,0,4,Oilers,0,1,1,0,2,20171206,0,1,2,2,6,-2,2017,0,2,2011,0
Senators,0,0,0,0,0,Ducks,0,2,1,0,3,20171206,0,2,3,3,3,3,2017,0,2,2345,0
Hurricanes,3,1,0,0,4,Sharks,0,2,2,1,5,20171207,-3,-2,0,1,9,1,2017,1,3,2382,0
Senators,1,1,1,0,3,Kings,1,1,1,1,4,20171207,0,0,0,1,7,1,2017,1,3,2345,0
Flyers,1,2,1,0,4,Canucks,0,1,0,0,1,20171207,1,2,3,3,5,-3,2017,0,3,2404,0
Stars,0,0,0,0,0,Blues,1,0,2,0,3,20171207,1,1,3,3,3,3,2017,0,3,547,0
Islanders,0,1,2,0,3,Penguins,1,0,2,1,4,20171207,1,0,0,1,7,1,2017,1,3,314,0
Avalanche,2,0,0,0,2,Lightning,2,1,2,0,5,20171207,0,1,3,3,7,3,2017,0,3,1521,0
Flames,1,0,1,1,3,Canadiens,1,1,0,0,2,20171207,0,-1,0,1,5,-1,2017,1,3,1852,0
Coyotes,1,0,0,0,1,Bruins,1,2,3,0,6,20171207,0,2,5,5,7,5,2017,0,3,2295,0
Jets,2,1,1,0,4,Panthers,2,1,3,0,6,20171207,0,0,2,2,10,2,2017,0,3,1899,0
Wild,0,2,0,1,3,Ducks,1,0,1,0,2,20171208,-1,1,0,1,5,-1,2017,1,4,1521,0
Sabres,1,1,0,0,2,Blackhawks,0,1,1,1,3,20171208,-1,-1,0,1,5,1,2017,1,4,453,0
Rangers,0,1,1,0,2,Capitals,1,1,2,0,4,20171208,1,1,2,2,6,2,2017,0,4,204,0
Blue Jackets,0,3,2,0,5,Devils,2,1,0,0,3,20171208,-2,0,2,2,8,-2,2017,0,4,467,0
Golden Knights,1,1,1,1,4,Predators,0,1,2,0,3,20171208,1,1,0,1,7,-1,2017,1,4,1575,0
Islanders,0,0,1,0,1,Bruins,0,1,2,0,3,20171209,0,1,2,2,4,2,2017,0,5,190,0
Hurricanes,0,0,2,0,2,Kings,0,2,0,1,3,20171209,0,2,0,1,5,1,2017,1,5,2231,0
Senators,0,0,0,0,0,Sharks,1,2,2,0,5,20171209,1,3,5,5,5,5,2017,0,5,2408,0
Blues,1,3,2,0,6,Red Wings,0,0,1,0,1,20171209,1,4,5,5,7,-5,2017,0,5,454,0
Coyotes,0,0,0,0,0,Blue Jackets,1,0,0,0,1,20171209,1,1,1,1,1,1,2017,0,5,1664,0
Canucks,1,1,0,0,2,Flames,1,0,3,0,4,20171209,0,-1,2,2,6,2,2017,0,5,426,0
Devils,0,1,1,0,2,Rangers,1,2,2,0,5,20171209,1,2,3,3,7,3,2017,0,5,8,0
Avalanche,1,2,4,0,7,Panthers,1,1,1,0,3,20171209,0,1,4,4,10,-4,2017,0,5,1724,0
Jets,1,1,1,0,3,Lightning,1,1,1,1,4,20171209,0,0,0,1,7,1,2017,1,5,1705,0
Oilers,2,2,2,0,6,Canadiens,0,1,1,0,2,20171209,2,3,4,4,8,-4,2017,0,5,1826,0
Maple Leafs,3,1,0,0,4,Penguins,0,2,1,0,3,20171209,3,2,1,1,7,-1,2017,0,5,222,0
Golden Knights,1,3,1,0,5,Stars,1,1,1,0,3,20171209,0,2,2,2,8,-2,2017,0,5,1068,0
Oilers,0,0,0,0,0,Maple Leafs,1,0,0,0,1,20171210,1,1,1,1,1,1,2017,0,6,1683,0
Coyotes,0,0,1,0,1,Blackhawks,0,0,3,0,3,20171210,0,0,2,2,4,2,2017,0,6,1450,0
Sabres,0,0,2,0,2,Blues,1,1,0,1,3,20171210,1,2,0,1,5,1,2017,1,6,660,0
Wild,2,1,0,1,4,Sharks,0,1,2,0,3,20171210,2,2,0,1,7,-1,2017,1,6,1570,0
Canucks,1,0,0,0,1,Jets,1,2,2,0,5,20171211,0,2,4,4,6,4,2017,0,0,1157,0
Hurricanes,1,0,1,0,2,Ducks,1,1,1,0,3,20171211,0,1,1,1,5,1,2017,0,0,2231,0
Panthers,0,0,1,1,2,Red Wings,1,0,0,0,1,20171211,-1,-1,0,1,3,-1,2017,1,0,1155,0
Stars,0,1,0,1,2,Rangers,0,0,1,0,1,20171211,0,1,0,1,3,-1,2017,1,0,1370,0
Capitals,0,0,1,0,1,Islanders,1,2,0,0,3,20171211,1,3,2,2,4,2,2017,0,0,204,0
Avalanche,0,0,2,0,2,Penguins,0,0,1,0,1,20171211,0,0,1,1,3,-1,2017,0,0,1317,0
Panthers,0,1,1,0,2,Blackhawks,1,0,1,1,3,20171212,1,0,0,1,5,1,2017,1,1,1189,0
Flames,0,1,0,0,1,Wild,1,0,0,1,2,20171212,1,0,0,1,3,1,2017,1,1,1043,0
Lightning,1,0,2,0,3,Blues,0,0,0,0,0,20171212,1,1,3,3,3,-3,2017,0,1,861,0
Hurricanes,1,1,0,1,3,Golden Knights,0,2,0,0,2,20171212,1,0,0,1,5,-1,2017,1,1,2028,0
Avalanche,0,1,1,0,2,Capitals,1,1,3,0,5,20171212,1,1,3,3,7,3,2017,0,1,1489,0
Maple Leafs,1,1,0,0,2,Flyers,1,0,3,0,4,20171212,0,-1,2,2,6,2,2017,0,1,334,0
Kings,0,0,1,0,1,Devils,2,2,1,0,5,20171212,2,4,4,4,6,4,2017,0,1,2436,0
Senators,0,0,2,0,2,Sabres,0,3,0,0,3,20171212,0,3,1,1,5,1,2017,0,1,219,0
Oilers,1,4,2,0,7,Blue Jackets,0,0,2,0,2,20171212,1,5,5,5,9,-5,2017,0,1,1703,0
Rangers,0,1,1,0,2,Senators,1,1,1,0,3,20171213,1,1,1,1,5,1,2017,0,2,334,0
Stars,2,2,1,0,5,Islanders,0,0,2,0,2,20171213,2,4,3,3,7,-3,2017,0,2,1370,0
Bruins,0,0,2,1,3,Red Wings,0,1,1,0,2,20171213,0,-1,0,1,5,-1,2017,1,2,611,0
Predators,2,2,3,0,7,Canucks,0,1,0,0,1,20171213,2,3,6,6,8,-6,2017,0,2,2030,0
Penguins,1,0,0,0,1,Golden Knights,1,0,1,0,2,20171214,0,0,1,1,3,1,2017,0,3,1915,0
Lightning,2,1,1,0,4,Coyotes,0,1,0,0,1,20171214,2,2,3,3,5,-3,2017,0,3,1793,0
Predators,0,4,0,0,4,Oilers,0,0,0,0,0,20171214,0,4,4,4,4,-4,2017,0,3,1758,0
Sharks,1,1,1,0,3,Flames,1,0,1,0,2,20171214,0,1,1,1,5,-1,2017,0,3,1027,0
Blackhawks,3,1,1,0,5,Jets,0,0,1,0,1,20171214,3,4,4,4,6,-4,2017,0,3,722,0
Panthers,0,1,0,0,1,Avalanche,0,1,1,0,2,20171214,0,0,1,1,3,1,2017,0,3,1724,0
Ducks,0,1,2,0,3,Blues,0,0,1,0,1,20171214,0,1,2,2,4,-2,2017,0,3,1586,0
Capitals,1,1,3,0,5,Bruins,0,1,2,0,3,20171214,1,1,2,2,8,-2,2017,0,3,394,0
Sabres,1,0,0,0,1,Flyers,1,1,0,0,2,20171214,0,1,1,1,3,1,2017,0,3,279,0
Maple Leafs,0,0,0,0,0,Wild,1,0,1,0,2,20171214,1,1,2,2,2,2,2017,0,3,691,0
Devils,1,0,0,0,1,Canadiens,1,0,0,1,2,20171214,0,0,0,1,3,1,2017,1,3,342,0
Islanders,0,3,1,0,4,Blue Jackets,3,2,1,0,6,20171214,3,2,2,2,10,2,2017,0,3,476,0
Stars,1,1,0,0,2,Devils,2,1,2,0,5,20171215,1,1,3,3,7,3,2017,0,4,1362,0
Kings,0,1,1,0,2,Rangers,1,1,2,0,4,20171215,1,1,2,2,6,2,2017,0,4,2445,0
Maple Leafs,1,0,0,0,1,Red Wings,0,2,1,0,3,20171215,-1,1,2,2,4,2,2017,0,4,205,0
Sharks,1,1,1,0,3,Canucks,2,1,0,1,4,20171215,1,1,0,1,7,1,2017,1,4,821,0
Hurricanes,0,1,3,1,5,Sabres,0,1,3,0,4,20171215,0,0,0,1,9,-1,2017,1,4,491,0
Predators,0,2,0,0,2,Flames,0,0,0,0,0,20171216,0,2,2,2,2,-2,2017,0,5,1692,0
Lightning,0,4,2,0,6,Avalanche,0,1,4,0,5,20171216,0,3,1,1,11,-1,2017,0,5,1521,0
Penguins,0,2,2,0,4,Coyotes,0,1,1,0,2,20171216,0,1,2,2,6,-2,2017,0,5,1824,0
Ducks,1,1,0,0,2,Capitals,0,0,2,1,3,20171216,-1,-2,0,1,5,1,2017,1,5,2294,0
Blue Jackets,1,0,0,0,1,Hurricanes,1,1,0,0,2,20171216,0,1,1,1,3,1,2017,0,5,374,0
Stars,1,0,0,0,1,Flyers,0,1,0,1,2,20171216,-1,0,0,1,3,1,2017,1,5,1297,0
Kings,2,0,1,0,3,Islanders,1,0,2,1,4,20171216,-1,-1,0,1,7,1,2017,1,5,2445,0
Canadiens,0,0,0,0,0,Senators,0,1,2,0,3,20171216,0,1,3,3,3,3,2017,0,5,104,0
Rangers,1,1,0,1,3,Bruins,0,1,1,0,2,20171216,1,1,0,1,5,-1,2017,1,5,190,0
Oilers,0,2,1,0,3,Wild,0,1,1,0,2,20171216,0,1,1,1,5,-1,2017,0,5,1083,0
Jets,0,0,0,0,0,Blues,1,0,1,0,2,20171216,1,1,2,2,2,2,2017,0,5,853,0
Blues,0,0,0,0,0,Jets,0,2,2,0,4,20171217,0,2,4,4,4,4,2017,0,6,853,0
Wild,0,0,1,0,1,Blackhawks,1,1,2,0,4,20171217,1,2,3,3,5,3,2017,0,6,355,0
Flames,1,4,1,0,6,Canucks,0,0,1,0,1,20171217,1,5,5,5,7,-5,2017,0,6,426,0
Panthers,2,0,0,0,2,Golden Knights,2,0,3,0,5,20171217,0,0,3,3,7,3,2017,0,6,2177,0
Sharks,1,1,1,0,3,Oilers,2,1,2,0,5,20171218,1,1,2,2,8,2,2017,0,0,1190,0
Penguins,1,0,1,0,2,Avalanche,1,2,1,0,4,20171218,0,2,2,2,6,2,2017,0,0,1317,0
Ducks,2,1,0,0,3,Devils,0,2,3,0,5,20171218,-2,-1,2,2,8,2,2017,0,0,2436,0
Blue Jackets,0,0,2,0,2,Bruins,1,2,4,0,7,20171218,1,3,5,5,9,5,2017,0,0,642,0
Kings,2,0,2,0,4,Flyers,1,0,0,0,1,20171218,1,1,3,3,5,-3,2017,0,0,2388,0
Lightning,2,0,1,0,3,Golden Knights,0,2,2,0,4,20171219,-2,0,1,1,7,1,2017,0,1,1985,0
Panthers,0,1,2,0,3,Coyotes,1,1,0,0,2,20171219,-1,-1,1,1,5,-1,2017,0,1,1978,0
Capitals,1,1,1,1,4,Stars,1,1,1,0,3,20171219,0,0,0,1,7,-1,2017,1,1,1181,0
Jets,1,3,2,0,6,Predators,2,1,1,0,4,20171219,-1,1,2,2,10,-2,2017,0,1,1084,0
Canadiens,1,3,3,0,7,Canucks,1,2,2,0,5,20171219,0,1,2,2,12,-2,2017,0,1,2273,0
Wild,1,2,3,0,6,Senators,1,2,1,0,4,20171219,0,0,2,2,10,-2,2017,0,1,838,0
Ducks,0,0,1,0,1,Rangers,1,2,1,0,4,20171219,1,3,3,3,5,3,2017,0,1,2445,0
Red Wings,2,1,3,0,6,Islanders,1,2,0,0,3,20171219,1,0,3,3,9,-3,2017,0,1,480,0
Hurricanes,1,0,0,0,1,Maple Leafs,4,0,4,0,8,20171219,3,3,7,7,9,7,2017,0,1,544,0
Bruins,0,1,2,0,3,Sabres,0,0,0,0,0,20171219,0,1,3,3,3,-3,2017,0,1,399,0
Maple Leafs,0,1,1,0,2,Blue Jackets,2,1,1,0,4,20171220,2,2,2,2,6,2,2017,0,2,313,0
Red Wings,1,2,0,0,3,Flyers,1,2,1,0,4,20171220,0,0,1,1,7,1,2017,0,2,441,0
Blues,0,1,0,0,1,Flames,1,0,1,0,2,20171220,1,0,1,1,3,1,2017,0,2,1440,0
Canucks,1,2,1,0,4,Sharks,1,3,0,1,5,20171221,0,1,0,1,9,1,2017,1,3,821,0
Avalanche,0,1,0,0,1,Kings,0,0,1,1,2,20171221,0,-1,0,1,3,1,2017,1,3,830,0
Blues,0,0,2,0,2,Oilers,0,0,3,0,3,20171221,0,0,1,1,5,1,2017,0,3,1508,0
Blackhawks,0,0,0,0,0,Stars,1,3,0,0,4,20171221,1,4,4,4,4,4,2017,0,3,802,0
Senators,1,1,1,0,3,Lightning,0,2,1,2,4,20171221,-1,0,0,1,7,1,2017,1,3,1251,0
Blue Jackets,0,1,1,0,2,Penguins,0,0,2,1,3,20171221,0,-1,0,1,5,1,2017,1,3,161,0
Hurricanes,4,0,0,0,4,Predators,1,0,0,0,1,20171221,3,3,3,3,5,-3,2017,0,3,456,0
Jets,0,0,1,0,1,Bruins,0,0,1,1,2,20171221,0,0,0,1,3,1,2017,1,3,1349,0
Ducks,2,1,1,1,5,Islanders,0,2,2,0,4,20171221,2,1,0,1,9,-1,2017,1,3,2445,0
Rangers,2,0,1,0,3,Devils,1,1,1,1,4,20171221,-1,0,0,1,7,1,2017,1,3,8,0
Flyers,0,0,2,0,2,Sabres,0,0,4,0,4,20171222,0,0,2,2,6,2,2017,0,4,279,0
Wild,1,1,0,0,2,Panthers,1,0,3,0,4,20171222,0,-1,2,2,6,2,2017,0,4,1513,0
Canadiens,1,1,1,0,3,Flames,0,0,2,0,2,20171222,1,2,1,1,5,-1,2017,0,4,1852,0
Capitals,0,1,1,0,2,Coyotes,0,0,2,1,3,20171222,0,-1,0,1,5,1,2017,1,4,1977,0
Blues,1,1,1,0,3,Canucks,0,1,0,0,1,20171223,1,1,2,2,4,-2,2017,0,5,1778,0
Avalanche,0,4,2,0,6,Coyotes,0,1,1,0,2,20171223,0,3,4,4,8,-4,2017,0,5,585,0
Predators,2,0,1,0,3,Stars,1,2,0,1,4,20171223,-1,1,0,1,7,1,2017,1,5,616,0
Canadiens,0,1,0,0,1,Oilers,2,1,1,0,4,20171223,2,2,3,3,5,3,2017,0,5,1826,0
Flyers,0,1,0,0,1,Blue Jackets,1,0,0,1,2,20171223,1,0,0,1,3,1,2017,1,5,414,0
Sabres,0,2,0,0,2,Hurricanes,1,3,0,0,4,20171223,1,2,2,2,6,2,2017,0,5,491,0
Kings,0,0,0,0,0,Sharks,0,1,1,0,2,20171223,0,1,2,2,2,2,2017,0,5,305,0
Maple Leafs,1,2,0,0,3,Rangers,0,1,1,0,2,20171223,1,2,1,1,5,-1,2017,0,5,341,0
Ducks,2,2,0,0,4,Penguins,0,0,0,0,0,20171223,2,4,4,4,4,-4,2017,0,5,2132,0
Red Wings,1,0,0,0,1,Bruins,1,0,2,0,3,20171223,0,0,2,2,4,2,2017,0,5,611,0
Jets,1,0,1,0,2,Islanders,3,0,2,0,5,20171223,2,2,3,3,7,3,2017,0,5,1287,0
Capitals,0,0,0,0,0,Golden Knights,3,0,0,0,3,20171223,3,3,3,3,3,3,2017,0,5,2080,0
Wild,0,0,0,0,0,Lightning,0,0,3,0,3,20171223,0,0,3,3,3,3,2017,0,5,1318,0
Senators,0,0,0,0,0,Panthers,0,1,0,0,1,20171223,0,1,1,1,1,1,2017,0,5,1370,0
Blackhawks,0,1,0,0,1,Devils,3,0,1,0,4,20171223,3,2,3,3,5,3,2017,0,5,703,0
Golden Knights,1,1,2,0,4,Ducks,1,0,0,0,1,20171227,0,1,3,3,5,-3,2017,0,2,228,0
Coyotes,1,1,1,0,3,Avalanche,1,0,0,0,1,20171227,0,1,2,2,4,-2,2017,0,2,585,0
Stars,1,1,0,0,2,Wild,1,2,1,0,4,20171227,0,1,2,2,6,2,2017,0,2,863,0
Predators,1,1,0,0,2,Blues,0,0,1,0,1,20171227,1,2,1,1,3,-1,2017,0,2,253,0
Oilers,2,1,0,0,3,Jets,2,2,0,0,4,20171227,0,1,1,1,7,1,2017,0,2,738,0
Blue Jackets,2,1,1,0,4,Penguins,0,1,3,1,5,20171227,-2,-2,0,1,9,1,2017,1,2,161,0
Sabres,0,1,1,0,2,Islanders,0,1,1,1,3,20171227,0,0,0,1,5,1,2017,1,2,292,0
Red Wings,0,1,0,0,1,Devils,2,0,1,0,3,20171227,2,1,2,2,4,2,2017,0,2,471,0
Senators,0,1,0,0,1,Bruins,2,2,1,0,5,20171227,2,3,4,4,6,4,2017,0,2,320,0
Canadiens,0,1,0,0,1,Hurricanes,1,0,2,0,3,20171227,1,0,2,2,4,2,2017,0,2,727,0
Capitals,0,0,0,0,0,Rangers,0,0,0,1,1,20171227,0,0,0,1,1,1,2017,1,2,204,0
Flames,2,0,0,0,2,Sharks,1,0,1,1,3,20171228,-1,-1,0,1,5,1,2017,1,3,1027,0
Bruins,2,0,1,0,3,Capitals,0,2,1,1,4,20171228,-2,0,0,1,7,1,2017,1,3,394,0
Canadiens,0,1,0,0,1,Lightning,0,1,2,0,3,20171228,0,0,2,2,4,2,2017,0,3,1311,0
Flyers,0,0,2,0,2,Panthers,1,2,0,0,3,20171228,1,3,1,1,5,1,2017,0,3,1021,0
Maple Leafs,3,3,1,0,7,Coyotes,2,1,1,0,4,20171228,1,3,3,3,11,-3,2017,0,3,1885,0
Blackhawks,1,0,1,0,2,Canucks,1,1,3,0,5,20171228,0,1,3,3,7,3,2017,0,3,1775,0
Golden Knights,0,1,1,1,3,Kings,1,0,1,0,2,20171228,-1,0,0,1,5,-1,2017,1,3,228,0
Blue Jackets,0,3,1,0,4,Senators,0,3,2,0,5,20171229,0,0,1,1,9,1,2017,0,4,512,0
Rangers,1,0,1,0,2,Red Wings,0,1,1,1,3,20171229,-1,0,0,1,5,1,2017,1,4,480,0
Flyers,0,3,2,0,5,Lightning,1,1,1,0,3,20171229,-1,1,2,2,8,-2,2017,0,4,928,0
Penguins,1,0,0,0,1,Hurricanes,0,2,0,0,2,20171229,-1,1,1,1,3,1,2017,0,4,330,0
Predators,1,0,1,0,2,Wild,2,1,1,0,4,20171229,1,2,2,2,6,2,2017,0,4,696,0
Islanders,0,1,1,0,2,Jets,2,0,2,0,4,20171229,2,1,2,2,6,2,2017,0,4,1287,0
Blues,0,0,2,0,2,Stars,0,1,3,0,4,20171229,0,1,2,2,6,2,2017,0,4,547,0
Maple Leafs,1,1,1,0,3,Avalanche,1,1,1,1,4,20171229,0,0,0,1,7,1,2017,1,4,1341,0
Blackhawks,1,1,1,1,4,Oilers,1,0,2,0,3,20171229,0,1,0,1,7,-1,2017,1,4,1437,0
Flames,0,1,0,0,1,Ducks,1,0,1,0,2,20171229,1,0,1,1,3,1,2017,0,4,1197,0
Sabres,0,2,1,1,4,Devils,1,2,0,0,3,20171229,-1,-1,0,1,7,-1,2017,1,4,284,0
Kings,2,0,2,0,4,Canucks,1,1,1,0,3,20171230,1,0,1,1,7,-1,2017,0,5,1076,0
Wild,0,0,0,0,0,Predators,0,0,3,0,3,20171230,0,0,3,3,3,3,2017,0,5,696,0
Bruins,1,3,1,0,5,Senators,0,0,0,0,0,20171230,1,4,5,5,5,-5,2017,0,5,320,0
Devils,1,0,1,0,2,Capitals,2,1,2,0,5,20171230,1,2,3,3,7,3,2017,0,5,198,0
Canadiens,0,0,0,0,0,Panthers,0,1,1,0,2,20171230,0,1,2,2,2,2,2017,0,5,1418,0
Hurricanes,0,2,0,0,2,Blues,1,1,1,0,3,20171230,1,0,1,1,5,1,2017,0,5,665,0
Sharks,0,0,0,0,0,Stars,2,2,2,0,6,20171231,2,4,6,6,6,6,2017,0,6,1449,0
Blackhawks,0,2,1,0,3,Flames,1,2,0,1,4,20171231,1,1,0,1,7,1,2017,1,6,1397,0
Jets,2,2,1,0,5,Oilers,0,0,0,0,0,20171231,2,4,5,5,5,-5,2017,0,6,738,0
Islanders,0,0,1,0,1,Avalanche,1,4,1,0,6,20171231,1,5,5,5,7,5,2017,0,6,1627,0
Lightning,0,4,1,0,5,Blue Jackets,0,0,0,0,0,20171231,0,4,5,5,5,-5,2017,0,6,830,0
Maple Leafs,0,2,1,0,3,Golden Knights,3,1,2,0,6,20171231,3,2,3,3,9,3,2017,0,6,1946,0
Coyotes,1,0,1,0,2,Ducks,2,0,3,0,5,20171231,1,1,3,3,7,3,2017,0,6,356,0
Penguins,0,1,0,0,1,Red Wings,1,2,1,0,4,20171231,1,2,3,3,5,3,2017,0,6,205,0
Rangers,2,0,0,1,3,Sabres,0,1,1,0,2,20180101,2,1,0,1,5,-1,2017,1,0,292,0
Predators,0,0,0,0,0,Golden Knights,0,2,1,0,3,20180102,0,2,3,3,3,3,2017,0,1,1575,0
Ducks,2,1,2,0,5,Canucks,0,0,0,0,0,20180102,2,3,5,5,5,-5,2017,0,1,1076,0
Kings,0,1,4,0,5,Oilers,0,0,0,0,0,20180102,0,1,5,5,5,-5,2017,0,1,1368,0
Jets,0,0,2,0,2,Avalanche,0,2,0,1,3,20180102,0,2,0,1,5,1,2017,1,1,797,0
Panthers,0,0,1,0,1,Wild,1,3,1,0,5,20180102,1,4,4,4,6,4,2017,0,1,1513,0
Blue Jackets,0,0,2,0,2,Stars,0,0,1,0,1,20180102,0,0,1,1,3,-1,2017,0,1,912,0
Sharks,1,2,1,0,4,Canadiens,0,1,0,0,1,20180102,1,2,3,3,5,-3,2017,0,1,2508,0
Capitals,2,1,1,1,5,Hurricanes,1,1,2,0,4,20180102,1,1,0,1,9,-1,2017,1,1,233,0
Penguins,0,4,1,0,5,Flyers,0,1,0,0,1,20180102,0,3,4,4,6,-4,2017,0,1,257,0
Bruins,1,1,3,0,5,Islanders,1,0,0,0,1,20180102,0,1,4,4,6,-4,2017,0,1,190,0
Lightning,0,2,0,0,2,Maple Leafs,0,0,0,0,0,20180102,0,2,2,2,2,-2,2017,0,1,1096,0
Devils,0,1,1,0,2,Blues,1,1,0,1,3,20180102,1,1,0,1,5,1,2017,1,1,863,0
Senators,0,0,1,0,1,Red Wings,1,0,0,1,2,20180103,1,1,0,1,3,1,2017,1,2,406,0
Blackhawks,1,1,3,0,5,Rangers,1,1,0,0,2,20180103,0,0,3,3,7,-3,2017,0,2,711,0
Blue Jackets,0,0,0,0,0,Avalanche,0,1,1,0,2,20180104,0,1,2,2,2,2,2017,0,3,1163,0
Predators,0,1,1,0,2,Coyotes,0,1,1,1,3,20180104,0,0,0,1,5,1,2017,1,3,1442,0
Kings,2,0,1,0,3,Flames,0,4,0,0,4,20180104,-2,2,1,1,7,1,2017,0,3,1197,0
Devils,1,1,1,0,3,Stars,0,3,1,0,4,20180104,-1,1,1,1,7,1,2017,0,3,1362,0
Ducks,0,0,1,0,1,Oilers,0,1,0,1,2,20180104,0,1,0,1,3,1,2017,1,3,1368,0
Golden Knights,0,1,0,0,1,Blues,1,0,1,0,2,20180104,1,0,1,1,3,1,2017,0,3,1375,0
Lightning,0,1,0,0,1,Canadiens,0,1,0,1,2,20180104,0,0,0,1,3,1,2017,1,3,1311,0
Hurricanes,0,2,2,0,4,Penguins,0,0,0,0,0,20180104,0,2,4,4,4,-4,2017,0,3,330,0
Sharks,1,1,0,0,2,Maple Leafs,1,1,0,1,3,20180104,0,0,0,1,5,1,2017,1,3,2249,0
Islanders,1,1,2,0,4,Flyers,1,4,1,0,6,20180104,0,3,2,2,10,2,2017,0,3,80,0
Sabres,0,0,2,0,2,Wild,3,3,0,0,6,20180104,3,6,4,4,8,4,2017,0,3,729,0
Penguins,0,3,1,0,4,Islanders,0,0,0,0,0,20180105,0,3,4,4,4,-4,2017,0,4,314,0
Sharks,2,3,0,0,5,Senators,1,1,3,1,6,20180105,-1,-3,0,1,11,1,2017,1,4,2408,0
Panthers,0,1,1,0,2,Red Wings,1,1,2,0,4,20180105,1,1,2,2,6,2,2017,0,4,1155,0
Sabres,1,1,1,0,3,Jets,2,1,1,0,4,20180105,1,1,1,1,7,1,2017,0,4,996,0
Golden Knights,2,1,2,0,5,Blackhawks,1,2,1,0,4,20180105,1,0,1,1,9,-1,2017,0,4,1519,0
Predators,1,2,1,0,4,Kings,0,1,2,0,3,20180106,1,2,1,1,7,-1,2017,0,5,1776,0
Ducks,0,0,2,0,2,Flames,2,0,1,0,3,20180106,2,2,1,1,5,1,2017,0,5,1197,0
Wild,1,1,0,0,2,Avalanche,2,2,3,0,7,20180106,1,2,5,5,9,5,2017,0,5,698,0
Rangers,0,1,0,1,2,Coyotes,1,0,0,0,1,20180106,-1,0,0,1,3,-1,2017,1,5,2139,0
Oilers,0,0,1,0,1,Stars,3,1,1,0,5,20180106,3,4,4,4,6,4,2017,0,5,1655,0
Canucks,0,1,1,0,2,Maple Leafs,0,0,2,1,3,20180106,0,-1,0,1,5,1,2017,1,5,2090,0
Hurricanes,1,0,0,0,1,Bruins,5,2,0,0,7,20180106,4,6,6,6,8,6,2017,0,5,609,0
Blues,0,1,2,0,3,Flyers,2,2,2,0,6,20180106,2,3,3,3,9,3,2017,0,5,808,0
Lightning,0,3,0,0,3,Senators,3,0,3,0,6,20180106,3,0,3,3,9,3,2017,0,5,1251,0
Rangers,1,0,0,0,1,Golden Knights,1,0,1,0,2,20180107,0,0,1,1,3,1,2017,0,6,2227,0
Bruins,1,4,0,0,5,Penguins,3,1,1,1,6,20180107,2,-1,0,1,11,1,2017,1,6,481,0
Lightning,2,1,2,0,5,Red Wings,0,1,1,0,2,20180107,2,2,3,3,7,-3,2017,0,6,994,0
Panthers,0,1,1,0,2,Blue Jackets,1,1,0,1,3,20180107,1,1,0,1,5,1,2017,1,6,993,0
Canucks,0,1,1,0,2,Canadiens,1,1,3,0,5,20180107,1,1,3,3,7,3,2017,0,6,2273,0
Oilers,0,1,0,0,1,Blackhawks,2,1,1,0,4,20180107,2,2,3,3,5,3,2017,0,6,1437,0
Blues,0,2,1,0,3,Capitals,1,0,2,1,4,20180107,1,-1,0,1,7,1,2017,1,6,708,0
Sabres,0,1,0,0,1,Flyers,0,2,2,0,4,20180107,0,1,3,3,5,3,2017,0,6,279,0
Devils,0,2,2,0,4,Islanders,1,1,2,1,5,20180107,1,0,0,1,9,1,2017,1,6,8,0
Sharks,0,1,0,0,1,Jets,1,2,1,0,4,20180107,1,2,3,3,5,3,2017,0,6,1496,0
Blue Jackets,0,0,2,1,3,Maple Leafs,0,2,0,0,2,20180108,0,-2,0,1,5,-1,2017,1,0,313,0
Jets,2,3,2,0,7,Sabres,1,1,2,0,4,20180109,1,3,3,3,11,-3,2017,0,1,996,0
Canucks,1,0,0,0,1,Capitals,2,1,0,0,3,20180109,1,2,2,2,4,2,2017,0,1,2359,0
Blackhawks,1,5,2,0,8,Senators,0,2,0,0,2,20180109,1,4,6,6,10,-6,2017,0,1,628,0
Hurricanes,2,1,1,0,4,Lightning,2,1,2,0,5,20180109,0,0,1,1,9,1,2017,0,1,585,0
Panthers,2,3,2,0,7,Blues,2,1,1,0,4,20180109,0,2,3,3,11,-3,2017,0,1,1061,0
Oilers,0,1,0,0,1,Predators,2,0,0,0,2,20180109,2,1,1,1,3,1,2017,0,1,1758,0
Flames,1,1,0,1,3,Wild,0,0,2,0,2,20180109,1,2,0,1,5,-1,2017,1,1,1043,0
Wild,0,1,1,0,2,Blackhawks,1,0,0,0,1,20180110,-1,0,1,1,3,-1,2017,0,2,355,0
Senators,1,1,2,0,4,Maple Leafs,0,1,2,0,3,20180110,1,1,1,1,7,-1,2017,0,2,203,0
Blue Jackets,0,0,1,0,1,Sabres,1,0,2,0,3,20180111,1,1,2,2,4,2,2017,0,3,293,0
Hurricanes,0,1,2,0,3,Capitals,0,1,0,0,1,20180111,0,0,2,2,4,-2,2017,0,3,233,0
Flames,1,2,2,0,5,Lightning,0,1,0,0,1,20180111,1,2,4,4,6,-4,2017,0,3,2289,0
Canucks,0,4,1,0,5,Blue Jackets,1,0,1,0,2,20180112,-1,3,3,3,7,-3,2017,0,4,2050,0
Flames,0,3,1,0,4,Panthers,0,1,1,0,2,20180112,0,2,2,2,6,-2,2017,0,4,2493,0
Capitals,1,1,2,0,4,Hurricanes,1,1,1,0,3,20180112,0,0,1,1,7,-1,2017,0,4,233,0
Jets,0,0,1,0,1,Blackhawks,0,2,0,0,2,20180112,0,2,1,1,3,1,2017,0,4,722,0
Oilers,2,0,2,0,4,Coyotes,2,0,0,0,2,20180112,0,0,2,2,6,-2,2017,0,4,1392,0
Oilers,0,1,1,1,3,Golden Knights,0,2,0,0,2,20180113,0,-1,0,1,5,-1,2017,1,5,1204,0
Coyotes,3,0,2,0,5,Sharks,3,1,1,1,6,20180113,0,1,0,1,11,1,2017,1,5,614,0
Ducks,2,0,2,0,4,Kings,0,0,2,0,2,20180113,2,2,2,2,6,-2,2017,0,5,0,0
Avalanche,1,0,3,0,4,Stars,0,1,0,0,1,20180113,1,0,3,3,5,-3,2017,0,5,661,0
Islanders,2,3,2,0,7,Rangers,1,0,1,0,2,20180113,1,4,5,5,9,-5,2017,0,5,0,0
Flyers,1,2,2,0,5,Devils,1,1,1,0,3,20180113,0,1,2,2,8,-2,2017,0,5,75,0
Red Wings,1,0,0,0,1,Penguins,2,1,1,0,4,20180113,1,2,3,3,5,3,2017,0,5,205,0
Jets,0,0,1,0,1,Wild,1,1,2,0,4,20180113,1,2,3,3,5,3,2017,0,5,388,0
Bruins,1,2,0,1,4,Canadiens,1,2,0,0,3,20180113,0,0,0,1,7,-1,2017,1,5,270,0
Red Wings,2,0,2,0,4,Blackhawks,0,0,0,0,0,20180114,2,2,4,4,4,-4,2017,0,6,238,0
Flames,2,0,2,0,4,Hurricanes,0,0,1,0,1,20180114,2,2,3,3,5,-3,2017,0,6,2038,0
Rangers,2,0,0,0,2,Penguins,1,2,2,0,5,20180114,-1,1,3,3,7,3,2017,0,6,314,0
Canucks,1,0,1,1,3,Wild,1,0,1,0,2,20180114,0,0,0,1,5,-1,2017,1,6,1427,0
Stars,0,2,0,1,3,Bruins,0,1,1,0,2,20180115,0,1,0,1,5,-1,2017,1,0,1548,0
Sharks,1,1,2,0,4,Kings,0,0,1,0,1,20180115,1,2,3,3,5,-3,2017,0,0,305,0
Islanders,2,2,0,1,5,Canadiens,2,1,1,0,4,20180115,0,1,0,1,9,-1,2017,1,0,343,0
Ducks,0,1,0,0,1,Avalanche,1,2,0,0,3,20180115,1,2,2,2,4,2,2017,0,0,830,0
Sharks,1,1,0,1,3,Coyotes,0,1,1,0,2,20180116,1,1,0,1,5,-1,2017,1,1,614,0
Blues,0,0,1,1,2,Maple Leafs,0,0,1,0,1,20180116,0,0,0,1,3,-1,2017,1,1,659,0
Devils,1,3,0,0,4,Islanders,1,0,0,0,1,20180116,0,3,3,3,5,-3,2017,0,1,8,0
Flyers,1,0,0,0,1,Rangers,3,2,0,0,5,20180116,2,4,4,4,6,4,2017,0,1,80,0
Stars,2,1,1,0,4,Red Wings,1,1,0,0,2,20180116,1,1,2,2,6,-2,2017,0,1,999,0
Golden Knights,0,0,0,0,0,Predators,0,0,1,0,1,20180116,0,0,1,1,1,1,2017,0,1,1575,0
Penguins,1,0,2,0,3,Ducks,0,4,1,0,5,20180117,-1,3,2,2,8,2,2017,0,2,2132,0
Canadiens,1,0,0,0,1,Bruins,1,1,2,0,4,20180117,0,1,3,3,5,3,2017,0,2,270,0
Capitals,1,1,1,0,3,Devils,1,2,0,1,4,20180118,0,1,0,1,7,1,2017,1,3,198,0
Sharks,0,1,2,0,3,Avalanche,3,1,1,0,5,20180118,3,3,2,2,8,2,2017,0,3,927,0
Coyotes,0,1,1,0,2,Predators,0,1,1,1,3,20180118,0,0,0,1,5,1,2017,1,3,1442,0
Golden Knights,2,1,1,0,4,Lightning,0,1,0,0,1,20180118,2,2,3,3,5,-3,2017,0,3,1985,0
Penguins,1,0,2,0,3,Kings,0,1,0,0,1,20180118,1,0,2,2,4,-2,2017,0,3,2132,0
Sabres,1,1,1,0,3,Rangers,1,1,2,0,4,20180118,0,0,1,1,7,1,2017,0,3,292,0
Stars,0,0,1,0,1,Blue Jackets,1,0,0,1,2,20180118,1,1,0,1,3,1,2017,1,3,912,0
Maple Leafs,0,2,0,0,2,Flyers,0,0,2,1,3,20180118,0,-2,0,1,5,1,2017,1,3,334,0
Bruins,1,2,2,0,5,Islanders,1,0,1,0,2,20180118,0,2,3,3,7,-3,2017,0,3,190,0
Blues,0,3,1,0,4,Senators,0,1,0,0,1,20180118,0,2,3,3,5,-3,2017,0,3,860,0
Golden Knights,1,1,1,0,3,Panthers,2,0,1,1,4,20180119,1,0,0,1,7,1,2017,1,4,2177,0
Canadiens,0,1,2,0,3,Capitals,0,1,1,0,2,20180119,0,0,1,1,5,-1,2017,0,4,495,0
Kings,0,0,1,0,1,Ducks,0,0,2,0,2,20180119,0,0,1,1,3,1,2017,0,4,0,0
Panthers,2,0,1,0,3,Predators,1,3,0,0,4,20180120,-1,2,1,1,7,1,2017,0,5,816,0
Canucks,0,2,0,0,2,Oilers,2,1,2,0,5,20180120,2,1,3,3,7,3,2017,0,5,514,0
Lightning,0,1,1,0,2,Wild,2,1,2,0,5,20180120,2,2,3,3,7,3,2017,0,5,1318,0
Penguins,1,0,0,0,1,Sharks,1,0,1,0,2,20180120,0,0,1,1,3,1,2017,0,5,2242,0
Coyotes,4,1,0,0,5,Blues,0,1,1,0,2,20180120,4,4,3,3,7,-3,2017,0,5,1270,0
Islanders,3,1,3,0,7,Blackhawks,1,1,1,0,3,20180120,2,2,4,4,10,-4,2017,0,5,711,0
Maple Leafs,1,0,3,0,4,Senators,0,3,0,0,3,20180120,1,-2,1,1,7,-1,2017,0,5,203,0
Stars,2,4,1,0,7,Sabres,0,1,0,0,1,20180120,2,5,6,6,8,-6,2017,0,5,1197,0
Devils,0,1,0,0,1,Flyers,3,0,0,0,3,20180120,3,2,2,2,4,2,2017,0,5,75,0
Hurricanes,1,0,2,0,3,Red Wings,1,0,0,0,1,20180120,0,0,2,2,4,-2,2017,0,5,511,0
Jets,0,1,0,1,2,Flames,1,0,0,0,1,20180120,-1,0,0,1,3,-1,2017,1,5,740,0
Bruins,0,2,2,0,4,Canadiens,0,1,0,0,1,20180120,0,1,3,3,5,-3,2017,0,5,270,0
Rangers,0,1,0,0,1,Avalanche,1,1,1,0,3,20180120,1,1,2,2,4,2,2017,0,5,1627,0
Flyers,0,1,0,1,2,Capitals,0,1,0,0,1,20180121,0,0,0,1,3,-1,2017,1,6,123,0
Golden Knights,3,1,1,0,5,Hurricanes,1,0,0,0,1,20180121,2,3,4,4,6,-4,2017,0,6,2028,0
Canucks,0,0,0,0,0,Jets,1,0,0,0,1,20180121,1,1,1,1,1,1,2017,0,6,1157,0
Sharks,1,2,3,0,6,Ducks,0,1,1,0,2,20180121,1,2,4,4,8,-4,2017,0,6,305,0
Rangers,2,0,0,0,2,Kings,0,3,1,0,4,20180121,-2,1,2,2,6,2,2017,0,6,2445,0
Islanders,0,1,1,0,2,Coyotes,1,1,0,1,3,20180122,1,1,0,1,5,1,2017,1,0,2139,0
Sabres,1,0,0,1,2,Flames,1,0,0,0,1,20180122,0,0,0,1,3,-1,2017,1,0,1731,0
Senators,0,1,0,0,1,Wild,1,0,2,0,3,20180122,1,0,2,2,4,2,2017,0,0,838,0
Red Wings,1,1,1,0,3,Devils,0,0,0,0,0,20180122,1,2,3,3,3,-3,2017,0,0,471,0
Lightning,0,1,1,0,2,Blackhawks,0,0,0,0,0,20180122,0,1,2,2,2,-2,2017,0,0,1004,0
Avalanche,1,1,2,0,4,Maple Leafs,0,2,0,0,2,20180122,1,0,2,2,6,-2,2017,0,0,1341,0
Sabres,1,4,0,0,5,Oilers,0,0,0,0,0,20180123,1,5,5,5,5,-5,2017,0,1,1734,0
Jets,3,0,1,1,5,Sharks,1,2,1,0,4,20180123,2,0,0,1,9,-1,2017,1,1,1496,0
Rangers,2,1,0,0,3,Ducks,4,0,2,0,6,20180123,2,1,3,3,9,3,2017,0,1,2445,0
Blue Jackets,1,1,1,0,3,Golden Knights,1,3,2,0,6,20180123,0,2,3,3,9,3,2017,0,1,1757,0
Kings,1,1,0,0,2,Canucks,4,2,0,0,6,20180123,3,4,4,4,8,4,2017,0,1,1076,0
Panthers,0,1,0,0,1,Stars,1,2,3,0,6,20180123,1,2,5,5,7,5,2017,0,1,1110,0
Senators,0,0,0,0,0,Blues,1,0,2,0,3,20180123,1,1,3,3,3,3,2017,0,1,860,0
Flyers,0,2,0,1,3,Red Wings,1,0,1,0,2,20180123,-1,1,0,1,5,-1,2017,1,1,441,0
Avalanche,0,0,2,0,2,Canadiens,0,2,2,0,4,20180123,0,2,2,2,6,2,2017,0,1,1618,0
Hurricanes,0,1,0,0,1,Penguins,0,2,1,0,3,20180123,0,1,2,2,4,2,2017,0,1,330,0
Devils,0,2,0,0,2,Bruins,0,3,0,0,3,20180123,0,1,1,1,5,1,2017,0,1,196,0
Lightning,2,0,1,1,4,Predators,2,1,0,0,3,20180123,0,-1,0,1,7,-1,2017,1,1,621,0
Maple Leafs,1,0,1,1,3,Blackhawks,1,0,1,0,2,20180124,0,0,0,1,5,-1,2017,1,2,436,0
Kings,0,0,1,1,2,Flames,1,0,0,0,1,20180124,-1,-1,0,1,3,-1,2017,1,2,1197,0
Rangers,2,3,1,0,6,Sharks,2,1,2,0,5,20180125,0,2,1,1,11,-1,2017,0,3,2549,0
Jets,1,1,1,0,3,Ducks,1,1,1,1,4,20180125,0,0,0,1,7,1,2017,1,3,1527,0
Islanders,0,1,1,0,2,Golden Knights,0,0,1,0,1,20180125,0,1,1,1,3,-1,2017,0,3,2227,0
Sabres,1,1,2,0,4,Canucks,0,0,0,0,0,20180125,1,2,4,4,4,-4,2017,0,3,2137,0
Blue Jackets,0,0,2,0,2,Coyotes,0,0,1,0,1,20180125,0,0,1,1,3,-1,2017,0,3,1664,0
Flames,2,0,1,0,3,Oilers,0,2,1,1,4,20180125,-2,0,0,1,7,1,2017,1,3,171,0
Blackhawks,3,1,1,0,5,Red Wings,0,0,1,0,1,20180125,3,4,4,4,6,-4,2017,0,3,238,0
Avalanche,0,1,0,0,1,Blues,1,1,1,0,3,20180125,1,1,2,2,4,2,2017,0,3,794,0
Capitals,1,2,1,0,4,Panthers,1,1,0,0,2,20180125,0,1,2,2,6,-2,2017,0,3,924,0
Bruins,0,1,2,0,3,Senators,1,0,1,0,2,20180125,-1,0,1,1,5,-1,2017,0,3,320,0
Wild,0,0,3,0,3,Penguins,2,2,2,0,6,20180125,2,4,3,3,9,3,2017,0,3,741,0
Lightning,0,3,2,0,5,Flyers,0,0,1,0,1,20180125,0,3,4,4,6,-4,2017,0,3,928,0
Predators,0,1,2,0,3,Devils,0,0,0,0,0,20180125,0,1,3,3,3,-3,2017,0,3,750,0
Maple Leafs,1,2,1,0,4,Stars,0,1,0,0,1,20180125,1,2,3,3,5,-3,2017,0,3,1201,0
Hurricanes,2,3,1,0,6,Canadiens,0,4,1,0,5,20180125,2,1,1,1,11,-1,2017,0,3,727,0
Devils,0,1,2,0,3,Sabres,0,0,1,0,1,20180130,0,1,2,2,4,-2,2017,0,1,284,0
Golden Knights,1,0,3,0,4,Flames,0,2,0,0,2,20180130,1,-1,2,2,6,-2,2017,0,1,1033,0
Panthers,1,1,2,0,4,Islanders,0,0,1,0,1,20180130,1,2,3,3,5,-3,2017,0,1,1091,0
Sharks,0,2,0,0,2,Penguins,1,1,3,0,5,20180130,1,0,3,3,7,3,2017,0,1,2242,0
Senators,0,1,0,0,1,Hurricanes,0,0,2,0,2,20180130,0,-1,1,1,3,1,2017,0,1,673,0
Wild,0,1,1,1,3,Blue Jackets,1,0,1,0,2,20180130,-1,0,0,1,5,-1,2017,1,1,626,0
Canadiens,0,0,1,0,1,Blues,0,1,2,0,3,20180130,0,1,2,2,4,2,2017,0,1,962,0
Blackhawks,1,1,0,0,2,Predators,0,1,0,0,1,20180130,1,1,1,1,3,-1,2017,0,1,395,0
Lightning,1,0,0,0,1,Jets,0,2,1,0,3,20180130,-1,1,2,2,4,2,2017,0,1,1705,0
Kings,1,1,1,0,3,Stars,0,0,0,0,0,20180130,1,2,3,3,3,-3,2017,0,1,1237,0
Avalanche,0,3,0,0,3,Canucks,2,0,1,1,4,20180130,2,-1,0,1,7,1,2017,1,1,1105,0
Ducks,2,0,1,0,3,Bruins,0,0,1,0,1,20180130,2,2,2,2,4,-2,2017,0,1,2590,0
Islanders,0,0,0,0,0,Maple Leafs,2,2,1,0,5,20180131,2,4,5,5,5,5,2017,0,2,341,0
Sharks,0,0,1,0,1,Red Wings,0,0,1,1,2,20180131,0,0,0,1,3,1,2017,1,2,2071,0
Flyers,2,0,1,0,3,Capitals,0,3,2,0,5,20180131,-2,1,2,2,8,2,2017,0,2,123,0
Avalanche,0,3,0,1,4,Oilers,0,1,2,0,3,20180201,0,2,0,1,7,-1,2017,1,3,1036,0
Stars,0,3,1,0,4,Coyotes,1,0,0,0,1,20180201,-1,2,3,3,5,-3,2017,0,3,884,0
Canadiens,0,0,0,0,0,Hurricanes,0,1,1,0,2,20180201,0,1,2,2,2,2,2017,0,3,727,0
Lightning,1,2,4,0,7,Flames,1,3,0,0,4,20180201,0,-1,3,3,11,-3,2017,0,3,2289,0
Blackhawks,1,0,1,0,2,Canucks,0,2,2,0,4,20180201,-1,1,2,2,6,2,2017,0,3,1775,0
Kings,0,0,0,0,0,Predators,3,1,1,0,5,20180201,3,4,5,5,5,5,2017,0,3,1776,0
Panthers,3,0,1,0,4,Sabres,1,1,0,0,2,20180201,2,1,2,2,6,-2,2017,0,3,1184,0
Ducks,0,0,1,0,1,Senators,0,0,1,1,2,20180201,0,0,0,1,3,1,2017,1,3,2345,0
Maple Leafs,2,2,0,0,4,Rangers,0,0,0,0,0,20180201,2,4,4,4,4,-4,2017,0,3,341,0
Flyers,2,1,0,0,3,Devils,2,0,2,0,4,20180201,0,-1,1,1,7,1,2017,0,3,75,0
Blues,0,0,1,0,1,Bruins,1,0,2,0,3,20180201,1,1,2,2,4,2,2017,0,3,1035,0
Golden Knights,0,2,0,1,3,Jets,1,0,1,0,2,20180201,-1,1,0,1,5,-1,2017,1,3,1303,0
Capitals,1,2,1,0,4,Penguins,2,1,4,0,7,20180202,1,0,3,3,11,3,2017,0,4,190,0
Red Wings,1,1,2,0,4,Hurricanes,1,0,0,0,1,20180202,0,1,3,3,5,-3,2017,0,4,511,0
Sharks,1,1,1,0,3,Blue Jackets,0,1,0,0,1,20180202,1,1,2,2,4,-2,2017,0,4,2090,0
Golden Knights,0,1,1,0,2,Wild,2,2,1,0,5,20180202,2,3,3,3,7,3,2017,0,4,1293,0
Wild,0,0,1,0,1,Stars,0,4,2,0,6,20180203,0,4,5,5,7,5,2017,0,5,863,0
Blackhawks,1,2,0,0,3,Flames,0,2,1,1,4,20180203,-1,-1,0,1,7,1,2017,1,5,1397,0
Blues,0,0,1,0,1,Sabres,0,0,0,0,0,20180203,0,0,1,1,1,-1,2017,0,5,660,0
Coyotes,0,0,0,0,0,Kings,1,3,2,0,6,20180203,1,4,6,6,6,6,2017,0,5,356,0
Rangers,0,0,2,0,2,Predators,0,2,3,0,5,20180203,0,2,3,3,7,3,2017,0,5,758,0
Lightning,2,1,1,0,4,Canucks,0,0,2,0,2,20180203,2,3,2,2,6,-2,2017,0,5,2598,0
Avalanche,0,0,0,0,0,Jets,1,0,2,0,3,20180203,1,1,3,3,3,3,2017,0,5,797,0
Ducks,0,2,0,0,2,Canadiens,3,1,1,0,5,20180203,3,2,3,3,7,3,2017,0,5,2448,0
Penguins,0,0,1,0,1,Devils,0,2,1,0,3,20180203,0,2,2,2,4,2,2017,0,5,306,0
Red Wings,0,1,1,0,2,Panthers,1,1,1,0,3,20180203,1,1,1,1,5,1,2017,0,5,1155,0
Maple Leafs,1,0,0,0,1,Bruins,1,2,1,0,4,20180203,0,2,3,3,5,3,2017,0,5,430,0
Senators,2,1,0,1,4,Flyers,0,1,2,0,3,20180203,2,2,0,1,7,-1,2017,1,5,373,0
Blue Jackets,1,2,0,0,3,Islanders,1,1,2,0,4,20180203,0,-1,1,1,7,1,2017,0,5,476,0
Golden Knights,1,1,2,0,4,Capitals,1,1,1,0,3,20180204,0,0,1,1,7,-1,2017,0,6,2080,0
Senators,0,1,0,0,1,Canadiens,0,3,1,0,4,20180204,0,2,3,3,5,3,2017,0,6,104,0
Sharks,2,1,0,0,3,Hurricanes,1,0,0,0,1,20180204,1,2,2,2,4,-2,2017,0,6,2382,0
Rangers,1,0,0,0,1,Stars,0,1,1,0,2,20180205,-1,0,1,1,3,1,2017,0,0,1370,0
Lightning,1,0,1,0,2,Oilers,2,2,2,0,6,20180205,1,3,4,4,8,4,2017,0,0,2367,0
Ducks,0,3,1,0,4,Maple Leafs,1,3,3,0,7,20180205,1,1,3,3,11,3,2017,0,0,2170,0
Predators,2,1,1,1,5,Islanders,3,1,0,0,4,20180205,-1,-1,0,1,9,-1,2017,1,0,758,0
Sharks,0,1,0,0,1,Avalanche,0,2,1,0,3,20180206,0,1,2,2,4,2,2017,0,1,927,0
Ducks,0,2,1,1,4,Sabres,1,1,1,0,3,20180206,-1,0,0,1,7,-1,2017,1,1,2193,0
Golden Knights,1,1,2,0,4,Penguins,0,3,2,0,5,20180206,-1,1,1,1,9,1,2017,0,1,1915,0
Flyers,0,1,0,1,2,Hurricanes,1,0,0,0,1,20180206,-1,0,0,1,3,-1,2017,1,1,345,0
Capitals,1,1,1,0,3,Blue Jackets,1,0,1,0,2,20180206,0,1,1,1,5,-1,2017,0,1,326,0
Devils,1,1,1,0,3,Senators,3,2,0,0,5,20180206,2,3,2,2,8,2,2017,0,1,330,0
Bruins,0,2,1,0,3,Red Wings,0,1,1,0,2,20180206,0,1,1,1,5,-1,2017,0,1,611,0
Canucks,0,1,0,0,1,Panthers,1,1,1,0,3,20180206,1,1,2,2,4,2,2017,0,1,2803,0
Wild,3,2,1,0,6,Blues,1,0,1,0,2,20180206,2,4,4,4,8,-4,2017,0,1,466,0
Coyotes,2,0,1,0,3,Jets,3,1,0,0,4,20180206,1,2,1,1,7,1,2017,0,1,1365,0
Flames,0,1,2,0,3,Blackhawks,1,0,1,0,2,20180206,-1,0,1,1,5,-1,2017,0,1,1397,0
Bruins,2,3,1,0,6,Rangers,1,0,0,0,1,20180207,1,4,5,5,7,-5,2017,0,2,190,0
Oilers,0,2,0,0,2,Kings,1,1,3,0,5,20180207,1,0,3,3,7,3,2017,0,2,1368,0
Predators,0,1,1,0,2,Maple Leafs,1,1,0,1,3,20180207,1,1,0,1,5,1,2017,1,2,646,0
Golden Knights,1,1,3,0,5,Sharks,1,1,1,0,3,20180208,0,0,2,2,8,-2,2017,0,3,382,0
Coyotes,0,1,2,1,4,Wild,1,2,0,0,3,20180208,-1,-2,0,1,7,-1,2017,1,3,1278,0
Stars,0,3,1,0,4,Blackhawks,1,1,0,0,2,20180208,-1,1,2,2,6,-2,2017,0,3,802,0
Avalanche,0,1,0,0,1,Blues,1,4,1,0,6,20180208,1,4,5,5,7,5,2017,0,3,794,0
Islanders,0,1,2,0,3,Sabres,2,1,1,0,4,20180208,2,2,1,1,7,1,2017,0,3,292,0
Predators,2,0,1,0,3,Senators,1,2,0,1,4,20180208,-1,1,0,1,7,1,2017,1,3,845,0
Canadiens,0,2,1,0,3,Flyers,0,2,3,0,5,20180208,0,0,2,2,8,2,2017,0,3,400,0
Flames,0,3,0,0,3,Devils,0,1,1,0,2,20180208,0,2,1,1,5,-1,2017,0,3,2015,0
Canucks,0,0,2,0,2,Lightning,1,3,1,0,5,20180208,1,4,3,3,7,3,2017,0,3,2598,0
Red Wings,3,0,3,0,6,Islanders,0,1,5,1,7,20180209,-3,-2,0,1,13,1,2017,1,4,480,0
Flames,1,2,0,0,3,Rangers,1,1,2,0,4,20180209,0,-1,1,1,7,1,2017,0,4,2023,0
Blue Jackets,1,1,0,0,2,Capitals,2,2,0,0,4,20180209,1,2,2,2,6,2,2017,0,4,326,0
Kings,0,2,1,0,3,Panthers,1,0,0,0,1,20180209,-1,1,2,2,4,-2,2017,0,4,2335,0
Canucks,0,1,0,0,1,Hurricanes,3,0,1,0,4,20180209,3,2,3,3,5,3,2017,0,4,2409,0
Blues,0,3,2,0,5,Jets,0,1,1,0,2,20180209,0,2,3,3,7,-3,2017,0,4,853,0
Penguins,2,0,1,0,3,Stars,1,0,2,1,4,20180209,-1,-1,0,1,7,1,2017,1,4,1069,0
Oilers,0,1,1,0,2,Ducks,1,1,1,0,3,20180209,1,1,1,1,5,1,2017,0,4,1368,0
Oilers,0,3,1,0,4,Sharks,2,1,3,0,6,20180210,2,0,2,2,10,2,2017,0,5,1190,0
Flyers,2,1,0,1,4,Coyotes,1,1,1,0,3,20180210,1,1,0,1,7,-1,2017,1,5,2078,0
Blackhawks,0,0,0,0,0,Wild,2,1,0,0,3,20180210,2,3,3,3,3,3,2017,0,5,355,0
Avalanche,1,0,0,0,1,Hurricanes,1,0,2,0,3,20180210,0,0,2,2,4,2,2017,0,5,1459,0
Sabres,0,3,1,0,4,Bruins,0,1,1,0,2,20180210,0,2,2,2,6,-2,2017,0,5,399,0
Devils,0,0,1,0,1,Blue Jackets,1,3,2,0,6,20180210,1,4,5,5,7,5,2017,0,5,467,0
Predators,0,1,1,1,3,Canadiens,0,1,1,0,2,20180210,0,0,0,1,5,-1,2017,1,5,937,0
Senators,0,1,2,0,3,Maple Leafs,3,1,2,0,6,20180210,3,3,3,3,9,3,2017,0,5,203,0
Kings,1,0,2,0,3,Lightning,2,2,0,0,4,20180210,1,3,1,1,7,1,2017,0,5,2149,0
Bruins,2,1,2,0,5,Devils,1,2,0,0,3,20180211,1,0,2,2,8,-2,2017,0,6,196,0
Flyers,1,2,1,0,4,Golden Knights,1,0,0,0,1,20180211,0,2,3,3,5,-3,2017,0,6,2171,0
Flames,0,1,2,0,3,Islanders,1,1,0,0,2,20180211,-1,-1,1,1,5,-1,2017,0,6,2023,0
Avalanche,2,1,2,0,5,Sabres,1,1,2,0,4,20180211,1,1,1,1,9,-1,2017,0,6,1366,0
Sharks,0,0,2,1,3,Ducks,1,0,1,0,2,20180211,-1,-1,0,1,5,-1,2017,1,6,305,0
Rangers,1,0,2,0,3,Jets,1,0,0,0,1,20180211,0,0,2,2,4,-2,2017,0,6,1287,0
Red Wings,1,3,0,1,5,Capitals,1,0,3,0,4,20180211,0,3,0,1,9,-1,2017,1,6,394,0
Penguins,0,1,3,0,4,Blues,0,1,0,0,1,20180211,0,0,3,3,5,-3,2017,0,6,557,0
Canucks,3,2,1,0,6,Stars,0,0,0,0,0,20180211,3,5,6,6,6,-6,2017,0,6,1766,0
Lightning,0,1,2,0,3,Maple Leafs,1,2,1,0,4,20180212,1,2,1,1,7,1,2017,0,0,1096,0
Panthers,1,2,4,0,7,Oilers,1,2,2,0,5,20180212,0,0,2,2,12,-2,2017,0,0,2569,0
Blackhawks,0,1,0,0,1,Coyotes,2,2,2,0,6,20180212,2,3,5,5,7,5,2017,0,0,1450,0
Coyotes,1,1,0,0,2,Sharks,1,0,0,0,1,20180213,0,1,1,1,3,-1,2017,0,1,614,0
Blackhawks,1,1,0,0,2,Golden Knights,1,0,4,0,5,20180213,0,-1,3,3,7,3,2017,0,1,1519,0
Rangers,1,1,0,0,2,Wild,3,0,0,0,3,20180213,2,1,1,1,5,1,2017,0,1,1016,0
Blues,1,2,0,0,3,Predators,0,0,3,1,4,20180213,-1,-3,0,1,7,1,2017,1,1,253,0
Ducks,0,0,1,0,1,Red Wings,1,1,0,0,2,20180213,1,2,1,1,3,1,2017,0,1,1979,0
Capitals,1,1,1,0,3,Jets,1,0,2,1,4,20180213,0,-1,0,1,7,1,2017,1,1,1247,0
Senators,0,2,1,0,3,Penguins,1,3,2,0,6,20180213,1,2,3,3,9,3,2017,0,1,392,0
Devils,0,3,1,1,5,Flyers,1,3,0,0,4,20180213,-1,-1,0,1,9,-1,2017,1,1,75,0
Blue Jackets,0,2,2,0,4,Islanders,1,0,0,0,1,20180213,-1,1,3,3,5,-3,2017,0,1,476,0
Lightning,1,1,1,0,3,Sabres,1,2,2,0,5,20180213,0,1,2,2,8,2,2017,0,1,1051,0
Flames,2,0,0,0,2,Bruins,1,1,3,0,5,20180213,-1,0,3,3,7,3,2017,0,1,2089,0
Kings,0,2,1,0,3,Hurricanes,3,2,2,0,7,20180213,3,3,4,4,10,4,2017,0,1,2231,0
Blue Jackets,1,2,0,0,3,Maple Leafs,2,2,2,0,6,20180214,1,1,3,3,9,3,2017,0,2,313,0
Canadiens,0,0,0,0,0,Avalanche,0,1,1,0,2,20180214,0,1,2,2,2,2,2017,0,2,1618,0
Panthers,4,0,0,0,4,Canucks,2,1,0,0,3,20180214,2,1,1,1,7,-1,2017,0,2,2803,0
Canadiens,0,0,2,0,2,Coyotes,1,2,2,0,5,20180215,1,3,3,3,7,3,2017,0,3,2175,0
Ducks,0,2,1,0,3,Blackhawks,0,2,0,0,2,20180215,0,0,1,1,5,-1,2017,0,3,1741,0
Capitals,0,2,3,0,5,Wild,0,0,2,0,2,20180215,0,2,3,3,7,-3,2017,0,3,931,0
Flames,1,1,2,0,4,Predators,1,1,1,0,3,20180215,0,0,1,1,7,-1,2017,0,3,1692,0
Hurricanes,1,1,0,0,2,Devils,1,2,2,0,5,20180215,0,1,3,3,7,3,2017,0,3,419,0
Sabres,1,0,1,0,2,Senators,0,0,2,1,3,20180215,-1,-1,0,1,5,1,2017,1,3,219,0
Kings,0,1,0,0,1,Penguins,0,1,2,0,3,20180215,0,0,2,2,4,2,2017,0,3,2132,0
Rangers,0,0,0,0,0,Islanders,1,1,1,0,3,20180215,1,2,3,3,3,3,2017,0,3,0,0
Oilers,0,0,1,0,1,Golden Knights,1,2,1,0,4,20180215,1,3,3,3,5,3,2017,0,3,1204,0
Red Wings,0,1,0,0,1,Lightning,2,1,1,0,4,20180215,2,2,3,3,5,3,2017,0,3,994,0
Canucks,0,0,1,0,1,Sharks,1,1,2,0,4,20180215,1,2,3,3,5,3,2017,0,3,821,0
Blues,0,0,1,0,1,Stars,0,1,1,0,2,20180216,0,1,1,1,3,1,2017,0,4,547,0
Avalanche,0,0,1,0,1,Jets,1,3,2,0,6,20180216,1,4,5,5,7,5,2017,0,4,797,0
Islanders,0,1,2,0,3,Hurricanes,0,0,0,0,0,20180216,0,1,3,3,3,-3,2017,0,4,423,0
Flyers,0,1,0,1,2,Blue Jackets,0,0,1,0,1,20180216,0,1,0,1,3,-1,2017,1,4,414,0
Kings,1,3,0,0,4,Sabres,0,0,2,0,2,20180217,1,4,2,2,6,-2,2017,0,5,2193,0
Rangers,1,1,1,0,3,Senators,2,2,2,0,6,20180217,1,2,3,3,9,3,2017,0,5,334,0
Ducks,1,0,1,1,3,Wild,1,1,0,0,2,20180217,0,-1,0,1,5,-1,2017,1,5,1521,0
Oilers,0,0,0,0,0,Coyotes,1,0,0,0,1,20180217,1,1,1,1,1,1,2017,0,5,1392,0
Devils,1,2,1,0,4,Lightning,1,1,1,0,3,20180217,0,1,1,1,7,-1,2017,0,5,1000,0
Maple Leafs,2,1,0,0,3,Penguins,2,1,2,0,5,20180217,0,0,2,2,8,2,2017,0,5,222,0
Canadiens,2,0,1,0,3,Golden Knights,3,2,1,0,6,20180217,1,3,3,3,9,3,2017,0,5,2221,0
Red Wings,2,0,1,0,3,Predators,0,0,1,0,1,20180217,2,2,2,2,4,-2,2017,0,5,470,0
Capitals,1,0,0,0,1,Blackhawks,3,3,1,0,7,20180217,2,5,6,6,8,6,2017,0,5,594,0
Panthers,1,3,2,0,6,Flames,1,1,1,0,3,20180217,0,2,3,3,9,-3,2017,0,5,2493,0
Bruins,0,0,1,0,1,Canucks,4,1,1,0,6,20180217,4,5,5,5,7,5,2017,0,5,2504,0
Stars,0,0,2,0,2,Sharks,4,1,0,0,5,20180218,4,5,3,3,7,3,2017,0,6,1449,0
Panthers,1,1,0,0,2,Jets,1,2,4,0,7,20180218,0,1,5,5,9,5,2017,0,6,1899,0
Maple Leafs,0,2,1,0,3,Red Wings,0,1,1,0,2,20180218,0,1,1,1,5,-1,2017,0,6,205,0
Devils,1,1,0,1,3,Hurricanes,0,1,1,0,2,20180218,1,1,0,1,5,-1,2017,1,6,419,0
Oilers,0,1,3,0,4,Avalanche,1,1,0,0,2,20180218,-1,-1,2,2,6,-2,2017,0,6,1036,0
Flyers,3,2,2,0,7,Rangers,3,1,0,0,4,20180218,0,1,3,3,11,-3,2017,0,6,80,0
Penguins,3,1,1,0,5,Blue Jackets,1,0,1,0,2,20180218,2,3,3,3,7,-3,2017,0,6,161,0
Wild,1,3,1,0,5,Islanders,1,2,0,0,3,20180219,0,1,2,2,8,-2,2017,0,0,1016,0
Capitals,0,2,1,0,3,Sabres,0,0,2,0,2,20180219,0,2,1,1,5,-1,2017,0,0,292,0
Bruins,1,0,0,1,2,Flames,0,1,0,0,1,20180219,1,0,0,1,3,-1,2017,1,0,2089,0
Senators,1,1,0,0,2,Predators,2,2,1,0,5,20180219,1,2,3,3,7,3,2017,0,0,845,0
Kings,2,1,0,0,3,Blackhawks,0,0,1,0,1,20180219,2,3,2,2,4,-2,2017,0,0,1741,0
Ducks,1,0,1,0,2,Golden Knights,0,0,0,0,0,20180219,1,1,2,2,2,-2,2017,0,0,228,0
Kings,0,2,2,0,4,Jets,1,1,1,0,3,20180220,-1,0,1,1,7,-1,2017,0,1,1527,0
Avalanche,0,3,1,1,5,Canucks,0,4,0,0,4,20180220,0,-1,0,1,9,-1,2017,1,1,1105,0
Bruins,0,0,3,0,3,Oilers,1,1,0,0,2,20180220,-1,-2,1,1,5,-1,2017,0,1,2074,0
Sharks,0,3,0,0,3,Blues,0,2,0,0,2,20180220,0,1,1,1,5,-1,2017,0,1,1719,0
Lightning,3,0,1,0,4,Capitals,0,1,1,0,2,20180220,3,2,2,2,6,-2,2017,0,1,818,0
Canadiens,1,0,1,0,2,Flyers,0,1,1,1,3,20180220,-1,0,0,1,5,1,2017,1,1,400,0
Blue Jackets,1,1,0,0,2,Devils,0,1,0,0,1,20180220,1,1,1,1,3,-1,2017,0,1,467,0
Panthers,0,0,0,0,0,Maple Leafs,1,0,0,0,1,20180220,1,1,1,1,1,1,2017,0,1,1234,0
Predators,2,0,1,0,3,Red Wings,0,1,1,0,2,20180220,2,1,1,1,5,-1,2017,0,1,470,0
Senators,1,1,0,0,2,Blackhawks,1,1,0,1,3,20180221,0,0,0,1,5,1,2017,1,2,628,0
Stars,0,0,0,0,0,Ducks,1,0,1,0,2,20180221,1,1,2,2,2,2,2017,0,2,1237,0
Flames,1,2,0,0,3,Golden Knights,2,2,3,0,7,20180221,1,1,4,4,10,4,2017,0,2,1033,0
Capitals,1,1,0,0,2,Panthers,1,0,2,0,3,20180222,0,-1,1,1,5,1,2017,0,3,924,0
Stars,0,0,2,0,2,Kings,0,0,0,0,0,20180222,0,0,2,2,2,-2,2017,0,3,1237,0
Flames,2,1,2,0,5,Coyotes,1,0,1,0,2,20180222,1,2,3,3,7,-3,2017,0,3,1224,0
Avalanche,0,1,1,0,2,Oilers,0,2,0,1,3,20180222,0,1,0,1,5,1,2017,1,3,1036,0
Sharks,0,1,0,0,1,Predators,2,1,4,0,7,20180222,2,2,6,6,8,6,2017,0,3,1934,0
Lightning,2,2,0,0,4,Senators,1,0,2,0,3,20180222,1,3,1,1,7,-1,2017,0,3,1251,0
Rangers,0,0,1,0,1,Canadiens,1,1,1,0,3,20180222,1,2,2,2,4,2,2017,0,3,343,0
Blue Jackets,0,1,0,0,1,Flyers,0,0,2,0,2,20180222,0,-1,1,1,3,1,2017,0,3,414,0
Wild,0,3,1,0,4,Devils,1,1,0,0,2,20180222,-1,1,2,2,6,-2,2017,0,3,1007,0
Islanders,2,0,1,0,3,Maple Leafs,1,0,2,1,4,20180222,-1,-1,0,1,7,1,2017,1,3,341,0
Sabres,1,1,0,1,3,Red Wings,0,1,1,0,2,20180222,1,1,0,1,5,-1,2017,1,3,215,0
Canucks,2,0,1,0,3,Golden Knights,2,3,1,0,6,20180223,0,3,3,3,9,3,2017,0,4,986,0
Wild,2,0,2,0,4,Rangers,0,1,0,0,1,20180223,2,1,3,3,5,-3,2017,0,4,1016,0
Penguins,1,3,2,0,6,Hurricanes,0,1,0,0,1,20180223,1,3,5,5,7,-5,2017,0,4,330,0
Jets,3,1,0,0,4,Blues,0,0,0,0,0,20180223,3,4,4,4,4,-4,2017,0,4,853,0
Sharks,0,0,1,0,1,Blackhawks,0,1,2,0,3,20180223,0,1,2,2,4,2,2017,0,4,1837,0
Jets,0,5,0,0,5,Stars,1,1,1,0,3,20180224,-1,3,2,2,8,-2,2017,0,5,1183,0
Blackhawks,1,1,0,0,2,Blue Jackets,1,1,1,0,3,20180224,0,0,1,1,5,1,2017,0,5,275,0
Oilers,1,2,1,0,4,Kings,0,1,2,0,3,20180224,1,2,1,1,7,-1,2017,0,5,1368,0
Ducks,0,0,0,0,0,Coyotes,1,0,1,0,2,20180224,1,1,2,2,2,2,2017,0,5,356,0
Sabres,0,0,1,0,1,Capitals,1,1,3,0,5,20180224,1,2,4,4,6,4,2017,0,5,292,0
Islanders,0,1,0,0,1,Devils,0,0,2,0,2,20180224,0,-1,1,1,3,1,2017,0,5,8,0
Hurricanes,0,1,0,0,1,Red Wings,1,2,0,0,3,20180224,1,2,2,2,4,2,2017,0,5,511,0
Flyers,2,0,3,0,5,Senators,1,0,2,0,3,20180224,1,1,2,2,8,-2,2017,0,5,373,0
Avalanche,1,0,0,0,1,Flames,2,1,2,0,5,20180224,1,2,4,4,6,4,2017,0,5,898,0
Penguins,1,1,3,0,5,Panthers,2,2,2,0,6,20180224,1,2,1,1,11,1,2017,0,5,1013,0
Lightning,1,1,1,1,4,Canadiens,1,2,0,0,3,20180224,0,-1,0,1,7,-1,2017,1,5,1311,0
Bruins,2,1,0,0,3,Maple Leafs,2,1,1,0,4,20180224,0,0,1,1,7,1,2017,0,5,430,0
Blues,0,0,0,0,0,Predators,2,2,0,0,4,20180225,2,4,4,4,4,4,2017,0,6,253,0
Bruins,0,1,0,0,1,Sabres,2,1,1,0,4,20180225,2,2,3,3,5,3,2017,0,6,399,0
Red Wings,1,1,0,1,3,Rangers,0,1,1,0,2,20180225,1,1,0,1,5,-1,2017,1,6,480,0
Sharks,1,1,0,0,2,Wild,0,1,1,1,3,20180225,-1,-1,0,1,5,1,2017,1,6,1570,0
Oilers,2,1,2,1,6,Ducks,1,1,3,0,5,20180225,1,1,0,1,11,-1,2017,1,6,1368,0
Canucks,1,0,2,0,3,Coyotes,0,0,1,0,1,20180225,1,1,2,2,4,-2,2017,0,6,1228,0
Capitals,1,0,0,0,1,Blue Jackets,4,0,1,0,5,20180226,3,3,4,4,6,4,2017,0,0,326,0
Flyers,0,0,0,1,1,Canadiens,0,0,0,0,0,20180226,0,0,0,1,1,-1,2017,1,0,400,0
Maple Leafs,2,0,1,0,3,Lightning,1,2,0,1,4,20180226,-1,1,0,1,7,1,2017,1,0,1096,0
Canucks,0,0,1,0,1,Avalanche,1,0,2,0,3,20180226,1,1,2,2,4,2,2017,0,0,1105,0
Golden Knights,1,0,1,0,2,Kings,0,0,2,1,3,20180226,-1,-1,0,1,5,1,2017,1,0,228,0
Kings,1,2,1,0,4,Golden Knights,1,0,0,0,1,20180227,0,2,3,3,5,-3,2017,0,1,228,0
Senators,0,1,1,0,2,Capitals,1,2,0,0,3,20180227,1,2,1,1,5,1,2017,0,1,446,0
Flames,0,0,0,0,0,Stars,1,1,0,0,2,20180227,1,2,2,2,2,2,2017,0,1,1536,0
Oilers,1,0,1,0,2,Sharks,0,4,1,0,5,20180227,-1,3,3,3,7,3,2017,0,1,1190,0
Predators,0,3,3,0,6,Jets,0,4,1,0,5,20180227,0,-1,1,1,11,-1,2017,0,1,1084,0
Hurricanes,3,0,0,0,3,Bruins,2,1,0,1,4,20180227,-1,0,0,1,7,1,2017,1,1,609,0
Maple Leafs,0,2,0,0,2,Panthers,1,1,0,1,3,20180227,1,0,0,1,5,1,2017,1,1,1234,0
Devils,1,1,1,0,3,Penguins,1,1,0,0,2,20180227,0,0,1,1,5,-1,2017,0,1,306,0
Blues,1,2,0,0,3,Wild,3,3,2,0,8,20180227,2,3,5,5,11,5,2017,0,1,466,0
Islanders,1,0,0,0,1,Canadiens,1,2,0,0,3,20180228,0,2,2,2,4,2,2017,0,2,343,0
Sabres,0,0,1,1,2,Lightning,1,0,0,0,1,20180228,-1,-1,0,1,3,-1,2017,1,2,1051,0
Red Wings,0,0,1,0,1,Blues,0,1,1,0,2,20180228,0,1,1,1,3,1,2017,0,2,454,0
Flames,1,1,0,0,2,Avalanche,0,4,1,0,5,20180228,-1,2,3,3,7,3,2017,0,2,898,0
Rangers,3,1,1,1,6,Canucks,2,1,2,0,5,20180228,1,1,0,1,11,-1,2017,1,2,2429,0
Predators,0,2,2,0,4,Oilers,2,0,0,0,2,20180301,-2,0,2,2,6,-2,2017,0,3,1758,0
Blackhawks,1,0,1,0,2,Sharks,2,4,1,0,7,20180301,1,5,5,5,9,5,2017,0,3,1837,0
Wild,1,0,2,0,3,Coyotes,0,1,4,0,5,20180301,-1,0,2,2,8,2,2017,0,3,1278,0
Blue Jackets,2,0,0,0,2,Kings,0,3,2,0,5,20180301,-2,1,3,3,7,3,2017,0,3,1973,0
Lightning,1,3,0,1,5,Stars,1,1,2,0,4,20180301,0,2,0,1,9,-1,2017,1,3,916,0
Hurricanes,1,2,1,0,4,Flyers,0,0,1,0,1,20180301,1,3,3,3,5,-3,2017,0,3,345,0
Penguins,3,0,1,0,4,Bruins,5,3,0,0,8,20180301,2,5,4,4,12,4,2017,0,3,481,0
Devils,0,1,1,0,2,Panthers,1,0,2,0,3,20180301,1,0,1,1,5,1,2017,0,3,1090,0
Canadiens,1,2,3,0,6,Islanders,1,2,0,0,3,20180302,0,0,3,3,9,-3,2017,0,4,343,0
Sabres,1,0,0,0,1,Panthers,2,2,0,0,4,20180302,1,3,3,3,5,3,2017,0,4,1184,0
Devils,0,1,0,0,1,Hurricanes,0,1,2,0,3,20180302,0,0,2,2,4,2,2017,0,4,419,0
Red Wings,1,1,1,0,3,Jets,2,2,0,0,4,20180302,1,2,1,1,7,1,2017,0,4,855,0
Wild,0,1,0,0,1,Avalanche,2,4,1,0,7,20180302,2,5,6,6,8,6,2017,0,4,698,0
Rangers,1,2,0,0,3,Flames,1,0,0,0,1,20180302,0,2,2,2,4,-2,2017,0,4,2023,0
Predators,0,1,2,1,4,Canucks,1,1,1,0,3,20180302,-1,-1,0,1,7,-1,2017,1,4,2030,0
Senators,1,3,1,0,5,Golden Knights,2,0,2,0,4,20180302,-1,2,1,1,9,-1,2017,0,4,2119,0
Blue Jackets,1,0,1,0,2,Ducks,1,2,1,0,4,20180302,0,2,2,2,6,2,2017,0,4,1973,0
Rangers,1,2,0,0,3,Oilers,0,2,0,0,2,20180303,1,1,1,1,5,-1,2017,0,5,2024,0
Senators,1,0,0,0,1,Coyotes,1,1,0,0,2,20180303,0,1,1,1,3,1,2017,0,5,2071,0
Maple Leafs,1,1,0,0,2,Capitals,3,2,0,0,5,20180303,2,3,3,3,7,3,2017,0,5,349,0
Islanders,1,0,1,0,2,Penguins,0,1,1,1,3,20180303,-1,0,0,1,5,1,2017,1,5,314,0
Blackhawks,1,0,4,0,5,Kings,0,3,0,0,3,20180303,1,-2,2,2,8,-2,2017,0,5,1741,0
Blues,0,1,1,0,2,Stars,0,1,1,1,3,20180303,0,0,0,1,5,1,2017,1,5,547,0
Flyers,3,1,2,0,6,Lightning,1,2,3,1,7,20180303,-2,-1,0,1,13,1,2017,1,5,928,0
Canadiens,1,0,0,0,1,Bruins,0,0,1,1,2,20180303,-1,-1,0,1,3,1,2017,1,5,270,0
Blue Jackets,2,1,1,0,4,Sharks,0,1,1,0,2,20180304,2,2,2,2,6,-2,2017,0,6,2090,0
Red Wings,1,0,0,0,1,Wild,0,2,2,0,4,20180304,-1,1,3,3,5,3,2017,0,6,542,0
Golden Knights,0,3,0,0,3,Devils,0,2,0,0,2,20180304,0,1,1,1,5,-1,2017,0,6,2218,0
Jets,1,1,1,0,3,Hurricanes,1,0,1,0,2,20180304,0,1,1,1,5,-1,2017,0,6,1350,0
Predators,1,1,1,1,4,Avalanche,1,0,2,0,3,20180304,0,1,0,1,7,-1,2017,1,6,1019,0
Flyers,0,0,1,0,1,Panthers,2,1,1,0,4,20180304,2,3,3,3,5,3,2017,0,6,1021,0
Blackhawks,0,1,2,0,3,Ducks,2,2,2,0,6,20180304,2,3,3,3,9,3,2017,0,6,1741,0
Islanders,1,1,1,0,3,Canucks,0,2,1,1,4,20180305,-1,0,0,1,7,1,2017,1,0,2429,0
Flames,2,1,0,0,3,Penguins,2,1,0,1,4,20180305,0,0,0,1,7,1,2017,1,0,1777,0
Maple Leafs,1,1,1,0,3,Sabres,2,2,1,0,5,20180305,1,2,2,2,8,2,2017,0,0,57,0
Senators,0,1,1,1,3,Stars,1,0,1,0,2,20180305,-1,0,0,1,5,-1,2017,1,0,1404,0
Coyotes,1,0,2,0,3,Oilers,3,0,0,1,4,20180305,2,2,0,1,7,1,2017,1,0,1392,0
Hurricanes,0,0,2,0,2,Wild,1,4,1,0,6,20180306,1,5,4,4,8,4,2017,0,1,995,0
Golden Knights,0,1,0,0,1,Blue Jackets,1,2,1,0,4,20180306,1,2,3,3,5,3,2017,0,1,1757,0
Capitals,0,0,0,0,0,Ducks,2,1,1,0,4,20180306,2,3,4,4,4,4,2017,0,1,2294,0
Avalanche,0,1,0,0,1,Blackhawks,1,0,0,1,2,20180306,1,0,0,1,3,1,2017,1,1,916,0
Stars,0,0,0,0,0,Predators,0,0,2,0,2,20180306,0,0,2,2,2,2,2017,0,1,616,0
Jets,1,1,1,0,3,Rangers,0,0,0,0,0,20180306,1,2,3,3,3,-3,2017,0,1,1287,0
Panthers,1,1,2,0,4,Lightning,2,2,0,1,5,20180306,1,2,0,1,9,1,2017,1,1,205,0
Canadiens,0,2,2,0,4,Devils,4,2,0,0,6,20180306,4,4,2,2,10,2,2017,0,1,342,0
Red Wings,2,2,1,0,5,Bruins,3,2,0,1,6,20180306,1,1,0,1,11,1,2017,1,1,611,0
Flames,2,3,0,0,5,Sabres,0,0,1,0,1,20180307,2,5,4,4,6,-4,2017,0,2,1731,0
Penguins,1,3,1,0,5,Flyers,0,2,0,0,2,20180307,1,2,3,3,7,-3,2017,0,2,257,0
Coyotes,1,0,1,0,2,Canucks,1,0,0,0,1,20180307,0,0,1,1,3,-1,2017,0,2,1228,0
Blues,0,0,0,0,0,Sharks,0,0,2,0,2,20180308,0,0,2,2,2,2,2017,0,3,1719,0
Capitals,0,1,0,0,1,Kings,1,1,1,0,3,20180308,1,1,2,2,4,2,2017,0,3,2294,0
Islanders,0,0,1,0,1,Oilers,0,0,1,1,2,20180308,0,0,0,1,3,1,2017,1,3,2024,0
Hurricanes,1,1,1,0,3,Blackhawks,2,0,0,0,2,20180308,-1,0,1,1,5,-1,2017,0,3,641,0
Ducks,0,0,2,0,2,Predators,2,1,1,0,4,20180308,2,3,2,2,6,2,2017,0,3,1776,0
Canadiens,0,0,0,0,0,Panthers,1,2,2,0,5,20180308,1,3,5,5,5,5,2017,0,3,1418,0
Golden Knights,1,3,0,0,4,Red Wings,0,0,0,0,0,20180308,1,4,4,4,4,-4,2017,0,3,1757,0
Sabres,1,1,1,1,4,Senators,0,3,0,0,3,20180308,1,-1,0,1,7,-1,2017,1,3,219,0
Avalanche,2,0,2,0,4,Blue Jackets,1,3,0,1,5,20180308,-1,2,0,1,9,1,2017,1,3,1163,0
Jets,1,1,1,0,3,Devils,0,1,1,0,2,20180308,1,1,1,1,5,-1,2017,0,3,1280,0
Flyers,1,1,0,0,2,Bruins,2,0,1,0,3,20180308,1,0,1,1,5,1,2017,0,3,270,0
Rangers,0,1,2,0,3,Lightning,2,3,0,0,5,20180308,2,4,2,2,8,2,2017,0,3,1004,0
Red Wings,1,0,1,0,2,Blue Jackets,1,2,0,0,3,20180309,0,2,1,1,5,1,2017,0,4,163,0
Flames,1,0,1,0,2,Senators,0,0,1,0,1,20180309,1,1,1,1,3,-1,2017,0,4,1773,0
Ducks,1,0,0,0,1,Stars,0,0,2,0,2,20180309,-1,-1,1,1,3,1,2017,0,4,1237,0
Wild,1,2,2,0,5,Canucks,1,1,0,0,2,20180309,0,1,3,3,7,-3,2017,0,4,1427,0
Penguins,0,0,2,0,2,Maple Leafs,2,2,1,0,5,20180310,2,4,3,3,7,3,2017,0,5,222,0
Wild,0,0,1,0,1,Oilers,0,2,2,0,4,20180310,0,2,3,3,5,3,2017,0,5,1083,0
Devils,1,1,0,1,3,Predators,1,0,1,0,2,20180310,0,1,0,1,5,-1,2017,1,5,750,0
Blues,2,2,3,0,7,Kings,0,1,1,0,2,20180310,2,3,5,5,9,-5,2017,0,5,1586,0
Rangers,0,1,2,0,3,Panthers,1,1,1,1,4,20180310,1,1,0,1,7,1,2017,1,5,1091,0
Jets,0,0,1,0,1,Flyers,0,2,0,0,2,20180310,0,2,1,1,3,1,2017,0,5,1273,0
Coyotes,1,1,0,0,2,Avalanche,3,0,2,0,5,20180310,2,1,3,3,7,3,2017,0,5,585,0
Blackhawks,2,2,0,0,4,Bruins,2,1,4,0,7,20180310,0,-1,3,3,11,3,2017,0,5,849,0
Golden Knights,0,0,1,1,2,Sabres,0,0,1,0,1,20180310,0,0,0,1,3,-1,2017,1,5,1970,0
Capitals,0,1,1,0,2,Sharks,0,0,0,0,0,20180310,0,1,2,2,2,-2,2017,0,5,2416,0
Canadiens,1,1,0,0,2,Lightning,1,0,1,1,3,20180310,0,-1,0,1,5,1,2017,1,5,1311,0
Bruins,0,0,1,0,1,Blackhawks,1,0,2,0,3,20180311,1,1,2,2,4,2,2017,0,6,849,0
Islanders,3,1,1,0,5,Flames,1,0,1,0,2,20180311,2,3,3,3,7,-3,2017,0,6,2023,0
Stars,0,1,0,0,1,Penguins,2,0,1,0,3,20180311,2,1,2,2,4,2,2017,0,6,1069,0
Canucks,0,0,0,0,0,Coyotes,0,1,0,0,1,20180311,0,1,1,1,1,1,2017,0,6,1228,0
Canucks,0,0,0,0,0,Kings,0,2,1,0,3,20180312,0,2,3,3,3,3,2017,0,0,1076,0
Senators,2,0,3,0,5,Panthers,0,2,1,0,3,20180312,2,0,2,2,8,-2,2017,0,0,1370,0
Canadiens,1,1,0,0,2,Blue Jackets,3,1,1,0,5,20180312,2,2,3,3,7,3,2017,0,0,605,0
Red Wings,1,1,1,0,3,Sharks,2,1,2,0,5,20180312,1,1,2,2,8,2,2017,0,0,2071,0
Golden Knights,1,0,2,0,3,Flyers,0,1,1,0,2,20180312,1,0,1,1,5,-1,2017,0,0,2171,0
Jets,1,0,1,0,2,Capitals,1,1,0,1,3,20180312,0,1,0,1,5,1,2017,1,0,1247,0
Blues,1,2,1,0,4,Ducks,0,1,1,0,2,20180312,1,2,2,2,6,-2,2017,0,0,1586,0
Hurricanes,1,1,1,0,3,Rangers,1,2,3,0,6,20180312,0,1,3,3,9,3,2017,0,0,423,0
Bruins,1,0,5,0,6,Hurricanes,0,3,1,0,4,20180313,1,-2,2,2,10,-2,2017,0,1,609,0
Stars,1,1,0,0,2,Canadiens,1,2,1,0,4,20180313,0,1,2,2,6,2,2017,0,1,1505,0
Senators,3,3,1,0,7,Lightning,1,2,1,0,4,20180313,2,3,3,3,11,-3,2017,0,1,1251,0
Jets,0,0,1,0,1,Predators,3,0,0,0,3,20180313,3,3,2,2,4,2,2017,0,1,1084,0
Oilers,0,0,0,0,0,Flames,0,1,0,0,1,20180313,0,1,1,1,1,1,2017,0,1,171,0
Kings,0,1,2,0,3,Coyotes,2,1,0,1,4,20180313,2,2,0,1,7,1,2017,1,1,356,0
Avalanche,1,1,3,0,5,Wild,0,1,0,0,1,20180313,1,1,4,4,6,-4,2017,0,1,698,0
Canucks,0,0,0,0,0,Ducks,1,1,1,0,3,20180314,1,2,3,3,3,3,2017,0,2,1076,0
Stars,2,2,1,0,5,Maple Leafs,2,0,3,1,6,20180314,0,-2,0,1,11,1,2017,1,2,1201,0
Penguins,0,2,1,0,3,Rangers,0,0,3,1,4,20180314,0,-2,0,1,7,1,2017,1,2,314,0
Sharks,1,1,1,1,4,Oilers,1,1,1,0,3,20180314,0,0,0,1,7,-1,2017,1,2,1190,0
Devils,2,2,4,0,8,Golden Knights,0,2,1,0,3,20180314,2,2,5,5,11,-5,2017,0,2,2218,0
Predators,0,1,2,0,3,Coyotes,0,2,0,0,2,20180315,0,-1,1,1,5,-1,2017,0,3,1442,0
Red Wings,0,0,1,0,1,Kings,1,0,3,0,4,20180315,1,1,3,3,5,3,2017,0,3,1979,0
Blackhawks,1,1,0,0,2,Jets,5,0,1,0,6,20180315,4,3,4,4,8,4,2017,0,3,722,0
Bruins,0,0,0,0,0,Panthers,2,1,0,0,3,20180315,2,3,3,3,3,3,2017,0,3,1257,0
Avalanche,2,1,1,0,4,Blues,0,1,0,0,1,20180315,2,2,3,3,5,-3,2017,0,3,794,0
Penguins,2,1,2,0,5,Canadiens,2,1,0,0,3,20180315,0,0,2,2,8,-2,2017,0,3,474,0
Blue Jackets,3,1,1,0,5,Flyers,1,2,0,0,3,20180315,2,1,2,2,8,-2,2017,0,3,414,0
Capitals,3,2,2,0,7,Islanders,2,0,1,0,3,20180315,1,3,4,4,10,-4,2017,0,3,204,0
Maple Leafs,2,2,1,0,5,Sabres,1,1,0,0,2,20180315,1,2,3,3,7,-3,2017,0,3,57,0
Islanders,0,1,2,0,3,Capitals,1,2,3,0,6,20180316,1,2,3,3,9,3,2017,0,4,204,0
Stars,1,0,1,0,2,Senators,0,0,2,1,3,20180316,-1,-1,0,1,5,1,2017,1,4,1404,0
Predators,1,2,1,0,4,Avalanche,1,1,0,0,2,20180316,0,1,2,2,6,-2,2017,0,4,1019,0
Sharks,1,4,2,0,7,Flames,1,2,1,0,4,20180316,0,2,3,3,11,-3,2017,0,4,1027,0
Red Wings,1,1,0,0,2,Ducks,1,2,1,0,4,20180316,0,1,2,2,6,2,2017,0,4,1979,0
Wild,1,2,1,0,4,Golden Knights,0,0,2,0,2,20180316,1,3,2,2,6,-2,2017,0,4,1293,0
Sharks,2,1,2,0,5,Canucks,1,2,0,0,3,20180317,1,0,2,2,8,-2,2017,0,5,821,0
Wild,1,0,2,0,3,Coyotes,0,1,0,0,1,20180317,1,0,2,2,4,-2,2017,0,5,1278,0
Rangers,0,3,0,0,3,Blues,1,1,1,1,4,20180317,1,-1,0,1,7,1,2017,1,5,871,0
Senators,1,0,0,0,1,Blue Jackets,1,1,0,0,2,20180317,0,1,1,1,3,1,2017,0,5,512,0
Flyers,0,0,4,0,4,Hurricanes,1,0,1,0,2,20180317,-1,-1,2,2,6,-2,2017,0,5,345,0
Bruins,2,1,0,0,3,Lightning,0,0,0,0,0,20180317,2,3,3,3,3,-3,2017,0,5,1183,0
Canadiens,0,0,0,0,0,Maple Leafs,1,2,1,0,4,20180317,1,3,4,4,4,4,2017,0,5,303,0
Devils,2,0,1,0,3,Kings,0,0,0,0,0,20180317,2,2,3,3,3,-3,2017,0,5,2436,0
Oilers,0,1,3,0,4,Panthers,0,2,0,0,2,20180317,0,-1,2,2,6,-2,2017,0,5,2569,0
Blackhawks,0,2,1,0,3,Sabres,1,1,3,0,5,20180317,1,0,2,2,8,2,2017,0,5,453,0
Red Wings,0,1,0,0,1,Avalanche,2,1,2,0,5,20180318,2,2,4,4,6,4,2017,0,6,1154,0
Flames,0,0,0,0,0,Golden Knights,0,4,0,0,4,20180318,0,4,4,4,4,4,2017,0,6,1033,0
Oilers,1,0,0,0,1,Lightning,1,1,1,0,3,20180318,0,1,2,2,4,2,2017,0,6,2367,0
Hurricanes,2,1,1,0,4,Islanders,0,2,1,0,3,20180318,2,1,1,1,7,-1,2017,0,6,423,0
Capitals,0,1,2,0,3,Flyers,0,3,3,0,6,20180318,0,2,3,3,9,3,2017,0,6,123,0
Blues,0,2,2,1,5,Blackhawks,2,1,1,0,4,20180318,-2,-1,0,1,9,-1,2017,1,6,260,0
Stars,0,2,0,0,2,Jets,1,2,1,0,4,20180318,1,1,2,2,6,2,2017,0,6,1183,0
Devils,0,1,1,0,2,Ducks,2,0,2,0,4,20180318,2,1,2,2,6,2,2017,0,6,2436,0
Flames,0,2,0,0,2,Coyotes,0,2,3,0,5,20180319,0,0,3,3,7,3,2017,0,0,1224,0
Kings,1,1,1,1,4,Wild,0,2,1,0,3,20180319,1,0,0,1,7,-1,2017,1,0,1521,0
Predators,0,2,2,0,4,Sabres,0,0,0,0,0,20180319,0,2,4,4,4,-4,2017,0,0,626,0
Blue Jackets,1,1,2,1,5,Bruins,0,3,1,0,4,20180319,1,-1,0,1,9,-1,2017,1,0,642,0
Panthers,1,0,1,0,2,Canadiens,0,0,0,0,0,20180319,1,1,2,2,2,-2,2017,0,0,1418,0
Penguins,0,1,0,0,1,Islanders,2,0,2,0,4,20180320,2,1,3,3,5,3,2017,0,1,314,0
Blue Jackets,1,1,3,0,5,Rangers,0,1,2,0,3,20180320,1,1,2,2,8,-2,2017,0,1,476,0
Stars,1,2,0,0,3,Capitals,0,3,1,0,4,20180320,-1,0,1,1,7,1,2017,0,1,1181,0
Oilers,3,3,1,0,7,Hurricanes,2,1,0,0,3,20180320,1,3,4,4,10,-4,2017,0,1,2076,0
Panthers,2,4,1,0,7,Senators,1,1,0,0,2,20180320,1,4,5,5,9,-5,2017,0,1,1370,0
Flyers,0,1,3,0,4,Red Wings,0,3,1,1,5,20180320,0,2,0,1,9,1,2017,1,1,441,0
Maple Leafs,1,2,0,0,3,Lightning,0,1,3,0,4,20180320,-1,-2,1,1,7,1,2017,0,1,1096,0
Kings,0,1,0,0,1,Jets,0,1,0,1,2,20180320,0,0,0,1,3,1,2017,1,1,1527,0
Avalanche,0,3,2,0,5,Blackhawks,1,0,0,0,1,20180320,-1,2,4,4,6,-4,2017,0,1,916,0
Canucks,0,0,1,0,1,Golden Knights,3,1,0,0,4,20180320,3,4,3,3,5,3,2017,0,1,986,0
Devils,1,0,1,0,2,Sharks,3,3,0,0,6,20180320,2,5,4,4,8,4,2017,0,1,2540,0
Canadiens,1,2,0,0,3,Penguins,2,1,2,0,5,20180321,1,0,2,2,8,2,2017,0,2,474,0
Ducks,1,2,1,0,4,Flames,0,0,0,0,0,20180321,1,3,4,4,4,-4,2017,0,2,1197,0
Coyotes,2,0,2,0,4,Sabres,1,0,0,0,1,20180321,1,1,3,3,5,-3,2017,0,2,1902,0
Bruins,1,0,0,0,1,Blues,0,0,1,1,2,20180321,-1,-1,0,1,3,1,2017,1,2,1035,0
Kings,3,2,2,0,7,Avalanche,1,0,0,0,1,20180322,2,4,6,6,8,-6,2017,0,3,830,0
Lightning,3,4,0,0,7,Islanders,1,2,3,0,6,20180322,2,4,1,1,13,-1,2017,0,3,1004,0
Rangers,1,1,1,0,3,Flyers,1,2,1,0,4,20180322,0,1,1,1,7,1,2017,0,3,80,0
Coyotes,2,3,0,0,5,Hurricanes,2,2,2,0,6,20180322,0,-1,1,1,11,1,2017,0,3,1898,0
Panthers,0,0,0,0,0,Blue Jackets,0,3,1,0,4,20180322,0,3,4,4,4,4,2017,0,3,993,0
Oilers,1,1,4,0,6,Senators,0,0,2,0,2,20180322,1,2,4,4,8,-4,2017,0,3,1754,0
Capitals,0,0,1,0,1,Red Wings,0,0,0,0,0,20180322,0,0,1,1,1,-1,2017,0,3,394,0
Maple Leafs,1,2,2,0,5,Predators,0,1,1,0,2,20180322,1,2,3,3,7,-3,2017,0,3,646,0
Canucks,2,2,1,0,5,Blackhawks,1,0,1,0,2,20180322,1,3,3,3,7,-3,2017,0,3,1775,0
Golden Knights,1,0,0,0,1,Sharks,0,1,0,1,2,20180322,-1,0,0,1,3,1,2017,1,3,382,0
Ducks,1,0,1,0,2,Jets,1,1,0,1,3,20180323,0,1,0,1,5,1,2017,1,4,1527,0
Canucks,0,1,0,0,1,Blues,1,1,2,0,4,20180323,1,1,3,3,5,3,2017,0,4,1778,0
Bruins,0,0,3,0,3,Stars,1,1,0,0,2,20180323,-1,-2,1,1,5,-1,2017,0,4,1548,0
Canadiens,0,1,2,0,3,Sabres,0,0,0,0,0,20180323,0,1,3,3,3,-3,2017,0,4,311,0
Devils,0,3,0,1,4,Penguins,1,0,2,0,3,20180323,-1,2,0,1,7,-1,2017,1,4,306,0
Blues,1,1,0,0,2,Blue Jackets,0,1,0,0,1,20180324,1,1,1,1,3,-1,2017,0,5,395,0
Capitals,3,1,2,0,6,Canadiens,1,1,2,0,4,20180324,2,2,2,2,10,-2,2017,0,5,495,0
Kings,1,1,0,0,2,Oilers,2,1,0,0,3,20180324,1,1,1,1,5,1,2017,0,5,1368,0
Sabres,0,0,1,0,1,Rangers,2,3,0,0,5,20180324,2,5,4,4,6,4,2017,0,5,292,0
Predators,1,0,0,0,1,Wild,0,2,2,0,4,20180324,-1,1,3,3,5,3,2017,0,5,696,0
Blackhawks,0,2,1,0,3,Islanders,0,0,1,0,1,20180324,0,2,2,2,4,-2,2017,0,5,711,0
Red Wings,0,2,1,0,3,Maple Leafs,1,1,2,0,4,20180324,1,0,1,1,7,1,2017,0,5,205,0
Coyotes,1,1,0,0,2,Panthers,0,0,4,0,4,20180324,-1,-2,2,2,6,2,2017,0,5,1978,0
Golden Knights,0,0,1,0,1,Avalanche,1,0,0,1,2,20180324,1,1,0,1,3,1,2017,1,5,604,0
Flames,1,0,0,0,1,Sharks,2,1,2,0,5,20180324,1,2,4,4,6,4,2017,0,5,1027,0
Lightning,0,0,1,0,1,Devils,1,1,0,0,2,20180324,1,2,1,1,3,1,2017,0,5,1000,0
Hurricanes,1,1,3,0,5,Senators,1,0,1,0,2,20180324,0,1,3,3,7,-3,2017,0,5,673,0
Flyers,2,1,1,0,4,Penguins,1,2,1,1,5,20180325,-1,0,0,1,9,1,2017,1,6,257,0
Canucks,1,1,2,0,4,Stars,1,0,0,0,1,20180325,0,1,3,3,5,-3,2017,0,6,1766,0
Predators,2,2,0,0,4,Jets,0,3,1,1,5,20180325,-2,-1,0,1,9,1,2017,1,6,1084,0
Bruins,0,1,0,1,2,Wild,0,0,1,0,1,20180325,0,1,0,1,3,-1,2017,1,6,1120,0
Ducks,0,1,3,1,5,Oilers,0,3,1,0,4,20180325,0,-2,0,1,9,-1,2017,1,6,1368,0
Flames,0,0,0,0,0,Kings,0,2,1,0,3,20180326,0,2,3,3,3,3,2017,0,0,1197,0
Avalanche,0,1,0,0,1,Golden Knights,0,2,2,0,4,20180326,0,1,3,3,5,3,2017,0,0,604,0
Coyotes,0,2,2,0,4,Lightning,0,0,1,0,1,20180326,0,2,3,3,5,-3,2017,0,0,1793,0
Red Wings,1,1,0,0,2,Canadiens,1,2,1,0,4,20180326,0,1,2,2,6,2,2017,0,0,508,0
Sharks,1,1,1,1,4,Blackhawks,2,0,1,0,3,20180326,-1,0,0,1,7,-1,2017,1,0,1837,0
Senators,0,1,0,0,1,Hurricanes,1,2,1,0,4,20180326,1,2,3,3,5,3,2017,0,0,673,0
Panthers,1,2,0,0,3,Islanders,0,0,0,0,0,20180326,1,3,3,3,3,-3,2017,0,0,1091,0
Sabres,1,0,2,0,3,Maple Leafs,0,2,0,0,2,20180326,1,-1,1,1,5,-1,2017,0,0,57,0
Capitals,4,0,0,0,4,Rangers,0,1,1,0,2,20180326,4,3,2,2,6,-2,2017,0,0,204,0
Ducks,0,1,0,0,1,Canucks,1,0,3,0,4,20180327,1,0,3,3,5,3,2017,0,1,1076,0
Hurricanes,2,0,1,0,3,Devils,1,1,2,0,4,20180327,-1,0,1,1,7,1,2017,0,1,419,0
Islanders,1,2,1,0,4,Senators,2,0,1,0,3,20180327,-1,1,1,1,7,-1,2017,0,1,334,0
Penguins,1,0,1,0,2,Red Wings,1,2,2,0,5,20180327,0,2,3,3,7,3,2017,0,1,205,0
Sharks,1,1,0,0,2,Blues,1,1,0,1,3,20180327,0,0,0,1,5,1,2017,1,1,1719,0
Wild,0,0,1,0,1,Predators,1,0,0,1,2,20180327,1,1,0,1,3,1,2017,1,1,696,0
Bruins,1,0,3,0,4,Jets,1,2,1,1,5,20180327,0,2,0,1,9,1,2017,1,1,1349,0
Flyers,1,1,0,0,2,Stars,1,1,0,1,3,20180327,0,0,0,1,5,1,2017,1,1,1297,0
Blue Jackets,3,3,1,0,7,Oilers,3,0,0,0,3,20180327,0,3,4,4,10,-4,2017,0,1,1703,0
Coyotes,2,1,0,0,3,Golden Knights,1,1,0,0,2,20180328,1,1,1,1,5,-1,2017,0,2,256,0
Flyers,2,0,0,0,2,Avalanche,0,1,0,0,1,20180328,2,1,1,1,3,-1,2017,0,2,1574,0
Panthers,1,1,1,0,3,Maple Leafs,3,0,1,0,4,20180328,2,1,1,1,7,1,2017,0,2,1234,0
Rangers,1,0,1,0,2,Capitals,1,0,1,1,3,20180328,0,0,0,1,5,1,2017,1,2,204,0
Lightning,0,1,1,0,2,Bruins,2,0,2,0,4,20180329,2,1,2,2,6,2,2017,0,3,1183,0
Red Wings,1,2,3,0,6,Sabres,2,0,1,0,3,20180329,-1,1,3,3,9,-3,2017,0,3,215,0
Penguins,1,1,1,1,4,Devils,1,1,1,0,3,20180329,0,0,0,1,7,-1,2017,1,3,306,0
Panthers,0,2,0,0,2,Senators,0,1,1,1,3,20180329,0,-1,0,1,5,1,2017,1,3,1370,0
Sharks,2,0,1,0,3,Predators,2,1,2,0,5,20180329,0,1,2,2,8,2,2017,0,3,1934,0
Stars,1,1,0,0,2,Wild,1,3,1,0,5,20180329,0,2,3,3,7,3,2017,0,3,863,0
Jets,0,2,0,0,2,Blackhawks,2,3,1,0,6,20180329,2,3,4,4,8,4,2017,0,3,722,0
Blue Jackets,2,1,2,0,5,Flames,0,0,1,0,1,20180329,2,3,4,4,6,-4,2017,0,3,1670,0
Oilers,1,0,0,0,1,Canucks,0,1,1,0,2,20180329,-1,0,1,1,3,1,2017,0,3,514,0
Coyotes,1,1,0,0,2,Kings,1,1,2,0,4,20180329,0,0,2,2,6,2,2017,0,3,356,0
Blues,2,0,1,0,3,Golden Knights,2,1,0,1,4,20180330,0,1,0,1,7,1,2017,1,4,1375,0
Kings,1,0,0,0,1,Ducks,0,1,0,1,2,20180330,-1,0,0,1,3,1,2017,1,4,0,0
Blackhawks,0,0,0,0,0,Avalanche,1,1,3,0,5,20180330,1,2,5,5,5,5,2017,0,4,916,0
Lightning,0,2,5,0,7,Rangers,1,0,2,0,3,20180330,-1,1,4,4,10,-4,2017,0,4,1004,0
Maple Leafs,1,2,2,0,5,Islanders,2,1,1,0,4,20180330,-1,0,1,1,9,-1,2017,0,4,341,0
Hurricanes,0,2,2,0,4,Capitals,0,1,0,0,1,20180330,0,1,3,3,5,-3,2017,0,4,233,0
Sharks,1,1,0,0,2,Golden Knights,1,1,1,0,3,20180331,0,0,1,1,5,1,2017,0,5,382,0
Oilers,1,1,0,0,2,Flames,3,0,0,0,3,20180331,2,1,1,1,5,1,2017,0,5,171,0
Blues,0,0,0,0,0,Coyotes,1,3,2,0,6,20180331,1,4,6,6,6,6,2017,0,5,1270,0
Wild,0,0,1,0,1,Stars,1,1,2,0,4,20180331,1,2,3,3,5,3,2017,0,5,863,0
Sabres,1,5,1,0,7,Predators,2,2,0,0,4,20180331,-1,2,3,3,11,-3,2017,0,5,626,0
Rangers,0,2,0,0,2,Hurricanes,0,0,1,0,1,20180331,0,2,1,1,3,-1,2017,0,5,423,0
Canadiens,2,0,0,0,2,Penguins,3,0,2,0,5,20180331,1,1,3,3,7,3,2017,0,5,474,0
Jets,0,3,0,0,3,Maple Leafs,0,1,0,0,1,20180331,0,2,2,2,4,-2,2017,0,5,946,0
Blue Jackets,1,0,3,0,4,Canucks,0,2,2,1,5,20180331,-1,1,0,1,9,1,2017,1,5,2050,0
Senators,0,0,0,0,0,Red Wings,0,1,1,0,2,20180331,0,1,2,2,2,2,2017,0,5,406,0
Panthers,1,0,0,0,1,Bruins,2,3,0,0,5,20180331,1,4,4,4,6,4,2017,0,5,1257,0
Islanders,1,1,1,0,3,Devils,1,3,0,0,4,20180331,0,2,1,1,7,1,2017,0,5,8,0
Avalanche,1,2,0,0,3,Ducks,1,0,2,1,4,20180401,0,-2,0,1,7,1,2017,1,6,830,0
Capitals,1,1,1,0,3,Penguins,0,0,1,0,1,20180401,1,2,2,2,4,-2,2017,0,6,190,0
Predators,1,1,2,0,4,Lightning,0,1,0,0,1,20180401,1,1,3,3,5,-3,2017,0,6,621,0
Bruins,0,1,2,0,3,Flyers,1,1,1,1,4,20180401,1,1,0,1,7,1,2017,1,6,270,0
Devils,0,0,2,0,2,Canadiens,1,0,0,0,1,20180401,-1,-1,1,1,3,-1,2017,0,6,342,0
Sabres,0,1,1,0,2,Maple Leafs,1,3,1,0,5,20180402,1,3,3,3,7,3,2017,0,0,57,0
Jets,3,2,1,0,6,Senators,1,2,2,0,5,20180402,2,2,1,1,11,-1,2017,0,0,1033,0
Hurricanes,1,1,0,0,2,Panthers,2,0,1,0,3,20180402,1,0,1,1,5,1,2017,0,0,696,0
Capitals,0,3,1,0,4,Blues,1,1,0,0,2,20180402,-1,1,2,2,6,-2,2017,0,0,708,0
Oilers,0,0,0,0,0,Wild,1,1,1,0,3,20180402,1,2,3,3,3,3,2017,0,0,1083,0
Avalanche,0,1,0,0,1,Kings,2,0,1,0,3,20180402,2,1,2,2,4,2,2017,0,0,830,0
Stars,0,1,3,0,4,Sharks,2,0,0,0,2,20180403,-2,-1,2,2,6,-2,2017,0,1,1449,0
Golden Knights,1,2,1,1,5,Canucks,1,0,3,0,4,20180403,0,2,0,1,9,-1,2017,1,1,986,0
Coyotes,2,1,1,0,4,Flames,0,1,0,0,1,20180403,2,2,3,3,5,-3,2017,0,1,1224,0
Predators,0,0,1,0,1,Panthers,1,0,1,0,2,20180403,1,1,1,1,3,1,2017,0,1,816,0
Bruins,0,0,0,0,0,Lightning,0,3,1,0,4,20180403,0,3,4,4,4,4,2017,0,1,1183,0
Jets,2,1,1,1,5,Canadiens,0,1,3,0,4,20180403,2,2,0,1,9,-1,2017,1,1,1115,0
Red Wings,3,1,0,0,4,Blue Jackets,1,1,2,1,5,20180403,-2,-2,0,1,9,1,2017,1,1,163,0
Flyers,1,0,3,0,4,Islanders,1,3,1,0,5,20180403,0,3,1,1,9,1,2017,0,1,80,0
Rangers,1,0,1,0,2,Devils,3,2,0,0,5,20180403,2,4,3,3,7,3,2017,0,1,8,0
Senators,2,1,1,0,4,Sabres,1,1,0,0,2,20180404,1,1,2,2,6,-2,2017,0,2,219,0
Blackhawks,1,1,2,0,4,Blues,1,2,0,0,3,20180404,0,-1,1,1,7,-1,2017,0,2,260,0
Wild,0,1,0,0,1,Ducks,0,1,2,0,3,20180404,0,0,2,2,4,2,2017,0,2,1521,0
Wild,2,0,2,0,4,Kings,1,3,0,1,5,20180405,-1,2,0,1,9,1,2017,1,3,1521,0
Avalanche,0,0,2,0,2,Sharks,1,0,3,0,4,20180405,1,1,2,2,6,2,2017,0,3,927,0
Golden Knights,0,2,1,0,3,Oilers,1,0,3,0,4,20180405,1,-1,1,1,7,1,2017,0,3,1204,0
Flames,0,1,0,0,1,Jets,1,1,0,0,2,20180405,1,1,1,1,3,1,2017,0,3,740,0
Bruins,1,1,0,0,2,Panthers,2,0,1,0,3,20180405,1,0,1,1,5,1,2017,0,3,1257,0
Coyotes,1,2,0,0,3,Canucks,0,1,2,1,4,20180405,-1,-2,0,1,7,1,2017,1,3,1228,0
Penguins,2,0,2,1,5,Blue Jackets,2,1,1,0,4,20180405,0,-1,0,1,9,-1,2017,1,3,161,0
Maple Leafs,1,0,0,0,1,Devils,0,2,0,0,2,20180405,-1,1,1,1,3,1,2017,0,3,333,0
Rangers,1,0,0,0,1,Islanders,0,2,0,0,2,20180405,-1,1,1,1,3,1,2017,0,3,0,0
Canadiens,1,2,1,0,4,Red Wings,1,1,1,0,3,20180405,0,1,1,1,7,-1,2017,0,3,508,0
Predators,1,1,2,0,4,Capitals,0,2,1,0,3,20180405,1,0,1,1,7,-1,2017,0,3,566,0
Hurricanes,2,0,1,0,3,Flyers,1,1,2,0,4,20180405,-1,0,1,1,7,1,2017,0,3,345,0
Senators,0,0,0,0,0,Penguins,0,2,2,0,4,20180406,0,2,4,4,4,4,2017,0,4,392,0
Sabres,2,3,0,0,5,Lightning,3,1,3,0,7,20180406,1,-1,2,2,12,2,2017,0,4,1051,0
Stars,1,1,1,0,3,Ducks,3,1,1,0,5,20180406,2,2,2,2,8,2,2017,0,4,1237,0
Blues,1,0,3,0,4,Blackhawks,0,0,1,0,1,20180406,1,1,3,3,5,-3,2017,0,4,260,0
Wild,2,3,1,0,6,Sharks,2,0,1,0,3,20180407,0,3,3,3,9,-3,2017,0,5,1570,0
Blue Jackets,0,1,1,0,2,Predators,3,0,1,0,4,20180407,3,2,2,2,6,2,2017,0,5,333,0
Stars,4,0,0,0,4,Kings,0,2,0,0,2,20180407,4,2,2,2,6,-2,2017,0,5,1237,0
Canucks,1,1,0,0,2,Oilers,1,1,0,1,3,20180407,0,0,0,1,5,1,2017,1,5,514,0
Golden Knights,0,1,0,0,1,Flames,3,3,1,0,7,20180407,3,5,6,6,8,6,2017,0,5,1033,0
Ducks,1,1,1,0,3,Coyotes,0,0,0,0,0,20180407,1,2,3,3,3,-3,2017,0,5,356,0
Blues,0,1,1,0,2,Avalanche,1,2,2,0,5,20180407,1,2,3,3,7,3,2017,0,5,794,0
Lightning,0,1,1,0,2,Hurricanes,2,0,0,1,3,20180407,2,1,0,1,5,1,2017,1,5,585,0
Devils,1,1,1,0,3,Capitals,2,1,2,0,5,20180407,1,1,2,2,8,2,2017,0,5,198,0
Sabres,0,0,3,0,3,Panthers,3,0,1,0,4,20180407,3,3,1,1,7,1,2017,0,5,1184,0
Islanders,0,1,2,1,4,Red Wings,1,1,1,0,3,20180407,-1,-1,0,1,7,-1,2017,1,5,480,0
Canadiens,0,1,1,0,2,Maple Leafs,1,0,3,0,4,20180407,1,0,2,2,6,2,2017,0,5,303,0
Senators,1,0,1,0,2,Bruins,0,3,2,0,5,20180407,-1,2,3,3,7,3,2017,0,5,320,0
Rangers,0,0,0,0,0,Flyers,1,3,1,0,5,20180407,1,4,5,5,5,5,2017,0,5,80,0
Blackhawks,0,1,0,0,1,Jets,1,3,0,0,4,20180407,1,3,3,3,5,3,2017,0,5,722,0
Panthers,2,1,1,0,4,Bruins,1,0,1,0,2,20180408,1,2,2,2,6,-2,2017,0,6,1257,0
Wild,0,0,2,0,2,Jets,0,1,2,0,3,20180411,0,1,1,1,5,1,2017,0,2,388,1
Flyers,0,0,0,0,0,Penguins,3,2,2,0,7,20180411,3,5,7,7,7,7,2017,0,2,257,1
Kings,0,0,0,0,0,Golden Knights,1,0,0,0,1,20180411,1,1,1,1,1,1,2017,0,2,228,1
Avalanche,1,1,0,0,2,Predators,0,2,3,0,5,20180412,-1,0,3,3,7,3,2017,0,3,1019,1
Devils,0,1,1,0,2,Lightning,2,1,2,0,5,20180412,2,2,3,3,7,3,2017,0,3,1000,1
Maple Leafs,1,0,0,0,1,Bruins,1,2,2,0,5,20180412,0,2,4,4,6,4,2017,0,3,430,1
Blue Jackets,0,1,2,1,4,Capitals,2,0,1,0,3,20180412,-2,-1,0,1,7,-1,2017,1,3,326,1
Sharks,0,3,0,0,3,Ducks,0,0,0,0,0,20180412,0,3,3,3,3,-3,2017,0,3,305,1
Wild,0,0,1,0,1,Jets,0,1,3,0,4,20180413,0,1,3,3,5,3,2017,0,4,388,1
Flyers,1,1,3,0,5,Penguins,0,0,1,0,1,20180413,1,2,4,4,6,-4,2017,0,4,257,1
Kings,0,1,0,0,1,Golden Knights,1,0,0,1,2,20180413,1,0,0,1,3,1,2017,1,4,228,1
Devils,1,1,1,0,3,Lightning,1,4,0,0,5,20180414,0,3,2,2,8,2,2017,0,5,1000,1
Sharks,2,1,0,0,3,Ducks,1,1,0,0,2,20180414,1,1,1,1,5,-1,2017,0,5,305,1
Avalanche,1,1,2,0,4,Predators,0,3,2,0,5,20180414,-1,1,1,1,9,1,2017,0,5,1019,1
Maple Leafs,0,2,1,0,3,Bruins,4,1,2,0,7,20180414,4,3,4,4,10,4,2017,0,5,430,1
Penguins,1,3,1,0,5,Flyers,0,1,0,0,1,20180415,1,3,4,4,6,-4,2017,0,6,257,1
Jets,1,1,0,0,2,Wild,2,4,0,0,6,20180415,1,4,4,4,8,4,2017,0,6,388,1
Blue Jackets,1,3,0,1,5,Capitals,2,1,1,0,4,20180415,-1,1,0,1,9,-1,2017,1,6,326,1
Golden Knights,0,0,3,0,3,Kings,1,0,1,0,2,20180415,-1,-1,1,1,5,-1,2017,0,6,228,1
Bruins,0,2,0,0,2,Maple Leafs,1,2,1,0,4,20180416,1,1,2,2,6,2,2017,0,0,430,1
Lightning,0,1,1,0,2,Devils,0,1,4,0,5,20180416,0,0,3,3,7,3,2017,0,0,1000,1
Predators,0,1,2,0,3,Avalanche,3,1,1,0,5,20180416,3,3,2,2,8,2,2017,0,0,1019,1
Ducks,1,0,0,0,1,Sharks,1,4,3,0,8,20180416,0,4,7,7,9,7,2017,0,0,305,1
Capitals,0,2,0,1,3,Blue Jackets,0,1,1,0,2,20180417,0,1,0,1,5,-1,2017,1,1,326,1
Jets,1,0,1,0,2,Wild,0,0,0,0,0,20180417,1,1,2,2,2,-2,2017,0,1,388,1
Golden Knights,0,1,0,0,1,Kings,0,0,0,0,0,20180417,0,1,1,1,1,-1,2017,0,1,228,1
Ducks,0,0,1,0,1,Sharks,1,0,1,0,2,20180418,1,1,1,1,3,1,2017,0,2,305,1
Predators,1,2,0,0,3,Avalanche,0,0,2,0,2,20180418,1,3,1,1,5,-1,2017,0,2,1019,1
Penguins,2,2,1,0,5,Flyers,0,0,0,0,0,20180418,2,4,5,5,5,-5,2017,0,2,257,1
Lightning,2,0,1,0,3,Devils,1,0,0,0,1,20180418,1,1,2,2,4,-2,2017,0,2,1000,1
Bruins,1,1,1,0,3,Maple Leafs,1,0,0,0,1,20180419,0,1,2,2,4,-2,2017,0,3,430,1
Capitals,1,1,2,0,4,Blue Jackets,0,0,1,0,1,20180419,1,2,3,3,5,-3,2017,0,3,326,1
Flyers,1,1,2,0,4,Penguins,0,2,0,0,2,20180420,1,0,2,2,6,-2,2017,0,4,257,1
Wild,0,0,0,0,0,Jets,4,0,1,0,5,20180420,4,4,5,5,5,5,2017,0,4,388,1
Avalanche,0,0,2,0,2,Predators,0,0,1,0,1,20180420,0,0,1,1,3,-1,2017,0,4,1019,1
Devils,0,0,1,0,1,Lightning,1,0,2,0,3,20180421,1,1,2,2,4,2,2017,0,5,1000,1
Blue Jackets,1,1,1,0,3,Capitals,1,2,0,1,4,20180421,0,1,0,1,7,1,2017,1,5,326,1
Maple Leafs,2,2,0,0,4,Bruins,0,2,1,0,3,20180421,2,2,1,1,7,-1,2017,0,5,430,1
Penguins,2,2,4,0,8,Flyers,2,2,1,0,5,20180422,0,0,3,3,13,-3,2017,0,6,257,1
Predators,2,2,1,0,5,Avalanche,0,0,0,0,0,20180422,2,4,5,5,5,-5,2017,0,6,1019,1
Bruins,0,1,0,0,1,Maple Leafs,0,2,1,0,3,20180423,0,1,2,2,4,2,2017,0,0,430,1
Capitals,1,2,3,0,6,Blue Jackets,0,1,2,0,3,20180423,1,2,3,3,9,-3,2017,0,0,326,1
Maple Leafs,2,2,0,0,4,Bruins,3,0,4,0,7,20180425,1,-1,3,3,11,3,2017,0,2,430,1
Sharks,0,0,0,0,0,Golden Knights,4,1,2,0,7,20180426,4,5,7,7,7,7,2017,0,3,382,1
Penguins,0,0,3,0,3,Capitals,1,0,1,0,2,20180426,-1,-1,1,1,5,-1,2017,0,3,190,1
Jets,1,2,1,0,4,Predators,0,0,1,0,1,20180427,1,3,3,3,5,-3,2017,0,4,1084,1
Bruins,1,2,3,0,6,Lightning,0,2,0,0,2,20180428,1,1,4,4,8,-4,2017,0,5,1183,1
Sharks,0,3,0,1,4,Golden Knights,1,1,1,0,3,20180428,-1,1,0,1,7,-1,2017,1,5,382,1
Penguins,0,1,0,0,1,Capitals,2,1,1,0,4,20180429,2,2,3,3,5,3,2017,0,6,190,1
Jets,2,0,2,0,4,Predators,1,2,1,1,5,20180429,-1,1,0,1,9,1,2017,1,6,1084,1
Bruins,1,0,1,0,2,Lightning,1,1,2,0,4,20180430,0,1,2,2,6,2,2017,0,0,1183,1
Golden Knights,0,3,0,1,4,Sharks,0,1,2,0,3,20180430,0,2,0,1,7,-1,2017,1,0,382,1
Capitals,0,2,2,0,4,Penguins,0,3,0,0,3,20180501,0,-1,1,1,7,-1,2017,0,1,190,1
Predators,3,0,1,0,4,Jets,0,4,3,0,7,20180501,-3,1,3,3,11,3,2017,0,1,1084,1
Lightning,3,0,1,0,4,Bruins,1,0,0,0,1,20180502,2,2,3,3,5,-3,2017,0,2,1183,1
Golden Knights,0,0,0,0,0,Sharks,2,1,1,0,4,20180502,2,3,4,4,4,4,2017,0,2,382,1
Predators,1,1,0,0,2,Jets,0,0,1,0,1,20180503,1,2,1,1,3,-1,2017,0,3,1084,1
Capitals,0,1,0,0,1,Penguins,0,2,1,0,3,20180503,0,1,2,2,4,2,2017,0,3,190,1
Lightning,2,0,1,1,4,Bruins,1,1,1,0,3,20180504,1,0,0,1,7,-1,2017,1,4,1183,1
Sharks,0,0,3,0,3,Golden Knights,1,2,2,0,5,20180504,1,3,2,2,8,2,2017,0,4,382,1
Penguins,1,2,0,0,3,Capitals,2,0,4,0,6,20180505,1,-1,3,3,9,3,2017,0,5,190,1
Jets,0,4,2,0,6,Predators,0,2,0,0,2,20180505,0,2,4,4,8,-4,2017,0,5,1084,1
Bruins,1,0,0,0,1,Lightning,0,2,1,0,3,20180506,-1,1,2,2,4,2,2017,0,6,1183,1
Golden Knights,0,2,1,0,3,Sharks,0,0,0,0,0,20180506,0,2,3,3,3,-3,2017,0,6,382,1
Capitals,0,1,0,1,2,Penguins,0,1,0,0,1,20180507,0,0,0,1,3,-1,2017,1,0,190,1
Predators,1,1,2,0,4,Jets,0,0,0,0,0,20180507,1,2,4,4,4,-4,2017,0,0,1084,1
Jets,2,1,2,0,5,Predators,1,0,0,0,1,20180510,1,2,4,4,6,-4,2017,0,3,1084,1
Capitals,2,2,0,0,4,Lightning,0,0,2,0,2,20180511,2,4,2,2,6,-2,2017,0,4,818,1
Golden Knights,1,1,0,0,2,Jets,3,1,0,0,4,20180512,2,2,2,2,6,2,2017,0,5,1303,1
Capitals,1,3,2,0,6,Lightning,2,0,0,0,2,20180513,-1,2,4,4,8,-4,2017,0,6,818,1
Golden Knights,2,0,1,0,3,Jets,0,0,1,0,1,20180514,2,2,2,2,4,-2,2017,0,0,1303,1
Lightning,1,3,0,0,4,Capitals,0,1,1,0,2,20180515,1,3,2,2,6,-2,2017,0,1,818,1
Jets,0,1,1,0,2,Golden Knights,1,2,1,0,4,20180516,1,2,2,2,6,2,2017,0,2,1303,1
Lightning,2,0,2,0,4,Capitals,1,1,0,0,2,20180517,1,0,2,2,6,-2,2017,0,3,818,1
Jets,0,1,1,0,2,Golden Knights,1,1,1,0,3,20180518,1,1,1,1,5,1,2017,0,4,1303,1
Capitals,0,1,1,0,2,Lightning,2,1,0,0,3,20180519,2,2,1,1,5,1,2017,0,5,818,1
Golden Knights,1,1,0,0,2,Jets,1,0,0,0,1,20180520,0,1,1,1,3,-1,2017,0,6,1303,1
Lightning,0,0,0,0,0,Capitals,0,1,2,0,3,20180521,0,1,3,3,3,3,2017,0,0,818,1
Capitals,1,2,1,0,4,Lightning,0,0,0,0,0,20180523,1,3,4,4,4,-4,2017,0,2,818,1
Capitals,2,1,1,0,4,Golden Knights,2,1,3,0,6,20180528,0,0,2,2,10,2,2017,0,0,2080,1
Capitals,1,2,0,0,3,Golden Knights,1,1,0,0,2,20180530,0,1,1,1,5,-1,2017,0,2,2080,1
Golden Knights,0,0,1,0,1,Capitals,0,2,1,0,3,20180602,0,2,2,2,4,2,2017,0,5,2080,1
Golden Knights,0,0,2,0,2,Capitals,3,1,2,0,6,20180604,3,4,4,4,8,4,2017,0,0,2080,1
Capitals,0,2,2,0,4,Golden Knights,0,3,0,0,3,20180607,0,-1,1,1,7,-1,2017,0,3,2080,1
Ducks,1,1,3,0,5,Sharks,1,1,0,0,2,20181003,0,0,3,3,7,-3,2018,0,2,305,0
Flames,0,0,2,0,2,Canucks,1,0,4,0,5,20181003,1,1,3,3,7,3,2018,0,2,426,0
Bruins,0,0,0,0,0,Capitals,2,4,1,0,7,20181003,2,6,7,7,7,7,2018,0,2,394,0
Canadiens,1,1,0,0,2,Maple Leafs,1,1,0,1,3,20181003,0,0,0,1,5,1,2018,1,2,303,0
Bruins,2,1,1,0,4,Sabres,0,0,0,0,0,20181004,2,3,4,4,4,-4,2018,0,3,399,0
Capitals,3,1,2,0,6,Penguins,2,3,1,1,7,20181004,-1,1,0,1,13,1,2018,1,3,190,0
Islanders,0,1,0,1,2,Hurricanes,0,0,1,0,1,20181004,0,1,0,1,3,-1,2018,1,3,423,0
Predators,0,1,2,0,3,Rangers,0,1,1,0,2,20181004,0,0,1,1,5,-1,2018,0,3,758,0
Blackhawks,2,0,1,1,4,Senators,3,0,0,0,3,20181004,-1,-1,0,1,7,-1,2018,1,3,628,0
Blue Jackets,1,1,0,1,3,Red Wings,0,2,0,0,2,20181004,1,0,0,1,5,-1,2018,1,3,163,0
Jets,1,0,4,0,5,Blues,0,0,1,0,1,20181004,1,1,4,4,6,-4,2018,0,3,853,0
Coyotes,0,0,0,0,0,Stars,0,3,0,0,3,20181004,0,3,3,3,3,3,2018,0,3,884,0
Wild,1,0,0,0,1,Avalanche,1,1,2,0,4,20181004,0,1,3,3,5,3,2018,0,3,698,0
Flyers,2,3,0,0,5,Golden Knights,1,0,1,0,2,20181004,1,4,3,3,7,-3,2018,0,3,2171,0
Sharks,2,0,0,1,3,Kings,1,1,0,0,2,20181005,1,0,0,1,5,-1,2018,1,4,305,0
Hurricanes,1,1,1,0,3,Blue Jackets,1,0,0,0,1,20181005,0,1,2,2,4,-2,2018,0,4,374,0
Canucks,2,2,0,0,4,Flames,2,1,4,0,7,20181006,0,-1,3,3,11,3,2018,0,5,426,0
Ducks,0,1,0,0,1,Coyotes,0,0,0,0,0,20181006,0,1,1,1,1,-1,2018,0,5,356,0
Flyers,1,1,0,0,2,Avalanche,2,1,2,0,5,20181006,1,1,3,3,7,3,2018,0,5,1574,0
Blackhawks,1,2,1,1,5,Blues,2,0,2,0,4,20181006,-1,1,0,1,9,-1,2018,1,5,260,0
Jets,0,1,0,0,1,Stars,2,1,2,0,5,20181006,2,2,4,4,6,4,2018,0,5,1183,0
Canadiens,2,2,1,0,5,Penguins,0,1,0,0,1,20181006,2,3,4,4,6,-4,2018,0,5,474,0
Golden Knights,0,0,1,1,2,Wild,1,0,0,0,1,20181006,-1,-1,0,1,3,-1,2018,1,5,1293,0
Panthers,1,0,0,0,1,Lightning,0,0,1,1,2,20181006,-1,-1,0,1,3,1,2018,1,5,205,0
Senators,1,2,2,0,5,Maple Leafs,0,3,0,0,3,20181006,1,0,2,2,8,-2,2018,0,5,203,0
Rangers,0,0,1,0,1,Sabres,1,1,1,0,3,20181006,1,2,2,2,4,2,2018,0,5,292,0
Oilers,1,0,1,0,2,Devils,1,2,2,0,5,20181006,0,2,3,3,7,3,2018,0,5,2016,0
Predators,2,2,0,0,4,Islanders,1,2,0,0,3,20181006,1,1,1,1,7,-1,2018,0,5,758,0
Rangers,2,2,1,0,5,Hurricanes,2,2,4,0,8,20181007,0,0,3,3,13,3,2018,0,6,423,0
Maple Leafs,2,2,2,1,7,Blackhawks,2,1,3,0,6,20181007,0,1,0,1,13,-1,2018,1,6,436,0
Red Wings,0,1,1,0,2,Kings,0,2,2,0,4,20181007,0,1,2,2,6,2,2018,0,6,1979,0
Red Wings,1,1,0,0,2,Ducks,0,1,1,1,3,20181008,-1,-1,0,1,5,1,2018,1,0,1979,0
Senators,0,2,1,0,3,Bruins,2,1,3,0,6,20181008,2,1,3,3,9,3,2018,0,0,320,0
Sharks,0,0,0,0,0,Islanders,0,1,3,0,4,20181008,0,1,4,4,4,4,2018,0,0,2549,0
Golden Knights,0,1,1,0,2,Sabres,1,3,0,0,4,20181008,1,3,2,2,6,2,2018,0,0,1970,0
Flames,1,1,1,0,3,Predators,0,0,0,0,0,20181009,1,2,3,3,3,-3,2018,0,1,1692,0
Avalanche,0,2,0,0,2,Blue Jackets,2,0,3,0,5,20181009,2,0,3,3,7,3,2018,0,1,1163,0
Kings,1,0,0,0,1,Jets,1,1,0,0,2,20181009,0,1,1,1,3,1,2018,0,1,1527,0
Sharks,4,1,3,0,8,Flyers,0,1,1,0,2,20181009,4,4,6,6,10,-6,2018,0,1,2499,0
Canucks,1,2,0,0,3,Hurricanes,3,1,1,0,5,20181009,2,1,2,2,8,2,2018,0,1,2409,0
Maple Leafs,2,3,2,0,7,Stars,1,2,1,0,4,20181009,1,2,3,3,11,-3,2018,0,1,1201,0
Golden Knights,0,1,1,0,2,Capitals,1,1,3,0,5,20181010,1,1,3,3,7,3,2018,0,2,2080,0
Coyotes,1,1,0,1,3,Ducks,1,1,0,0,2,20181010,0,0,0,1,5,-1,2018,1,2,356,0
Flyers,1,3,3,0,7,Senators,1,2,1,0,4,20181010,0,1,3,3,11,-3,2018,0,2,373,0
Maple Leafs,1,2,2,0,5,Red Wings,1,0,2,0,3,20181011,0,2,2,2,8,-2,2018,0,3,205,0
Canucks,0,0,4,0,4,Lightning,1,0,0,0,1,20181011,-1,-1,3,3,5,-3,2018,0,3,2598,0
Blackhawks,2,0,1,0,3,Wild,0,2,1,1,4,20181011,-2,0,0,1,7,1,2018,1,3,355,0
Kings,2,0,1,0,3,Canadiens,0,0,0,0,0,20181011,2,2,3,3,3,-3,2018,0,3,2448,0
Jets,0,0,0,0,0,Predators,0,1,2,0,3,20181011,0,1,3,3,3,3,2018,0,3,1084,0
Golden Knights,1,0,1,0,2,Penguins,1,3,0,0,4,20181011,0,3,2,2,6,2,2018,0,3,1915,0
Flames,1,0,2,0,3,Blues,3,2,0,0,5,20181011,2,4,2,2,8,2,2018,0,3,1440,0
Capitals,0,0,0,0,0,Devils,2,1,3,0,6,20181011,2,3,6,6,6,6,2018,0,3,198,0
Blue Jackets,2,1,2,0,5,Panthers,1,3,0,0,4,20181011,1,-1,1,1,9,-1,2018,0,3,993,0
Avalanche,3,1,2,0,6,Sabres,0,1,0,0,1,20181011,3,3,5,5,7,-5,2018,0,3,1366,0
Sharks,1,1,0,0,2,Rangers,1,0,1,1,3,20181011,0,-1,0,1,5,1,2018,1,3,2549,0
Oilers,1,0,0,0,1,Bruins,3,0,1,0,4,20181011,2,2,3,3,5,3,2018,0,3,2074,0
Flames,0,1,1,1,3,Avalanche,2,0,0,0,2,20181013,-2,-1,0,1,5,-1,2018,1,5,898,0
Sabres,2,0,1,0,3,Coyotes,0,0,0,0,0,20181013,2,2,3,3,3,-3,2018,0,5,1902,0
Blues,0,1,2,0,3,Blackhawks,2,0,1,1,4,20181013,2,1,0,1,7,1,2018,1,5,260,0
Ducks,2,1,0,0,3,Stars,0,4,1,0,5,20181013,-2,1,2,2,8,2,2018,0,5,1237,0
Islanders,0,2,0,0,2,Predators,3,0,2,0,5,20181013,3,1,3,3,7,3,2018,0,5,758,0
Canucks,0,2,1,0,3,Panthers,0,2,0,0,2,20181013,0,0,1,1,5,-1,2018,0,5,2803,0
Blue Jackets,0,2,0,0,2,Lightning,3,1,4,0,8,20181013,3,2,6,6,10,6,2018,0,5,830,0
Maple Leafs,0,2,2,0,4,Capitals,1,1,0,0,2,20181013,-1,0,2,2,6,-2,2018,0,5,349,0
Hurricanes,1,1,2,1,5,Wild,1,0,3,0,4,20181013,0,1,0,1,9,-1,2018,1,5,995,0
Red Wings,0,0,2,0,2,Bruins,1,3,4,0,8,20181013,1,4,6,6,10,6,2018,0,5,611,0
Kings,0,1,0,0,1,Senators,3,1,1,0,5,20181013,3,3,4,4,6,4,2018,0,5,2345,0
Golden Knights,0,0,1,0,1,Flyers,0,0,0,0,0,20181013,0,0,1,1,1,-1,2018,0,5,2171,0
Oilers,1,0,1,0,2,Rangers,1,0,0,0,1,20181013,0,0,1,1,3,-1,2018,0,5,2024,0
Penguins,2,1,0,0,3,Canadiens,0,3,0,1,4,20181013,-2,0,0,1,7,1,2018,1,5,474,0
Hurricanes,0,0,1,0,1,Jets,0,0,3,0,3,20181014,0,0,2,2,4,2,2018,0,6,1350,0
Ducks,1,0,2,0,3,Blues,0,2,0,0,2,20181014,1,-1,1,1,5,-1,2018,0,6,1586,0
Sharks,0,2,0,0,2,Devils,0,1,2,0,3,20181014,0,-1,1,1,5,1,2018,0,6,2540,0
Kings,0,1,0,0,1,Maple Leafs,2,1,1,0,4,20181015,2,2,3,3,5,3,2018,0,0,2170,0
Red Wings,1,0,2,0,3,Canadiens,3,3,1,0,7,20181015,2,5,4,4,10,4,2018,0,0,508,0
Stars,1,0,0,0,1,Senators,0,1,3,0,4,20181015,-1,0,3,3,5,3,2018,0,0,1404,0
Wild,1,1,0,0,2,Predators,1,2,1,0,4,20181015,0,1,2,2,6,2,2018,0,0,696,0
Sabres,0,0,1,0,1,Golden Knights,1,1,2,0,4,20181016,1,2,3,3,5,3,2018,0,1,1970,0
Coyotes,1,0,0,0,1,Wild,0,1,1,0,2,20181016,-1,0,1,1,3,1,2018,0,1,1278,0
Oilers,1,0,3,1,5,Jets,3,1,0,0,4,20181016,-2,-3,0,1,9,-1,2018,1,1,738,0
Hurricanes,1,1,0,0,2,Lightning,1,1,2,0,4,20181016,0,0,2,2,6,2,2018,0,1,585,0
Stars,0,0,0,0,0,Devils,1,2,0,0,3,20181016,1,3,3,3,3,3,2018,0,1,1362,0
Panthers,1,2,2,0,5,Flyers,0,5,0,1,6,20181016,-1,2,0,1,11,1,2018,1,1,1021,0
Avalanche,0,2,0,0,2,Rangers,1,1,0,1,3,20181016,1,0,0,1,5,1,2018,1,1,1627,0
Canucks,2,0,0,1,3,Penguins,1,0,1,0,2,20181016,1,1,0,1,5,-1,2018,1,1,2168,0
Blues,0,1,1,0,2,Canadiens,1,1,1,0,3,20181017,1,1,1,1,5,1,2018,0,2,962,0
Rangers,1,1,1,0,3,Capitals,1,2,0,1,4,20181017,0,1,0,1,7,1,2018,1,2,204,0
Bruins,0,2,0,0,2,Flames,3,1,1,0,5,20181017,3,2,3,3,7,3,2018,0,2,2089,0
Islanders,0,0,1,0,1,Ducks,1,1,2,0,4,20181017,1,2,3,3,5,3,2018,0,2,2445,0
Sabres,0,1,0,0,1,Sharks,2,0,3,0,5,20181018,2,1,4,4,6,4,2018,0,3,2279,0
Islanders,1,2,4,0,7,Kings,1,0,1,0,2,20181018,0,2,5,5,9,-5,2018,0,3,2445,0
Bruins,0,1,1,0,2,Oilers,0,1,1,1,3,20181018,0,0,0,1,5,1,2018,1,3,2074,0
Coyotes,1,1,2,0,4,Blackhawks,0,1,0,0,1,20181018,1,1,3,3,5,-3,2018,0,3,1450,0
Canucks,0,1,0,0,1,Jets,1,0,3,0,4,20181018,1,0,3,3,5,3,2018,0,3,1157,0
Flyers,2,0,1,0,3,Blue Jackets,1,3,2,0,6,20181018,-1,2,3,3,9,3,2018,0,3,414,0
Avalanche,0,2,3,0,5,Devils,1,1,1,0,3,20181018,-1,0,2,2,8,-2,2018,0,3,1618,0
Penguins,1,0,2,0,3,Maple Leafs,0,0,0,0,0,20181018,1,1,3,3,3,-3,2018,0,3,222,0
Red Wings,0,1,0,0,1,Lightning,1,1,1,0,3,20181018,1,1,2,2,4,2,2018,0,3,994,0
Panthers,4,1,0,1,6,Capitals,1,3,1,0,5,20181019,3,1,0,1,11,-1,2018,1,4,924,0
Wild,0,0,3,0,3,Stars,0,0,1,0,1,20181019,0,0,2,2,4,-2,2018,0,4,863,0
Predators,1,2,2,0,5,Flames,1,1,1,0,3,20181019,0,1,2,2,8,-2,2018,0,4,1692,0
Ducks,0,0,1,0,1,Golden Knights,1,1,1,0,3,20181020,1,2,2,2,4,2,2018,0,5,228,0
Blackhawks,1,0,3,0,4,Blue Jackets,1,0,0,0,1,20181020,0,0,3,3,5,-3,2018,0,5,275,0
Bruins,0,0,1,0,1,Canucks,1,0,0,1,2,20181020,1,1,0,1,3,1,2018,1,5,2504,0
Predators,0,2,1,0,3,Oilers,0,0,0,0,0,20181020,0,2,3,3,3,-3,2018,0,5,1758,0
Lightning,3,0,1,0,4,Wild,1,1,2,1,5,20181020,-2,-1,0,1,9,1,2018,1,5,1318,0
Red Wings,0,3,0,1,4,Panthers,2,0,1,0,3,20181020,-2,1,0,1,7,-1,2018,1,5,1155,0
Islanders,1,0,0,0,1,Sharks,1,2,1,0,4,20181020,0,2,3,3,5,3,2018,0,5,2549,0
Blues,0,3,1,0,4,Maple Leafs,0,0,1,0,1,20181020,0,3,3,3,5,-3,2018,0,5,659,0
Coyotes,1,0,2,0,3,Jets,1,2,2,0,5,20181020,0,2,2,2,8,2,2018,0,5,1365,0
Sabres,1,3,1,0,5,Kings,0,0,1,0,1,20181020,1,4,4,4,6,-4,2018,0,5,2193,0
Avalanche,1,1,1,0,3,Hurricanes,0,0,1,0,1,20181020,1,2,2,2,4,-2,2018,0,5,1459,0
Devils,1,0,1,0,2,Flyers,1,1,3,0,5,20181020,0,1,3,3,7,3,2018,0,5,75,0
Canadiens,3,0,0,0,3,Senators,1,2,0,1,4,20181020,-2,0,0,1,7,1,2018,1,5,104,0
Sabres,0,2,2,0,4,Ducks,1,1,0,0,2,20181021,-1,0,2,2,6,-2,2018,0,6,2193,0
Lightning,1,3,2,0,6,Blackhawks,1,0,2,0,3,20181021,0,3,3,3,9,-3,2018,0,6,1004,0
Flames,1,2,1,0,4,Rangers,0,0,1,0,1,20181021,1,3,3,3,5,-3,2018,0,6,2023,0
Avalanche,1,1,2,0,4,Flyers,0,0,1,0,1,20181022,1,2,3,3,5,-3,2018,0,0,1574,0
Hurricanes,1,1,1,0,3,Red Wings,0,0,1,0,1,20181022,1,2,2,2,4,-2,2018,0,0,511,0
Blues,2,1,1,0,4,Jets,1,0,3,1,5,20181022,-1,-2,0,1,9,1,2018,1,0,853,0
Capitals,1,2,2,0,5,Canucks,0,1,1,0,2,20181022,1,2,3,3,7,-3,2018,0,0,2359,0
Ducks,0,1,0,0,1,Blackhawks,1,0,2,0,3,20181023,1,0,2,2,4,2,2018,0,1,1741,0
Penguins,1,3,1,1,6,Oilers,0,3,2,0,5,20181023,1,1,0,1,11,-1,2018,1,1,1797,0
Kings,0,2,0,0,2,Stars,1,2,1,0,4,20181023,1,1,2,2,6,2,2018,0,1,1237,0
Sharks,1,1,3,0,5,Predators,1,3,0,0,4,20181023,0,-2,1,1,9,-1,2018,0,1,1934,0
Panthers,1,0,1,0,2,Rangers,0,3,2,0,5,20181023,-1,2,3,3,7,3,2018,0,1,1091,0
Flames,1,0,1,0,2,Canadiens,0,3,0,0,3,20181023,-1,2,1,1,5,1,2018,0,1,1852,0
Coyotes,2,1,1,0,4,Blue Jackets,1,0,0,0,1,20181023,1,2,3,3,5,-3,2018,0,1,1664,0
Bruins,1,1,2,0,4,Senators,0,1,0,0,1,20181023,1,1,3,3,5,-3,2018,0,1,320,0
Panthers,0,0,2,1,3,Islanders,1,1,0,0,2,20181024,-1,-2,0,1,5,-1,2018,1,2,1091,0
Maple Leafs,1,2,1,0,4,Jets,0,0,2,0,2,20181024,1,3,2,2,6,-2,2018,0,2,946,0
Lightning,0,0,1,0,1,Avalanche,0,0,0,0,0,20181024,0,0,1,1,1,-1,2018,0,2,1521,0
Canucks,0,2,0,1,3,Golden Knights,0,2,0,0,2,20181024,0,0,0,1,5,-1,2018,1,2,986,0
Rangers,1,0,0,0,1,Blackhawks,1,1,2,0,4,20181025,0,1,3,3,5,3,2018,0,3,711,0
Capitals,0,1,0,0,1,Oilers,1,1,2,0,4,20181025,1,1,3,3,5,3,2018,0,3,1985,0
Penguins,3,4,2,0,9,Flames,0,0,1,0,1,20181025,3,7,8,8,10,-8,2018,0,3,1777,0
Ducks,1,1,0,0,2,Stars,2,3,0,0,5,20181025,1,3,3,3,7,3,2018,0,3,1237,0
Kings,0,0,1,0,1,Wild,1,1,2,0,4,20181025,1,2,3,3,5,3,2018,0,3,1521,0
Canucks,0,1,0,0,1,Coyotes,0,1,3,0,4,20181025,0,0,3,3,5,3,2018,0,3,1228,0
Predators,1,1,1,1,4,Devils,2,1,0,0,3,20181025,-1,-1,0,1,7,-1,2018,1,3,750,0
Canadiens,1,1,1,0,3,Sabres,0,2,2,0,4,20181025,-1,0,1,1,7,1,2018,0,3,311,0
Flyers,0,0,0,0,0,Bruins,0,2,1,0,3,20181025,0,2,3,3,3,3,2018,0,3,270,0
Blue Jackets,1,3,3,0,7,Blues,2,1,1,0,4,20181025,-1,1,3,3,11,-3,2018,0,3,395,0
Lightning,2,1,0,0,3,Golden Knights,1,0,1,0,2,20181026,1,2,1,1,5,-1,2018,0,4,1985,0
Jets,0,1,1,0,2,Red Wings,1,0,0,0,1,20181026,-1,0,1,1,3,-1,2018,0,4,855,0
Sharks,2,1,0,0,3,Hurricanes,0,3,0,1,4,20181026,-2,0,0,1,7,1,2018,1,4,2382,0
Senators,2,1,0,0,3,Avalanche,0,2,4,0,6,20181026,-2,-1,3,3,9,3,2018,0,4,1515,0
Lightning,0,0,1,0,1,Coyotes,3,2,2,0,7,20181027,3,5,6,6,8,6,2018,0,5,1793,0
Avalanche,1,0,1,0,2,Wild,0,1,2,0,3,20181027,-1,0,1,1,5,1,2018,0,5,698,0
Blackhawks,2,1,0,0,3,Blues,2,2,3,0,7,20181027,0,1,4,4,10,4,2018,0,5,260,0
Sabres,2,0,2,0,4,Blue Jackets,1,3,0,1,5,20181027,-1,2,0,1,9,1,2018,1,5,293,0
Jets,1,1,0,0,2,Maple Leafs,0,0,3,0,3,20181027,-1,-2,1,1,5,1,2018,0,5,946,0
Penguins,0,2,3,0,5,Canucks,0,0,0,0,0,20181027,0,2,5,5,5,-5,2018,0,5,2168,0
Capitals,2,1,0,1,4,Flames,2,0,1,0,3,20181027,0,1,0,1,7,-1,2018,1,5,1967,0
Oilers,1,2,2,0,5,Predators,0,1,2,0,3,20181027,1,2,2,2,8,-2,2018,0,5,1758,0
Islanders,2,1,3,0,6,Flyers,0,1,0,0,1,20181027,2,2,5,5,7,-5,2018,0,5,80,0
Panthers,0,0,2,0,2,Devils,1,2,0,0,3,20181027,1,3,1,1,5,1,2018,0,5,1090,0
Canadiens,2,0,1,0,3,Bruins,0,0,0,0,0,20181027,2,2,3,3,3,-3,2018,0,5,270,0
Rangers,1,1,1,0,3,Kings,0,2,2,0,4,20181028,-1,0,1,1,7,1,2018,0,6,2445,0
Stars,1,0,1,0,2,Red Wings,0,1,3,0,4,20181028,-1,0,2,2,6,2,2018,0,6,999,0
Islanders,1,1,0,0,2,Hurricanes,0,1,0,0,1,20181028,1,1,1,1,3,-1,2018,0,6,423,0
Oilers,1,0,0,1,2,Blackhawks,1,0,0,0,1,20181028,0,0,0,1,3,-1,2018,1,6,1437,0
Senators,1,1,1,0,3,Golden Knights,0,2,1,1,4,20181028,-1,0,0,1,7,1,2018,1,6,2119,0
Sharks,1,2,0,1,4,Ducks,1,1,1,0,3,20181028,0,1,0,1,7,-1,2018,1,6,305,0
Wild,1,1,0,0,2,Canucks,1,2,2,0,5,20181029,0,1,3,3,7,3,2018,0,0,1427,0
Flames,0,0,3,0,3,Maple Leafs,0,0,1,0,1,20181029,0,0,2,2,4,-2,2018,0,0,1682,0
Flames,0,0,1,1,2,Sabres,1,0,0,0,1,20181030,-1,-1,0,1,3,-1,2018,1,1,1731,0
Islanders,2,3,1,0,6,Penguins,2,0,1,0,3,20181030,0,3,3,3,9,-3,2018,0,1,314,0
Bruins,0,2,1,0,3,Hurricanes,1,1,0,0,2,20181030,-1,0,1,1,5,-1,2018,0,1,609,0
Red Wings,3,0,2,0,5,Blue Jackets,0,0,3,0,3,20181030,3,3,2,2,8,-2,2018,0,1,163,0
Stars,0,2,2,0,4,Canadiens,0,0,1,0,1,20181030,0,2,3,3,5,-3,2018,0,1,1505,0
Devils,2,1,0,0,3,Lightning,2,3,3,0,8,20181030,0,2,5,5,11,5,2018,0,1,1000,0
Golden Knights,1,0,0,0,1,Predators,0,2,2,0,4,20181030,-1,1,3,3,5,3,2018,0,1,1575,0
Wild,1,2,1,0,4,Oilers,1,2,0,0,3,20181030,0,0,1,1,7,-1,2018,0,1,1083,0
Senators,0,1,0,0,1,Coyotes,3,1,1,0,5,20181030,3,3,4,4,6,4,2018,0,1,2071,0
Flyers,1,1,1,0,3,Ducks,0,1,1,0,2,20181030,1,1,1,1,5,-1,2018,0,1,2388,0
Rangers,1,0,2,1,4,Sharks,1,0,2,0,3,20181030,0,0,0,1,7,-1,2018,1,1,2549,0
Blackhawks,1,1,0,0,2,Canucks,1,1,2,0,4,20181031,0,0,2,2,6,2,2018,0,2,1775,0
Blackhawks,0,0,0,0,0,Oilers,0,2,2,0,4,20181101,0,2,4,4,4,4,2018,0,3,1437,0
Rangers,0,2,0,1,3,Ducks,0,1,1,0,2,20181101,0,1,0,1,5,-1,2018,1,3,2445,0
Golden Knights,1,1,1,0,3,Blues,1,3,1,0,5,20181101,0,2,2,2,8,2,2018,0,3,1375,0
Blue Jackets,1,2,1,0,4,Sharks,1,0,0,0,1,20181101,0,2,3,3,5,-3,2018,0,3,2090,0
Flyers,1,2,2,0,5,Kings,0,2,0,0,2,20181101,1,1,3,3,7,-3,2018,0,3,2388,0
Predators,2,0,2,0,4,Lightning,0,1,0,0,1,20181101,2,1,3,3,5,-3,2018,0,3,621,0
Avalanche,0,4,1,0,5,Flames,0,1,5,0,6,20181101,0,-3,1,1,11,1,2018,0,3,898,0
Sabres,0,0,2,0,2,Senators,1,2,1,0,4,20181101,1,3,2,2,6,2,2018,0,3,219,0
Capitals,1,3,0,0,4,Canadiens,1,2,3,0,6,20181101,0,-1,2,2,10,2,2018,0,3,495,0
Penguins,1,0,1,0,2,Islanders,0,1,1,1,3,20181101,-1,0,0,1,5,1,2018,1,3,314,0
Stars,0,1,1,0,2,Maple Leafs,0,0,1,0,1,20181101,0,1,1,1,3,-1,2018,0,3,1201,0
Jets,1,1,2,0,4,Panthers,0,2,0,0,2,20181101,1,0,2,2,6,-2,2018,0,3,1899,0
Devils,0,1,2,0,3,Red Wings,1,0,3,0,4,20181101,1,0,1,1,7,1,2018,0,3,471,0
Panthers,1,2,1,0,4,Jets,2,0,0,0,2,20181102,-1,1,2,2,6,-2,2018,0,4,1899,0
Avalanche,0,4,2,0,6,Canucks,1,3,2,1,7,20181102,1,0,0,1,13,1,2018,1,4,1105,0
Hurricanes,0,1,2,0,3,Coyotes,3,0,0,1,4,20181102,3,2,0,1,7,1,2018,1,4,1898,0
Flyers,2,1,0,0,3,Sharks,1,1,1,1,4,20181103,-1,-1,0,1,7,1,2018,1,5,2499,0
Blue Jackets,0,0,1,0,1,Kings,1,1,2,0,4,20181103,1,2,3,3,5,3,2018,0,5,1973,0
Hurricanes,0,0,0,0,0,Golden Knights,1,1,1,0,3,20181103,1,2,3,3,3,3,2018,0,5,2028,0
Blackhawks,2,1,0,0,3,Flames,1,1,3,0,5,20181103,-1,-1,2,2,8,2,2018,0,5,1397,0
Bruins,0,0,0,0,0,Predators,1,0,0,0,1,20181103,1,1,1,1,1,1,2018,0,5,941,0
Stars,2,1,0,1,4,Capitals,0,2,1,0,3,20181103,2,1,0,1,7,-1,2018,1,5,1181,0
Wild,3,1,1,0,5,Blues,1,0,0,0,1,20181103,2,3,4,4,6,-4,2018,0,5,466,0
Devils,0,0,0,0,0,Islanders,1,0,2,0,3,20181103,1,1,3,3,3,3,2018,0,5,8,0
Oilers,1,2,1,0,4,Red Wings,1,1,1,0,3,20181103,0,1,1,1,7,-1,2018,0,5,1592,0
Lightning,2,0,2,0,4,Canadiens,1,0,0,0,1,20181103,1,1,3,3,5,-3,2018,0,5,1311,0
Senators,0,1,1,0,2,Sabres,3,4,2,0,9,20181103,3,6,7,7,11,7,2018,0,5,219,0
Maple Leafs,1,2,2,0,5,Penguins,0,0,0,0,0,20181103,1,3,5,5,5,-5,2018,0,5,222,0
Blue Jackets,0,1,1,0,2,Ducks,0,2,0,1,3,20181104,0,1,0,1,5,1,2018,1,6,1973,0
Lightning,0,1,2,1,4,Senators,2,0,1,0,3,20181104,-2,-1,0,1,7,-1,2018,1,6,1251,0
Sabres,0,0,1,0,1,Rangers,0,2,1,0,3,20181104,0,2,2,2,4,2,2018,0,6,292,0
Stars,1,0,0,0,1,Bruins,1,0,0,1,2,20181105,0,0,0,1,3,1,2018,1,0,1548,0
Canadiens,1,1,1,1,4,Islanders,3,0,0,0,3,20181105,-2,-1,0,1,7,-1,2018,1,0,343,0
Devils,2,2,1,0,5,Penguins,1,0,0,0,1,20181105,1,3,4,4,6,-4,2018,0,0,306,0
Oilers,1,1,0,0,2,Capitals,2,2,0,0,4,20181105,1,2,2,2,6,2,2018,0,0,1985,0
Flyers,2,1,2,0,5,Coyotes,0,1,1,0,2,20181105,2,2,3,3,7,-3,2018,0,0,2078,0
Hurricanes,1,0,0,0,1,Blues,3,0,1,0,4,20181106,2,2,3,3,5,3,2018,0,1,665,0
Oilers,0,1,1,0,2,Lightning,2,2,1,0,5,20181106,2,3,3,3,7,3,2018,0,1,2367,0
Wild,0,1,2,0,3,Sharks,1,2,1,0,4,20181106,1,2,1,1,7,1,2018,0,1,1570,0
Ducks,0,1,0,0,1,Kings,2,1,1,0,4,20181106,2,2,3,3,5,3,2018,0,1,0,0
Canucks,1,1,0,0,2,Red Wings,0,1,1,1,3,20181106,-1,-1,0,1,5,1,2018,1,1,1967,0
Golden Knights,0,1,0,0,1,Maple Leafs,1,1,1,0,3,20181106,1,1,2,2,4,2,2018,0,1,1946,0
Stars,0,0,1,0,1,Blue Jackets,1,2,1,0,4,20181106,1,3,3,3,5,3,2018,0,1,912,0
Canadiens,1,2,0,0,3,Rangers,1,1,3,0,5,20181106,0,-1,2,2,8,2,2018,0,1,343,0
Devils,2,0,1,0,3,Senators,2,3,2,0,7,20181106,0,3,4,4,10,4,2018,0,1,330,0
Penguins,1,0,0,0,1,Capitals,0,1,1,0,2,20181107,-1,0,1,1,3,1,2018,0,2,190,0
Predators,2,1,1,0,4,Avalanche,0,1,0,0,1,20181107,2,2,3,3,5,-3,2018,0,2,1019,0
Flames,1,0,1,0,2,Ducks,2,0,1,0,3,20181107,1,1,1,1,5,1,2018,0,2,1197,0
Wild,1,1,1,0,3,Kings,1,0,0,0,1,20181108,0,1,2,2,4,-2,2018,0,3,1521,0
Sharks,1,1,1,0,3,Stars,1,2,1,0,4,20181108,0,1,1,1,7,1,2018,0,3,1449,0
Hurricanes,3,1,0,0,4,Blackhawks,0,2,1,0,3,20181108,3,2,1,1,7,-1,2018,0,3,641,0
Golden Knights,2,1,2,0,5,Senators,0,1,2,0,3,20181108,2,2,2,2,8,-2,2018,0,3,2119,0
Islanders,1,0,1,0,2,Lightning,0,2,2,0,4,20181108,-1,1,2,2,6,2,2018,0,3,1004,0
Coyotes,1,3,0,0,4,Flyers,2,0,2,1,5,20181108,1,-2,0,1,9,1,2018,1,3,2078,0
Oilers,0,0,1,0,1,Panthers,0,2,2,0,4,20181108,0,2,3,3,5,3,2018,0,3,2569,0
Canucks,1,5,2,0,8,Bruins,1,3,1,0,5,20181108,0,2,3,3,13,-3,2018,0,3,2504,0
Sabres,3,1,1,1,6,Canadiens,3,2,0,0,5,20181108,0,-1,0,1,11,-1,2018,1,3,311,0
Devils,0,1,0,0,1,Maple Leafs,1,4,1,0,6,20181109,1,4,5,5,7,5,2018,0,4,333,0
Blue Jackets,1,0,1,0,2,Capitals,0,1,0,0,1,20181109,1,0,1,1,3,-1,2018,0,4,326,0
Rangers,0,2,0,0,2,Red Wings,0,0,2,1,3,20181109,0,-2,0,1,5,1,2018,1,4,480,0
Sharks,0,0,0,0,0,Blues,1,2,1,0,4,20181109,1,3,4,4,4,4,2018,0,4,1719,0
Avalanche,0,0,2,0,2,Jets,2,0,3,0,5,20181109,2,2,3,3,7,3,2018,0,4,797,0
Wild,1,2,2,0,5,Ducks,0,1,0,0,1,20181109,1,2,4,4,6,-4,2018,0,4,1521,0
Flames,1,0,0,0,1,Kings,0,0,0,0,0,20181110,1,1,1,1,1,-1,2018,0,5,1197,0
Coyotes,0,0,0,0,0,Penguins,0,3,1,0,4,20181110,0,3,4,4,4,4,2018,0,5,1824,0
Rangers,1,3,0,1,5,Blue Jackets,1,3,0,0,4,20181110,0,0,0,1,9,-1,2018,1,5,476,0
Red Wings,1,0,2,1,4,Hurricanes,1,2,0,0,3,20181110,0,-2,0,1,7,-1,2018,1,5,511,0
Islanders,1,1,0,0,2,Panthers,1,1,2,0,4,20181110,0,0,2,2,6,2,2018,0,5,1091,0
Senators,2,0,4,0,6,Lightning,1,3,0,0,4,20181110,1,-2,2,2,10,-2,2018,0,5,1251,0
Maple Leafs,0,1,0,0,1,Bruins,1,2,2,0,5,20181110,1,2,4,4,6,4,2018,0,5,430,0
Predators,0,1,3,1,5,Stars,1,2,1,0,4,20181110,-1,-2,0,1,9,-1,2018,1,5,616,0
Blackhawks,0,0,0,0,0,Flyers,1,1,2,0,4,20181110,1,2,4,4,4,4,2018,0,5,664,0
Canucks,0,2,1,0,3,Sabres,1,0,2,1,4,20181110,1,-1,0,1,7,1,2018,1,5,2137,0
Golden Knights,2,1,1,0,4,Canadiens,0,3,2,0,5,20181110,-2,0,1,1,9,1,2018,0,5,2221,0
Wild,0,2,1,0,3,Blues,1,1,0,0,2,20181111,-1,0,1,1,5,-1,2018,0,6,466,0
Senators,1,0,0,0,1,Panthers,0,5,0,0,5,20181111,-1,4,4,4,6,4,2018,0,6,1370,0
Coyotes,1,2,1,0,4,Capitals,0,1,0,0,1,20181111,1,2,3,3,5,-3,2018,0,6,1977,0
Golden Knights,0,1,0,0,1,Bruins,2,1,1,0,4,20181111,2,2,3,3,5,3,2018,0,6,2369,0
Devils,1,1,0,0,2,Jets,2,3,0,0,5,20181111,1,3,3,3,7,3,2018,0,6,1280,0
Flames,0,1,0,0,1,Sharks,1,1,1,0,3,20181111,1,1,2,2,4,2,2018,0,6,1027,0
Avalanche,2,2,0,0,4,Oilers,0,0,1,0,1,20181111,2,4,3,3,5,-3,2018,0,6,1036,0
Predators,0,0,1,0,1,Ducks,0,1,0,1,2,20181112,0,1,0,1,3,1,2018,1,0,1776,0
Blue Jackets,0,1,1,0,2,Stars,0,1,0,0,1,20181112,0,0,1,1,3,-1,2018,0,0,912,0
Blackhawks,1,1,0,0,2,Hurricanes,0,2,0,1,3,20181112,-1,0,0,1,5,1,2018,1,0,641,0
Canucks,0,1,0,0,1,Rangers,0,1,1,0,2,20181112,0,0,1,1,3,1,2018,0,0,2429,0
Penguins,1,0,1,0,2,Devils,1,1,2,0,4,20181113,0,1,2,2,6,2,2018,0,1,306,0
Canucks,1,1,0,0,2,Islanders,3,0,2,0,5,20181113,2,1,3,3,7,3,2018,0,1,2429,0
Panthers,0,2,0,0,2,Flyers,0,0,1,0,1,20181113,0,2,1,1,3,-1,2018,0,1,1021,0
Lightning,0,1,0,0,1,Sabres,1,1,0,0,2,20181113,1,1,1,1,3,1,2018,0,1,1051,0
Coyotes,0,0,1,0,1,Red Wings,3,1,2,0,6,20181113,3,4,5,5,7,5,2018,0,1,1687,0
Capitals,2,1,2,0,5,Wild,0,1,1,0,2,20181113,2,2,3,3,7,-3,2018,0,1,931,0
Canadiens,1,1,0,0,2,Oilers,2,1,3,0,6,20181113,1,1,4,4,8,4,2018,0,1,1826,0
Maple Leafs,2,3,0,0,5,Kings,1,0,0,0,1,20181113,1,4,4,4,6,-4,2018,0,1,2170,0
Predators,0,3,1,0,4,Sharks,3,0,2,0,5,20181113,3,0,1,1,9,1,2018,0,1,1934,0
Blues,0,0,0,0,0,Blackhawks,0,1,0,0,1,20181114,0,1,1,1,1,1,2018,0,2,260,0
Capitals,1,0,0,0,1,Jets,0,1,2,0,3,20181114,-1,0,2,2,4,2,2018,0,2,1247,0
Bruins,2,1,0,0,3,Avalanche,1,1,4,0,6,20181114,-1,-1,3,3,9,3,2018,0,2,1765,0
Ducks,0,0,0,0,0,Golden Knights,1,3,1,0,5,20181114,1,4,5,5,5,5,2018,0,2,228,0
Predators,0,0,1,0,1,Coyotes,1,1,0,0,2,20181115,1,2,1,1,3,1,2018,0,3,1442,0
Devils,1,0,2,0,3,Flyers,0,0,0,0,0,20181115,1,1,3,3,3,-3,2018,0,3,75,0
Maple Leafs,2,2,1,0,5,Sharks,3,0,0,0,3,20181115,-1,1,2,2,8,-2,2018,0,3,2249,0
Canadiens,1,0,2,0,3,Flames,0,2,0,0,2,20181115,1,-1,1,1,5,-1,2018,0,3,1852,0
Canucks,0,1,1,0,2,Wild,2,3,1,0,6,20181115,2,4,4,4,8,4,2018,0,3,1427,0
Rangers,2,1,2,0,5,Islanders,2,3,2,0,7,20181115,0,2,2,2,12,2,2018,0,3,0,0
Panthers,2,1,0,0,3,Blue Jackets,0,3,4,0,7,20181115,-2,0,4,4,10,4,2018,0,3,993,0
Lightning,1,3,0,0,4,Penguins,2,1,0,0,3,20181115,-1,1,1,1,7,-1,2018,0,3,874,0
Red Wings,0,1,0,0,1,Senators,1,1,0,0,2,20181115,1,1,1,1,3,1,2018,0,3,406,0
Bruins,0,0,0,0,0,Stars,0,0,0,1,1,20181116,0,0,0,1,1,1,2018,1,4,1548,0
Sabres,0,0,1,1,2,Jets,0,1,0,0,1,20181116,0,-1,0,1,3,-1,2018,1,4,996,0
Kings,0,1,0,1,2,Blackhawks,0,0,1,0,1,20181116,0,1,0,1,3,-1,2018,1,4,1741,0
Capitals,0,2,0,1,3,Avalanche,1,0,1,0,2,20181116,-1,1,0,1,5,-1,2018,1,4,1489,0
Blues,1,3,0,0,4,Golden Knights,1,0,0,0,1,20181116,0,3,3,3,5,-3,2018,0,4,1375,0
Maple Leafs,1,0,0,1,2,Ducks,0,1,0,0,1,20181116,1,0,0,1,3,-1,2018,1,4,2170,0
Blues,0,0,0,0,0,Sharks,0,3,1,0,4,20181117,0,3,4,4,4,4,2018,0,5,1719,0
Oilers,1,1,0,0,2,Flames,0,1,3,0,4,20181117,-1,-1,2,2,6,2,2018,0,5,171,0
Bruins,2,0,0,0,2,Coyotes,0,1,0,0,1,20181117,2,1,1,1,3,-1,2018,0,5,2295,0
Kings,0,3,0,0,3,Predators,0,2,3,0,5,20181117,0,-1,2,2,8,2,2018,0,5,1776,0
Canadiens,0,1,2,0,3,Canucks,0,1,1,0,2,20181117,0,0,1,1,5,-1,2018,0,5,2273,0
Blue Jackets,1,3,0,0,4,Hurricanes,0,1,0,0,1,20181117,1,3,3,3,5,-3,2018,0,5,374,0
Sabres,1,0,2,0,3,Wild,2,0,0,0,2,20181117,-1,-1,1,1,5,-1,2018,0,5,729,0
Penguins,1,0,3,0,4,Senators,3,2,1,0,6,20181117,2,4,2,2,10,2,2018,0,5,392,0
Lightning,0,3,2,1,6,Flyers,0,1,4,0,5,20181117,0,2,0,1,11,-1,2018,1,5,928,0
Red Wings,0,1,1,1,3,Devils,1,1,0,0,2,20181117,-1,-1,0,1,5,-1,2018,1,5,471,0
Panthers,2,0,0,0,2,Rangers,2,1,1,0,4,20181117,0,1,2,2,6,2,2018,0,5,1091,0
Golden Knights,1,3,2,0,6,Oilers,2,0,1,0,3,20181118,-1,2,3,3,9,-3,2018,0,6,1204,0
Stars,0,4,2,0,6,Islanders,1,0,1,0,2,20181118,-1,3,4,4,8,-4,2018,0,6,1370,0
Devils,1,0,0,0,1,Hurricanes,2,0,0,0,2,20181118,1,1,1,1,3,1,2018,0,6,419,0
Wild,0,1,0,0,1,Blackhawks,2,0,1,0,3,20181118,2,1,2,2,4,2,2018,0,6,355,0
Avalanche,0,2,1,1,4,Ducks,1,2,0,0,3,20181118,-1,-1,0,1,7,-1,2018,1,6,830,0
Lightning,1,0,1,0,2,Predators,1,2,0,0,3,20181119,0,2,1,1,5,1,2018,0,0,621,0
Kings,0,1,1,0,2,Blues,0,0,0,0,0,20181119,0,1,2,2,2,-2,2018,0,0,1586,0
Jets,3,1,2,0,6,Canucks,1,2,0,0,3,20181119,2,1,3,3,9,-3,2018,0,0,1157,0
Panthers,4,2,1,0,7,Senators,1,2,2,0,5,20181119,3,3,2,2,12,-2,2018,0,0,1370,0
Golden Knights,0,0,2,0,2,Flames,5,2,0,0,7,20181119,5,7,5,5,9,5,2018,0,0,1033,0
Sabres,1,2,1,1,5,Penguins,2,2,0,0,4,20181119,-1,-1,0,1,9,-1,2018,1,0,178,0
Blue Jackets,2,0,0,0,2,Maple Leafs,0,2,2,0,4,20181119,-2,0,2,2,6,2,2018,0,0,313,0
Capitals,2,1,1,1,5,Canadiens,1,3,0,0,4,20181119,1,-1,0,1,9,-1,2018,1,0,495,0
Stars,0,1,0,0,1,Rangers,0,1,1,0,2,20181119,0,0,1,1,3,1,2018,0,0,1370,0
Oilers,1,1,1,1,4,Sharks,2,1,0,0,3,20181120,-1,-1,0,1,7,-1,2018,1,1,1190,0
Blues,1,0,0,0,1,Predators,1,1,2,0,4,20181121,0,1,3,3,5,3,2018,0,2,253,0
Canucks,0,1,2,0,3,Ducks,1,1,2,0,4,20181121,1,1,1,1,7,1,2018,0,2,1076,0
Jets,1,1,1,0,3,Flames,5,0,1,0,6,20181121,4,3,3,3,9,3,2018,0,2,740,0
Golden Knights,0,2,0,1,3,Coyotes,1,0,1,0,2,20181121,-1,1,0,1,5,-1,2018,1,2,256,0
Senators,0,1,3,0,4,Wild,2,2,2,0,6,20181121,2,3,2,2,10,2,2018,0,2,838,0
Panthers,1,1,1,0,3,Lightning,2,2,3,0,7,20181121,1,2,4,4,10,4,2018,0,2,205,0
Bruins,0,1,1,0,2,Red Wings,0,1,1,1,3,20181121,0,0,0,1,5,1,2018,1,2,611,0
Flyers,0,2,0,0,2,Sabres,4,0,1,0,5,20181121,4,2,3,3,7,3,2018,0,2,279,0
Maple Leafs,1,0,1,0,2,Hurricanes,2,0,3,0,5,20181121,1,1,3,3,7,3,2018,0,2,544,0
Blackhawks,0,1,1,0,2,Capitals,2,1,1,0,4,20181121,2,2,2,2,6,2,2018,0,2,594,0
Stars,0,0,1,0,1,Penguins,3,2,0,0,5,20181121,3,5,4,4,6,4,2018,0,2,1069,0
Islanders,0,0,0,0,0,Rangers,3,1,1,0,5,20181121,3,4,5,5,5,5,2018,0,2,0,0
Canadiens,1,0,1,0,2,Devils,2,3,0,0,5,20181121,1,4,3,3,7,3,2018,0,2,342,0
Avalanche,2,2,3,0,7,Kings,1,0,2,0,3,20181121,1,3,4,4,10,-4,2018,0,2,830,0
Blackhawks,1,1,0,0,2,Lightning,4,0,0,0,4,20181123,3,2,2,2,6,2,2018,0,4,1004,0
Panthers,0,0,1,0,1,Hurricanes,1,0,3,0,4,20181123,1,1,3,3,5,3,2018,0,4,696,0
Canucks,0,0,0,0,0,Sharks,2,0,2,0,4,20181123,2,2,4,4,4,4,2018,0,4,821,0
Senators,1,1,2,0,4,Stars,1,2,3,0,6,20181123,0,1,2,2,10,2,2018,0,4,1404,0
Penguins,0,1,0,0,1,Bruins,0,1,0,1,2,20181123,0,0,0,1,3,1,2018,1,4,481,0
Predators,1,0,1,0,2,Blues,3,2,1,0,6,20181123,2,4,4,4,8,4,2018,0,4,253,0
Maple Leafs,1,1,0,0,2,Blue Jackets,2,1,1,0,4,20181123,1,1,2,2,6,2,2018,0,4,313,0
Avalanche,3,0,2,0,5,Coyotes,0,0,1,0,1,20181123,3,3,4,4,6,-4,2018,0,4,585,0
Oilers,0,0,1,0,1,Ducks,0,0,1,1,2,20181123,0,0,0,1,3,1,2018,1,4,1368,0
Rangers,0,0,0,0,0,Flyers,1,0,3,0,4,20181123,1,1,4,4,4,4,2018,0,4,80,0
Canadiens,0,1,1,0,2,Sabres,1,0,1,1,3,20181123,1,0,0,1,5,1,2018,1,4,311,0
Flames,0,0,0,0,0,Golden Knights,0,1,1,0,2,20181123,0,1,2,2,2,2,2018,0,4,1033,0
Red Wings,1,0,0,0,1,Capitals,0,1,2,0,3,20181123,-1,0,2,2,4,2,2018,0,4,394,0
Jets,1,1,0,0,2,Wild,0,0,4,0,4,20181123,-1,-2,2,2,6,2,2018,0,4,388,0
Islanders,1,1,1,1,4,Devils,0,1,2,0,3,20181123,1,1,0,1,7,-1,2018,1,4,8,0
Capitals,0,3,2,0,5,Rangers,1,1,1,0,3,20181124,-1,1,2,2,8,-2,2018,0,5,204,0
Canucks,0,2,2,0,4,Kings,0,2,0,0,2,20181124,0,0,2,2,6,-2,2018,0,5,1076,0
Bruins,2,0,1,0,3,Canadiens,0,0,2,0,2,20181124,2,2,1,1,5,-1,2018,0,5,270,0
Sabres,1,0,1,1,3,Red Wings,0,1,1,0,2,20181124,1,0,0,1,5,-1,2018,1,5,215,0
Blackhawks,0,2,2,1,5,Panthers,2,2,0,0,4,20181124,-2,-2,0,1,9,-1,2018,1,5,1189,0
Hurricanes,0,0,1,0,1,Islanders,2,1,1,0,4,20181124,2,3,3,3,5,3,2018,0,5,423,0
Blue Jackets,1,1,0,0,2,Penguins,3,1,0,0,4,20181124,2,2,2,2,6,2,2018,0,5,161,0
Jets,2,4,2,0,8,Blues,2,0,2,0,4,20181124,0,4,4,4,12,-4,2018,0,5,853,0
Stars,0,0,2,0,2,Avalanche,0,1,2,0,3,20181124,0,1,1,1,5,1,2018,0,5,661,0
Sharks,0,0,0,0,0,Golden Knights,4,1,1,0,6,20181124,4,5,6,6,6,6,2018,0,5,382,0
Flyers,0,0,0,0,0,Maple Leafs,4,2,0,0,6,20181124,4,6,6,6,6,6,2018,0,5,334,0
Oilers,1,1,0,0,2,Kings,1,1,3,0,5,20181125,0,0,3,3,7,3,2018,0,6,1368,0
Ducks,0,2,0,0,2,Predators,1,2,2,0,5,20181125,1,1,3,3,7,3,2018,0,6,1776,0
Flames,2,2,2,0,6,Coyotes,0,0,1,0,1,20181125,2,4,5,5,7,-5,2018,0,6,1224,0
Devils,1,0,1,0,2,Lightning,4,1,0,0,5,20181125,3,4,3,3,7,3,2018,0,6,1000,0
Bruins,0,2,0,0,2,Maple Leafs,1,2,1,0,4,20181126,1,1,2,2,6,2,2018,0,0,430,0
Devils,0,2,1,0,3,Panthers,0,2,1,1,4,20181126,0,0,0,1,7,1,2018,1,0,1090,0
Capitals,1,1,2,0,4,Islanders,1,0,0,0,1,20181126,0,1,3,3,5,-3,2018,0,0,204,0
Senators,1,0,1,0,2,Rangers,1,0,3,0,4,20181126,0,0,2,2,6,2,2018,0,0,334,0
Blue Jackets,3,2,2,0,7,Red Wings,0,3,2,0,5,20181126,3,2,2,2,12,-2,2018,0,0,163,0
Hurricanes,1,1,0,0,2,Canadiens,0,0,1,0,1,20181127,1,2,1,1,3,-1,2018,0,1,727,0
Kings,0,1,0,1,2,Canucks,0,0,1,0,1,20181127,0,1,0,1,3,-1,2018,1,1,1076,0
Sharks,0,0,2,0,2,Sabres,0,1,1,1,3,20181127,0,1,0,1,5,1,2018,1,1,2279,0
Senators,1,0,3,0,4,Flyers,1,2,0,0,3,20181127,0,-2,1,1,7,-1,2018,0,1,373,0
Ducks,0,1,2,0,3,Lightning,0,1,0,0,1,20181127,0,0,2,2,4,-2,2018,0,1,2149,0
Avalanche,1,1,1,0,3,Predators,1,1,0,0,2,20181127,0,0,1,1,5,-1,2018,0,1,1019,0
Coyotes,1,0,3,0,4,Wild,1,2,0,0,3,20181127,0,-2,1,1,7,-1,2018,0,1,1278,0
Penguins,1,1,2,0,4,Jets,1,2,0,0,3,20181127,0,-1,1,1,7,-1,2018,0,1,1060,0
Golden Knights,3,3,2,0,8,Blackhawks,0,2,1,0,3,20181127,3,4,5,5,11,-5,2018,0,1,1519,0
Stars,0,0,0,0,0,Oilers,0,0,0,1,1,20181127,0,0,0,1,1,1,2018,1,1,1655,0
Stars,1,1,1,1,4,Flames,1,0,2,0,3,20181128,0,1,0,1,7,-1,2018,1,2,1536,0
Sharks,1,1,1,0,3,Maple Leafs,3,1,1,0,5,20181128,2,2,2,2,8,2,2018,0,2,2249,0
Penguins,0,2,1,0,3,Avalanche,1,2,3,0,6,20181128,1,1,3,3,9,3,2018,0,2,1317,0
Ducks,1,1,1,0,3,Panthers,0,2,0,0,2,20181128,1,0,1,1,5,-1,2018,0,2,2335,0
Blues,0,2,1,0,3,Red Wings,0,3,1,0,4,20181128,0,1,1,1,7,1,2018,0,2,454,0
Wild,1,1,0,0,2,Blue Jackets,1,3,0,0,4,20181129,0,2,2,2,6,2,2018,0,3,626,0
Rangers,0,0,0,0,0,Senators,2,1,0,0,3,20181129,2,3,3,3,3,3,2018,0,3,334,0
Sabres,2,1,1,0,4,Lightning,3,0,2,0,5,20181129,1,0,1,1,9,1,2018,0,3,1051,0
Islanders,1,0,0,0,1,Bruins,0,1,0,1,2,20181129,-1,0,0,1,3,1,2018,1,3,190,0
Coyotes,0,2,1,0,3,Predators,0,0,0,0,0,20181129,0,2,3,3,3,-3,2018,0,3,1442,0
Blackhawks,2,1,2,0,5,Jets,2,2,2,0,6,20181129,0,1,1,1,11,1,2018,0,3,722,0
Kings,2,0,0,0,2,Oilers,2,0,1,0,3,20181129,0,0,1,1,5,1,2018,0,3,1368,0
Golden Knights,1,1,2,0,4,Canucks,1,0,2,0,3,20181129,0,1,1,1,7,-1,2018,0,3,986,0
Kings,0,1,0,0,1,Flames,1,0,3,0,4,20181130,1,0,3,3,5,3,2018,0,4,1197,0
Blues,2,0,0,1,3,Avalanche,0,1,1,0,2,20181130,2,1,0,1,5,-1,2018,1,4,794,0
Ducks,0,0,1,1,2,Hurricanes,1,0,0,0,1,20181130,-1,-1,0,1,3,-1,2018,1,4,2231,0
Sabres,1,1,0,0,2,Panthers,1,0,1,1,3,20181130,0,-1,0,1,5,1,2018,1,4,1184,0
Devils,0,1,2,0,3,Capitals,1,1,4,0,6,20181130,1,1,3,3,9,3,2018,0,4,198,0
Blackhawks,1,1,0,0,2,Predators,4,0,1,0,5,20181201,3,2,3,3,7,3,2018,0,5,395,0
Golden Knights,0,1,0,0,1,Oilers,1,0,1,0,2,20181201,1,0,1,1,3,1,2018,0,5,1204,0
Sharks,0,1,1,0,2,Senators,0,3,3,0,6,20181201,0,2,4,4,8,4,2018,0,5,2408,0
Stars,0,0,2,0,2,Canucks,1,0,0,0,1,20181201,-1,-1,1,1,3,-1,2018,0,5,1766,0
Red Wings,0,2,2,0,4,Bruins,1,0,1,0,2,20181201,-1,1,2,2,6,-2,2018,0,5,611,0
Rangers,0,2,0,0,2,Canadiens,2,2,1,0,5,20181201,2,2,3,3,7,3,2018,0,5,343,0
Lightning,1,2,1,1,5,Panthers,2,2,0,0,4,20181201,-1,-1,0,1,9,-1,2018,1,5,205,0
Jets,0,1,2,1,4,Devils,1,0,2,0,3,20181201,-1,0,0,1,7,-1,2018,1,5,1280,0
Blue Jackets,0,2,0,0,2,Islanders,0,2,1,0,3,20181201,0,0,1,1,5,1,2018,0,5,476,0
Flyers,1,1,2,0,4,Penguins,1,1,0,0,2,20181201,0,0,2,2,6,-2,2018,0,5,257,0
Maple Leafs,2,1,2,0,5,Wild,1,1,1,0,3,20181201,1,1,2,2,8,-2,2018,0,5,691,0
Blues,0,1,0,0,1,Coyotes,1,4,1,0,6,20181201,1,4,5,5,7,5,2018,0,5,1270,0
Hurricanes,0,0,0,0,0,Kings,0,0,2,0,2,20181202,0,0,2,2,2,2,2018,0,6,2231,0
Flames,1,2,0,0,3,Blackhawks,1,1,0,0,2,20181202,0,1,1,1,5,-1,2018,0,6,1397,0
Sharks,2,1,0,0,3,Canadiens,0,1,0,0,1,20181202,2,2,2,2,4,-2,2018,0,6,2508,0
Avalanche,0,1,1,0,2,Red Wings,0,0,0,0,0,20181202,0,1,2,2,2,-2,2018,0,6,1154,0
Ducks,1,2,3,0,6,Capitals,3,2,0,0,5,20181202,-2,-2,1,1,11,-1,2018,0,6,2294,0
Jets,0,0,3,1,4,Rangers,1,2,0,0,3,20181202,-1,-3,0,1,7,-1,2018,1,6,1287,0
Lightning,2,2,1,0,5,Devils,0,1,0,0,1,20181203,2,3,4,4,6,-4,2018,0,0,1000,0
Sabres,0,1,0,0,1,Predators,1,1,0,0,2,20181203,1,1,1,1,3,1,2018,0,0,626,0
Oilers,0,0,1,0,1,Stars,1,0,3,0,4,20181203,1,1,3,3,5,3,2018,0,0,1655,0
Coyotes,1,1,0,0,2,Kings,0,0,1,0,1,20181204,1,2,1,1,3,-1,2018,0,1,356,0
Capitals,1,1,1,0,3,Golden Knights,1,0,4,0,5,20181204,0,-1,2,2,8,2,2018,0,1,2080,0
Lightning,0,3,2,1,6,Red Wings,2,2,1,0,5,20181204,-2,-1,0,1,11,-1,2018,1,1,994,0
Senators,0,1,1,0,2,Canadiens,1,3,1,0,5,20181204,1,3,3,3,7,3,2018,0,1,104,0
Maple Leafs,0,2,1,1,4,Sabres,0,1,2,0,3,20181204,0,1,0,1,7,-1,2018,1,1,57,0
Wild,1,2,0,0,3,Canucks,1,1,0,0,2,20181204,0,1,1,1,5,-1,2018,0,1,1427,0
Avalanche,0,3,0,0,3,Penguins,3,0,3,0,6,20181204,3,0,3,3,9,3,2018,0,1,1317,0
Jets,0,0,3,0,3,Islanders,0,0,1,0,1,20181204,0,0,2,2,4,-2,2018,0,1,1287,0
Bruins,0,0,0,0,0,Panthers,0,4,1,0,5,20181204,0,4,5,5,5,5,2018,0,1,1257,0
Flames,1,5,3,0,9,Blue Jackets,3,2,1,0,6,20181204,-2,1,3,3,15,-3,2018,0,1,1670,0
Oilers,0,1,1,1,3,Blues,2,0,0,0,2,20181205,-2,-1,0,1,5,-1,2018,1,2,1508,0
Blackhawks,0,2,0,0,2,Ducks,2,0,2,0,4,20181205,2,0,2,2,6,2,2018,0,2,1741,0
Hurricanes,0,1,0,0,1,Sharks,2,2,1,0,5,20181205,2,3,4,4,6,4,2018,0,2,2382,0
Rangers,2,1,1,1,5,Panthers,0,3,1,0,4,20181208,2,0,0,1,9,-1,2018,1,5,1091,0
Avalanche,1,0,0,0,1,Lightning,3,3,1,0,7,20181208,2,5,6,6,8,6,2018,0,5,1521,0
Islanders,0,2,1,0,3,Red Wings,2,0,0,0,2,20181208,-2,0,1,1,5,-1,2018,0,5,480,0
Penguins,0,1,0,0,1,Senators,1,0,0,1,2,20181208,1,0,0,1,3,1,2018,1,5,392,0
Flyers,1,1,4,0,6,Sabres,2,0,0,0,2,20181208,-1,0,4,4,8,-4,2018,0,5,279,0
Golden Knights,1,0,0,0,1,Kings,1,2,2,0,5,20181208,0,2,4,4,6,4,2018,0,5,228,0
Predators,1,0,1,0,2,Flames,1,1,3,0,5,20181208,0,1,3,3,7,3,2018,0,5,1692,0
Capitals,3,0,1,0,4,Blue Jackets,0,0,0,0,0,20181208,3,3,4,4,4,-4,2018,0,5,326,0
Maple Leafs,0,0,3,0,3,Bruins,1,2,3,0,6,20181208,1,3,3,3,9,3,2018,0,5,430,0
Sharks,2,1,2,0,5,Coyotes,0,2,1,0,3,20181208,2,1,2,2,8,-2,2018,0,5,614,0
Canadiens,2,0,1,0,3,Blackhawks,1,1,0,0,2,20181209,1,0,1,1,5,-1,2018,0,6,732,0
Devils,3,1,1,0,5,Ducks,3,0,2,1,6,20181209,0,-1,0,1,11,1,2018,1,6,2436,0
Bruins,0,1,0,1,2,Senators,1,0,0,0,1,20181209,-1,0,0,1,3,-1,2018,1,6,320,0
Flames,0,0,0,0,0,Oilers,1,0,0,0,1,20181209,1,1,1,1,1,1,2018,0,6,171,0
Canucks,3,2,1,0,6,Blues,0,0,1,0,1,20181209,3,5,5,5,7,-5,2018,0,6,1778,0
Flyers,1,0,0,0,1,Jets,2,3,2,0,7,20181209,1,4,6,6,8,6,2018,0,6,1273,0
Stars,1,0,1,0,2,Golden Knights,1,2,1,0,4,20181209,0,2,2,2,6,2,2018,0,6,1068,0
Kings,0,0,1,0,1,Red Wings,1,2,0,0,3,20181210,1,3,2,2,4,2,2018,0,0,1979,0
Devils,1,1,0,0,2,Sharks,2,2,1,0,5,20181210,1,2,3,3,7,3,2018,0,0,2540,0
Rangers,2,0,1,0,3,Lightning,1,2,3,0,6,20181210,-1,1,3,3,9,3,2018,0,0,1004,0
Penguins,0,0,1,1,2,Islanders,0,1,0,0,1,20181210,0,-1,0,1,3,-1,2018,1,0,314,0
Oilers,1,4,1,0,6,Avalanche,0,1,3,0,4,20181211,1,4,2,2,10,-2,2018,0,1,1036,0
Blackhawks,0,2,1,0,3,Jets,3,1,2,0,6,20181211,3,2,3,3,9,3,2018,0,1,722,0
Panthers,1,0,2,0,3,Blues,0,0,4,0,4,20181211,-1,-1,1,1,7,1,2018,0,1,1061,0
Red Wings,0,0,2,0,2,Capitals,3,2,1,0,6,20181211,3,5,4,4,8,4,2018,0,1,394,0
Senators,1,0,0,0,1,Predators,1,1,1,0,3,20181211,0,1,2,2,4,2,2018,0,1,845,0
Maple Leafs,1,1,2,0,4,Hurricanes,0,1,0,0,1,20181211,1,1,3,3,5,-3,2018,0,1,544,0
Canucks,0,0,3,0,3,Blue Jackets,1,0,1,0,2,20181211,-1,-1,1,1,5,-1,2018,0,1,2050,0
Canadiens,0,0,1,0,1,Wild,1,4,2,0,7,20181211,1,5,6,6,8,6,2018,0,1,938,0
Kings,1,2,0,0,3,Sabres,1,0,2,1,4,20181211,0,-2,0,1,7,1,2018,1,1,2193,0
Coyotes,2,1,0,0,3,Bruins,0,4,0,0,4,20181211,-2,1,1,1,7,1,2018,0,1,2295,0
Golden Knights,1,1,1,0,3,Islanders,1,1,0,0,2,20181212,0,0,1,1,5,-1,2018,0,2,2227,0
Penguins,1,2,0,0,3,Blackhawks,2,1,3,0,6,20181212,1,0,3,3,9,3,2018,0,2,409,0
Flyers,0,4,1,0,5,Flames,1,2,2,1,6,20181212,1,-1,0,1,11,1,2018,1,2,2003,0
Stars,0,3,0,0,3,Ducks,1,1,4,0,6,20181212,1,-1,3,3,9,3,2018,0,2,1237,0
Stars,0,1,1,0,2,Sharks,0,1,2,0,3,20181213,0,0,1,1,5,1,2018,0,3,1449,0
Oilers,1,3,0,0,4,Jets,2,1,1,1,5,20181213,1,-1,0,1,9,1,2018,1,3,738,0
Panthers,1,0,0,0,1,Wild,1,2,2,0,5,20181213,0,2,4,4,6,4,2018,0,3,1513,0
Canucks,1,0,2,0,3,Predators,2,1,0,1,4,20181213,1,2,0,1,7,1,2018,1,3,2030,0
Maple Leafs,1,0,0,0,1,Lightning,1,3,0,0,4,20181213,0,3,3,3,5,3,2018,0,3,1096,0
Hurricanes,0,1,3,0,4,Canadiens,0,2,4,0,6,20181213,0,1,2,2,10,2,2018,0,3,727,0
Kings,1,0,0,0,1,Blue Jackets,2,2,0,0,4,20181213,1,3,3,3,5,3,2018,0,3,1973,0
Coyotes,1,0,0,0,1,Sabres,2,0,1,0,3,20181213,1,1,2,2,4,2,2018,0,3,1902,0
Flyers,0,0,1,0,1,Oilers,1,2,1,0,4,20181214,1,3,3,3,5,3,2018,0,4,2011,0
Jets,1,2,0,1,4,Blackhawks,1,1,1,0,3,20181214,0,1,0,1,7,-1,2018,1,4,722,0
Avalanche,2,0,1,0,3,Blues,2,0,1,1,4,20181214,0,0,0,1,7,1,2018,1,4,794,0
Capitals,1,3,1,1,6,Hurricanes,2,2,1,0,5,20181214,-1,0,0,1,11,-1,2018,1,4,233,0
Senators,2,0,2,0,4,Red Wings,1,1,0,0,2,20181214,1,0,2,2,6,-2,2018,0,4,406,0
Bruins,0,1,2,0,3,Penguins,1,2,2,0,5,20181214,1,2,2,2,8,2,2018,0,4,481,0
Coyotes,0,1,2,1,4,Rangers,2,1,0,0,3,20181214,-2,-2,0,1,7,-1,2018,1,4,2139,0
Golden Knights,3,1,0,0,4,Devils,0,2,2,1,5,20181214,-3,-2,0,1,9,1,2018,1,4,2218,0
Flames,1,0,1,0,2,Wild,0,1,0,0,1,20181215,1,0,1,1,3,-1,2018,0,5,1043,0
Senators,1,1,0,0,2,Canadiens,1,0,4,0,5,20181215,0,-1,3,3,7,3,2018,0,5,104,0
Maple Leafs,0,0,3,0,3,Panthers,1,1,1,1,4,20181215,1,2,0,1,7,1,2018,1,5,1234,0
Red Wings,2,0,1,0,3,Islanders,1,0,2,1,4,20181215,-1,-1,0,1,7,1,2018,1,5,480,0
Kings,0,2,1,0,3,Penguins,2,1,0,1,4,20181215,2,1,0,1,7,1,2018,1,5,2132,0
Sabres,1,2,0,0,3,Capitals,2,1,0,1,4,20181215,1,0,0,1,7,1,2018,1,5,292,0
Ducks,1,0,0,1,2,Blue Jackets,1,0,0,0,1,20181215,0,0,0,1,3,-1,2018,1,5,1973,0
Devils,0,0,1,0,1,Predators,1,0,0,1,2,20181215,1,1,0,1,3,1,2018,1,5,750,0
Stars,0,2,2,0,4,Avalanche,3,1,2,0,6,20181215,3,2,2,2,10,2,2018,0,5,661,0
Flyers,1,0,0,0,1,Canucks,3,1,1,0,5,20181215,2,3,4,4,6,4,2018,0,5,2404,0
Oilers,0,1,1,0,2,Canucks,0,2,2,0,4,20181216,0,1,2,2,6,2,2018,0,6,514,0
Lightning,1,2,1,0,4,Jets,1,2,1,1,5,20181216,0,0,0,1,9,1,2018,1,6,1705,0
Golden Knights,1,2,0,1,4,Rangers,1,1,1,0,3,20181216,0,1,0,1,7,-1,2018,1,6,2227,0
Sabres,0,1,3,0,4,Bruins,0,1,1,0,2,20181216,0,0,2,2,6,-2,2018,0,6,399,0
Flames,4,1,2,0,7,Blues,0,2,0,0,2,20181216,4,3,5,5,9,-5,2018,0,6,1440,0
Coyotes,0,0,0,0,0,Hurricanes,0,2,1,0,3,20181216,0,2,3,3,3,3,2018,0,6,1898,0
Sharks,2,3,2,0,7,Blackhawks,3,0,0,0,3,20181216,-1,2,4,4,10,-4,2018,0,6,1837,0
Ducks,0,3,1,0,4,Penguins,2,0,0,0,2,20181217,-2,1,2,2,6,-2,2018,0,0,2132,0
Golden Knights,0,0,0,0,0,Blue Jackets,0,0,1,0,1,20181217,0,0,1,1,1,1,2018,0,0,1757,0
Bruins,1,1,2,0,4,Canadiens,0,0,0,0,0,20181217,1,2,4,4,4,-4,2018,0,0,270,0
Predators,0,1,2,0,3,Senators,3,0,0,1,4,20181217,3,2,0,1,7,1,2018,1,0,845,0
Islanders,1,2,1,0,4,Avalanche,0,1,0,0,1,20181217,1,2,3,3,5,-3,2018,0,0,1627,0
Jets,0,1,0,0,1,Kings,1,2,1,0,4,20181218,1,2,3,3,5,3,2018,0,1,1527,0
Lightning,2,1,2,0,5,Canucks,1,0,1,0,2,20181218,1,2,3,3,7,-3,2018,0,1,2598,0
Islanders,1,2,0,0,3,Coyotes,1,0,0,0,1,20181218,0,2,2,2,4,-2,2018,0,1,2139,0
Blues,1,0,3,0,4,Oilers,0,1,0,0,1,20181218,1,0,3,3,5,-3,2018,0,1,1508,0
Predators,1,0,0,0,1,Blackhawks,0,2,0,0,2,20181218,-1,1,1,1,3,1,2018,0,1,395,0
Sharks,0,2,2,0,4,Wild,0,0,0,0,0,20181218,0,2,4,4,4,-4,2018,0,1,1570,0
Red Wings,0,1,1,0,2,Flyers,1,2,0,0,3,20181218,1,2,1,1,5,1,2018,0,1,441,0
Ducks,0,1,0,0,1,Rangers,0,0,3,0,3,20181218,0,-1,2,2,4,2,2018,0,1,2445,0
Maple Leafs,3,2,2,0,7,Devils,1,0,1,0,2,20181218,2,4,5,5,9,-5,2018,0,1,333,0
Panthers,0,1,4,0,5,Sabres,1,1,0,0,2,20181218,-1,-1,3,3,7,-3,2018,0,1,1184,0
Flames,0,0,0,0,0,Stars,1,1,0,0,2,20181218,1,2,2,2,2,2,2018,0,1,1536,0
Penguins,0,2,0,0,2,Capitals,0,1,0,0,1,20181219,0,1,1,1,3,-1,2018,0,2,190,0
Canadiens,1,0,0,0,1,Avalanche,0,1,1,0,2,20181219,-1,0,1,1,3,1,2018,0,2,1618,0
Canadiens,0,1,1,0,2,Coyotes,0,1,0,0,1,20181220,0,0,1,1,3,-1,2018,0,3,2175,0
Jets,3,0,2,0,5,Sharks,2,1,0,0,3,20181220,1,0,2,2,8,-2,2018,0,3,1496,0
Islanders,2,0,0,0,2,Golden Knights,0,1,3,0,4,20181220,-2,-1,2,2,6,2,2018,0,3,2227,0
Lightning,1,2,1,1,5,Flames,3,0,1,0,4,20181220,-2,0,0,1,9,-1,2018,1,3,2289,0
Blues,0,0,1,0,1,Canucks,0,2,3,0,5,20181220,0,2,4,4,6,4,2018,0,3,1778,0
Devils,0,1,0,0,1,Blue Jackets,1,1,0,0,2,20181220,1,1,1,1,3,1,2018,0,3,467,0
Red Wings,1,1,2,0,4,Hurricanes,0,1,0,0,1,20181220,1,1,3,3,5,-3,2018,0,3,511,0
Ducks,0,0,1,0,1,Bruins,0,2,1,0,3,20181220,0,2,2,2,4,2,2018,0,3,2590,0
Wild,1,0,0,0,1,Penguins,1,0,1,0,2,20181220,0,0,1,1,3,1,2018,0,3,741,0
Predators,0,1,0,0,1,Flyers,1,1,0,0,2,20181220,1,1,1,1,3,1,2018,0,3,683,0
Blackhawks,2,1,2,0,5,Stars,0,1,1,0,2,20181220,2,2,3,3,7,-3,2018,0,3,802,0
Panthers,0,0,1,0,1,Maple Leafs,1,2,3,0,6,20181220,1,3,5,5,7,5,2018,0,3,1234,0
Senators,0,2,0,0,2,Devils,2,3,0,0,5,20181221,2,3,3,3,7,3,2018,0,4,330,0
Sabres,0,0,1,0,1,Capitals,0,1,1,0,2,20181221,0,1,1,1,3,1,2018,0,4,292,0
Blackhawks,1,0,1,0,2,Avalanche,0,1,0,0,1,20181221,1,0,1,1,3,-1,2018,0,4,916,0
Jets,0,0,1,0,1,Canucks,0,0,0,0,0,20181222,0,0,1,1,1,-1,2018,0,5,1157,0
Lightning,1,2,3,0,6,Oilers,1,1,1,0,3,20181222,0,1,3,3,9,-3,2018,0,5,2367,0
Stars,0,0,1,1,2,Wild,0,0,1,0,1,20181222,0,0,0,1,3,-1,2018,1,5,863,0
Penguins,1,2,0,0,3,Hurricanes,0,0,0,0,0,20181222,1,3,3,3,3,-3,2018,0,5,330,0
Capitals,2,2,0,0,4,Senators,0,0,0,0,0,20181222,2,4,4,4,4,-4,2018,0,5,446,0
Avalanche,1,0,3,0,4,Coyotes,2,2,2,0,6,20181222,1,3,2,2,10,2,2018,0,5,585,0
Ducks,0,0,0,0,0,Sabres,1,0,2,0,3,20181222,1,1,3,3,3,3,2018,0,5,2193,0
Kings,1,0,1,1,3,Sharks,0,0,2,0,2,20181222,1,1,0,1,5,-1,2018,1,5,305,0
Predators,0,1,1,0,2,Bruins,1,0,4,0,5,20181222,1,0,3,3,7,3,2018,0,5,941,0
Canadiens,1,1,1,1,4,Golden Knights,1,2,0,0,3,20181222,0,-1,0,1,7,-1,2018,1,5,2221,0
Blues,2,0,1,0,3,Flames,1,0,0,0,1,20181222,1,1,2,2,4,-2,2018,0,5,1440,0
Panthers,2,0,0,0,2,Red Wings,0,1,0,0,1,20181222,2,1,1,1,3,-1,2018,0,5,1155,0
Blue Jackets,1,3,0,0,4,Flyers,1,1,1,0,3,20181222,0,2,1,1,7,-1,2018,0,5,414,0
Rangers,0,1,2,0,3,Maple Leafs,1,0,4,0,5,20181222,1,0,2,2,8,2,2018,0,5,341,0
Coyotes,1,1,1,1,4,Sharks,1,0,2,0,3,20181223,0,1,0,1,7,-1,2018,1,6,614,0
Kings,0,2,1,1,4,Golden Knights,1,1,1,0,3,20181223,-1,0,0,1,7,-1,2018,1,6,228,0
Islanders,0,1,2,0,3,Stars,0,1,0,0,1,20181223,0,0,2,2,4,-2,2018,0,6,1370,0
Red Wings,2,1,1,0,4,Maple Leafs,1,2,1,1,5,20181223,-1,0,0,1,9,1,2018,1,6,205,0
Flyers,0,1,1,1,3,Rangers,1,0,1,0,2,20181223,-1,0,0,1,5,-1,2018,1,6,80,0
Bruins,2,1,0,0,3,Hurricanes,1,3,1,0,5,20181223,-1,1,2,2,8,2,2018,0,6,609,0
Blue Jackets,2,1,0,0,3,Devils,0,0,0,0,0,20181223,2,3,3,3,3,-3,2018,0,6,467,0
Panthers,1,3,2,0,6,Blackhawks,1,1,1,0,3,20181223,0,2,3,3,9,-3,2018,0,6,1189,0
Ducks,1,0,1,0,2,Sharks,1,1,2,0,4,20181227,0,1,2,2,6,2,2018,0,3,305,0
Coyotes,1,0,0,0,1,Kings,1,0,1,0,2,20181227,0,0,1,1,3,1,2018,0,3,356,0
Canucks,4,0,0,0,4,Oilers,1,1,0,0,2,20181227,3,2,2,2,6,-2,2018,0,3,514,0
Avalanche,1,0,0,0,1,Golden Knights,1,0,1,0,2,20181227,0,0,1,1,3,1,2018,0,3,604,0
Wild,1,0,1,0,2,Blackhawks,1,2,2,0,5,20181227,0,2,3,3,7,3,2018,0,3,355,0
Hurricanes,0,0,1,0,1,Capitals,0,2,1,0,3,20181227,0,2,2,2,4,2,2018,0,3,233,0
Stars,1,1,0,0,2,Predators,0,0,0,0,0,20181227,1,2,2,2,2,-2,2018,0,3,616,0
Sabres,0,1,0,0,1,Blues,0,3,1,0,4,20181227,0,2,3,3,5,3,2018,0,3,660,0
Flyers,1,1,3,0,5,Lightning,2,3,0,1,6,20181227,1,3,0,1,11,1,2018,1,3,928,0
Red Wings,1,0,1,0,2,Penguins,0,3,2,0,5,20181227,-1,2,3,3,7,3,2018,0,3,205,0
Blue Jackets,2,0,1,1,4,Rangers,1,1,1,0,3,20181227,1,0,0,1,7,-1,2018,1,3,476,0
Devils,2,0,3,0,5,Bruins,0,1,1,0,2,20181227,2,1,3,3,7,-3,2018,0,3,196,0
Flames,0,2,2,0,4,Jets,0,1,0,0,1,20181227,0,1,3,3,5,-3,2018,0,3,740,0
Canadiens,2,0,3,0,5,Panthers,2,0,1,0,3,20181228,0,0,2,2,8,-2,2018,0,4,1418,0
Senators,1,2,0,0,3,Islanders,0,2,4,0,6,20181228,-1,-1,3,3,9,3,2018,0,4,334,0
Maple Leafs,2,1,1,0,4,Blue Jackets,1,0,1,0,2,20181228,1,2,2,2,6,-2,2018,0,4,313,0
Coyotes,1,3,0,1,5,Ducks,2,2,0,0,4,20181229,-1,0,0,1,9,-1,2018,1,5,356,0
Canucks,1,1,0,1,3,Flames,1,1,0,0,2,20181229,0,0,0,1,5,-1,2018,1,5,426,0
Blackhawks,2,0,0,1,3,Avalanche,1,1,0,0,2,20181229,1,0,0,1,5,-1,2018,1,5,916,0
Red Wings,0,0,1,0,1,Stars,0,3,2,0,5,20181229,0,3,4,4,6,4,2018,0,5,999,0
Rangers,1,1,2,0,4,Predators,1,2,0,0,3,20181229,0,-1,1,1,7,-1,2018,0,5,758,0
Penguins,1,3,2,0,6,Blues,0,1,0,0,1,20181229,1,3,5,5,7,-5,2018,0,5,557,0
Capitals,2,1,0,0,3,Senators,0,1,1,0,2,20181229,2,2,1,1,5,-1,2018,0,5,446,0
Canadiens,3,2,0,0,5,Lightning,2,2,2,0,6,20181229,-1,-1,1,1,11,1,2018,0,5,1311,0
Islanders,1,3,0,0,4,Maple Leafs,0,0,0,0,0,20181229,1,4,4,4,4,-4,2018,0,5,341,0
Bruins,1,0,1,1,3,Sabres,1,1,0,0,2,20181229,0,-1,0,1,5,-1,2018,1,5,399,0
Golden Knights,1,1,2,0,4,Kings,1,0,0,0,1,20181229,0,1,3,3,5,-3,2018,0,5,228,0
Sharks,2,2,3,0,7,Oilers,1,0,3,0,4,20181229,1,3,3,3,11,-3,2018,0,5,1190,0
Wild,1,1,1,0,3,Jets,0,0,1,0,1,20181229,1,2,2,2,4,-2,2018,0,5,388,0
Hurricanes,0,0,0,0,0,Devils,0,1,1,0,2,20181229,0,1,2,2,2,2,2018,0,5,419,0
Flyers,1,0,0,0,1,Panthers,0,0,2,0,2,20181229,-1,-1,1,1,3,1,2018,0,5,1021,0
Golden Knights,1,1,3,0,5,Coyotes,0,1,0,0,1,20181230,1,1,4,4,6,-4,2018,0,6,256,0
Jets,0,3,1,0,4,Oilers,1,1,1,0,3,20181231,-1,1,1,1,7,-1,2018,0,0,738,0
Kings,0,2,0,1,3,Avalanche,0,0,2,0,2,20181231,0,2,0,1,5,-1,2018,1,0,830,0
Canadiens,1,0,1,1,3,Stars,0,2,0,0,2,20181231,1,-1,0,1,5,-1,2018,1,0,1505,0
Panthers,0,3,0,1,4,Red Wings,3,0,0,0,3,20181231,-3,0,0,1,7,-1,2018,1,0,1155,0
Sharks,1,2,2,0,5,Flames,3,2,3,0,8,20181231,2,2,3,3,13,3,2018,0,0,1027,0
Senators,0,1,2,0,3,Blue Jackets,0,1,5,0,6,20181231,0,0,3,3,9,3,2018,0,0,512,0
Predators,1,3,2,0,6,Capitals,2,1,0,0,3,20181231,-1,1,3,3,9,-3,2018,0,0,566,0
Rangers,1,1,0,0,2,Blues,1,0,0,0,1,20181231,0,1,1,1,3,-1,2018,0,0,871,0
Canucks,0,0,0,0,0,Devils,2,0,2,0,4,20181231,2,2,4,4,4,4,2018,0,0,2421,0
Lightning,1,0,0,1,2,Ducks,1,0,0,0,1,20181231,0,0,0,1,3,-1,2018,1,0,2149,0
Flyers,0,0,1,0,1,Hurricanes,1,2,0,0,3,20181231,1,3,2,2,4,2,2018,0,0,345,0
Penguins,2,1,0,0,3,Wild,1,0,1,0,2,20181231,1,2,1,1,5,-1,2018,0,0,741,0
Islanders,0,1,2,0,3,Sabres,0,0,1,0,1,20181231,0,1,2,2,4,-2,2018,0,0,292,0
Kings,0,0,0,0,0,Golden Knights,0,0,2,0,2,20190101,0,0,2,2,2,2,2018,0,1,228,0
Flyers,0,0,0,0,0,Predators,0,2,2,0,4,20190101,0,2,4,4,4,4,2018,0,1,683,0
Bruins,1,1,2,0,4,Blackhawks,1,1,0,0,2,20190101,0,0,2,2,6,-2,2018,0,1,849,0
Canucks,0,2,1,1,4,Senators,0,1,2,0,3,20190102,0,1,0,1,7,-1,2018,1,2,2191,0
Flames,0,3,2,0,5,Red Wings,2,1,0,0,3,20190102,-2,0,2,2,8,-2,2018,0,2,1573,0
Penguins,0,4,3,0,7,Rangers,0,1,1,0,2,20190102,0,3,5,5,9,-5,2018,0,2,314,0
Devils,1,3,0,0,4,Stars,1,3,1,0,5,20190102,0,0,1,1,9,1,2018,0,2,1362,0
Sharks,2,3,0,0,5,Avalanche,1,1,2,0,4,20190102,1,3,1,1,9,-1,2018,0,2,927,0
Oilers,0,2,1,0,3,Coyotes,1,0,0,0,1,20190102,-1,1,2,2,4,-2,2018,0,2,1392,0
Lightning,3,2,1,0,6,Kings,0,1,1,0,2,20190103,3,4,4,4,8,-4,2018,0,3,2149,0
Canucks,0,0,0,0,0,Canadiens,1,1,0,0,2,20190103,1,2,2,2,2,2,2018,0,3,2273,0
Capitals,1,1,0,0,2,Blues,1,2,2,0,5,20190103,0,1,3,3,7,3,2018,0,3,708,0
Hurricanes,0,3,2,0,5,Flyers,0,0,3,0,3,20190103,0,3,2,2,8,-2,2018,0,3,345,0
Panthers,0,1,2,0,3,Sabres,2,0,2,0,4,20190103,2,1,1,1,7,1,2018,0,3,1184,0
Flames,1,1,2,0,4,Bruins,2,1,3,0,6,20190103,1,1,2,2,10,2,2018,0,3,2089,0
Wild,1,2,1,0,4,Maple Leafs,2,1,0,0,3,20190103,-1,0,1,1,7,-1,2018,0,3,691,0
Blackhawks,1,0,1,0,2,Islanders,1,1,0,1,3,20190103,0,1,0,1,5,1,2018,1,3,711,0
Jets,0,0,0,0,0,Penguins,2,1,1,0,4,20190104,2,3,4,4,4,4,2018,0,4,1060,0
Predators,1,1,1,0,3,Red Wings,0,2,1,1,4,20190104,-1,0,0,1,7,1,2018,1,4,470,0
Blue Jackets,0,2,0,0,2,Hurricanes,2,1,1,0,4,20190104,2,1,2,2,6,2,2018,0,4,374,0
Capitals,0,1,0,0,1,Stars,1,0,0,1,2,20190104,1,0,0,1,3,1,2018,1,4,1181,0
Rangers,0,0,1,0,1,Avalanche,2,1,3,0,6,20190104,2,3,5,5,7,5,2018,0,4,1627,0
Devils,1,1,0,1,3,Coyotes,1,1,0,0,2,20190104,0,0,0,1,5,-1,2018,1,4,2131,0
Golden Knights,1,2,0,0,3,Ducks,0,2,0,0,2,20190104,1,1,1,1,5,-1,2018,0,4,228,0
Islanders,0,1,3,0,4,Blues,2,0,1,0,3,20190105,-2,-1,1,1,7,-1,2018,0,5,871,0
Lightning,1,1,0,0,2,Sharks,2,1,2,0,5,20190105,1,1,3,3,7,3,2018,0,5,2365,0
Blue Jackets,1,1,1,1,4,Panthers,2,0,1,0,3,20190105,-1,0,0,1,7,-1,2018,1,5,993,0
Oilers,0,0,0,0,0,Kings,3,0,1,0,4,20190105,3,3,4,4,4,4,2018,0,5,1368,0
Canucks,0,0,0,0,0,Maple Leafs,2,0,3,0,5,20190105,2,2,5,5,5,5,2018,0,5,2090,0
Flames,0,1,1,1,3,Flyers,1,0,1,0,2,20190105,-1,0,0,1,5,-1,2018,1,5,2003,0
Sabres,0,0,1,0,1,Bruins,1,1,0,0,2,20190105,1,2,1,1,3,1,2018,0,5,399,0
Wild,0,3,1,0,4,Senators,1,1,1,0,3,20190105,-1,1,1,1,7,-1,2018,0,5,838,0
Predators,2,1,1,0,4,Canadiens,0,1,0,0,1,20190105,2,2,3,3,5,-3,2018,0,5,937,0
Oilers,3,1,0,0,4,Ducks,0,0,0,0,0,20190106,3,4,4,4,4,-4,2018,0,6,1368,0
Blackhawks,1,2,2,0,5,Penguins,2,1,0,0,3,20190106,-1,0,2,2,8,-2,2018,0,6,409,0
Hurricanes,2,2,1,0,5,Senators,0,4,0,0,4,20190106,2,0,1,1,9,-1,2018,0,6,673,0
Capitals,1,0,2,0,3,Red Wings,1,1,0,0,2,20190106,0,-1,1,1,5,-1,2018,0,6,394,0
Devils,2,0,0,0,2,Golden Knights,1,2,0,0,3,20190106,-1,1,1,1,5,1,2018,0,6,2218,0
Rangers,0,0,0,0,0,Coyotes,2,3,0,0,5,20190106,2,5,5,5,5,5,2018,0,6,2139,0
Stars,0,1,0,0,1,Jets,0,2,3,0,5,20190106,0,1,4,4,6,4,2018,0,6,1183,0
Predators,0,2,2,0,4,Maple Leafs,0,0,0,0,0,20190107,0,2,4,4,4,-4,2018,0,0,646,0
Blues,0,1,2,0,3,Flyers,0,0,0,0,0,20190107,0,1,3,3,3,-3,2018,0,0,808,0
Wild,0,0,1,0,1,Canadiens,0,0,0,0,0,20190107,0,0,1,1,1,-1,2018,0,0,938,0
Flames,1,1,2,0,4,Blackhawks,1,1,1,0,3,20190107,0,0,1,1,7,-1,2018,0,0,1397,0
Kings,0,1,0,0,1,Sharks,1,1,1,0,3,20190107,1,1,2,2,4,2,2018,0,0,305,0
Oilers,1,1,0,0,2,Sharks,3,2,2,0,7,20190108,2,3,5,5,9,5,2018,0,1,1190,0
Rangers,0,0,2,0,2,Golden Knights,1,2,1,0,4,20190108,1,3,2,2,6,2,2018,0,1,2227,0
Avalanche,1,2,1,0,4,Jets,2,2,3,0,7,20190108,1,1,3,3,11,3,2018,0,1,797,0
Stars,1,2,0,0,3,Blues,0,1,0,0,1,20190108,1,2,2,2,4,-2,2018,0,1,547,0
Blue Jackets,0,0,0,0,0,Lightning,2,0,2,0,4,20190108,2,2,4,4,4,4,2018,0,1,830,0
Flyers,1,0,2,0,3,Capitals,1,3,1,0,5,20190108,0,3,2,2,8,2,2018,0,1,123,0
Panthers,0,1,0,0,1,Penguins,2,2,1,0,5,20190108,2,3,4,4,6,4,2018,0,1,1013,0
Devils,1,0,0,0,1,Sabres,0,5,0,0,5,20190108,-1,4,4,4,6,4,2018,0,1,284,0
Wild,0,0,0,0,0,Bruins,3,1,0,0,4,20190108,3,4,4,4,4,4,2018,0,1,1120,0
Canadiens,0,2,1,0,3,Red Wings,0,1,1,0,2,20190108,0,1,1,1,5,-1,2018,0,1,508,0
Hurricanes,2,0,2,0,4,Islanders,1,0,2,0,3,20190108,1,1,1,1,7,-1,2018,0,1,423,0
Predators,2,1,0,1,4,Blackhawks,1,1,1,0,3,20190109,1,1,0,1,7,-1,2018,1,2,395,0
Avalanche,2,0,1,0,3,Flames,2,1,2,0,5,20190109,0,1,2,2,8,2,2018,0,2,898,0
Senators,0,0,1,1,2,Ducks,1,0,0,0,1,20190109,-1,-1,0,1,3,-1,2018,1,2,2345,0
Panthers,1,1,1,0,3,Oilers,1,1,1,1,4,20190110,0,0,0,1,7,1,2018,1,3,2569,0
Senators,0,2,2,0,4,Kings,0,1,0,0,1,20190110,0,1,3,3,5,-3,2018,0,3,2345,0
Sharks,0,1,2,0,3,Golden Knights,1,0,1,0,2,20190110,-1,0,1,1,5,-1,2018,0,3,382,0
Coyotes,0,2,1,1,4,Canucks,0,2,1,0,3,20190110,0,0,0,1,7,-1,2018,1,3,1228,0
Jets,0,1,1,0,2,Wild,1,2,0,0,3,20190110,1,2,1,1,5,1,2018,0,3,388,0
Hurricanes,0,1,0,0,1,Lightning,0,0,3,0,3,20190110,0,-1,2,2,4,2,2018,0,3,585,0
Capitals,1,1,2,0,4,Bruins,0,1,1,0,2,20190110,1,1,2,2,6,-2,2018,0,3,394,0
Canadiens,0,1,0,0,1,Blues,2,1,1,0,4,20190110,2,2,3,3,5,3,2018,0,3,962,0
Maple Leafs,3,0,1,0,4,Devils,0,2,0,0,2,20190110,3,1,2,2,6,-2,2018,0,3,333,0
Predators,0,0,3,0,3,Blue Jackets,1,0,2,1,4,20190110,1,1,0,1,7,1,2018,1,3,333,0
Stars,0,0,1,0,1,Flyers,0,2,0,0,2,20190110,0,2,1,1,3,1,2018,0,3,1297,0
Islanders,2,1,1,0,4,Rangers,1,1,1,0,3,20190110,1,1,1,1,7,-1,2018,0,3,0,0
Sabres,1,1,1,0,3,Hurricanes,1,3,0,0,4,20190111,0,2,1,1,7,1,2018,0,4,491,0
Red Wings,0,1,1,0,2,Jets,2,1,1,0,4,20190111,2,2,2,2,6,2,2018,0,4,855,0
Panthers,1,1,1,0,3,Flames,0,2,2,0,4,20190111,-1,0,1,1,7,1,2018,0,4,2493,0
Penguins,0,3,4,0,7,Ducks,3,1,0,0,4,20190111,-3,-1,3,3,11,-3,2018,0,4,2132,0
Penguins,1,0,1,0,2,Kings,1,2,2,0,5,20190112,0,2,3,3,7,3,2018,0,5,2132,0
Senators,0,0,1,0,1,Sharks,0,1,3,0,4,20190112,0,1,3,3,5,3,2018,0,5,2408,0
Coyotes,0,2,1,0,3,Oilers,1,1,0,0,2,20190112,-1,0,1,1,5,-1,2018,0,5,1392,0
Blues,2,0,1,0,3,Stars,0,0,1,0,1,20190112,2,2,2,2,4,-2,2018,0,5,547,0
Golden Knights,0,2,1,1,4,Blackhawks,2,1,0,0,3,20190112,-2,-1,0,1,7,-1,2018,1,5,1519,0
Blue Jackets,1,0,0,1,2,Capitals,0,0,1,0,1,20190112,1,1,0,1,3,-1,2018,1,5,326,0
Avalanche,0,0,0,0,0,Canadiens,0,0,3,0,3,20190112,0,0,3,3,3,3,2018,0,5,1618,0
Bruins,1,2,0,0,3,Maple Leafs,0,2,0,0,2,20190112,1,1,1,1,5,-1,2018,0,5,430,0
Lightning,1,1,3,0,5,Sabres,2,0,1,0,3,20190112,-1,0,2,2,8,-2,2018,0,5,1051,0
Rangers,0,1,1,0,2,Islanders,0,1,0,0,1,20190112,0,0,1,1,3,-1,2018,0,5,0,0
Flyers,0,1,1,0,2,Devils,1,1,1,0,3,20190112,1,1,1,1,5,1,2018,0,5,75,0
Red Wings,1,2,2,0,5,Wild,1,1,0,0,2,20190112,0,1,3,3,7,-3,2018,0,5,542,0
Coyotes,0,1,0,0,1,Flames,2,2,3,0,7,20190113,2,3,6,6,8,6,2018,0,6,1224,0
Panthers,0,0,1,0,1,Canucks,0,1,4,0,5,20190113,0,1,4,4,6,4,2018,0,6,2803,0
Predators,0,2,1,0,3,Hurricanes,2,3,1,0,6,20190113,2,3,3,3,9,3,2018,0,6,456,0
Ducks,2,1,0,0,3,Jets,1,1,1,1,4,20190113,-1,-1,0,1,7,1,2018,1,6,1527,0
Rangers,2,1,2,0,5,Blue Jackets,2,3,2,0,7,20190113,0,2,2,2,12,2,2018,0,6,476,0
Lightning,0,1,0,0,1,Islanders,3,1,1,0,5,20190113,3,3,4,4,6,4,2018,0,6,1004,0
Avalanche,0,3,3,0,6,Maple Leafs,0,2,1,0,3,20190114,0,1,3,3,9,-3,2018,0,0,1341,0
Blackhawks,0,3,2,0,5,Devils,1,5,2,0,8,20190114,1,3,3,3,13,3,2018,0,0,703,0
Wild,2,1,1,0,4,Flyers,2,3,2,0,7,20190114,0,2,3,3,11,3,2018,0,0,983,0
Blues,0,3,1,0,4,Capitals,1,0,0,0,1,20190114,-1,2,3,3,5,-3,2018,0,0,708,0
Canadiens,1,1,0,1,3,Bruins,1,0,1,0,2,20190114,0,1,0,1,5,-1,2018,1,0,270,0
Sabres,2,0,0,0,2,Oilers,3,2,2,0,7,20190114,1,3,5,5,9,5,2018,0,0,1734,0
Penguins,1,0,1,0,2,Sharks,2,1,2,0,5,20190115,1,2,3,3,7,3,2018,0,1,2242,0
Lightning,1,0,1,0,2,Stars,0,0,0,0,0,20190115,1,1,2,2,2,-2,2018,0,1,916,0
Golden Knights,0,0,1,0,1,Jets,0,2,2,0,4,20190115,0,2,3,3,5,3,2018,0,1,1303,0
Kings,0,1,1,0,2,Wild,0,1,1,1,3,20190115,0,0,0,1,5,1,2018,1,1,1521,0
Panthers,1,0,0,0,1,Canadiens,0,3,2,0,5,20190115,-1,2,4,4,6,4,2018,0,1,1418,0
Ducks,0,1,0,0,1,Red Wings,0,0,3,0,3,20190115,0,-1,2,2,4,2,2018,0,1,1979,0
Capitals,0,1,1,0,2,Predators,2,4,1,0,7,20190115,2,5,5,5,9,5,2018,0,1,566,0
Blues,0,0,1,0,1,Islanders,1,0,0,1,2,20190115,1,1,0,1,3,1,2018,1,1,871,0
Hurricanes,1,0,1,0,2,Rangers,3,1,2,0,6,20190115,2,3,4,4,8,4,2018,0,1,423,0
Devils,0,1,0,0,1,Blue Jackets,3,1,0,0,4,20190115,3,3,3,3,5,3,2018,0,1,467,0
Avalanche,0,1,1,0,2,Senators,0,3,2,0,5,20190116,0,2,3,3,7,3,2018,0,2,1515,0
Bruins,2,0,1,0,3,Flyers,1,2,1,0,4,20190116,-1,1,1,1,7,1,2018,0,2,270,0
Sabres,0,1,2,1,4,Flames,1,0,2,0,3,20190116,-1,0,0,1,7,-1,2018,1,2,1731,0
Oilers,2,0,0,1,3,Canucks,1,1,0,0,2,20190116,1,0,0,1,5,-1,2018,1,2,514,0
Sharks,1,1,1,0,3,Coyotes,2,2,2,0,6,20190116,1,2,3,3,9,3,2018,0,2,614,0
Kings,1,1,0,0,2,Stars,0,0,1,0,1,20190117,1,2,1,1,3,-1,2018,0,3,1237,0
Jets,1,2,2,0,5,Predators,0,1,0,0,1,20190117,1,2,4,4,6,-4,2018,0,3,1084,0
Ducks,3,0,0,0,3,Wild,0,0,0,0,0,20190117,3,3,3,3,3,-3,2018,0,3,1521,0
Blackhawks,1,0,2,0,3,Rangers,2,1,1,0,4,20190117,1,2,1,1,7,1,2018,0,3,711,0
Devils,0,0,1,0,1,Islanders,3,0,1,0,4,20190117,3,3,3,3,5,3,2018,0,3,8,0
Blues,0,2,0,0,2,Bruins,0,2,3,0,5,20190117,0,0,3,3,7,3,2018,0,3,1035,0
Maple Leafs,1,2,1,0,4,Lightning,1,1,0,0,2,20190117,0,1,2,2,6,-2,2018,0,3,1096,0
Canadiens,1,1,2,0,4,Blue Jackets,0,0,1,0,1,20190118,1,2,3,3,5,-3,2018,0,4,605,0
Islanders,0,0,2,0,2,Capitals,0,0,0,0,0,20190118,0,0,2,2,2,-2,2018,0,4,204,0
Senators,1,3,0,0,4,Hurricanes,0,1,0,0,1,20190118,1,3,3,3,5,-3,2018,0,4,673,0
Red Wings,1,1,2,0,4,Flames,0,2,4,0,6,20190118,-1,0,2,2,10,2,2018,0,4,1573,0
Penguins,0,2,0,1,3,Coyotes,1,0,1,0,2,20190118,-1,1,0,1,5,-1,2018,1,4,1824,0
Sabres,1,2,0,0,3,Canucks,2,1,1,0,4,20190118,1,0,1,1,7,1,2018,0,4,2137,0
Maple Leafs,1,0,0,0,1,Panthers,2,0,1,0,3,20190118,1,1,2,2,4,2,2018,0,4,1234,0
Panthers,2,1,1,0,4,Predators,0,0,2,0,2,20190119,2,3,2,2,6,-2,2018,0,5,816,0
Penguins,1,2,0,0,3,Golden Knights,3,2,2,0,7,20190119,2,2,4,4,10,4,2018,0,5,1915,0
Flames,0,3,2,0,5,Oilers,0,1,1,0,2,20190119,0,2,3,3,7,-3,2018,0,5,171,0
Blue Jackets,0,1,0,0,1,Wild,2,0,0,0,2,20190119,2,1,1,1,3,1,2018,0,5,626,0
Senators,1,0,1,0,2,Blues,1,1,1,0,3,20190119,0,1,1,1,5,1,2018,0,5,860,0
Sharks,1,1,1,0,3,Lightning,2,2,2,0,6,20190119,1,2,3,3,9,3,2018,0,5,2365,0
Jets,0,0,2,0,2,Stars,1,2,1,0,4,20190119,1,3,2,2,6,2,2018,0,5,1183,0
Kings,0,0,1,0,1,Avalanche,1,6,0,0,7,20190119,1,7,6,6,8,6,2018,0,5,830,0
Ducks,2,0,1,0,3,Devils,1,0,1,0,2,20190119,1,1,1,1,5,-1,2018,0,5,2436,0
Flyers,0,2,3,0,5,Canadiens,0,0,2,0,2,20190119,0,2,3,3,7,-3,2018,0,5,400,0
Rangers,1,1,1,0,3,Bruins,1,0,1,0,2,20190119,0,1,1,1,5,-1,2018,0,5,190,0
Capitals,1,1,3,0,5,Blackhawks,3,1,4,0,8,20190120,2,2,3,3,13,3,2018,0,6,594,0
Ducks,0,0,0,0,0,Islanders,2,1,0,0,3,20190120,2,3,3,3,3,3,2018,0,6,2445,0
Red Wings,0,2,0,0,2,Canucks,1,0,2,0,3,20190120,1,-1,1,1,5,1,2018,0,6,1967,0
Coyotes,0,2,2,0,4,Maple Leafs,1,0,1,0,2,20190120,-1,1,2,2,6,-2,2018,0,6,1885,0
Hurricanes,3,3,1,0,7,Oilers,1,1,2,0,4,20190120,2,4,3,3,11,-3,2018,0,6,2076,0
Predators,0,3,1,0,4,Avalanche,0,1,0,0,1,20190121,0,2,3,3,5,-3,2018,0,0,1019,0
Blues,2,0,1,0,3,Kings,1,2,1,0,4,20190121,-1,1,1,1,7,1,2018,0,0,1586,0
Wild,0,2,2,0,4,Golden Knights,1,1,0,0,2,20190121,-1,0,2,2,6,-2,2018,0,0,1293,0
Sharks,0,2,0,0,2,Panthers,1,1,4,0,6,20190121,1,0,4,4,8,4,2018,0,0,2558,0
Sharks,2,2,2,1,7,Capitals,3,2,1,0,6,20190122,-1,-1,0,1,13,-1,2018,1,1,2416,0
Coyotes,1,2,0,0,3,Senators,0,1,1,0,2,20190122,1,2,1,1,5,-1,2018,0,1,2071,0
Islanders,1,1,0,0,2,Blackhawks,0,2,0,1,3,20190122,-1,0,0,1,5,1,2018,1,1,711,0
Hurricanes,1,0,1,0,2,Flames,1,1,0,1,3,20190122,0,1,0,1,5,1,2018,1,1,2038,0
Red Wings,0,2,1,0,3,Oilers,0,0,2,0,2,20190122,0,2,1,1,5,-1,2018,0,1,1592,0
Jets,0,1,0,0,1,Flyers,0,2,1,0,3,20190128,0,1,2,2,4,2,2018,0,0,1273,0
Devils,2,2,2,0,6,Penguins,0,1,2,0,3,20190128,2,3,3,3,9,-3,2018,0,0,306,0
Sabres,3,1,1,0,5,Blue Jackets,1,3,0,0,4,20190129,2,0,1,1,9,-1,2018,0,1,293,0
Flyers,1,0,0,0,1,Rangers,0,0,0,0,0,20190129,1,1,1,1,1,-1,2018,0,1,80,0
Jets,1,0,2,1,4,Bruins,2,0,1,0,3,20190129,-1,-1,0,1,7,-1,2018,1,1,1349,0
Lightning,0,0,2,0,2,Penguins,3,1,0,0,4,20190130,3,4,2,2,6,2,2018,0,2,874,0
Sabres,0,0,0,0,0,Stars,1,0,0,0,1,20190130,1,1,1,1,1,1,2018,0,2,1197,0
Flyers,1,0,1,1,3,Bruins,1,1,0,0,2,20190131,0,-1,0,1,5,-1,2018,1,3,270,0
Rangers,1,1,2,0,4,Devils,2,0,1,0,3,20190131,-1,0,1,1,7,-1,2018,0,3,8,0
Blue Jackets,2,1,0,0,3,Jets,1,1,2,0,4,20190131,-1,-1,1,1,7,1,2018,0,3,975,0
Golden Knights,1,1,0,0,2,Hurricanes,1,2,2,0,5,20190201,0,1,3,3,7,3,2018,0,4,2028,0
Wild,0,1,0,0,1,Stars,0,1,2,0,3,20190201,0,0,2,2,4,2,2018,0,4,863,0
Maple Leafs,0,1,1,0,2,Red Wings,0,1,1,1,3,20190201,0,0,0,1,5,1,2018,1,4,205,0
Flames,1,1,1,0,3,Capitals,2,1,1,0,4,20190201,1,1,1,1,7,1,2018,0,4,1967,0
Senators,0,1,2,0,3,Penguins,2,1,2,0,5,20190201,2,2,2,2,8,2,2018,0,4,392,0
Lightning,0,0,0,1,1,Islanders,0,0,0,0,0,20190201,0,0,0,1,1,-1,2018,1,4,1004,0
Blackhawks,1,3,3,0,7,Sabres,0,1,2,0,3,20190201,1,3,4,4,10,-4,2018,0,4,453,0
Predators,0,0,4,0,4,Panthers,0,1,0,0,1,20190201,0,-1,3,3,5,-3,2018,0,4,816,0
Coyotes,0,1,1,0,2,Sharks,0,2,0,1,3,20190202,0,1,0,1,5,1,2018,1,5,614,0
Blackhawks,0,2,1,1,4,Wild,1,0,2,0,3,20190202,-1,1,0,1,7,-1,2018,1,5,355,0
Stars,1,0,2,0,3,Predators,1,0,0,0,1,20190202,0,0,2,2,4,-2,2018,0,5,616,0
Lightning,1,2,0,0,3,Rangers,0,1,1,0,2,20190202,1,2,1,1,5,-1,2018,0,5,1004,0
Ducks,0,2,1,0,3,Jets,6,2,1,0,9,20190202,6,6,6,6,12,6,2018,0,5,1527,0
Canucks,2,2,1,0,5,Avalanche,0,1,0,0,1,20190202,2,3,4,4,6,-4,2018,0,5,1105,0
Kings,1,0,1,0,2,Islanders,1,0,3,0,4,20190202,0,0,2,2,6,2,2018,0,5,2445,0
Golden Knights,1,0,0,0,1,Panthers,1,0,2,0,3,20190202,0,0,2,2,4,2,2018,0,5,2177,0
Red Wings,2,0,0,0,2,Senators,0,0,0,0,0,20190202,2,2,2,2,2,-2,2018,0,5,406,0
Oilers,2,1,1,0,4,Flyers,1,1,2,1,5,20190202,-1,-1,0,1,9,1,2018,1,5,2011,0
Penguins,2,0,0,0,2,Maple Leafs,1,2,0,0,3,20190202,-1,1,1,1,5,1,2018,0,5,222,0
Blues,2,0,2,0,4,Blue Jackets,0,0,2,0,2,20190202,2,2,2,2,6,-2,2018,0,5,395,0
Devils,1,0,1,1,3,Canadiens,1,1,0,0,2,20190202,0,-1,0,1,5,-1,2018,1,5,342,0
Bruins,0,1,0,0,1,Capitals,0,0,0,0,0,20190203,0,1,1,1,1,-1,2018,0,6,394,0
Oilers,1,2,0,0,3,Canadiens,1,1,1,1,4,20190203,0,-1,0,1,7,1,2018,1,6,1826,0
Flames,1,2,1,0,4,Hurricanes,1,1,1,0,3,20190203,0,1,1,1,7,-1,2018,0,6,2038,0
Coyotes,1,1,2,0,4,Stars,0,1,4,0,5,20190204,-1,-1,1,1,9,1,2018,0,0,884,0
Ducks,0,0,1,0,1,Maple Leafs,0,3,3,0,6,20190204,0,3,5,5,7,5,2018,0,0,2170,0
Kings,1,0,2,1,4,Rangers,1,1,1,0,3,20190204,0,-1,0,1,7,-1,2018,1,0,2445,0
Canucks,0,1,0,0,1,Flyers,1,1,0,0,2,20190204,1,1,1,1,3,1,2018,0,0,2404,0
Blackhawks,1,0,5,0,6,Oilers,2,0,0,0,2,20190205,-1,-1,4,4,8,-4,2018,0,1,1437,0
Coyotes,1,0,1,0,2,Predators,0,3,2,0,5,20190205,-1,2,3,3,7,3,2018,0,1,1442,0
Sharks,1,0,1,1,3,Jets,1,1,0,0,2,20190205,0,-1,0,1,5,-1,2018,1,1,1496,0
Golden Knights,0,1,1,1,3,Lightning,1,1,0,0,2,20190205,-1,-1,0,1,5,-1,2018,1,1,1985,0
Blue Jackets,2,1,3,0,6,Avalanche,2,1,0,0,3,20190205,0,0,3,3,9,-3,2018,0,1,1163,0
Canucks,0,0,2,0,2,Capitals,1,0,2,0,3,20190205,1,1,1,1,5,1,2018,0,1,2359,0
Hurricanes,1,1,2,0,4,Penguins,0,0,0,0,0,20190205,1,2,4,4,4,-4,2018,0,1,330,0
Kings,1,0,4,0,5,Devils,0,1,0,0,1,20190205,1,0,4,4,6,-4,2018,0,1,2436,0
Blues,0,0,3,0,3,Panthers,1,0,1,0,2,20190205,-1,-1,1,1,5,-1,2018,0,1,1061,0
Wild,0,3,1,0,4,Sabres,1,2,1,1,5,20190205,1,0,0,1,9,1,2018,1,1,729,0
Ducks,0,1,0,0,1,Canadiens,3,0,1,0,4,20190205,3,2,3,3,5,3,2018,0,1,2448,0
Islanders,0,1,0,0,1,Bruins,0,1,2,0,3,20190205,0,0,2,2,4,2,2018,0,1,190,0
Senators,1,1,2,0,4,Maple Leafs,1,3,1,0,5,20190206,0,2,1,1,9,1,2018,0,2,203,0
Bruins,0,3,0,0,3,Rangers,1,0,2,1,4,20190206,1,-2,0,1,7,1,2018,1,2,190,0
Blue Jackets,2,1,1,0,4,Coyotes,0,2,0,0,2,20190207,2,1,2,2,6,-2,2018,0,3,1664,0
Sharks,3,1,1,0,5,Flames,1,1,0,0,2,20190207,2,2,3,3,7,-3,2018,0,3,1027,0
Canucks,0,2,1,0,3,Blackhawks,2,1,0,1,4,20190207,2,1,0,1,7,1,2018,1,3,1775,0
Oilers,1,1,2,0,4,Wild,0,0,1,0,1,20190207,1,2,3,3,5,-3,2018,0,3,1083,0
Stars,0,0,2,0,2,Predators,1,0,1,1,3,20190207,1,1,0,1,5,1,2018,1,3,616,0
Blues,0,0,0,1,1,Lightning,0,0,0,0,0,20190207,0,0,0,1,1,-1,2018,1,3,861,0
Golden Knights,0,3,1,0,4,Red Wings,1,0,2,0,3,20190207,-1,2,1,1,7,-1,2018,0,3,1757,0
Ducks,0,0,0,0,0,Senators,1,1,2,0,4,20190207,1,2,4,4,4,4,2018,0,3,2345,0
Jets,1,0,1,0,2,Canadiens,1,1,3,0,5,20190207,0,1,3,3,7,3,2018,0,3,1115,0
Avalanche,0,1,2,0,3,Capitals,1,1,1,1,4,20190207,1,1,0,1,7,1,2018,1,3,1489,0
Kings,1,1,0,1,3,Flyers,0,1,1,0,2,20190207,1,1,0,1,5,-1,2018,1,3,2388,0
Islanders,1,0,0,1,2,Devils,1,0,0,0,1,20190207,0,0,0,1,3,-1,2018,1,3,8,0
Penguins,0,1,1,0,2,Panthers,1,1,0,1,3,20190207,1,1,0,1,5,1,2018,1,3,1013,0
Hurricanes,1,1,3,1,6,Sabres,0,2,3,0,5,20190207,1,0,0,1,11,-1,2018,1,3,491,0
Hurricanes,0,0,3,0,3,Rangers,0,0,0,0,0,20190208,0,0,3,3,3,-3,2018,0,4,423,0
Blue Jackets,1,1,2,0,4,Golden Knights,2,0,1,0,3,20190209,-1,0,1,1,7,-1,2018,0,5,1757,0
Flames,2,1,0,0,3,Canucks,2,1,0,1,4,20190209,0,0,0,1,7,1,2018,1,5,426,0
Panthers,2,1,1,1,5,Capitals,0,2,2,0,4,20190209,2,1,0,1,9,-1,2018,1,5,924,0
Penguins,1,2,1,0,4,Lightning,2,1,2,0,5,20190209,1,0,1,1,9,1,2018,0,5,874,0
Maple Leafs,2,0,1,1,4,Canadiens,1,1,1,0,3,20190209,1,0,0,1,7,-1,2018,1,5,303,0
Sharks,2,1,2,0,5,Oilers,0,1,1,0,2,20190209,2,2,3,3,7,-3,2018,0,5,1190,0
Predators,0,1,1,0,2,Blues,2,1,0,0,3,20190209,2,2,1,1,5,1,2018,0,5,253,0
Jets,0,1,1,0,2,Senators,2,2,1,0,5,20190209,2,3,3,3,7,3,2018,0,5,1033,0
Ducks,0,1,1,0,2,Flyers,4,0,2,0,6,20190209,4,3,4,4,8,4,2018,0,5,2388,0
Avalanche,1,1,1,0,3,Islanders,0,1,2,1,4,20190209,-1,-1,0,1,7,1,2018,1,5,1627,0
Wild,1,2,1,0,4,Devils,1,0,1,0,2,20190209,0,2,2,2,6,-2,2018,0,5,1007,0
Red Wings,0,1,0,0,1,Sabres,0,3,0,0,3,20190209,0,2,2,2,4,2,2018,0,5,215,0
Stars,0,0,2,0,2,Coyotes,1,1,1,0,3,20190209,1,2,1,1,5,1,2018,0,5,884,0
Kings,0,2,2,0,4,Bruins,0,1,3,1,5,20190209,0,-1,0,1,9,1,2018,1,5,2590,0
Maple Leafs,1,0,0,0,1,Rangers,2,0,2,0,4,20190210,1,1,3,3,5,3,2018,0,6,341,0
Lightning,1,2,2,0,5,Panthers,0,2,0,0,2,20190210,1,1,3,3,7,-3,2018,0,6,205,0
Red Wings,0,1,1,0,2,Blackhawks,2,0,3,0,5,20190210,2,1,3,3,7,3,2018,0,6,238,0
Hurricanes,0,1,1,0,2,Devils,2,0,1,0,3,20190210,2,1,1,1,5,1,2018,0,6,419,0
Jets,0,1,2,0,3,Sabres,0,1,0,0,1,20190210,0,0,2,2,4,-2,2018,0,6,996,0
Avalanche,1,0,0,0,1,Bruins,0,1,0,1,2,20190210,-1,0,0,1,3,1,2018,1,6,1765,0
Blues,0,3,1,1,5,Predators,0,1,3,0,4,20190210,0,2,0,1,9,-1,2018,1,6,253,0
Wild,0,1,0,0,1,Islanders,1,1,0,0,2,20190210,1,1,1,1,3,1,2018,0,6,1016,0
Penguins,1,1,2,0,4,Flyers,0,0,1,0,1,20190211,1,2,3,3,5,-3,2018,0,0,257,0
Kings,2,1,1,0,4,Capitals,2,3,1,0,6,20190211,0,2,2,2,10,2,2018,0,0,2294,0
Sharks,3,3,1,0,7,Canucks,1,0,1,0,2,20190211,2,5,5,5,9,-5,2018,0,0,821,0
Flyers,1,2,2,0,5,Wild,3,0,1,0,4,20190212,-2,0,1,1,9,-1,2018,0,1,983,0
Coyotes,0,2,3,0,5,Golden Knights,0,2,0,0,2,20190212,0,0,3,3,7,-3,2018,0,1,256,0
Maple Leafs,1,3,1,0,5,Avalanche,1,0,1,0,2,20190212,0,3,3,3,7,-3,2018,0,1,1341,0
Rangers,0,2,1,0,3,Jets,2,0,2,0,4,20190212,2,0,1,1,7,1,2018,0,1,1287,0
Red Wings,1,1,1,0,3,Predators,0,2,0,0,2,20190212,1,0,1,1,5,-1,2018,0,1,470,0
Islanders,1,0,0,0,1,Sabres,1,1,1,0,3,20190212,0,1,2,2,4,2,2018,0,1,292,0
Flames,1,1,1,0,3,Lightning,3,2,1,0,6,20190212,2,3,3,3,9,3,2018,0,1,2289,0
Hurricanes,0,0,4,0,4,Senators,1,0,0,0,1,20190212,-1,-1,3,3,5,-3,2018,0,1,673,0
Capitals,0,0,0,0,0,Blue Jackets,0,1,2,0,3,20190212,0,1,3,3,3,3,2018,0,1,326,0
Stars,1,1,1,0,3,Panthers,0,0,0,0,0,20190212,1,2,3,3,3,-3,2018,0,1,1110,0
Blackhawks,1,1,1,0,3,Bruins,3,1,2,0,6,20190212,2,2,3,3,9,3,2018,0,1,849,0
Devils,1,0,2,0,3,Blues,3,3,2,0,8,20190212,2,5,5,5,11,5,2018,0,1,863,0
Oilers,1,0,0,0,1,Penguins,0,2,1,0,3,20190213,-1,1,2,2,4,2,2018,0,2,1797,0
Canucks,0,0,0,0,0,Ducks,1,0,0,0,1,20190213,1,1,1,1,1,1,2018,0,2,1076,0
Capitals,2,2,1,0,5,Sharks,1,0,0,0,1,20190214,1,3,4,4,6,-4,2018,0,3,2416,0
Canucks,1,1,1,1,4,Kings,1,1,1,0,3,20190214,0,0,0,1,7,-1,2018,1,3,1076,0
Maple Leafs,1,2,3,0,6,Golden Knights,0,2,1,0,3,20190214,1,1,3,3,9,-3,2018,0,3,1946,0
Devils,2,0,0,0,2,Blackhawks,1,2,2,0,5,20190214,-1,1,3,3,7,3,2018,0,3,703,0
Blues,2,1,1,0,4,Coyotes,0,0,0,0,0,20190214,2,3,4,4,4,-4,2018,0,3,1270,0
Canadiens,0,0,1,0,1,Predators,0,1,2,0,3,20190214,0,1,2,2,4,2,2018,0,3,937,0
Stars,0,0,0,0,0,Lightning,4,2,0,0,6,20190214,4,6,6,6,6,6,2018,0,3,916,0
Senators,1,1,0,0,2,Red Wings,2,1,0,0,3,20190214,1,1,1,1,5,1,2018,0,3,406,0
Islanders,1,2,0,0,3,Blue Jackets,0,0,0,0,0,20190214,1,3,3,3,3,-3,2018,0,3,476,0
Flames,0,0,2,0,2,Panthers,0,1,1,1,3,20190214,0,1,0,1,5,1,2018,1,3,2493,0
Avalanche,2,1,1,0,4,Jets,1,0,0,0,1,20190214,1,2,3,3,5,-3,2018,0,3,797,0
Rangers,2,1,3,0,6,Sabres,0,2,0,0,2,20190215,2,1,4,4,8,-4,2018,0,4,292,0
Oilers,1,0,0,0,1,Hurricanes,2,0,1,0,3,20190215,1,1,2,2,4,2,2018,0,4,2076,0
Devils,0,2,2,1,5,Wild,2,2,0,0,4,20190215,-2,-2,0,1,9,-1,2018,1,4,1007,0
Bruins,1,1,1,0,3,Ducks,0,0,0,0,0,20190215,1,2,3,3,3,-3,2018,0,4,2590,0
Bruins,1,1,2,0,4,Kings,0,1,1,0,2,20190216,1,1,2,2,6,-2,2018,0,5,2590,0
Predators,0,0,1,0,1,Golden Knights,1,1,3,0,5,20190216,1,2,4,4,6,4,2018,0,5,1575,0
Blue Jackets,3,0,2,0,5,Blackhawks,1,1,0,0,2,20190216,2,1,3,3,7,-3,2018,0,5,275,0
Stars,0,0,0,0,0,Hurricanes,2,0,1,0,3,20190216,2,2,3,3,3,3,2018,0,5,1055,0
Canucks,1,0,1,0,2,Sharks,1,1,1,0,3,20190216,0,1,1,1,5,1,2018,0,5,821,0
Senators,1,1,1,1,4,Jets,2,0,1,0,3,20190216,-1,0,0,1,7,-1,2018,1,5,1033,0
Oilers,0,1,1,0,2,Islanders,0,2,3,0,5,20190216,0,1,3,3,7,3,2018,0,5,2024,0
Canadiens,0,0,0,0,0,Lightning,0,0,3,0,3,20190216,0,0,3,3,3,3,2018,0,5,1311,0
Red Wings,1,0,4,0,5,Flyers,1,2,2,1,6,20190216,0,2,0,1,11,1,2018,1,5,441,0
Blues,0,0,3,0,3,Avalanche,0,0,0,0,0,20190216,0,0,3,3,3,-3,2018,0,5,794,0
Flames,1,4,0,0,5,Penguins,1,1,2,0,4,20190216,0,3,1,1,9,-1,2018,0,5,1777,0
Maple Leafs,0,0,0,0,0,Coyotes,0,2,0,0,2,20190216,0,2,2,2,2,2,2018,0,5,1885,0
Canadiens,2,1,0,0,3,Panthers,3,1,2,0,6,20190217,1,1,3,3,9,3,2018,0,6,1418,0
Capitals,1,1,0,0,2,Ducks,0,2,3,0,5,20190217,-1,0,3,3,7,3,2018,0,6,2294,0
Sabres,0,1,0,0,1,Devils,0,2,2,0,4,20190217,0,1,3,3,5,3,2018,0,6,284,0
Blues,2,2,0,0,4,Wild,0,0,0,0,0,20190217,2,4,4,4,4,-4,2018,0,6,466,0
Rangers,1,2,2,0,5,Penguins,1,2,3,0,6,20190217,0,0,1,1,11,1,2018,0,6,314,0
Flyers,1,0,2,0,3,Red Wings,0,1,0,0,1,20190217,1,0,2,2,4,-2,2018,0,6,441,0
Coyotes,0,2,0,0,2,Flames,1,2,2,0,5,20190218,1,1,3,3,7,3,2018,0,0,1224,0
Lightning,2,1,2,0,5,Blue Jackets,0,0,1,0,1,20190218,2,3,4,4,6,-4,2018,0,0,830,0
Senators,4,1,2,0,7,Blackhawks,5,2,1,0,8,20190218,1,2,1,1,15,1,2018,0,0,628,0
Golden Knights,0,0,0,0,0,Avalanche,1,1,1,0,3,20190218,1,2,3,3,3,3,2018,0,0,604,0
Bruins,3,1,1,1,6,Sharks,1,3,1,0,5,20190218,2,0,0,1,11,-1,2018,1,0,2678,0
Capitals,2,1,0,0,3,Kings,0,0,2,0,2,20190218,2,3,1,1,5,-1,2018,0,0,2294,0
Predators,1,2,2,0,5,Stars,0,3,0,0,3,20190219,1,0,2,2,8,-2,2018,0,1,616,0
Coyotes,0,1,1,1,3,Oilers,0,0,2,0,2,20190219,0,1,0,1,5,-1,2018,1,1,1392,0
Ducks,0,1,3,0,4,Wild,0,0,0,0,0,20190219,0,1,4,4,4,-4,2018,0,1,1521,0
Penguins,2,2,0,0,4,Devils,2,0,1,0,3,20190219,0,2,1,1,7,-1,2018,0,1,306,0
Blue Jackets,0,1,1,0,2,Canadiens,2,0,1,0,3,20190219,2,1,1,1,5,1,2018,0,1,605,0
Rangers,0,1,1,0,2,Hurricanes,0,1,0,0,1,20190219,0,0,1,1,3,-1,2018,0,1,423,0
Lightning,3,0,2,0,5,Flyers,0,0,2,0,2,20190219,3,3,3,3,7,-3,2018,0,1,928,0
Sabres,0,1,1,0,2,Panthers,0,0,4,0,4,20190219,0,-1,2,2,6,2,2018,0,1,1184,0
Maple Leafs,0,0,2,0,2,Blues,2,0,0,1,3,20190219,2,2,0,1,5,1,2018,1,1,659,0
Blackhawks,3,1,0,1,5,Red Wings,1,0,3,0,4,20190220,2,3,0,1,9,-1,2018,1,2,238,0
Jets,0,0,1,0,1,Avalanche,0,2,5,0,7,20190220,0,2,6,6,8,6,2018,0,2,797,0
Islanders,0,1,1,0,2,Flames,2,0,2,0,4,20190220,2,1,2,2,6,2,2018,0,2,2023,0
Bruins,1,0,1,1,3,Golden Knights,1,0,1,0,2,20190220,0,0,0,1,5,-1,2018,1,2,2369,0
Coyotes,0,0,2,1,3,Canucks,1,0,1,0,2,20190221,-1,-1,0,1,5,-1,2018,1,3,1228,0
Islanders,3,0,0,0,3,Oilers,2,0,1,1,4,20190221,-1,-1,0,1,7,1,2018,1,3,2024,0
Blues,0,2,0,0,2,Stars,0,4,1,0,5,20190221,0,2,3,3,7,3,2018,0,3,547,0
Sabres,1,0,0,0,1,Lightning,0,1,0,1,2,20190221,-1,0,0,1,3,1,2018,1,3,1051,0
Kings,0,0,1,0,1,Predators,1,1,0,0,2,20190221,1,2,1,1,3,1,2018,0,3,1776,0
Sharks,3,0,1,0,4,Penguins,0,0,0,0,0,20190221,3,3,4,4,4,-4,2018,0,3,2242,0
Wild,1,1,2,0,4,Rangers,0,1,0,0,1,20190221,1,1,3,3,5,-3,2018,0,3,1016,0
Senators,0,0,0,0,0,Devils,2,2,0,0,4,20190221,2,4,4,4,4,4,2018,0,3,330,0
Hurricanes,1,1,2,0,4,Panthers,0,3,0,0,3,20190221,1,-1,1,1,7,-1,2018,0,3,696,0
Capitals,0,2,1,0,3,Maple Leafs,0,0,2,0,2,20190221,0,2,1,1,5,-1,2018,0,3,349,0
Flyers,0,0,1,0,1,Canadiens,3,2,0,0,5,20190221,3,5,4,4,6,4,2018,0,3,400,0
Blue Jackets,1,0,2,0,3,Senators,0,0,0,0,0,20190222,1,1,3,3,3,-3,2018,0,4,512,0
Wild,2,1,0,0,3,Red Wings,0,1,1,0,2,20190222,2,2,1,1,5,-1,2018,0,4,542,0
Avalanche,1,1,3,0,5,Blackhawks,0,2,1,0,3,20190222,1,0,2,2,8,-2,2018,0,4,916,0
Ducks,0,1,0,0,1,Flames,0,1,1,0,2,20190222,0,0,1,1,3,1,2018,0,4,1197,0
Jets,2,2,2,0,6,Golden Knights,1,1,1,0,3,20190222,1,2,3,3,9,-3,2018,0,4,1303,0
Penguins,1,1,1,0,3,Flyers,1,0,2,1,4,20190223,0,-1,0,1,7,1,2018,1,5,257,0
Islanders,2,0,2,0,4,Canucks,0,0,0,0,0,20190223,2,2,4,4,4,-4,2018,0,5,2429,0
Ducks,0,1,0,0,1,Oilers,1,1,0,0,2,20190223,1,1,1,1,3,1,2018,0,5,1368,0
Canadiens,3,0,0,0,3,Maple Leafs,0,2,4,0,6,20190223,-3,-1,3,3,9,3,2018,0,5,303,0
Kings,1,0,0,0,1,Panthers,1,3,2,0,6,20190223,0,3,5,5,7,5,2018,0,5,2335,0
Hurricanes,1,1,1,0,3,Stars,0,0,0,0,0,20190223,1,2,3,3,3,-3,2018,0,5,1055,0
Capitals,0,1,1,0,2,Sabres,2,1,2,0,5,20190223,2,2,3,3,7,3,2018,0,5,292,0
Devils,0,0,2,0,2,Rangers,3,0,2,0,5,20190223,3,3,3,3,7,3,2018,0,5,8,0
Avalanche,1,2,2,0,5,Predators,0,0,0,0,0,20190223,1,3,5,5,5,-5,2018,0,5,1019,0
Sharks,0,0,0,0,0,Blue Jackets,1,2,1,0,4,20190223,1,3,4,4,4,4,2018,0,5,2090,0
Bruins,0,1,0,0,1,Blues,1,0,0,1,2,20190223,1,0,0,1,3,1,2018,1,5,1035,0
Rangers,1,1,3,0,5,Capitals,2,1,2,1,6,20190224,1,1,0,1,11,1,2018,1,6,204,0
Sharks,1,3,1,0,5,Red Wings,2,1,0,0,3,20190224,-1,1,2,2,8,-2,2018,0,6,2071,0
Stars,2,1,1,0,4,Blackhawks,0,2,1,0,3,20190224,2,1,1,1,7,-1,2018,0,6,802,0
Flames,1,0,1,0,2,Senators,0,1,0,0,1,20190224,1,0,1,1,3,-1,2018,0,6,1773,0
Blues,0,0,1,0,1,Wild,0,1,0,1,2,20190224,0,1,0,1,3,1,2018,1,6,466,0
Jets,1,0,0,0,1,Coyotes,1,2,1,0,4,20190224,0,2,3,3,5,3,2018,0,6,1365,0
Ducks,0,0,0,0,0,Canucks,2,1,1,0,4,20190225,2,3,4,4,4,4,2018,0,0,1076,0
Panthers,0,2,1,1,4,Avalanche,0,2,1,0,3,20190225,0,0,0,1,7,-1,2018,1,0,1724,0
Kings,0,0,3,0,3,Lightning,2,0,1,1,4,20190225,2,2,0,1,7,1,2018,1,0,2149,0
Canadiens,0,0,1,0,1,Devils,1,1,0,0,2,20190225,1,2,1,1,3,1,2018,0,0,342,0
Sabres,1,1,1,0,3,Maple Leafs,0,4,1,0,5,20190225,-1,2,2,2,8,2,2018,0,0,57,0
Oilers,1,0,1,0,2,Predators,0,2,0,1,3,20190225,-1,1,0,1,5,1,2018,1,0,1758,0
Flames,0,1,2,0,3,Islanders,0,1,0,0,1,20190226,0,0,2,2,4,-2,2018,0,1,2023,0
Sabres,1,1,0,0,2,Flyers,2,1,2,0,5,20190226,1,1,3,3,7,3,2018,0,1,279,0
Senators,2,0,0,0,2,Capitals,2,4,1,0,7,20190226,0,4,5,5,9,5,2018,0,1,446,0
Kings,0,0,1,0,1,Hurricanes,2,4,0,0,6,20190226,2,6,5,5,7,5,2018,0,1,2231,0
Penguins,2,1,2,0,5,Blue Jackets,0,2,0,0,2,20190226,2,1,3,3,7,-3,2018,0,1,161,0
Canadiens,1,5,2,0,8,Red Wings,0,1,0,0,1,20190226,1,5,7,7,9,-7,2018,0,1,508,0
Predators,0,0,0,0,0,Blues,0,0,2,0,2,20190226,0,0,2,2,2,2,2018,0,1,253,0
Wild,0,1,2,0,3,Jets,1,1,0,0,2,20190226,-1,-1,1,1,5,-1,2018,0,1,388,0
Panthers,0,1,2,0,3,Coyotes,0,2,1,1,4,20190226,0,1,0,1,7,1,2018,1,1,1978,0
Stars,1,0,0,0,1,Golden Knights,0,1,3,0,4,20190226,-1,0,3,3,5,3,2018,0,1,1068,0
Sharks,1,0,0,0,1,Bruins,1,3,0,0,4,20190226,0,3,3,3,5,3,2018,0,1,2678,0
Blackhawks,0,2,2,0,4,Ducks,0,2,1,0,3,20190227,0,0,1,1,7,-1,2018,0,2,1741,0
Canucks,1,0,1,0,2,Avalanche,2,0,0,1,3,20190227,1,1,0,1,5,1,2018,1,2,1105,0
Flames,0,2,0,0,2,Devils,0,1,0,0,1,20190227,0,1,1,1,3,-1,2018,0,2,2015,0
Oilers,1,0,1,0,2,Maple Leafs,1,4,1,0,6,20190227,0,4,4,4,8,4,2018,0,2,1683,0
Lightning,2,1,0,1,4,Rangers,0,3,0,0,3,20190227,2,0,0,1,7,-1,2018,1,2,1004,0
Maple Leafs,1,0,0,0,1,Islanders,1,3,2,0,6,20190228,0,3,5,5,7,5,2018,0,3,341,0
Flyers,2,0,1,0,3,Blue Jackets,1,1,1,1,4,20190228,-1,0,0,1,7,1,2018,1,3,414,0
Lightning,0,0,1,0,1,Bruins,0,1,3,0,4,20190228,0,1,3,3,5,3,2018,0,3,1183,0
Oilers,0,2,2,0,4,Senators,1,0,1,0,2,20190228,-1,1,2,2,6,-2,2018,0,3,1754,0
Canucks,1,0,1,0,2,Coyotes,2,2,1,0,5,20190228,1,3,3,3,7,3,2018,0,3,1228,0
Panthers,3,1,1,0,5,Golden Knights,1,3,1,1,6,20190228,-2,0,0,1,11,1,2018,1,3,2177,0
Stars,1,1,1,1,4,Kings,2,1,0,0,3,20190228,-1,-1,0,1,7,-1,2018,1,3,1237,0
Avalanche,0,1,2,0,3,Sharks,1,2,1,0,4,20190301,1,2,1,1,7,1,2018,0,4,927,0
Predators,1,1,1,0,3,Jets,0,2,3,0,5,20190301,-1,0,2,2,8,2,2018,0,4,1084,0
Golden Knights,1,1,1,0,3,Ducks,0,0,0,0,0,20190301,1,2,3,3,3,-3,2018,0,4,228,0
Canadiens,0,2,2,0,4,Rangers,1,0,1,0,2,20190301,-1,1,2,2,6,-2,2018,0,4,343,0
Capitals,0,0,3,0,3,Islanders,1,0,0,0,1,20190301,-1,-1,2,2,4,-2,2018,0,4,204,0
Flyers,2,1,3,0,6,Devils,0,2,1,0,3,20190301,2,1,3,3,9,-3,2018,0,4,75,0
Penguins,1,2,0,0,3,Sabres,2,0,1,1,4,20190301,1,-1,0,1,7,1,2018,1,4,178,0
Blues,1,1,0,0,2,Hurricanes,2,1,2,0,5,20190301,1,1,3,3,7,3,2018,0,4,665,0
Wild,1,0,3,0,4,Flames,0,1,1,0,2,20190302,1,0,2,2,6,-2,2018,0,5,1043,0
Red Wings,0,1,0,0,1,Coyotes,2,0,1,0,3,20190302,2,1,2,2,4,2,2018,0,5,1687,0
Stars,2,1,1,0,4,Blues,0,1,0,0,1,20190302,2,2,3,3,5,-3,2018,0,5,547,0
Hurricanes,2,0,1,1,4,Panthers,2,0,1,0,3,20190302,0,0,0,1,7,-1,2018,1,5,696,0
Senators,1,0,0,0,1,Lightning,2,2,1,0,5,20190302,1,3,4,4,6,4,2018,0,5,1251,0
Sabres,2,0,0,0,2,Maple Leafs,2,2,1,0,5,20190302,0,2,3,3,7,3,2018,0,5,57,0
Devils,0,0,0,0,0,Bruins,1,0,0,0,1,20190302,1,1,1,1,1,1,2018,0,5,196,0
Blackhawks,1,2,0,0,3,Kings,3,1,2,0,6,20190302,2,1,3,3,9,3,2018,0,5,1741,0
Oilers,1,3,0,0,4,Blue Jackets,0,0,0,0,0,20190302,1,4,4,4,4,-4,2018,0,5,1703,0
Penguins,3,1,1,0,5,Canadiens,0,1,0,0,1,20190302,3,3,4,4,6,-4,2018,0,5,474,0
Blackhawks,1,1,0,0,2,Sharks,1,1,3,0,5,20190303,0,0,3,3,7,3,2018,0,6,1837,0
Jets,1,1,3,0,5,Blue Jackets,1,1,0,0,2,20190303,0,0,3,3,7,-3,2018,0,6,975,0
Predators,1,0,1,1,3,Wild,0,2,0,0,2,20190303,1,-1,0,1,5,-1,2018,1,6,696,0
Avalanche,0,0,1,0,1,Ducks,1,1,0,0,2,20190303,1,2,1,1,3,1,2018,0,6,830,0
Capitals,2,0,0,1,3,Rangers,1,1,0,0,2,20190303,1,0,0,1,5,-1,2018,1,6,204,0
Senators,1,2,0,0,3,Panthers,2,0,0,0,2,20190303,-1,1,1,1,5,-1,2018,0,6,1370,0
Canucks,0,0,0,0,0,Golden Knights,0,3,0,0,3,20190303,0,3,3,3,3,3,2018,0,6,986,0
Flyers,2,2,0,0,4,Islanders,0,0,1,0,1,20190303,2,4,3,3,5,-3,2018,0,6,80,0
Oilers,1,3,0,0,4,Sabres,3,0,0,0,3,20190304,-2,1,1,1,7,-1,2018,0,0,1734,0
Maple Leafs,3,1,2,0,6,Flames,0,1,1,0,2,20190304,3,3,4,4,8,-4,2018,0,0,1682,0
Hurricanes,1,1,1,0,3,Bruins,0,2,1,1,4,20190305,-1,0,0,1,7,1,2018,1,1,609,0
Blue Jackets,1,0,0,1,2,Devils,0,1,0,0,1,20190305,1,0,0,1,3,-1,2018,1,1,467,0
Senators,0,2,2,0,4,Islanders,1,3,0,1,5,20190305,1,2,0,1,9,1,2018,1,1,334,0
Panthers,1,1,0,0,2,Penguins,0,2,0,1,3,20190305,-1,0,0,1,5,1,2018,1,1,1013,0
Jets,1,0,1,0,2,Lightning,1,2,2,0,5,20190305,0,2,3,3,7,3,2018,0,1,1705,0
Wild,1,1,2,0,4,Predators,1,1,2,1,5,20190305,0,0,0,1,9,1,2018,1,1,696,0
Rangers,0,0,0,0,0,Stars,0,1,0,0,1,20190305,0,1,1,1,1,1,2018,0,1,1370,0
Red Wings,1,0,2,0,3,Avalanche,0,1,2,1,4,20190305,-1,0,0,1,7,1,2018,1,1,1154,0
Ducks,1,0,2,0,3,Coyotes,1,0,0,0,1,20190305,0,0,2,2,4,-2,2018,0,1,356,0
Canadiens,1,1,1,0,3,Kings,0,0,1,0,1,20190305,1,2,2,2,4,-2,2018,0,1,2448,0
Flames,0,1,0,0,1,Golden Knights,1,0,1,0,2,20190306,1,0,1,1,3,1,2018,0,2,1033,0
Blues,2,1,2,0,5,Ducks,1,2,1,0,4,20190306,1,0,1,1,9,-1,2018,0,2,1586,0
Capitals,2,3,0,0,5,Flyers,0,1,2,0,3,20190306,2,4,2,2,8,-2,2018,0,2,123,0
Maple Leafs,0,2,0,0,2,Canucks,0,0,2,1,3,20190306,0,-2,0,1,5,1,2018,1,2,2090,0
Panthers,0,2,1,0,3,Bruins,0,1,3,0,4,20190307,0,-1,1,1,7,1,2018,0,3,1257,0
Blue Jackets,0,0,0,0,0,Penguins,1,1,1,0,3,20190307,1,2,3,3,3,3,2018,0,3,161,0
Islanders,2,0,2,0,4,Senators,1,1,0,0,2,20190307,1,0,2,2,6,-2,2018,0,3,334,0
Rangers,1,0,1,0,2,Red Wings,0,1,1,1,3,20190307,-1,0,0,1,5,1,2018,1,3,480,0
Wild,1,0,2,0,3,Lightning,0,0,0,0,0,20190307,1,1,3,3,3,-3,2018,0,3,1318,0
Sabres,0,3,1,0,4,Blackhawks,2,0,2,1,5,20190307,2,-1,0,1,9,1,2018,1,3,453,0
Avalanche,0,0,0,0,0,Stars,1,1,2,0,4,20190307,1,2,4,4,4,4,2018,0,3,661,0
Canucks,0,1,1,0,2,Oilers,2,1,0,0,3,20190307,2,2,1,1,5,1,2018,0,3,514,0
Flames,0,0,0,0,0,Coyotes,1,0,1,0,2,20190307,1,1,2,2,2,2,2018,0,3,1224,0
Blues,0,3,1,0,4,Kings,0,0,0,0,0,20190307,0,3,4,4,4,-4,2018,0,3,1586,0
Canadiens,1,1,0,0,2,Sharks,2,1,2,0,5,20190307,1,1,3,3,7,3,2018,0,3,2508,0
Canadiens,1,1,0,0,2,Ducks,2,3,3,0,8,20190308,1,3,6,6,10,6,2018,0,4,2448,0
Jets,4,1,3,0,8,Hurricanes,0,0,1,0,1,20190308,4,5,7,7,9,-7,2018,0,4,1350,0
Wild,0,2,0,0,2,Panthers,3,2,1,0,6,20190308,3,3,4,4,8,4,2018,0,4,1513,0
Devils,0,0,0,0,0,Capitals,1,0,2,0,3,20190308,1,1,3,3,3,3,2018,0,4,198,0
Sabres,0,0,0,0,0,Avalanche,0,1,2,0,3,20190309,0,1,3,3,3,3,2018,0,5,1366,0
Blues,1,1,0,0,2,Sharks,2,0,0,1,3,20190309,1,0,0,1,5,1,2018,1,5,1719,0
Senators,0,1,1,0,2,Bruins,0,1,2,0,3,20190309,0,0,1,1,5,1,2018,0,5,320,0
Red Wings,0,1,1,0,2,Lightning,2,0,1,0,3,20190309,2,1,1,1,5,1,2018,0,5,994,0
Flyers,2,3,0,0,5,Islanders,1,0,1,0,2,20190309,1,4,3,3,7,-3,2018,0,5,80,0
Devils,2,0,0,0,2,Rangers,0,1,3,0,4,20190309,-2,-1,2,2,6,2,2018,0,5,8,0
Penguins,0,1,0,0,1,Blue Jackets,1,1,2,0,4,20190309,1,1,3,3,5,3,2018,0,5,161,0
Maple Leafs,1,1,1,0,3,Oilers,0,0,2,0,2,20190309,1,2,1,1,5,-1,2018,0,5,1683,0
Hurricanes,2,0,3,0,5,Predators,0,1,2,0,3,20190309,2,1,2,2,8,-2,2018,0,5,456,0
Blackhawks,2,0,0,0,2,Stars,1,0,0,0,1,20190309,1,1,1,1,3,-1,2018,0,5,802,0
Kings,1,0,1,0,2,Coyotes,2,0,2,0,4,20190309,1,1,2,2,6,2,2018,0,5,356,0
Golden Knights,5,1,0,0,6,Canucks,1,1,0,0,2,20190309,4,4,4,4,8,-4,2018,0,5,986,0
Kings,3,0,0,0,3,Ducks,1,0,1,0,2,20190310,2,2,1,1,5,-1,2018,0,6,0,0
Jets,1,0,0,0,1,Capitals,1,1,1,0,3,20190310,0,1,2,2,4,2,2018,0,6,1247,0
Bruins,0,1,1,0,2,Penguins,2,1,1,0,4,20190310,2,2,2,2,6,2,2018,0,6,481,0
Red Wings,0,1,0,0,1,Panthers,2,1,3,0,6,20190310,2,2,5,5,7,5,2018,0,6,1155,0
Golden Knights,1,2,0,0,3,Flames,3,1,2,0,6,20190310,2,1,3,3,9,3,2018,0,6,1033,0
Lightning,2,3,1,0,6,Maple Leafs,0,1,1,0,2,20190311,2,4,4,4,8,-4,2018,0,0,1096,0
Blue Jackets,0,0,0,0,0,Islanders,1,0,1,0,2,20190311,1,1,2,2,2,2,2018,0,0,476,0
Senators,1,0,1,0,2,Flyers,0,3,0,0,3,20190311,-1,2,1,1,5,1,2018,0,0,373,0
Sharks,0,1,2,0,3,Wild,0,0,0,0,0,20190311,0,1,3,3,3,-3,2018,0,0,1570,0
Coyotes,1,0,0,0,1,Blackhawks,2,4,1,0,7,20190311,1,5,6,6,8,6,2018,0,0,1450,0
Hurricanes,0,1,2,0,3,Avalanche,0,0,0,0,0,20190311,0,1,3,3,3,-3,2018,0,0,1459,0
Rangers,0,1,1,0,2,Oilers,2,0,0,1,3,20190311,2,1,0,1,5,1,2018,1,0,2024,0
Devils,2,2,0,0,4,Flames,1,2,6,0,9,20190312,-1,-1,5,5,13,5,2018,0,1,2015,0
Sharks,2,1,2,0,5,Jets,2,1,1,0,4,20190312,0,0,1,1,9,-1,2018,0,1,1496,0
Predators,0,0,2,0,2,Ducks,2,1,0,0,3,20190312,2,3,1,1,5,1,2018,0,1,1776,0
Red Wings,0,0,1,0,1,Canadiens,0,2,1,0,3,20190312,0,2,2,2,4,2,2018,0,1,508,0
Bruins,1,3,0,0,4,Blue Jackets,3,2,2,0,7,20190312,2,1,3,3,11,3,2018,0,1,642,0
Stars,0,2,0,0,2,Sabres,0,0,0,0,0,20190312,0,2,2,2,2,-2,2018,0,1,1197,0
Coyotes,0,1,2,0,3,Blues,0,0,1,0,1,20190312,0,1,2,2,4,-2,2018,0,1,1270,0
Capitals,1,1,1,0,3,Penguins,0,3,2,0,5,20190312,-1,1,2,2,8,2,2018,0,1,190,0
Blackhawks,4,1,0,0,5,Maple Leafs,0,1,3,0,4,20190313,4,4,1,1,9,-1,2018,0,2,436,0
Devils,2,3,1,0,6,Oilers,2,1,0,0,3,20190313,0,2,3,3,9,-3,2018,0,2,2016,0
Rangers,0,0,1,0,1,Canucks,0,3,1,0,4,20190313,0,3,3,3,5,3,2018,0,2,2429,0
Panthers,1,2,1,0,4,Sharks,2,0,0,0,2,20190314,-1,1,2,2,6,-2,2018,0,3,2558,0
Predators,1,2,0,0,3,Kings,0,1,0,0,1,20190314,1,2,2,2,4,-2,2018,0,3,1776,0
Bruins,1,1,1,0,3,Jets,2,0,2,0,4,20190314,1,0,1,1,7,1,2018,0,3,1349,0
Ducks,0,1,0,0,1,Coyotes,2,2,2,0,6,20190314,2,3,5,5,7,5,2018,0,3,356,0
Lightning,0,1,4,0,5,Red Wings,2,1,1,0,4,20190314,-2,-2,1,1,9,-1,2018,0,3,994,0
Blues,0,0,0,0,0,Senators,0,1,1,0,2,20190314,0,1,2,2,2,2,2018,0,3,860,0
Capitals,2,2,1,0,5,Flyers,0,2,0,0,2,20190314,2,2,3,3,7,-3,2018,0,3,123,0
Canadiens,0,1,0,0,1,Islanders,0,1,1,0,2,20190314,0,0,1,1,3,1,2018,0,3,343,0
Penguins,0,3,2,0,5,Sabres,0,0,0,0,0,20190314,0,3,5,5,5,-5,2018,0,3,178,0
Stars,0,3,1,0,4,Wild,0,1,0,0,1,20190314,0,2,3,3,5,-3,2018,0,3,863,0
Flyers,1,4,1,0,6,Maple Leafs,1,3,3,0,7,20190315,0,-1,1,1,13,1,2018,0,4,334,0
Hurricanes,0,0,0,0,0,Blue Jackets,2,0,1,0,3,20190315,2,2,3,3,3,3,2018,0,4,374,0
Golden Knights,1,0,1,0,2,Stars,1,0,0,0,1,20190315,0,0,1,1,3,-1,2018,0,4,1068,0
Ducks,0,3,2,0,5,Avalanche,2,0,1,0,3,20190315,-2,1,2,2,8,-2,2018,0,4,830,0
Rangers,1,0,0,0,1,Flames,1,2,2,0,5,20190315,0,2,4,4,6,4,2018,0,4,2023,0
Devils,0,0,2,1,3,Canucks,0,1,1,0,2,20190315,0,-1,0,1,5,-1,2018,1,4,2421,0
Flames,0,1,0,0,1,Jets,1,1,0,0,2,20190316,1,1,1,1,3,1,2018,0,5,740,0
Predators,1,1,2,0,4,Sharks,0,2,0,0,2,20190316,1,0,2,2,6,-2,2018,0,5,1934,0
Rangers,1,0,1,0,2,Wild,2,1,2,0,5,20190316,1,2,3,3,7,3,2018,0,5,1016,0
Sabres,1,0,1,0,2,Hurricanes,1,2,1,0,4,20190316,0,2,2,2,6,2,2018,0,5,491,0
Oilers,1,1,0,1,3,Coyotes,1,1,0,0,2,20190316,0,0,0,1,5,-1,2018,1,5,1392,0
Maple Leafs,0,1,1,0,2,Senators,1,3,2,0,6,20190316,1,3,4,4,8,4,2018,0,5,203,0
Blackhawks,0,1,1,0,2,Canadiens,0,0,0,0,0,20190316,0,1,2,2,2,-2,2018,0,5,732,0
Blue Jackets,1,0,0,0,1,Bruins,1,0,0,1,2,20190316,0,0,0,1,3,1,2018,1,5,642,0
Panthers,1,1,2,0,4,Kings,1,0,2,0,3,20190316,0,1,1,1,7,-1,2018,0,5,2335,0
Islanders,1,0,0,0,1,Red Wings,1,1,0,0,2,20190316,0,1,1,1,3,1,2018,0,5,480,0
Capitals,1,1,1,0,3,Lightning,3,0,3,0,6,20190316,2,1,3,3,9,3,2018,0,5,818,0
Blues,2,2,1,0,5,Penguins,0,1,0,0,1,20190316,2,3,4,4,6,-4,2018,0,5,557,0
Oilers,1,1,1,0,3,Golden Knights,2,1,3,0,6,20190317,1,1,3,3,9,3,2018,0,6,1204,0
Flyers,0,0,1,1,2,Penguins,0,0,1,0,1,20190317,0,0,0,1,3,-1,2018,1,6,257,0
Panthers,0,1,1,0,2,Ducks,1,1,1,0,3,20190317,1,1,1,1,5,1,2018,0,6,2335,0
Islanders,1,1,0,1,3,Wild,0,1,1,0,2,20190317,1,1,0,1,5,-1,2018,1,6,1016,0
Blues,1,1,1,0,3,Sabres,2,1,0,1,4,20190317,1,1,0,1,7,1,2018,1,6,660,0
Devils,0,0,0,0,0,Avalanche,0,2,1,0,3,20190317,0,2,3,3,3,3,2018,0,6,1618,0
Canucks,2,0,0,1,3,Stars,0,1,1,0,2,20190317,2,1,0,1,5,-1,2018,1,6,1766,0
Coyotes,1,0,0,0,1,Lightning,1,0,3,0,4,20190318,0,0,3,3,5,3,2018,0,0,1793,0
Canucks,0,2,0,1,3,Blackhawks,1,0,1,0,2,20190318,-1,1,0,1,5,-1,2018,1,0,1775,0
Jets,2,1,0,0,3,Kings,1,1,0,0,2,20190318,1,1,1,1,5,-1,2018,0,0,1527,0
Golden Knights,3,1,3,0,7,Sharks,2,0,1,0,3,20190318,1,2,4,4,10,-4,2018,0,0,382,0
Avalanche,1,1,1,0,3,Wild,0,1,0,0,1,20190319,1,1,2,2,4,-2,2018,0,1,698,0
Blue Jackets,1,0,1,0,2,Flames,2,1,1,0,4,20190319,1,2,2,2,6,2,2018,0,1,1670,0
Panthers,1,1,0,0,2,Stars,1,1,2,0,4,20190319,0,0,2,2,6,2,2018,0,1,1110,0
Maple Leafs,0,0,0,0,0,Predators,1,0,2,0,3,20190319,1,1,3,3,3,3,2018,0,1,646,0
Red Wings,1,1,1,0,3,Rangers,0,0,2,0,2,20190319,1,2,1,1,5,-1,2018,0,1,480,0
Capitals,1,3,0,0,4,Devils,1,0,0,0,1,20190319,0,3,3,3,5,-3,2018,0,1,198,0
Penguins,0,1,1,0,2,Hurricanes,0,1,1,1,3,20190319,0,0,0,1,5,1,2018,1,1,330,0
Canadiens,1,1,1,0,3,Flyers,0,0,1,0,1,20190319,1,2,2,2,4,-2,2018,0,1,400,0
Bruins,1,2,2,0,5,Islanders,0,0,0,0,0,20190319,1,3,5,5,5,-5,2018,0,1,190,0
Oilers,0,2,0,0,2,Blues,1,3,3,0,7,20190319,1,2,5,5,9,5,2018,0,1,1508,0
Maple Leafs,0,2,2,0,4,Sabres,1,0,1,0,2,20190320,-1,1,2,2,6,-2,2018,0,2,57,0
Lightning,0,4,0,1,5,Capitals,1,2,1,0,4,20190320,-1,1,0,1,9,-1,2018,1,2,818,0
Senators,0,0,4,0,4,Canucks,1,3,3,0,7,20190320,1,4,3,3,11,3,2018,0,2,2191,0
Jets,1,0,2,0,3,Ducks,0,0,0,0,0,20190320,1,1,3,3,3,-3,2018,0,2,1527,0
Sharks,1,1,0,0,2,Kings,1,0,3,0,4,20190321,0,-1,2,2,6,2,2018,0,3,305,0
Jets,0,0,0,0,0,Golden Knights,2,3,0,0,5,20190321,2,5,5,5,5,5,2018,0,3,1303,0
Avalanche,0,1,2,0,3,Stars,0,0,1,0,1,20190321,0,1,2,2,4,-2,2018,0,3,661,0
Flyers,1,0,2,0,3,Blackhawks,1,0,0,0,1,20190321,0,0,2,2,4,-2,2018,0,3,664,0
Blue Jackets,0,1,0,0,1,Oilers,0,1,3,0,4,20190321,0,0,3,3,5,3,2018,0,3,1703,0
Red Wings,1,0,1,0,2,Blues,1,2,2,0,5,20190321,0,2,3,3,7,3,2018,0,3,454,0
Coyotes,1,0,1,0,2,Panthers,1,1,2,0,4,20190321,0,1,2,2,6,2,2018,0,3,1978,0
Penguins,0,1,0,1,2,Predators,0,0,1,0,1,20190321,0,1,0,1,3,-1,2018,1,3,471,0
Bruins,1,1,3,0,5,Devils,0,1,0,0,1,20190321,1,1,4,4,6,-4,2018,0,3,196,0
Senators,1,0,0,0,1,Flames,2,1,2,0,5,20190321,1,2,4,4,6,4,2018,0,3,1773,0
Islanders,0,0,0,0,0,Canadiens,1,3,0,0,4,20190321,1,4,4,4,4,4,2018,0,3,343,0
Lightning,2,0,4,0,6,Hurricanes,2,1,0,0,3,20190321,0,-1,3,3,9,-3,2018,0,3,585,0
Wild,1,0,1,0,2,Capitals,0,1,0,0,1,20190322,1,0,1,1,3,-1,2018,0,4,931,0
Sharks,0,1,2,0,3,Ducks,1,0,2,1,4,20190322,1,0,0,1,7,1,2018,1,4,305,0
Islanders,1,1,2,0,4,Flyers,1,0,1,0,2,20190323,0,1,2,2,6,-2,2018,0,5,80,0
Blackhawks,0,1,1,0,2,Avalanche,0,2,2,0,4,20190323,0,1,2,2,6,2,2018,0,5,916,0
Senators,2,0,1,1,4,Oilers,1,1,1,0,3,20190323,1,0,0,1,7,-1,2018,1,5,1754,0
Rangers,0,0,1,1,2,Maple Leafs,0,0,1,0,1,20190323,0,0,0,1,3,-1,2018,1,5,341,0
Sabres,1,2,1,0,4,Canadiens,0,4,3,0,7,20190323,-1,1,3,3,11,3,2018,0,5,311,0
Bruins,1,5,1,0,7,Panthers,0,2,1,0,3,20190323,1,4,4,4,10,-4,2018,0,5,1257,0
Wild,0,1,0,0,1,Hurricanes,0,2,3,0,5,20190323,0,1,4,4,6,4,2018,0,5,995,0
Predators,0,0,0,0,0,Jets,0,3,2,0,5,20190323,0,3,5,5,5,5,2018,0,5,1084,0
Lightning,0,2,1,0,3,Blues,3,1,0,0,4,20190323,3,2,1,1,7,1,2018,0,5,861,0
Penguins,1,1,1,0,3,Stars,0,2,0,0,2,20190323,1,0,1,1,5,-1,2018,0,5,1069,0
Flames,1,1,1,0,3,Canucks,0,0,1,0,1,20190323,1,2,2,2,4,-2,2018,0,5,426,0
Red Wings,1,0,1,1,3,Golden Knights,0,1,1,0,2,20190323,1,0,0,1,5,-1,2018,1,5,1757,0
Ducks,1,1,1,0,3,Kings,1,1,1,1,4,20190323,0,0,0,1,7,1,2018,1,5,0,0
Coyotes,1,0,0,0,1,Devils,1,0,0,1,2,20190323,0,0,0,1,3,1,2018,1,5,2131,0
Blue Jackets,1,2,2,0,5,Canucks,0,0,0,0,0,20190324,1,3,5,5,5,-5,2018,0,6,2050,0
Canadiens,1,0,0,0,1,Hurricanes,0,0,1,1,2,20190324,-1,-1,0,1,3,1,2018,1,6,727,0
Coyotes,0,0,0,0,0,Islanders,1,0,1,0,2,20190324,1,1,2,2,2,2,2018,0,6,2139,0
Flyers,0,1,0,0,1,Capitals,1,1,1,0,3,20190324,1,1,2,2,4,2,2018,0,6,123,0
Avalanche,0,1,0,0,1,Blackhawks,0,0,1,1,2,20190324,0,-1,0,1,3,1,2018,1,6,916,0
Panthers,2,0,3,0,5,Maple Leafs,4,1,2,0,7,20190325,2,3,2,2,12,2,2018,0,0,1234,0
Sabres,1,0,0,0,1,Devils,1,0,2,0,3,20190325,0,0,2,2,4,2,2018,0,0,284,0
Penguins,1,3,1,0,5,Rangers,2,0,0,0,2,20190325,-1,2,3,3,7,-3,2018,0,0,314,0
Bruins,1,3,0,0,4,Lightning,2,0,3,0,5,20190325,1,-2,1,1,9,1,2018,0,0,1183,0
Golden Knights,0,1,0,0,1,Blues,1,1,1,0,3,20190325,1,1,2,2,4,2,2018,0,0,1375,0
Predators,1,0,0,0,1,Wild,0,0,0,0,0,20190325,1,1,1,1,1,-1,2018,0,0,696,0
Stars,0,3,2,0,5,Jets,0,0,2,0,2,20190325,0,3,3,3,7,-3,2018,0,0,1183,0
Kings,1,0,2,0,3,Flames,0,0,0,0,0,20190325,1,1,3,3,3,-3,2018,0,0,1197,0
Red Wings,1,1,1,0,3,Sharks,0,0,2,0,2,20190325,1,2,1,1,5,-1,2018,0,0,2071,0
Blackhawks,0,0,0,0,0,Coyotes,0,0,1,0,1,20190326,0,0,1,1,1,1,2018,0,1,1450,0
Ducks,1,2,2,0,5,Canucks,2,0,2,0,4,20190326,-1,1,1,1,9,-1,2018,0,1,1076,0
Islanders,0,0,0,0,0,Blue Jackets,1,0,3,0,4,20190326,1,1,4,4,4,4,2018,0,1,476,0
Sabres,0,0,0,0,0,Senators,2,0,2,0,4,20190326,2,2,4,4,4,4,2018,0,1,219,0
Kings,1,3,0,0,4,Oilers,5,2,1,0,8,20190326,4,3,4,4,12,4,2018,0,1,1368,0
Hurricanes,0,1,0,0,1,Capitals,1,0,3,0,4,20190326,1,0,3,3,5,3,2018,0,1,233,0
Panthers,0,0,1,0,1,Canadiens,3,2,1,0,6,20190326,3,5,5,5,7,5,2018,0,1,1418,0
Rangers,1,0,2,0,3,Bruins,1,1,4,0,6,20190327,0,1,3,3,9,3,2018,0,2,190,0
Stars,1,0,1,0,2,Flames,0,0,1,0,1,20190327,1,1,1,1,3,-1,2018,0,2,1536,0
Golden Knights,0,2,1,0,3,Avalanche,2,2,0,0,4,20190327,2,2,1,1,7,1,2018,0,2,604,0
Maple Leafs,2,0,2,0,4,Flyers,0,3,1,1,5,20190327,-2,1,0,1,9,1,2018,1,2,334,0
Blackhawks,3,2,0,0,5,Sharks,1,3,0,0,4,20190328,2,1,1,1,9,-1,2018,0,3,1837,0
Stars,0,1,1,1,3,Oilers,1,1,0,0,2,20190328,-1,-1,0,1,5,-1,2018,1,3,1655,0
Kings,1,0,1,0,2,Canucks,0,2,0,1,3,20190328,-1,1,0,1,5,1,2018,1,3,1076,0
Panthers,1,2,2,0,5,Senators,1,0,1,0,2,20190328,0,2,3,3,7,-3,2018,0,3,1370,0
Canadiens,1,1,0,0,2,Blue Jackets,0,3,3,0,6,20190328,-1,1,4,4,8,4,2018,0,3,605,0
Capitals,1,0,2,0,3,Hurricanes,1,1,0,0,2,20190328,0,-1,1,1,5,-1,2018,0,3,233,0
Red Wings,1,1,2,1,5,Sabres,0,2,2,0,4,20190328,1,0,0,1,9,-1,2018,1,3,215,0
Islanders,1,1,3,0,5,Jets,2,1,1,0,4,20190328,-1,-1,1,1,9,-1,2018,0,3,1287,0
Predators,1,1,1,0,3,Penguins,0,0,1,0,1,20190329,1,2,2,2,4,-2,2018,0,4,471,0
Devils,0,0,0,0,0,Red Wings,1,1,2,0,4,20190329,1,2,4,4,4,4,2018,0,4,471,0
Coyotes,0,0,2,0,2,Avalanche,0,2,0,1,3,20190329,0,2,0,1,5,1,2018,1,4,585,0
Ducks,1,0,0,0,1,Flames,1,2,3,0,6,20190329,0,2,5,5,7,5,2018,0,4,1197,0
Wild,2,1,0,0,3,Golden Knights,0,1,1,0,2,20190329,2,2,1,1,5,-1,2018,0,4,1293,0
Blues,2,0,0,0,2,Rangers,0,2,2,0,4,20190329,-2,0,2,2,6,2,2018,0,4,871,0
Blackhawks,0,1,1,0,2,Kings,0,1,1,1,3,20190330,0,0,0,1,5,1,2018,1,5,1741,0
Stars,0,0,2,0,2,Canucks,2,0,0,1,3,20190330,2,2,0,1,5,1,2018,1,5,1766,0
Ducks,1,3,1,0,5,Oilers,0,0,1,0,1,20190330,1,4,4,4,6,-4,2018,0,5,1368,0
Blue Jackets,3,2,0,0,5,Predators,1,1,0,0,2,20190330,2,3,3,3,7,-3,2018,0,5,333,0
Golden Knights,1,1,1,0,3,Sharks,0,1,2,1,4,20190330,-1,-1,0,1,7,1,2018,1,5,382,0
Blues,1,1,0,1,3,Devils,0,2,0,0,2,20190330,1,0,0,1,5,-1,2018,1,5,863,0
Canadiens,1,1,1,0,3,Jets,0,0,1,0,1,20190330,1,2,2,2,4,-2,2018,0,5,1115,0
Panthers,2,1,1,0,4,Bruins,0,1,0,0,1,20190330,2,2,3,3,5,-3,2018,0,5,1257,0
Sabres,0,0,1,0,1,Islanders,1,2,2,0,5,20190330,1,3,4,4,6,4,2018,0,5,292,0
Maple Leafs,0,0,2,0,2,Senators,0,2,2,0,4,20190330,0,2,2,2,6,2,2018,0,5,203,0
Capitals,3,1,2,0,6,Lightning,0,1,2,0,3,20190330,3,3,3,3,9,-3,2018,0,5,818,0
Flyers,1,0,1,0,2,Hurricanes,2,0,3,0,5,20190330,1,1,3,3,7,3,2018,0,5,345,0
Rangers,2,0,1,0,3,Flyers,0,0,0,0,0,20190331,2,2,3,3,3,-3,2018,0,6,80,0
Hurricanes,0,0,1,0,1,Penguins,2,0,1,0,3,20190331,2,2,2,2,4,2,2018,0,6,330,0
Wild,0,0,0,0,0,Coyotes,1,1,2,0,4,20190331,1,2,4,4,4,4,2018,0,6,1278,0
Blue Jackets,3,1,0,0,4,Sabres,0,0,0,0,0,20190331,3,4,4,4,4,-4,2018,0,6,293,0
Bruins,0,3,0,0,3,Red Wings,2,0,4,0,6,20190331,2,-1,3,3,9,3,2018,0,6,611,0
Flames,3,1,1,0,5,Sharks,1,0,2,0,3,20190331,2,3,2,2,8,-2,2018,0,6,1027,0
Flames,2,1,4,0,7,Kings,2,0,0,0,2,20190401,0,1,5,5,9,-5,2018,0,0,1197,0
Oilers,0,1,0,0,1,Golden Knights,1,1,1,0,3,20190401,1,1,2,2,4,2,2018,0,0,1204,0
Jets,2,1,0,1,4,Blackhawks,1,1,1,0,3,20190401,1,1,0,1,7,-1,2018,1,0,722,0
Lightning,1,2,2,0,5,Senators,1,0,1,0,2,20190401,0,2,3,3,7,-3,2018,0,0,1251,0
Maple Leafs,0,1,1,0,2,Islanders,0,0,1,0,1,20190401,0,1,1,1,3,-1,2018,0,0,341,0
Rangers,1,1,0,0,2,Devils,2,0,2,0,4,20190401,1,0,2,2,6,2,2018,0,0,8,0
Capitals,0,0,3,0,3,Panthers,1,3,1,0,5,20190401,1,4,2,2,8,2,2018,0,0,924,0
Avalanche,0,0,2,0,2,Blues,1,0,1,1,3,20190401,1,1,0,1,5,1,2018,1,0,794,0
Oilers,2,0,0,0,2,Avalanche,0,4,2,0,6,20190402,-2,2,4,4,8,4,2018,0,1,1036,0
Kings,0,1,2,0,3,Coyotes,0,1,0,0,1,20190402,0,0,2,2,4,-2,2018,0,1,356,0
Sharks,2,0,0,0,2,Canucks,1,0,3,0,4,20190402,-1,-1,2,2,6,2,2018,0,1,821,0
Flyers,0,2,0,0,2,Stars,2,2,2,0,6,20190402,2,2,4,4,8,4,2018,0,1,1297,0
Hurricanes,1,1,2,0,4,Maple Leafs,0,1,0,0,1,20190402,1,1,3,3,5,-3,2018,0,1,544,0
Penguins,1,0,0,0,1,Red Wings,1,1,2,0,4,20190402,0,1,3,3,5,3,2018,0,1,205,0
Lightning,1,1,0,0,2,Canadiens,1,1,2,0,4,20190402,0,0,2,2,6,2,2018,0,1,1311,0
Bruins,2,2,2,0,6,Blue Jackets,0,0,2,0,2,20190402,2,4,4,4,8,-4,2018,0,1,642,0
Predators,1,1,1,0,3,Sabres,1,1,0,0,2,20190402,0,0,1,1,5,-1,2018,0,1,626,0
Jets,0,1,0,0,1,Wild,3,1,1,0,5,20190402,3,3,4,4,6,4,2018,0,1,388,0
Senators,2,1,1,0,4,Rangers,0,1,0,0,1,20190403,2,2,3,3,5,-3,2018,0,2,334,0
Blues,0,1,2,0,3,Blackhawks,1,1,1,1,4,20190403,1,1,0,1,7,1,2018,1,2,260,0
Flames,1,0,0,0,1,Ducks,2,1,0,0,3,20190403,1,2,2,2,4,2,2018,0,2,1197,0
Bruins,0,1,2,0,3,Wild,0,0,0,0,0,20190404,0,1,3,3,3,-3,2018,0,3,1120,0
Coyotes,1,2,1,0,4,Golden Knights,1,0,0,0,1,20190404,0,2,3,3,5,-3,2018,0,3,256,0
Sharks,2,1,0,0,3,Oilers,1,1,0,0,2,20190404,1,1,1,1,5,-1,2018,0,3,1190,0
Jets,2,0,0,0,2,Avalanche,0,1,1,1,3,20190404,-2,-1,0,1,5,1,2018,1,3,797,0
Canucks,2,0,0,0,2,Predators,0,1,2,0,3,20190404,-2,-1,1,1,5,1,2018,0,3,2030,0
Islanders,0,1,0,1,2,Panthers,0,0,1,0,1,20190404,0,1,0,1,3,-1,2018,1,3,1091,0
Devils,1,0,0,0,1,Hurricanes,1,1,1,0,3,20190404,0,1,2,2,4,2,2018,0,3,419,0
Flyers,3,0,0,0,3,Blues,5,1,1,0,7,20190404,2,3,4,4,10,4,2018,0,3,808,0
Lightning,0,1,2,0,3,Maple Leafs,1,0,0,0,1,20190404,-1,0,2,2,4,-2,2018,0,3,1096,0
Senators,2,0,0,0,2,Sabres,1,2,2,0,5,20190404,-1,1,3,3,7,3,2018,0,3,219,0
Canadiens,1,0,0,0,1,Capitals,1,1,0,0,2,20190404,0,1,1,1,3,1,2018,0,3,495,0
Red Wings,1,0,0,0,1,Penguins,2,1,1,0,4,20190404,1,2,3,3,5,3,2018,0,3,205,0
Blue Jackets,0,0,2,1,3,Rangers,0,1,1,0,2,20190405,0,-1,0,1,5,-1,2018,1,4,476,0
Stars,0,0,1,0,1,Blackhawks,1,3,2,0,6,20190405,1,4,5,5,7,5,2018,0,4,802,0
Kings,1,0,1,0,2,Ducks,1,2,2,0,5,20190405,0,2,3,3,7,3,2018,0,4,0,0
Avalanche,1,1,0,0,2,Sharks,2,1,2,0,5,20190406,1,1,3,3,7,3,2018,0,5,927,0
Golden Knights,0,2,0,0,2,Kings,2,1,2,0,5,20190406,2,1,3,3,7,3,2018,0,5,228,0
Jets,1,3,0,0,4,Coyotes,1,0,1,0,2,20190406,0,3,2,2,6,-2,2018,0,5,1365,0
Oilers,1,1,1,0,3,Flames,1,0,0,0,1,20190406,0,1,2,2,4,-2,2018,0,5,171,0
Wild,0,0,0,0,0,Stars,0,0,3,0,3,20190406,0,0,3,3,3,3,2018,0,5,863,0
Blackhawks,2,0,0,0,2,Predators,0,2,3,0,5,20190406,-2,0,3,3,7,3,2018,0,5,395,0
Rangers,1,0,2,1,4,Penguins,1,0,2,0,3,20190406,0,0,0,1,7,-1,2018,1,5,314,0
Hurricanes,3,1,0,0,4,Flyers,1,2,0,0,3,20190406,2,1,1,1,7,-1,2018,0,5,345,0
Sabres,2,3,2,0,7,Red Wings,1,0,0,0,1,20190406,1,4,6,6,8,-6,2018,0,5,215,0
Blue Jackets,3,1,2,0,6,Senators,0,1,1,0,2,20190406,3,3,4,4,8,-4,2018,0,5,512,0
Maple Leafs,2,2,1,0,5,Canadiens,1,3,1,1,6,20190406,-1,0,0,1,11,1,2018,1,5,303,0
Canucks,0,0,2,0,2,Blues,1,0,1,1,3,20190406,1,1,0,1,5,1,2018,1,5,1778,0
Lightning,0,3,3,0,6,Bruins,2,0,1,0,3,20190406,-2,1,3,3,9,-3,2018,0,5,1183,0
Islanders,0,1,2,0,3,Capitals,0,0,0,0,0,20190406,0,1,3,3,3,-3,2018,0,5,204,0
Devils,1,2,0,1,4,Panthers,0,1,2,0,3,20190406,1,2,0,1,7,-1,2018,1,5,1090,0
Golden Knights,0,1,1,0,2,Sharks,1,3,1,0,5,20190410,1,3,3,3,7,3,2018,0,2,382,1
Stars,0,1,2,0,3,Predators,1,0,1,0,2,20190410,-1,0,1,1,5,-1,2018,0,2,616,1
Penguins,1,1,1,0,3,Islanders,2,0,1,1,4,20190410,1,0,0,1,7,1,2018,1,2,314,1
Blue Jackets,0,1,3,0,4,Lightning,3,0,0,0,3,20190410,-3,-2,1,1,7,-1,2018,0,2,830,1
Blues,0,0,2,0,2,Jets,1,0,0,0,1,20190410,-1,-1,1,1,3,-1,2018,0,2,853,1
Avalanche,0,0,0,0,0,Flames,0,2,2,0,4,20190411,0,2,4,4,4,4,2018,0,3,898,1
Hurricanes,0,0,2,0,2,Capitals,3,0,1,0,4,20190411,3,3,2,2,6,2,2018,0,3,233,1
Maple Leafs,1,2,1,0,4,Bruins,1,0,0,0,1,20190411,0,2,3,3,5,-3,2018,0,3,430,1
Blues,1,2,1,0,4,Jets,1,2,0,0,3,20190412,0,0,1,1,7,-1,2018,0,4,853,1
Golden Knights,3,1,1,0,5,Sharks,3,0,0,0,3,20190412,0,1,2,2,8,-2,2018,0,4,382,1
Penguins,0,1,0,0,1,Islanders,0,1,2,0,3,20190412,0,0,2,2,4,2,2018,0,4,314,1
Blue Jackets,2,1,2,0,5,Lightning,0,0,1,0,1,20190412,2,3,4,4,6,-4,2018,0,4,830,1
Hurricanes,1,1,1,0,3,Capitals,2,0,1,1,4,20190413,1,0,0,1,7,1,2018,1,5,233,1
Stars,0,1,0,0,1,Predators,0,1,0,1,2,20190413,0,0,0,1,3,1,2018,1,5,616,1
Maple Leafs,0,0,1,0,1,Bruins,2,1,1,0,4,20190413,2,3,3,3,5,3,2018,0,5,430,1
Avalanche,0,1,1,1,3,Flames,0,1,1,0,2,20190413,0,0,0,1,5,-1,2018,1,5,898,1
Islanders,2,0,2,0,4,Penguins,1,0,0,0,1,20190414,1,1,3,3,5,-3,2018,0,6,314,1
Lightning,0,0,1,0,1,Blue Jackets,0,2,1,0,3,20190414,0,2,2,2,4,2,2018,0,6,830,1
Jets,0,3,3,0,6,Blues,1,0,2,0,3,20190414,-1,2,3,3,9,-3,2018,0,6,853,1
Sharks,1,0,2,0,3,Golden Knights,2,2,2,0,6,20190414,1,3,3,3,9,3,2018,0,6,382,1
Flames,0,1,1,0,2,Avalanche,3,2,1,0,6,20190415,3,4,4,4,8,4,2018,0,0,898,1
Bruins,0,2,0,0,2,Maple Leafs,0,3,0,0,3,20190415,0,1,1,1,5,1,2018,0,0,430,1
Capitals,0,0,0,0,0,Hurricanes,1,2,2,0,5,20190415,1,3,5,5,5,5,2018,0,0,233,1
Predators,0,2,1,0,3,Stars,0,1,1,0,2,20190415,0,1,1,1,5,-1,2018,0,0,616,1
Lightning,1,2,0,0,3,Blue Jackets,2,2,3,0,7,20190416,1,1,4,4,10,4,2018,0,1,830,1
Islanders,2,0,1,0,3,Penguins,1,0,0,0,1,20190416,1,1,2,2,4,-2,2018,0,1,314,1
Jets,0,0,1,1,2,Blues,0,0,1,0,1,20190416,0,0,0,1,3,-1,2018,1,1,853,1
Sharks,0,0,0,0,0,Golden Knights,2,1,2,0,5,20190416,2,3,5,5,5,5,2018,0,1,382,1
Bruins,2,2,2,0,6,Maple Leafs,1,1,2,0,4,20190417,1,2,2,2,10,-2,2018,0,2,430,1
Predators,0,0,1,0,1,Stars,4,1,0,0,5,20190417,4,5,4,4,6,4,2018,0,2,616,1
Flames,0,1,1,0,2,Avalanche,0,0,2,1,3,20190417,0,-1,0,1,5,1,2018,1,2,898,1
Capitals,0,1,0,0,1,Hurricanes,1,1,0,0,2,20190418,1,1,1,1,3,1,2018,0,3,233,1
Blues,0,0,3,0,3,Jets,2,0,0,0,2,20190418,-2,-2,1,1,5,-1,2018,0,3,853,1
Golden Knights,1,0,1,0,2,Sharks,2,1,2,0,5,20190418,1,2,3,3,7,3,2018,0,3,382,1
Maple Leafs,0,0,2,0,2,Bruins,0,0,1,0,1,20190419,0,0,1,1,3,-1,2018,0,4,430,1
Avalanche,2,2,1,0,5,Flames,1,0,0,0,1,20190419,1,3,4,4,6,-4,2018,0,4,898,1
Hurricanes,0,0,0,0,0,Capitals,1,2,3,0,6,20190420,1,3,6,6,6,6,2018,0,5,233,1
Stars,1,3,1,0,5,Predators,1,1,1,0,3,20190420,0,2,2,2,8,-2,2018,0,5,616,1
Jets,0,0,2,0,2,Blues,1,1,1,0,3,20190420,1,2,1,1,5,1,2018,0,5,853,1
Bruins,2,1,1,0,4,Maple Leafs,1,0,1,0,2,20190421,1,2,2,2,6,-2,2018,0,6,430,1
Sharks,1,0,0,1,2,Golden Knights,0,1,0,0,1,20190421,1,0,0,1,3,-1,2018,1,6,382,1
Predators,1,0,0,0,1,Stars,0,1,0,1,2,20190422,-1,0,0,1,3,1,2018,1,0,616,1
Capitals,2,0,0,0,2,Hurricanes,1,1,3,0,5,20190422,-1,0,3,3,7,3,2018,0,0,233,1
Maple Leafs,0,1,0,0,1,Bruins,2,0,3,0,5,20190423,2,1,4,4,6,4,2018,0,1,430,1
Golden Knights,1,1,2,0,4,Sharks,0,0,4,1,5,20190423,-1,-2,0,1,9,1,2018,1,1,382,1
Hurricanes,0,2,1,1,4,Capitals,2,1,0,0,3,20190424,-2,-1,0,1,7,-1,2018,1,2,233,1
Blue Jackets,0,0,2,0,2,Bruins,1,0,1,1,3,20190425,1,1,0,1,5,1,2018,1,3,642,1
Stars,0,1,1,0,2,Blues,1,1,1,0,3,20190425,1,1,1,1,5,1,2018,0,3,547,1
Hurricanes,0,0,0,1,1,Islanders,0,0,0,0,0,20190426,0,0,0,1,1,-1,2018,1,4,423,1
Avalanche,1,1,0,0,2,Sharks,1,3,1,0,5,20190426,0,2,3,3,7,3,2018,0,4,927,1
Stars,3,0,1,0,4,Blues,1,0,1,0,2,20190427,2,2,2,2,6,-2,2018,0,5,547,1
Blue Jackets,0,2,0,1,3,Bruins,1,1,0,0,2,20190427,-1,0,0,1,5,-1,2018,1,5,642,1
Hurricanes,0,0,2,0,2,Islanders,1,0,0,0,1,20190428,-1,-1,1,1,3,-1,2018,0,6,423,1
Avalanche,0,2,2,0,4,Sharks,1,0,2,0,3,20190428,-1,1,1,1,7,-1,2018,0,6,927,1
Blues,1,1,2,0,4,Stars,1,0,2,0,3,20190429,0,1,1,1,7,-1,2018,0,0,547,1
Bruins,0,1,0,0,1,Blue Jackets,1,1,0,0,2,20190430,1,1,1,1,3,1,2018,0,1,642,1
Sharks,2,0,2,0,4,Avalanche,0,1,1,0,2,20190430,2,1,2,2,6,-2,2018,0,1,927,1
Blues,1,0,1,0,2,Stars,2,2,0,0,4,20190501,1,3,2,2,6,2,2018,0,2,547,1
Islanders,1,1,0,0,2,Hurricanes,1,1,3,0,5,20190501,0,0,3,3,7,3,2018,0,2,423,1
Bruins,2,0,2,0,4,Blue Jackets,1,0,0,0,1,20190502,1,1,3,3,5,-3,2018,0,3,642,1
Sharks,0,0,0,0,0,Avalanche,0,1,2,0,3,20190502,0,1,3,3,3,3,2018,0,3,927,1
Islanders,1,0,1,0,2,Hurricanes,1,3,1,0,5,20190503,0,3,3,3,7,3,2018,0,4,423,1
Stars,1,1,0,0,2,Blues,0,0,1,0,1,20190503,1,2,1,1,3,-1,2018,0,4,547,1
Blue Jackets,0,0,3,0,3,Bruins,0,1,3,0,4,20190504,0,1,1,1,7,1,2018,0,5,642,1
Avalanche,0,1,0,0,1,Sharks,0,1,1,0,2,20190504,0,0,1,1,3,1,2018,0,5,927,1
Blues,1,1,2,0,4,Stars,1,0,0,0,1,20190505,0,1,3,3,5,-3,2018,0,6,547,1
Bruins,0,1,2,0,3,Blue Jackets,0,0,0,0,0,20190506,0,1,3,3,3,-3,2018,0,0,642,1
Sharks,0,2,1,0,3,Avalanche,0,2,1,1,4,20190506,0,0,0,1,7,1,2018,1,0,927,1
Stars,1,0,0,0,1,Blues,1,0,0,1,2,20190507,0,0,0,1,3,1,2018,1,1,547,1
Avalanche,1,0,1,0,2,Sharks,2,1,0,0,3,20190508,1,2,1,1,5,1,2018,0,2,927,1
Hurricanes,1,1,0,0,2,Bruins,1,0,4,0,5,20190509,0,-1,3,3,7,3,2018,0,3,609,1
Blues,1,1,1,0,3,Sharks,2,3,1,0,6,20190511,1,3,3,3,9,3,2018,0,5,1719,1
Hurricanes,0,0,2,0,2,Bruins,2,2,2,0,6,20190512,2,4,4,4,8,4,2018,0,6,609,1
Blues,1,2,1,0,4,Sharks,0,2,0,0,2,20190513,1,1,2,2,6,-2,2018,0,0,1719,1
Bruins,0,2,0,0,2,Hurricanes,0,1,0,0,1,20190514,0,1,1,1,3,-1,2018,0,1,609,1
Sharks,2,1,1,1,5,Blues,0,4,0,0,4,20190515,2,-1,0,1,9,-1,2018,1,2,1719,1
Bruins,0,2,2,0,4,Hurricanes,0,0,0,0,0,20190516,0,2,4,4,4,-4,2018,0,3,609,1
Sharks,0,0,1,0,1,Blues,2,0,0,0,2,20190517,2,2,1,1,3,1,2018,0,4,1719,1
Blues,1,2,2,0,5,Sharks,0,0,0,0,0,20190519,1,3,5,5,5,-5,2018,0,6,1719,1
Sharks,0,1,0,0,1,Blues,2,1,2,0,5,20190521,2,2,4,4,6,4,2018,0,1,1719,1
Blues,1,1,0,0,2,Bruins,0,2,2,0,4,20190527,-1,0,2,2,6,2,2018,0,0,1035,1
Blues,2,0,0,1,3,Bruins,2,0,0,0,2,20190529,0,0,0,1,5,-1,2018,1,2,1035,1
Bruins,3,2,2,0,7,Blues,0,1,1,0,2,20190601,3,4,5,5,9,-5,2018,0,5,1035,1
Bruins,1,1,0,0,2,Blues,2,0,2,0,4,20190603,1,0,2,2,6,2,2018,0,0,1035,1
Blues,0,1,1,0,2,Bruins,0,0,1,0,1,20190606,0,1,1,1,3,-1,2018,0,3,1035,1
Bruins,1,0,4,0,5,Blues,0,0,1,0,1,20190609,1,1,4,4,6,-4,2018,0,6,1035,1
Blues,2,0,2,0,4,Bruins,0,0,1,0,1,20190612,2,2,3,3,5,-3,2018,0,2,1035,1
Senators,1,1,1,0,3,Maple Leafs,0,4,1,0,5,20191002,-1,2,2,2,8,2,2019,0,2,203,1
Capitals,1,1,0,1,3,Blues,2,0,0,0,2,20191002,-1,0,0,1,5,-1,2019,1,2,708,1
Canucks,0,1,1,0,2,Oilers,1,0,2,0,3,20191002,1,0,1,1,5,1,2019,0,2,514,1
Sharks,1,0,0,0,1,Golden Knights,2,1,1,0,4,20191002,1,2,3,3,5,3,2019,0,2,382,1
Flames,1,2,0,0,3,Avalanche,2,2,1,0,5,20191003,1,1,2,2,8,2,2019,0,3,898,1
Coyotes,0,1,0,0,1,Ducks,1,1,0,0,2,20191003,1,1,1,1,3,1,2019,0,3,356,1
Bruins,2,0,0,0,2,Stars,0,1,0,0,1,20191003,2,1,1,1,3,-1,2019,0,3,1548,1
Jets,1,2,1,0,4,Rangers,1,2,3,0,6,20191003,0,0,2,2,10,2,2019,0,3,1287,1
Panthers,0,1,1,0,2,Lightning,1,1,3,0,5,20191003,1,1,3,3,7,3,2019,0,3,205,1
Sabres,1,2,0,0,3,Penguins,0,1,0,0,1,20191003,1,2,2,2,4,-2,2019,0,3,178,1
Canadiens,0,3,0,0,3,Hurricanes,1,1,1,1,4,20191003,1,-1,0,1,7,1,2019,1,3,727,1
Wild,0,2,0,0,2,Predators,0,1,4,0,5,20191003,0,-1,3,3,7,3,2019,0,3,696,1
Blackhawks,1,1,1,0,3,Flyers,1,2,1,0,4,20191004,0,1,1,1,7,1,2019,0,4,664,1
Maple Leafs,1,1,2,0,4,Blue Jackets,0,1,0,0,1,20191004,1,1,3,3,5,-3,2019,0,4,313,1
Jets,0,1,3,1,5,Devils,1,3,0,0,4,20191004,-1,-3,0,1,9,-1,2019,1,4,1280,1
Capitals,1,1,0,0,2,Islanders,1,0,0,0,1,20191004,0,1,1,1,3,-1,2019,0,4,204,1
Golden Knights,2,2,1,0,5,Sharks,0,0,1,0,1,20191004,2,4,4,4,6,-4,2019,0,4,382,1
Wild,1,1,0,0,2,Avalanche,2,1,1,0,4,20191005,1,1,2,2,6,2,2019,0,5,698,1
Sharks,0,1,0,0,1,Ducks,1,2,0,0,3,20191005,1,2,2,2,4,2,2019,0,5,305,1
Kings,3,0,2,0,5,Oilers,2,1,3,0,6,20191005,-1,0,1,1,11,1,2019,0,5,1368,1
Canucks,0,0,0,0,0,Flames,1,1,1,0,3,20191005,1,2,3,3,3,3,2019,0,5,426,1
Bruins,1,0,0,0,1,Coyotes,0,0,0,0,0,20191005,1,1,1,1,1,-1,2019,0,5,2295,1
Rangers,1,2,1,0,4,Senators,1,0,0,0,1,20191005,0,2,3,3,5,-3,2019,0,5,334,1
Stars,1,1,0,0,2,Blues,1,0,2,0,3,20191005,0,-1,1,1,5,1,2019,0,5,547,1
Blue Jackets,0,1,1,0,2,Penguins,0,5,2,0,7,20191005,0,4,5,5,9,5,2019,0,5,161,1
Canadiens,1,0,4,1,6,Maple Leafs,2,1,2,0,5,20191005,-1,-2,0,1,11,-1,2019,1,5,303,1
Hurricanes,0,0,2,1,3,Capitals,1,1,0,0,2,20191005,-1,-2,0,1,5,-1,2019,1,5,233,1
Lightning,0,1,2,0,3,Panthers,0,3,1,0,4,20191005,0,2,1,1,7,1,2019,0,5,205,1
Devils,0,1,1,0,2,Sabres,2,3,2,0,7,20191005,2,4,5,5,9,5,2019,0,5,284,1
Red Wings,2,0,3,0,5,Predators,0,2,1,0,3,20191005,2,0,2,2,8,-2,2019,0,5,470,1
Lightning,3,0,0,0,3,Hurricanes,1,1,1,1,4,20191006,-2,-1,0,1,7,1,2019,1,6,585,1
Stars,2,0,1,0,3,Red Wings,0,2,2,0,4,20191006,-2,0,1,1,7,1,2019,0,6,999,1
Jets,0,1,0,0,1,Islanders,0,3,1,0,4,20191006,0,2,3,3,5,3,2019,0,6,1287,1
Blues,0,2,1,0,3,Maple Leafs,0,2,0,0,2,20191007,0,0,1,1,5,-1,2019,0,0,659,1
Sabres,0,2,1,0,3,Blue Jackets,2,0,1,1,4,20191007,2,0,0,1,7,1,2019,1,0,293,1
Bruins,2,2,0,0,4,Golden Knights,2,0,1,0,3,20191008,0,2,1,1,7,-1,2019,0,1,2369,1
Kings,2,1,0,1,4,Flames,0,2,1,0,3,20191008,2,1,0,1,7,-1,2019,1,1,1197,1
Sharks,0,1,1,0,2,Predators,1,1,3,0,5,20191008,1,1,3,3,7,3,2019,0,1,1934,1
Stars,0,1,2,1,4,Capitals,1,1,1,0,3,20191008,-1,-1,0,1,7,-1,2019,1,1,1181,1
Jets,2,2,0,0,4,Penguins,1,0,0,0,1,20191008,1,3,3,3,5,-3,2019,0,1,1060,1
Oilers,2,2,1,0,5,Islanders,1,0,1,0,2,20191008,1,3,3,3,7,-3,2019,0,1,2024,1
Hurricanes,4,1,1,0,6,Panthers,0,1,2,0,3,20191008,4,4,3,3,9,-3,2019,0,1,696,1
Ducks,0,0,3,0,3,Red Wings,0,1,0,0,1,20191008,0,-1,2,2,4,-2,2019,0,1,1979,1
Canadiens,2,0,2,0,4,Sabres,1,2,1,1,5,20191009,-1,1,0,1,9,1,2019,1,2,311,1
Devils,0,0,0,0,0,Flyers,0,1,3,0,4,20191009,0,1,4,4,4,4,2019,0,2,75,1
Kings,0,1,1,0,2,Canucks,2,2,4,0,8,20191009,2,3,6,6,10,6,2019,0,2,1076,1
Golden Knights,1,0,0,0,1,Coyotes,2,2,0,0,4,20191010,1,3,3,3,5,3,2019,0,3,256,1
Bruins,2,0,0,0,2,Avalanche,1,1,2,0,4,20191010,-1,0,2,2,6,2,2019,0,3,1765,1
Sharks,2,2,1,0,5,Blackhawks,2,2,0,0,4,20191010,0,0,1,1,9,-1,2019,0,3,1837,1
Capitals,1,3,1,0,5,Predators,1,1,4,0,6,20191010,0,-2,1,1,11,1,2019,0,3,566,1
Flames,0,0,2,1,3,Stars,0,1,1,0,2,20191010,0,-1,0,1,5,-1,2019,1,3,1536,1
Blues,0,2,4,0,6,Senators,2,1,1,0,4,20191010,-2,-1,2,2,10,-2,2019,0,3,860,1
Red Wings,2,1,1,0,4,Canadiens,1,1,0,0,2,20191010,1,1,2,2,6,-2,2019,0,3,508,1
Lightning,4,1,2,0,7,Maple Leafs,3,0,0,0,3,20191010,1,2,4,4,10,-4,2019,0,3,1096,1
Wild,1,0,1,0,2,Jets,0,2,3,0,5,20191010,-1,1,3,3,7,3,2019,0,3,388,1
Ducks,0,1,0,0,1,Penguins,0,1,1,0,2,20191010,0,0,1,1,3,1,2019,0,3,2132,1
Oilers,1,1,1,1,4,Devils,1,1,1,0,3,20191010,0,0,0,1,7,-1,2019,1,3,2016,1
Panthers,0,0,2,0,2,Sabres,0,1,1,1,3,20191011,0,1,0,1,5,1,2019,1,4,1184,1
Ducks,0,2,0,0,2,Blue Jackets,0,1,0,0,1,20191011,0,1,1,1,3,-1,2019,0,4,1973,1
Islanders,1,1,0,0,2,Hurricanes,2,2,1,0,5,20191011,1,2,3,3,7,3,2019,0,4,423,1
Oilers,0,1,3,0,4,Rangers,1,0,0,0,1,20191012,-1,0,3,3,5,-3,2019,0,5,2024,1
Coyotes,0,0,2,0,2,Avalanche,0,0,2,1,3,20191012,0,0,0,1,5,1,2019,1,5,585,1
Penguins,1,4,2,0,7,Wild,0,2,2,0,4,20191012,1,3,3,3,11,-3,2019,0,5,741,1
Capitals,1,1,2,0,4,Stars,0,0,1,0,1,20191012,1,2,3,3,5,-3,2019,0,5,1181,1
Jets,0,1,1,1,3,Blackhawks,2,0,0,0,2,20191012,-2,-1,0,1,5,-1,2019,1,5,722,1
Flames,0,2,0,0,2,Golden Knights,1,3,2,0,6,20191012,1,2,4,4,8,4,2019,0,5,1033,1
Panthers,1,0,1,0,2,Islanders,0,2,0,1,3,20191012,-1,1,0,1,5,1,2019,1,5,1091,1
Lightning,0,1,1,0,2,Senators,0,2,2,0,4,20191012,0,1,2,2,6,2,2019,0,5,1251,1
Blue Jackets,1,1,1,0,3,Hurricanes,1,1,0,0,2,20191012,0,0,1,1,5,-1,2019,0,5,374,1
Predators,1,0,3,0,4,Kings,2,2,3,0,7,20191012,1,3,3,3,11,3,2019,0,5,1776,1
Flyers,0,1,1,0,2,Canucks,1,1,0,1,3,20191012,1,1,0,1,5,1,2019,1,5,2404,1
Devils,0,0,0,0,0,Bruins,2,1,0,0,3,20191012,2,3,3,3,3,3,2019,0,5,196,1
Blues,1,2,0,0,3,Canadiens,2,1,3,0,6,20191012,1,0,3,3,9,3,2019,0,5,962,1
Maple Leafs,1,1,3,0,5,Red Wings,1,0,1,0,2,20191012,0,1,3,3,7,-3,2019,0,5,205,1
Penguins,1,3,3,0,7,Jets,1,1,0,0,2,20191013,0,2,5,5,9,-5,2019,0,6,1060,1
Golden Knights,2,2,1,0,5,Kings,1,0,1,0,2,20191013,1,3,3,3,7,-3,2019,0,6,228,1
Flames,0,1,0,0,1,Sharks,2,1,0,0,3,20191013,2,2,2,2,4,2,2019,0,6,1027,1
Wild,0,0,2,0,2,Senators,0,0,0,0,0,20191014,0,0,2,2,2,-2,2019,0,0,838,1
Panthers,1,2,3,0,6,Devils,2,2,0,0,4,20191014,-1,-1,2,2,10,-2,2019,0,0,1090,1
Blues,1,0,1,0,2,Islanders,0,0,2,1,3,20191014,-1,-1,0,1,5,1,2019,1,0,871,1
Stars,0,0,0,0,0,Sabres,0,2,2,0,4,20191014,0,2,4,4,4,4,2019,0,0,1197,1
Avalanche,4,0,2,0,6,Capitals,0,2,1,0,3,20191014,4,2,3,3,9,-3,2019,0,0,1489,1
Oilers,0,0,1,0,1,Blackhawks,0,1,2,0,3,20191014,0,1,2,2,4,2,2019,0,0,1437,1
Ducks,0,1,1,0,2,Bruins,1,1,2,0,4,20191014,1,1,2,2,6,2,2019,0,0,2590,1
Hurricanes,0,1,1,0,2,Kings,0,0,0,0,0,20191015,0,1,2,2,2,-2,2019,0,1,2231,1
Predators,1,3,1,0,5,Golden Knights,2,0,0,0,2,20191015,-1,2,3,3,7,-3,2019,0,1,1575,1
Flyers,0,0,1,0,1,Flames,1,1,1,0,3,20191015,1,2,2,2,4,2,2019,0,1,2003,1
Coyotes,1,3,0,0,4,Jets,1,0,1,0,2,20191015,0,3,2,2,6,-2,2019,0,1,1365,1
Lightning,1,2,0,0,3,Canadiens,1,0,0,0,1,20191015,0,2,2,2,4,-2,2019,0,1,1311,1
Wild,1,0,1,0,2,Maple Leafs,0,4,0,0,4,20191015,-1,3,2,2,6,2,2019,0,1,691,1
Red Wings,1,0,0,0,1,Canucks,1,3,1,0,5,20191015,0,3,4,4,6,4,2019,0,1,1967,1
Avalanche,1,0,1,0,2,Penguins,1,1,0,1,3,20191016,0,1,0,1,5,1,2019,1,2,1317,1
Maple Leafs,2,0,1,0,3,Capitals,1,3,0,0,4,20191016,-1,2,1,1,7,1,2019,0,2,349,1
Stars,1,0,1,0,2,Blue Jackets,2,0,1,0,3,20191016,1,1,1,1,5,1,2019,0,2,912,1
Flyers,1,0,2,0,3,Oilers,2,3,1,0,6,20191016,1,4,3,3,9,3,2019,0,2,2011,1
Sabres,2,0,0,0,2,Ducks,1,3,1,0,5,20191016,-1,2,3,3,7,3,2019,0,2,2193,1
Hurricanes,1,0,1,0,2,Sharks,3,1,1,0,5,20191016,2,3,3,3,7,3,2019,0,2,2382,1
Sabres,2,1,0,0,3,Kings,0,0,0,0,0,20191017,2,3,3,3,3,-3,2019,0,3,2193,1
Senators,1,0,1,0,2,Golden Knights,2,0,0,1,3,20191017,1,1,0,1,5,1,2019,1,3,2119,1
Red Wings,0,1,0,0,1,Flames,1,1,3,0,5,20191017,1,1,4,4,6,4,2019,0,3,1573,1
Predators,0,1,1,0,2,Coyotes,2,1,2,0,5,20191017,2,2,3,3,7,3,2019,0,3,1442,1
Canucks,0,2,1,1,4,Blues,1,2,0,0,3,20191017,-1,-1,0,1,7,-1,2019,1,3,1778,1
Rangers,1,0,1,0,2,Devils,1,2,2,0,5,20191017,0,2,3,3,7,3,2019,0,3,8,1
Wild,0,0,0,0,0,Canadiens,3,0,1,0,4,20191017,3,3,4,4,4,4,2019,0,3,938,1
Lightning,1,1,1,1,4,Bruins,1,1,1,0,3,20191017,0,0,0,1,7,-1,2019,1,3,1183,1
Islanders,0,2,1,0,3,Jets,1,0,0,0,1,20191017,-1,1,2,2,4,-2,2019,0,3,1287,1
Avalanche,1,3,0,1,5,Panthers,3,1,0,0,4,20191018,-2,0,0,1,9,-1,2019,1,4,1724,1
Stars,0,1,1,0,2,Penguins,0,1,3,0,4,20191018,0,0,2,2,6,2,2019,0,4,1069,1
Rangers,1,1,0,0,2,Capitals,2,1,2,0,5,20191018,1,1,3,3,7,3,2019,0,4,204,1
Blue Jackets,0,1,1,0,2,Blackhawks,1,0,1,1,3,20191018,1,0,0,1,5,1,2019,1,4,275,1
Red Wings,0,1,0,0,1,Oilers,0,2,0,0,2,20191018,0,1,1,1,3,1,2019,0,4,1592,1
Hurricanes,0,2,0,0,2,Ducks,2,2,0,0,4,20191018,2,2,2,2,6,2,2019,0,4,2231,1
Sabres,1,1,2,0,4,Sharks,1,0,2,0,3,20191019,0,1,1,1,7,-1,2019,0,5,2279,1
Flames,0,0,1,0,1,Kings,1,3,0,0,4,20191019,1,4,3,3,5,3,2019,0,5,1197,1
Panthers,0,2,0,1,3,Predators,0,0,2,0,2,20191019,0,2,0,1,5,-1,2019,1,5,816,1
Islanders,2,0,0,1,3,Blue Jackets,1,1,0,0,2,20191019,1,0,0,1,5,-1,2019,1,5,476,1
Senators,0,0,2,0,2,Coyotes,2,1,2,0,5,20191019,2,3,3,3,7,3,2019,0,5,2071,1
Stars,2,0,2,0,4,Flyers,1,0,0,0,1,20191019,1,1,3,3,5,-3,2019,0,5,1297,1
Canucks,0,0,0,0,0,Devils,1,0,0,0,1,20191019,1,1,1,1,1,1,2019,0,5,2421,1
Canadiens,1,3,1,0,5,Blues,1,0,1,0,2,20191019,0,3,3,3,7,-3,2019,0,5,962,1
Golden Knights,0,1,2,0,3,Penguins,0,0,0,0,0,20191019,0,1,3,3,3,-3,2019,0,5,1915,1
Avalanche,1,3,2,0,6,Lightning,1,0,1,0,2,20191019,0,3,4,4,8,-4,2019,0,5,1521,1
Bruins,1,0,2,0,3,Maple Leafs,2,0,1,1,4,20191019,1,1,0,1,7,1,2019,1,5,430,1
Canucks,3,0,0,0,3,Rangers,0,1,1,0,2,20191020,3,2,1,1,5,-1,2019,0,6,2429,1
Canadiens,0,2,1,0,3,Wild,1,1,2,0,4,20191020,1,0,1,1,7,1,2019,0,6,938,1
Capitals,1,1,3,0,5,Blackhawks,0,1,2,0,3,20191020,1,1,2,2,8,-2,2019,0,6,594,1
Oilers,0,0,0,0,0,Jets,0,0,0,1,1,20191020,0,0,0,1,1,1,2019,1,6,738,1
Flames,0,1,1,0,2,Ducks,0,1,0,0,1,20191020,0,0,1,1,3,-1,2019,0,6,1197,1
Blue Jackets,2,0,1,1,4,Maple Leafs,2,1,0,0,3,20191021,0,-1,0,1,7,-1,2019,1,0,313,1
Golden Knights,0,0,2,0,2,Flyers,1,4,1,0,6,20191021,1,5,4,4,8,4,2019,0,0,2171,1
Avalanche,1,0,0,0,1,Blues,1,2,0,0,3,20191021,0,2,2,2,4,2,2019,0,0,794,1
Senators,0,0,1,0,1,Stars,1,1,0,0,2,20191021,1,2,1,1,3,1,2019,0,0,1404,1
Capitals,0,3,2,0,5,Flames,0,2,1,0,3,20191022,0,1,2,2,8,-2,2019,0,1,1967,1
Golden Knights,0,0,1,1,2,Blackhawks,1,0,0,0,1,20191022,-1,-1,0,1,3,-1,2019,1,1,1519,1
Kings,1,1,1,0,3,Jets,1,1,0,0,2,20191022,0,0,1,1,5,-1,2019,0,1,1527,1
Oilers,0,0,0,0,0,Wild,3,0,0,0,3,20191022,3,3,3,3,3,3,2019,0,1,1083,1
Coyotes,1,1,0,1,3,Rangers,0,2,0,0,2,20191022,1,0,0,1,5,-1,2019,1,1,2139,1
Canucks,0,0,5,0,5,Red Wings,1,1,0,0,2,20191022,-1,-2,3,3,7,-3,2019,0,1,1967,1
Penguins,0,1,1,0,2,Panthers,0,2,2,0,4,20191022,0,1,2,2,6,2,2019,0,1,1013,1
Maple Leafs,0,2,0,0,2,Bruins,1,1,2,0,4,20191022,1,0,2,2,6,2,2019,0,1,430,1
Ducks,0,0,1,0,1,Predators,2,2,2,0,6,20191022,2,4,5,5,7,5,2019,0,1,1776,1
Sharks,2,0,1,0,3,Sabres,0,2,1,1,4,20191022,-2,0,0,1,7,1,2019,1,1,2279,1
Red Wings,0,2,0,0,2,Senators,1,3,1,0,5,20191023,1,2,3,3,7,3,2019,0,2,406,1
Penguins,0,2,0,0,2,Lightning,1,0,2,0,3,20191023,1,-1,1,1,5,1,2019,0,2,874,1
Ducks,0,1,0,0,1,Stars,2,0,0,0,2,20191024,2,1,1,1,3,1,2019,0,3,1237,1
Capitals,0,3,0,0,3,Oilers,1,0,2,1,4,20191024,1,-2,0,1,7,1,2019,1,3,1985,1
Panthers,0,2,3,0,5,Flames,1,1,3,1,6,20191024,1,0,0,1,11,1,2019,1,3,2493,1
Flyers,1,1,2,0,4,Blackhawks,0,0,1,0,1,20191024,1,2,3,3,5,-3,2019,0,3,664,1
Kings,1,1,0,0,2,Blues,1,2,2,0,5,20191024,0,1,3,3,7,3,2019,0,3,1586,1
Hurricanes,3,0,0,0,3,Blue Jackets,1,2,0,1,4,20191024,-2,0,0,1,7,1,2019,1,3,374,1
Sabres,0,2,0,0,2,Rangers,3,1,2,0,6,20191024,3,2,4,4,8,4,2019,0,3,292,1
Coyotes,1,0,1,0,2,Islanders,1,1,2,0,4,20191024,0,1,2,2,6,2,2019,0,3,2139,1
Sharks,1,3,0,0,4,Canadiens,1,1,0,0,2,20191024,0,2,2,2,6,-2,2019,0,3,2508,1
Wild,0,0,0,0,0,Predators,0,2,2,0,4,20191024,0,2,4,4,4,4,2019,0,3,696,1
Avalanche,2,3,1,0,6,Golden Knights,1,0,0,0,1,20191025,1,4,5,5,7,-5,2019,0,4,604,1
Sharks,1,0,0,0,1,Maple Leafs,0,1,3,0,4,20191025,-1,0,3,3,5,3,2019,0,4,2249,1
Coyotes,1,2,2,0,5,Devils,2,1,0,0,3,20191025,-1,0,2,2,8,-2,2019,0,4,2131,1
Islanders,2,2,0,0,4,Senators,1,0,1,0,2,20191025,1,3,2,2,6,-2,2019,0,4,334,1
Sabres,0,1,1,0,2,Red Wings,0,0,0,0,0,20191025,0,1,2,2,2,-2,2019,0,4,215,1
Capitals,1,1,3,1,6,Canucks,2,3,0,0,5,20191025,-1,-3,0,1,11,-1,2019,1,4,2359,1
Flames,0,1,0,0,1,Jets,0,0,1,1,2,20191026,0,-1,0,1,3,1,2019,1,5,740,1
Ducks,2,1,2,0,5,Avalanche,0,1,1,0,2,20191026,2,2,3,3,7,-3,2019,0,5,830,1
Kings,0,1,0,0,1,Wild,1,1,3,0,5,20191026,1,1,4,4,6,4,2019,0,5,1521,1
Penguins,0,0,3,0,3,Stars,0,0,0,0,0,20191026,0,0,3,3,3,-3,2019,0,5,1069,1
Predators,1,0,1,1,3,Lightning,0,2,0,0,2,20191026,1,-1,0,1,5,-1,2019,1,5,621,1
Maple Leafs,1,1,0,0,2,Canadiens,2,0,3,0,5,20191026,1,0,3,3,7,3,2019,0,5,303,1
Blues,0,0,0,0,0,Bruins,1,1,1,0,3,20191026,1,2,3,3,3,3,2019,0,5,1035,1
Blackhawks,0,0,0,0,0,Hurricanes,1,1,2,0,4,20191026,1,2,4,4,4,4,2019,0,5,641,1
Blue Jackets,1,2,1,0,4,Flyers,1,1,5,0,7,20191026,0,-1,3,3,11,3,2019,0,5,414,1
Panthers,0,3,3,0,6,Oilers,0,0,2,0,2,20191027,0,3,4,4,8,-4,2019,0,6,2569,1
Blues,2,1,1,1,5,Red Wings,0,1,3,0,4,20191027,2,2,0,1,9,-1,2019,1,6,454,1
Sharks,1,1,0,0,2,Senators,2,2,1,0,5,20191027,1,2,3,3,7,3,2019,0,6,2408,1
Flyers,2,0,1,0,3,Islanders,3,2,0,0,5,20191027,1,3,2,2,8,2,2019,0,6,80,1
Bruins,0,4,3,0,7,Rangers,1,0,3,0,4,20191027,-1,3,3,3,11,-3,2019,0,6,190,1
Kings,0,0,1,0,1,Blackhawks,1,3,1,0,5,20191027,1,4,4,4,6,4,2019,0,6,1741,1
Ducks,1,0,1,0,2,Golden Knights,3,1,1,0,5,20191027,2,3,3,3,7,3,2019,0,6,228,1
Coyotes,1,1,0,1,3,Sabres,2,0,0,0,2,20191028,-1,0,0,1,5,-1,2019,1,0,1902,1
Panthers,1,1,0,0,2,Canucks,5,1,1,0,7,20191028,4,4,5,5,9,5,2019,0,0,2803,1
Wild,2,1,0,0,3,Stars,0,1,5,0,6,20191029,-2,-2,3,3,9,3,2019,0,1,863,1
Oilers,0,0,1,0,1,Red Wings,2,0,1,0,3,20191029,2,2,2,2,4,2,2019,0,1,1592,1
Jets,2,1,1,0,4,Ducks,1,4,2,0,7,20191029,-1,2,3,3,11,3,2019,0,1,1527,1
Flames,1,0,0,0,1,Hurricanes,0,0,2,0,2,20191029,-1,-1,1,1,3,1,2019,0,1,2038,1
Lightning,1,0,0,0,1,Rangers,0,1,3,0,4,20191029,-1,0,3,3,5,3,2019,0,1,1004,1
Sharks,0,1,0,0,1,Bruins,2,3,0,0,5,20191029,2,4,4,4,6,4,2019,0,1,2678,1
Blackhawks,0,0,0,0,0,Predators,1,1,1,0,3,20191029,1,2,3,3,3,3,2019,0,1,395,1
Flyers,0,0,1,0,1,Penguins,4,2,1,0,7,20191029,4,6,6,6,8,6,2019,0,1,257,1
Capitals,1,1,1,1,4,Maple Leafs,1,1,1,0,3,20191029,0,0,0,1,7,-1,2019,1,1,349,1
Canucks,2,1,2,0,5,Kings,1,1,1,0,3,20191030,1,1,2,2,8,-2,2019,0,2,1076,1
Canadiens,1,1,2,0,4,Coyotes,0,0,1,0,1,20191030,1,2,3,3,5,-3,2019,0,2,2175,1
Lightning,2,1,3,1,7,Devils,1,3,2,0,6,20191030,1,-1,0,1,13,-1,2019,1,2,1000,1
Wild,0,1,0,0,1,Blues,0,1,1,0,2,20191030,0,0,1,1,3,1,2019,0,2,466,1
Oilers,2,2,0,0,4,Blue Jackets,0,1,0,0,1,20191030,2,3,3,3,5,-3,2019,0,2,1703,1
Panthers,1,0,2,1,4,Avalanche,2,0,1,0,3,20191030,-1,-1,0,1,7,-1,2019,1,2,1724,1
Flames,1,0,4,1,6,Predators,2,2,1,0,5,20191031,-1,-3,0,1,11,-1,2019,1,3,1692,1
Canadiens,1,1,2,1,5,Golden Knights,2,0,2,0,4,20191031,-1,0,0,1,9,-1,2019,1,3,2221,1
Flyers,1,1,1,1,4,Devils,1,1,1,0,3,20191101,0,0,0,1,7,-1,2019,1,4,75,1
Lightning,0,1,1,0,2,Islanders,0,2,3,0,5,20191101,0,1,3,3,7,3,2019,0,4,1004,1
Sabres,0,1,0,0,1,Capitals,4,1,1,0,6,20191101,4,4,5,5,7,5,2019,0,4,292,1
Red Wings,1,2,0,0,3,Hurricanes,1,4,2,0,7,20191101,0,2,4,4,10,4,2019,0,4,511,1
Blue Jackets,1,2,0,0,3,Blues,1,2,0,1,4,20191101,0,0,0,1,7,1,2019,1,4,395,1
Stars,1,1,0,0,2,Avalanche,0,1,0,0,1,20191101,1,1,1,1,3,-1,2019,0,4,661,1
Canucks,0,0,1,0,1,Ducks,1,0,0,1,2,20191101,1,1,0,1,3,1,2019,1,4,1076,1
Jets,1,1,1,0,3,Sharks,0,1,1,0,2,20191101,1,1,1,1,5,-1,2019,0,4,1496,1
Blackhawks,2,0,1,0,3,Kings,2,0,1,1,4,20191102,0,0,0,1,7,1,2019,1,5,1741,1
Canucks,2,2,1,0,5,Sharks,0,0,2,0,2,20191102,2,4,3,3,7,-3,2019,0,5,821,1
Jets,1,0,2,1,4,Golden Knights,3,0,0,0,3,20191102,-2,-2,0,1,7,-1,2019,1,5,1303,1
Avalanche,0,0,0,0,0,Coyotes,2,1,0,0,3,20191102,2,3,3,3,3,3,2019,0,5,585,1
Blues,2,0,1,1,4,Wild,1,2,0,0,3,20191102,1,-1,0,1,7,-1,2019,1,5,466,1
Canadiens,0,0,1,0,1,Stars,1,1,2,0,4,20191102,1,2,3,3,5,3,2019,0,5,1505,1
Islanders,1,0,0,0,1,Sabres,0,0,0,0,0,20191102,1,1,1,1,1,-1,2019,0,5,292,1
Devils,2,1,2,0,5,Hurricanes,2,1,0,0,3,20191102,0,0,2,2,8,-2,2019,0,5,419,1
Maple Leafs,1,1,1,1,4,Flyers,1,1,1,0,3,20191102,0,0,0,1,7,-1,2019,1,5,334,1
Red Wings,0,0,0,0,0,Panthers,2,1,1,0,4,20191102,2,3,4,4,4,4,2019,0,5,1155,1
Rangers,1,1,0,0,2,Predators,0,1,0,0,1,20191102,1,1,1,1,3,-1,2019,0,5,758,1
Oilers,0,1,0,1,2,Penguins,0,0,1,0,1,20191102,0,1,0,1,3,-1,2019,1,5,1797,1
Flames,1,1,1,0,3,Blue Jackets,0,0,0,0,0,20191102,1,2,3,3,3,-3,2019,0,5,1670,1
Senators,1,1,0,0,2,Bruins,1,1,3,0,5,20191102,0,0,3,3,7,3,2019,0,5,320,1
Blackhawks,2,0,0,1,3,Ducks,0,1,1,0,2,20191103,2,1,0,1,5,-1,2019,1,6,1741,1
Flames,2,0,0,0,2,Capitals,2,1,1,0,4,20191103,0,1,2,2,6,2,2019,0,6,1967,1
Senators,2,3,1,0,6,Rangers,1,1,0,0,2,20191104,1,3,4,4,8,-4,2019,0,0,334,1
Predators,0,5,1,0,6,Red Wings,1,0,0,0,1,20191104,-1,4,5,5,7,-5,2019,0,0,470,1
Coyotes,1,1,0,1,3,Oilers,1,0,1,0,2,20191104,0,1,0,1,5,-1,2019,1,0,1392,1
Penguins,0,4,0,0,4,Bruins,2,1,3,0,6,20191104,2,-1,2,2,10,2,2019,0,0,481,1
Senators,1,0,0,0,1,Islanders,1,1,2,0,4,20191105,0,1,3,3,5,3,2019,0,1,334,1
Hurricanes,0,1,0,0,1,Flyers,1,0,3,0,4,20191105,1,0,3,3,5,3,2019,0,1,345,1
Golden Knights,1,1,0,0,2,Blue Jackets,0,1,0,0,1,20191105,1,1,1,1,3,-1,2019,0,1,1757,1
Bruins,1,2,1,0,4,Canadiens,3,1,1,0,5,20191105,2,1,1,1,9,1,2019,0,1,270,1
Kings,0,1,0,0,1,Maple Leafs,0,1,2,0,3,20191105,0,0,2,2,4,2,2019,0,1,2170,1
Devils,1,0,0,1,2,Jets,0,1,0,0,1,20191105,1,0,0,1,3,-1,2019,1,1,1280,1
Avalanche,1,0,0,0,1,Stars,2,1,1,0,4,20191105,1,2,3,3,5,3,2019,0,1,661,1
Coyotes,1,1,1,0,3,Flames,0,1,2,1,4,20191105,-1,-1,0,1,7,1,2019,1,1,1224,1
Blues,0,1,0,1,2,Canucks,0,0,1,0,1,20191105,0,1,0,1,3,-1,2019,1,1,1778,1
Wild,0,1,3,0,4,Ducks,0,2,0,0,2,20191105,0,-1,2,2,6,-2,2019,0,1,1521,1
Blackhawks,0,0,2,0,2,Sharks,0,2,2,0,4,20191105,0,2,2,2,6,2,2019,0,1,1837,1
Red Wings,0,1,0,0,1,Rangers,0,3,2,0,5,20191106,0,2,4,4,6,4,2019,0,2,480,1
Blues,1,2,2,0,5,Oilers,1,0,1,0,2,20191106,0,2,3,3,7,-3,2019,0,2,1508,1
Capitals,1,2,1,1,5,Panthers,2,2,0,0,4,20191107,-1,-1,0,1,9,-1,2019,1,3,924,1
Penguins,0,0,3,1,4,Islanders,1,2,0,0,3,20191107,-1,-3,0,1,7,-1,2019,1,3,314,1
Canadiens,0,1,1,0,2,Flyers,1,1,0,1,3,20191107,1,1,0,1,5,1,2019,1,3,400,1
Rangers,1,1,2,0,4,Hurricanes,0,1,1,0,2,20191107,1,1,2,2,6,-2,2019,0,3,423,1
Kings,0,1,1,0,2,Senators,0,1,1,1,3,20191107,0,0,0,1,5,1,2019,1,3,2345,1
Canucks,0,1,1,0,2,Blackhawks,2,0,3,0,5,20191107,2,1,3,3,7,3,2019,0,3,1775,1
Predators,1,2,1,0,4,Avalanche,2,6,1,0,9,20191107,1,5,5,5,13,5,2019,0,3,1019,1
Devils,1,1,0,0,2,Flames,0,4,1,0,5,20191107,-1,2,3,3,7,3,2019,0,3,2015,1
Blue Jackets,1,1,1,0,3,Coyotes,1,1,0,0,2,20191107,0,0,1,1,5,-1,2019,0,3,1664,1
Wild,0,2,3,0,5,Sharks,4,2,0,0,6,20191107,4,4,1,1,11,1,2019,0,3,1570,1
Golden Knights,0,0,1,0,1,Maple Leafs,0,0,1,1,2,20191107,0,0,0,1,3,1,2019,1,3,1946,1
Devils,0,0,0,0,0,Oilers,0,3,1,0,4,20191108,0,3,4,4,4,4,2019,0,4,2016,1
Canucks,0,1,0,0,1,Jets,0,2,2,0,4,20191108,0,1,3,3,5,3,2019,0,4,1157,1
Lightning,2,0,1,0,3,Sabres,0,1,1,0,2,20191108,2,1,1,1,5,-1,2019,0,4,1051,1
Bruins,1,1,0,0,2,Red Wings,2,1,1,0,4,20191108,1,1,2,2,6,2,2019,0,4,611,1
Predators,0,1,0,0,1,Sharks,0,0,1,1,2,20191109,0,-1,0,1,3,1,2019,1,5,1934,1
Blues,1,1,0,1,3,Flames,0,0,2,0,2,20191109,1,2,0,1,5,-1,2019,1,5,1440,1
Blue Jackets,2,0,0,0,2,Avalanche,1,2,1,0,4,20191109,-1,1,2,2,6,2,2019,0,5,1163,1
Wild,0,3,1,0,4,Coyotes,2,1,0,0,3,20191109,-2,0,1,1,7,-1,2019,0,5,1278,1
Panthers,0,0,1,0,1,Islanders,1,0,1,0,2,20191109,1,1,1,1,3,1,2019,0,5,1091,1
Blackhawks,0,2,0,0,2,Penguins,0,1,1,1,3,20191109,0,-1,0,1,5,1,2019,1,5,409,1
Golden Knights,1,1,0,0,2,Capitals,2,1,2,0,5,20191109,1,1,3,3,7,3,2019,0,5,2080,1
Flyers,2,0,0,1,3,Maple Leafs,0,1,1,0,2,20191109,2,1,0,1,5,-1,2019,1,5,334,1
Sabres,1,0,2,0,3,Lightning,1,2,2,0,5,20191109,0,2,2,2,8,2,2019,0,5,1051,1
Hurricanes,0,1,0,0,1,Senators,3,0,1,0,4,20191109,3,2,3,3,5,3,2019,0,5,673,1
Kings,0,1,1,0,2,Canadiens,3,0,0,0,3,20191109,3,2,1,1,5,1,2019,0,5,2448,1
Panthers,2,2,1,1,6,Rangers,1,4,0,0,5,20191110,1,-1,0,1,11,-1,2019,1,6,1091,1
Stars,0,2,0,0,2,Jets,1,0,1,1,3,20191110,1,-1,0,1,5,1,2019,1,6,1183,1
Devils,2,0,0,0,2,Canucks,0,1,0,0,1,20191110,2,1,1,1,3,-1,2019,0,6,2421,1
Golden Knights,1,1,0,0,2,Red Wings,1,0,2,0,3,20191110,0,-1,1,1,5,1,2019,0,6,1757,1
Flyers,2,0,0,1,3,Bruins,0,0,2,0,2,20191110,2,2,0,1,5,-1,2019,1,6,270,1
Maple Leafs,1,0,3,0,4,Blackhawks,4,0,1,0,5,20191110,3,3,1,1,9,1,2019,0,6,436,1
Oilers,2,2,2,0,6,Ducks,1,0,1,0,2,20191110,1,3,4,4,8,-4,2019,0,6,1368,1
Senators,0,1,1,0,2,Hurricanes,2,3,3,0,8,20191111,2,4,6,6,10,6,2019,0,0,673,1
Coyotes,1,2,0,1,4,Capitals,0,1,2,0,3,20191111,1,2,0,1,7,-1,2019,1,0,1977,1
Penguins,0,2,0,0,2,Rangers,2,0,0,1,3,20191112,2,0,0,1,5,1,2019,1,1,314,1
Coyotes,0,1,1,1,3,Blues,1,1,0,0,2,20191112,-1,-1,0,1,5,-1,2019,1,1,1270,1
Avalanche,1,0,3,0,4,Jets,0,0,0,0,0,20191112,1,1,4,4,4,-4,2019,0,1,797,1
Predators,0,1,2,0,3,Canucks,0,1,4,0,5,20191112,0,0,2,2,8,2,2019,0,1,2030,1
Red Wings,0,2,1,1,4,Ducks,0,3,0,0,3,20191112,0,-1,0,1,7,-1,2019,1,1,1979,1
Wild,0,1,0,0,1,Kings,1,1,1,0,3,20191112,1,1,2,2,4,2,2019,0,1,1521,1
Oilers,0,1,2,0,3,Sharks,3,2,1,0,6,20191112,3,4,3,3,9,3,2019,0,1,1190,1
Panthers,0,0,4,1,5,Bruins,0,4,0,0,4,20191112,0,-4,0,1,9,-1,2019,1,1,1257,1
Blue Jackets,1,0,1,0,2,Canadiens,0,0,2,1,3,20191112,-1,-1,0,1,5,1,2019,1,1,605,1
Blackhawks,1,2,2,0,5,Golden Knights,2,0,1,0,3,20191113,-1,1,2,2,8,-2,2019,0,2,1519,1
Stars,0,1,2,0,3,Flames,0,0,1,0,1,20191113,0,1,2,2,4,-2,2019,0,2,1536,1
Maple Leafs,0,2,2,0,4,Islanders,2,1,2,0,5,20191113,2,1,1,1,9,1,2019,0,2,341,1
Capitals,1,0,0,1,2,Flyers,0,0,1,0,1,20191113,1,1,0,1,3,-1,2019,1,2,123,1
Senators,1,0,3,0,4,Devils,2,0,0,0,2,20191113,-1,-1,2,2,6,-2,2019,0,2,330,1
Red Wings,0,1,1,0,2,Kings,1,0,1,1,3,20191114,1,0,0,1,5,1,2019,1,3,1979,1
Sharks,1,1,3,0,5,Ducks,1,1,1,0,3,20191114,0,0,2,2,8,-2,2019,0,3,305,1
Stars,1,2,1,0,4,Canucks,0,2,0,0,2,20191114,1,1,2,2,6,-2,2019,0,3,1766,1
Jets,0,1,3,0,4,Panthers,0,1,2,0,3,20191114,0,0,1,1,7,-1,2019,0,3,1899,1
Coyotes,0,1,1,0,2,Wild,1,0,2,0,3,20191114,1,0,1,1,5,1,2019,0,3,1278,1
Rangers,1,0,2,0,3,Lightning,4,4,1,0,9,20191114,3,7,6,6,12,6,2019,0,3,1004,1
Hurricanes,2,1,1,1,5,Sabres,1,1,2,0,4,20191114,1,1,0,1,9,-1,2019,1,3,491,1
Avalanche,1,1,0,0,2,Oilers,4,2,0,0,6,20191114,3,4,4,4,8,4,2019,0,3,1036,1
Bruins,1,0,3,0,4,Maple Leafs,0,1,1,0,2,20191115,1,0,2,2,6,-2,2019,0,4,430,1
Penguins,0,0,1,0,1,Devils,1,1,0,0,2,20191115,1,2,1,1,3,1,2019,0,4,306,1
Canadiens,0,4,1,0,5,Capitals,0,0,2,0,2,20191115,0,4,3,3,7,-3,2019,0,4,495,1
Blues,1,1,0,0,2,Blue Jackets,1,0,1,1,3,20191115,0,-1,0,1,5,1,2019,1,4,395,1
Flyers,1,0,0,0,1,Senators,0,2,0,0,2,20191115,-1,1,1,1,3,1,2019,0,4,373,1
Red Wings,0,2,1,0,3,Sharks,1,2,0,1,4,20191116,1,1,0,1,7,1,2019,1,5,2071,1
Avalanche,1,2,1,1,5,Canucks,1,1,2,0,4,20191116,0,1,0,1,9,-1,2019,1,5,1105,1
Blackhawks,2,2,3,0,7,Predators,0,0,2,0,2,20191116,2,4,5,5,9,-5,2019,0,5,395,1
Ducks,2,1,1,0,4,Blues,0,1,0,0,1,20191116,2,2,3,3,5,-3,2019,0,5,1586,1
Maple Leafs,0,1,0,0,1,Penguins,2,3,1,0,6,20191116,2,4,5,5,7,5,2019,0,5,222,1
Islanders,0,0,3,1,4,Flyers,2,1,0,0,3,20191116,-2,-3,0,1,7,-1,2019,1,5,80,1
Capitals,1,0,1,1,3,Bruins,1,1,0,0,2,20191116,0,-1,0,1,5,-1,2019,1,5,394,1
Devils,1,1,1,1,4,Canadiens,1,2,0,0,3,20191116,0,-1,0,1,7,-1,2019,1,5,342,1
Senators,0,1,1,0,2,Sabres,0,2,2,0,4,20191116,0,1,2,2,6,2,2019,0,5,219,1
Golden Knights,0,3,0,0,3,Kings,2,1,1,0,4,20191116,2,0,1,1,7,1,2019,0,5,228,1
Flames,0,0,0,0,0,Coyotes,0,2,1,0,3,20191116,0,2,3,3,3,3,2019,0,5,1224,1
Jets,1,2,1,0,4,Lightning,1,0,2,0,3,20191116,0,2,1,1,7,-1,2019,0,5,1705,1
Hurricanes,2,1,0,1,4,Wild,0,3,0,0,3,20191116,2,0,0,1,7,-1,2019,1,5,995,1
Rangers,2,1,0,0,3,Panthers,2,2,0,0,4,20191116,0,1,1,1,7,1,2019,0,5,1091,1
Stars,1,1,2,1,5,Oilers,2,2,0,0,4,20191116,-1,-2,0,1,9,-1,2019,1,5,1655,1
Sabres,0,0,1,0,1,Blackhawks,1,1,2,0,4,20191117,1,2,3,3,5,3,2019,0,6,453,1
Flames,0,0,0,0,0,Golden Knights,1,1,4,0,6,20191117,1,2,6,6,6,6,2019,0,6,1033,1
Ducks,0,0,2,0,2,Capitals,1,2,2,0,5,20191118,1,3,3,3,7,3,2019,0,0,2294,1
Kings,0,0,0,0,0,Coyotes,2,1,0,0,3,20191118,2,3,3,3,3,3,2019,0,0,356,1
Wild,2,1,1,0,4,Sabres,0,0,1,0,1,20191119,2,3,3,3,5,-3,2019,0,1,729,1
Oilers,3,1,1,0,5,Sharks,1,0,1,0,2,20191119,2,3,3,3,7,-3,2019,0,1,1190,1
Maple Leafs,0,0,2,0,2,Golden Knights,0,1,3,0,4,20191119,0,1,2,2,6,2,2019,0,1,1946,1
Avalanche,2,1,0,0,3,Flames,0,1,1,0,2,20191119,2,2,1,1,5,-1,2019,0,1,898,1
Canucks,0,1,0,0,1,Stars,1,2,3,0,6,20191119,1,2,5,5,7,5,2019,0,1,1766,1
Hurricanes,1,2,1,0,4,Blackhawks,0,0,2,0,2,20191119,1,3,2,2,6,-2,2019,0,1,641,1
Flyers,1,1,0,0,2,Panthers,2,2,1,0,5,20191119,1,2,3,3,7,3,2019,0,1,1021,1
Lightning,1,0,0,0,1,Blues,0,1,2,0,3,20191119,-1,0,2,2,4,2,2019,0,1,861,1
Bruins,2,0,3,0,5,Devils,0,1,0,0,1,20191119,2,1,4,4,6,-4,2019,0,1,196,1
Islanders,0,2,2,1,5,Penguins,2,1,1,0,4,20191119,-2,-1,0,1,9,-1,2019,1,1,314,1
Jets,1,1,0,0,2,Predators,0,1,0,0,1,20191119,1,1,1,1,3,-1,2019,0,1,1084,1
Senators,1,3,0,0,4,Red Wings,2,0,1,0,3,20191119,-1,2,1,1,7,-1,2019,0,1,406,1
Canadiens,1,1,0,0,2,Blue Jackets,1,1,3,0,5,20191119,0,0,3,3,7,3,2019,0,1,605,1
Senators,0,1,0,1,2,Canadiens,0,1,0,0,1,20191120,0,0,0,1,3,-1,2019,1,2,104,1
Capitals,0,0,1,0,1,Rangers,0,1,3,0,4,20191120,0,1,3,3,5,3,2019,0,2,204,1
Oilers,0,1,0,0,1,Kings,3,1,1,0,5,20191121,3,3,4,4,6,4,2019,0,3,1368,1
Sharks,0,1,0,1,2,Golden Knights,0,0,1,0,1,20191121,0,1,0,1,3,-1,2019,1,3,382,1
Jets,0,1,2,0,3,Stars,0,3,2,0,5,20191121,0,2,2,2,8,2,2019,0,3,1183,1
Avalanche,0,2,0,0,2,Wild,0,2,1,0,3,20191121,0,0,1,1,5,1,2019,0,3,698,1
Maple Leafs,1,1,1,0,3,Coyotes,0,0,1,0,1,20191121,1,2,2,2,4,-2,2019,0,3,1885,1
Flames,0,0,0,0,0,Blues,1,2,2,0,5,20191121,1,3,5,5,5,5,2019,0,3,1440,1
Red Wings,1,2,1,0,4,Blue Jackets,1,1,3,0,5,20191121,0,-1,1,1,9,1,2019,0,3,163,1
Flyers,2,1,2,0,5,Hurricanes,2,0,1,0,3,20191121,0,1,2,2,8,-2,2019,0,3,345,1
Penguins,1,1,1,0,3,Islanders,1,1,1,1,4,20191121,0,0,0,1,7,1,2019,1,3,314,1
Ducks,1,3,0,0,4,Panthers,0,2,2,1,5,20191121,-1,-2,0,1,9,1,2019,1,3,2335,1
Sabres,1,0,1,0,2,Bruins,1,1,1,0,3,20191121,0,1,1,1,5,1,2019,0,3,399,1
Canucks,2,3,1,0,6,Predators,1,1,1,0,3,20191121,1,3,3,3,9,-3,2019,0,3,2030,1
Lightning,1,0,3,0,4,Blackhawks,0,0,2,0,2,20191121,1,1,2,2,6,-2,2019,0,3,1004,1
Devils,0,1,0,0,1,Penguins,1,1,2,0,4,20191122,1,1,3,3,5,3,2019,0,4,306,1
Rangers,1,0,0,0,1,Senators,2,2,0,0,4,20191122,1,3,3,3,5,3,2019,0,4,334,1
Blue Jackets,1,2,0,0,3,Jets,1,2,1,0,4,20191123,0,0,1,1,7,1,2019,0,5,975,1
Islanders,0,1,0,0,1,Sharks,0,1,0,1,2,20191123,0,0,0,1,3,1,2019,1,5,2549,1
Oilers,2,1,1,0,4,Golden Knights,1,1,0,0,2,20191123,1,1,2,2,6,-2,2019,0,5,1204,1
Blackhawks,1,0,0,0,1,Stars,1,0,0,1,2,20191123,0,0,0,1,3,1,2019,1,5,802,1
Predators,3,0,1,0,4,Blues,1,0,1,0,2,20191123,2,2,2,2,6,-2,2019,0,5,253,1
Maple Leafs,4,0,1,0,5,Avalanche,1,1,1,0,3,20191123,3,2,2,2,8,-2,2019,0,5,1341,1
Panthers,2,0,0,0,2,Hurricanes,2,1,1,0,4,20191123,0,1,2,2,6,2,2019,0,5,696,1
Ducks,1,1,0,0,2,Lightning,1,3,2,0,6,20191123,0,2,4,4,8,4,2019,0,5,2149,1
Canucks,1,0,0,1,2,Capitals,1,0,0,0,1,20191123,0,0,0,1,3,-1,2019,1,5,2359,1
Red Wings,0,1,0,0,1,Devils,0,1,4,0,5,20191123,0,0,4,4,6,4,2019,0,5,471,1
Flames,0,0,2,1,3,Flyers,0,1,1,0,2,20191123,0,-1,0,1,5,-1,2019,1,5,2003,1
Wild,1,2,1,0,4,Bruins,0,2,2,1,5,20191123,-1,-1,0,1,9,1,2019,1,5,1120,1
Rangers,0,3,3,0,6,Canadiens,3,1,1,0,5,20191123,-3,-1,1,1,11,-1,2019,0,5,343,1
Coyotes,1,1,1,0,3,Kings,0,1,1,0,2,20191123,1,1,1,1,5,-1,2019,0,5,356,1
Sabres,2,2,1,0,5,Panthers,0,1,1,0,2,20191124,2,3,3,3,7,-3,2019,0,6,1184,1
Hurricanes,0,1,1,0,2,Red Wings,0,0,0,0,0,20191124,0,1,2,2,2,-2,2019,0,6,511,1
Oilers,1,1,1,1,4,Coyotes,1,2,0,0,3,20191124,0,-1,0,1,7,-1,2019,1,6,1392,1
Sharks,1,2,0,1,4,Kings,0,1,2,0,3,20191125,1,2,0,1,7,-1,2019,1,0,305,1
Golden Knights,0,1,1,0,2,Stars,2,1,1,0,4,20191125,2,2,2,2,6,2,2019,0,0,1068,1
Islanders,0,0,0,0,0,Ducks,0,1,2,0,3,20191125,0,1,3,3,3,3,2019,0,0,2445,1
Flames,1,1,0,0,2,Penguins,1,1,0,1,3,20191125,0,0,0,1,5,1,2019,1,0,1777,1
Canucks,1,0,0,0,1,Flyers,0,1,1,0,2,20191125,-1,0,1,1,3,1,2019,0,0,2404,1
Wild,0,1,1,0,2,Rangers,1,0,1,1,3,20191125,1,0,0,1,5,1,2019,1,0,1016,1
Sabres,1,1,0,0,2,Lightning,1,2,2,0,5,20191125,0,1,3,3,7,3,2019,0,0,1051,1
Senators,0,0,0,0,0,Blue Jackets,0,0,1,0,1,20191125,0,0,1,1,1,1,2019,0,0,512,1
Blues,0,1,1,0,2,Predators,2,0,0,1,3,20191125,2,1,0,1,5,1,2019,1,0,253,1
Bruins,3,3,2,0,8,Canadiens,1,0,0,0,1,20191126,2,5,7,7,9,-7,2019,0,1,270,1
Wild,1,1,1,0,3,Devils,1,1,0,0,2,20191126,0,0,1,1,5,-1,2019,0,1,1007,1
Stars,0,0,0,0,0,Blackhawks,1,0,2,0,3,20191126,1,1,3,3,3,3,2019,0,1,802,1
Golden Knights,1,1,1,1,4,Predators,0,2,1,0,3,20191127,1,0,0,1,7,-1,2019,1,2,1575,1
Jets,2,2,1,0,5,Sharks,1,0,0,0,1,20191127,1,3,4,4,6,-4,2019,0,2,1496,1
Islanders,1,0,0,0,1,Kings,1,1,2,0,4,20191127,0,1,3,3,5,3,2019,0,2,2445,1
Oilers,1,0,0,0,1,Avalanche,0,1,3,0,4,20191127,-1,0,3,3,5,3,2019,0,2,1036,1
Ducks,1,1,1,0,3,Coyotes,2,0,1,1,4,20191127,1,0,0,1,7,1,2019,1,2,356,1
Flyers,1,2,0,0,3,Blue Jackets,2,0,0,0,2,20191127,-1,1,1,1,5,-1,2019,0,2,414,1
Canucks,1,3,2,0,6,Penguins,2,0,6,0,8,20191127,1,-2,2,2,14,2,2019,0,2,2168,1
Panthers,0,2,1,0,3,Capitals,1,1,2,0,4,20191127,1,0,1,1,7,1,2019,0,2,924,1
Bruins,0,0,2,0,2,Senators,0,0,1,0,1,20191127,0,0,1,1,3,-1,2019,0,2,320,1
Flames,1,0,1,1,3,Sabres,0,1,1,0,2,20191127,1,0,0,1,5,-1,2019,1,2,1731,1
Blues,0,2,2,0,4,Lightning,0,2,1,0,3,20191127,0,0,1,1,7,-1,2019,0,2,861,1
Hurricanes,0,2,0,0,2,Rangers,3,0,0,0,3,20191127,3,1,1,1,5,1,2019,0,2,423,1
Maple Leafs,3,3,0,0,6,Red Wings,0,0,0,0,0,20191127,3,6,6,6,6,-6,2019,0,2,205,1
Devils,2,2,2,0,6,Canadiens,1,2,1,0,4,20191128,1,1,2,2,10,-2,2019,0,3,342,1
Blues,1,0,2,0,3,Stars,0,0,1,0,1,20191129,1,1,2,2,4,-2,2019,0,4,547,1
Predators,2,1,0,0,3,Hurricanes,0,0,0,0,0,20191129,2,3,3,3,3,-3,2019,0,4,456,1
Penguins,1,0,1,0,2,Blue Jackets,1,3,1,0,5,20191129,0,3,3,3,7,3,2019,0,4,161,1
Lightning,1,2,0,0,3,Capitals,0,1,2,1,4,20191129,-1,-2,0,1,7,1,2019,1,4,818,1
Coyotes,0,1,0,0,1,Golden Knights,0,1,0,1,2,20191129,0,0,0,1,3,1,2019,1,4,256,1
Jets,0,2,1,0,3,Ducks,0,0,0,0,0,20191129,0,2,3,3,3,-3,2019,0,4,1527,1
Senators,1,1,0,0,2,Wild,0,3,4,0,7,20191129,-1,1,5,5,9,5,2019,0,4,838,1
Avalanche,3,2,0,0,5,Blackhawks,1,1,0,0,2,20191129,2,3,3,3,7,-3,2019,0,4,916,1
Red Wings,1,0,0,0,1,Flyers,2,1,3,0,6,20191129,1,2,5,5,7,5,2019,0,4,441,1
Maple Leafs,1,1,2,0,4,Sabres,0,4,2,0,6,20191129,-1,2,2,2,10,2,2019,0,4,57,1
Rangers,1,1,0,0,2,Bruins,0,1,1,1,3,20191129,-1,-1,0,1,5,1,2019,1,4,190,1
Kings,0,0,1,0,1,Sharks,2,2,0,0,4,20191129,2,4,3,3,5,3,2019,0,4,305,1
Sharks,1,2,1,0,4,Coyotes,2,0,0,0,2,20191130,-1,1,2,2,6,-2,2019,0,5,614,1
Jets,0,0,1,0,1,Kings,2,0,0,0,2,20191130,2,2,1,1,3,1,2019,0,5,1527,1
Canucks,2,2,1,0,5,Oilers,1,1,0,0,2,20191130,1,2,3,3,7,-3,2019,0,5,514,1
Blackhawks,1,1,1,0,3,Avalanche,3,4,0,0,7,20191130,2,5,4,4,10,4,2019,0,5,916,1
Penguins,0,1,1,0,2,Blues,1,1,3,0,5,20191130,1,1,3,3,7,3,2019,0,5,557,1
Sabres,0,0,1,0,1,Maple Leafs,0,1,0,1,2,20191130,0,1,0,1,3,1,2019,1,5,57,1
Blue Jackets,0,0,0,0,0,Islanders,1,1,0,0,2,20191130,1,2,2,2,2,2,2019,0,5,476,1
Predators,0,0,0,0,0,Panthers,0,1,2,0,3,20191130,0,1,3,3,3,3,2019,0,5,816,1
Hurricanes,3,0,0,0,3,Lightning,0,0,2,0,2,20191130,3,3,1,1,5,-1,2019,0,5,585,1
Capitals,0,2,3,0,5,Red Wings,1,0,1,0,2,20191130,-1,1,3,3,7,-3,2019,0,5,394,1
Flyers,0,2,1,1,4,Canadiens,1,1,1,0,3,20191130,-1,0,0,1,7,-1,2019,1,5,400,1
Rangers,1,0,3,0,4,Devils,0,0,0,0,0,20191130,1,1,4,4,4,-4,2019,0,5,8,1
Senators,0,0,1,0,1,Flames,1,0,2,0,3,20191130,1,1,2,2,4,2,2019,0,5,1773,1
Stars,0,1,1,0,2,Wild,0,1,1,1,3,20191201,0,0,0,1,5,1,2019,1,6,863,1
Canadiens,1,0,0,0,1,Bruins,0,0,3,0,3,20191201,-1,-1,2,2,4,2,2019,0,6,270,1
Oilers,1,1,1,0,3,Canucks,1,1,0,0,2,20191201,0,0,1,1,5,-1,2019,0,6,514,1
Kings,0,2,0,0,2,Ducks,2,1,1,0,4,20191202,2,1,2,2,6,2,2019,0,0,0,1
Devils,0,1,0,0,1,Sabres,5,2,0,0,7,20191202,5,6,6,6,8,6,2019,0,0,284,1
Islanders,2,1,1,0,4,Red Wings,0,1,0,0,1,20191202,2,2,3,3,5,-3,2019,0,0,480,1
Golden Knights,2,2,0,0,4,Rangers,0,1,0,0,1,20191202,2,3,3,3,5,-3,2019,0,0,2227,1
Blues,2,0,2,0,4,Blackhawks,0,0,0,0,0,20191202,2,2,4,4,4,-4,2019,0,0,260,1
Hurricanes,0,0,0,0,0,Bruins,0,0,2,0,2,20191203,0,0,2,2,2,2,2019,0,1,609,1
Islanders,0,0,2,0,2,Canadiens,1,1,2,0,4,20191203,1,2,2,2,6,2,2019,0,1,343,1
Wild,0,2,2,0,4,Panthers,2,0,0,0,2,20191203,-2,0,2,2,6,-2,2019,0,1,1513,1
Golden Knights,0,1,3,0,4,Devils,1,1,1,0,3,20191203,-1,-1,1,1,7,-1,2019,0,1,2218,1
Maple Leafs,0,0,1,0,1,Flyers,0,1,5,0,6,20191203,0,1,5,5,7,5,2019,0,1,334,1
Coyotes,1,2,1,0,4,Blue Jackets,0,1,1,0,2,20191203,1,2,2,2,6,-2,2019,0,1,1664,1
Lightning,1,1,0,1,3,Predators,0,1,1,0,2,20191203,1,1,0,1,5,-1,2019,1,1,621,1
Stars,0,1,0,0,1,Jets,1,3,1,0,5,20191203,1,3,4,4,6,4,2019,0,1,1183,1
Senators,0,1,1,0,2,Canucks,4,0,1,0,5,20191203,4,3,3,3,7,3,2019,0,1,2191,1
Capitals,3,2,0,0,5,Sharks,1,0,1,0,2,20191203,2,4,3,3,7,-3,2019,0,1,2416,1
Capitals,2,0,1,0,3,Kings,0,0,1,0,1,20191204,2,2,2,2,4,-2,2019,0,2,2294,1
Senators,0,3,2,0,5,Oilers,1,1,0,0,2,20191204,-1,1,3,3,7,-3,2019,0,2,1754,1
Avalanche,0,1,2,0,3,Maple Leafs,0,1,0,0,1,20191204,0,0,2,2,4,-2,2019,0,2,1341,1
Blues,0,0,0,0,0,Penguins,1,1,1,0,3,20191204,1,2,3,3,3,3,2019,0,2,557,1
Blackhawks,2,0,1,1,4,Bruins,0,0,3,0,3,20191205,2,2,0,1,7,-1,2019,1,3,849,1
Avalanche,2,1,0,0,3,Canadiens,0,1,1,0,2,20191205,2,2,1,1,5,-1,2019,0,3,1618,1
Wild,3,1,1,0,5,Lightning,2,1,1,0,4,20191205,1,1,1,1,9,-1,2019,0,3,1318,1
Golden Knights,0,1,1,0,2,Islanders,0,1,1,1,3,20191205,0,0,0,1,5,1,2019,1,3,2227,1
Coyotes,1,0,2,0,3,Flyers,0,0,1,0,1,20191205,1,1,2,2,4,-2,2019,0,3,2078,1
Sharks,1,1,0,0,2,Hurricanes,1,1,0,1,3,20191205,0,0,0,1,5,1,2019,1,3,2382,1
Rangers,1,2,0,0,3,Blue Jackets,1,0,1,0,2,20191205,0,2,1,1,5,-1,2019,0,3,476,1
Jets,0,0,2,0,2,Stars,1,1,0,1,3,20191205,1,2,0,1,5,1,2019,1,3,1183,1
Sabres,1,0,2,0,3,Flames,1,2,1,0,4,20191205,0,2,1,1,7,1,2019,0,3,1731,1
Kings,0,0,1,0,1,Oilers,2,0,0,0,2,20191206,2,2,1,1,3,1,2019,0,4,1368,1
Capitals,1,1,1,0,3,Ducks,0,1,1,0,2,20191206,1,1,1,1,5,-1,2019,0,4,2294,1
Blackhawks,0,1,0,1,2,Devils,1,0,0,0,1,20191206,-1,0,0,1,3,-1,2019,1,4,703,1
Coyotes,0,0,0,0,0,Penguins,0,0,2,0,2,20191206,0,0,2,2,2,2,2019,0,4,1824,1
Canadiens,1,0,1,0,2,Rangers,0,1,0,0,1,20191206,1,0,1,1,3,-1,2019,0,4,343,1
Kings,2,0,1,0,3,Flames,1,2,1,0,4,20191207,-1,1,1,1,7,1,2019,0,5,1197,1
Islanders,0,0,1,0,1,Stars,2,1,0,0,3,20191207,2,3,2,2,4,2,2019,0,5,1370,1
Devils,2,1,1,0,4,Predators,2,2,2,0,6,20191207,0,1,2,2,10,2,2019,0,5,750,1
Maple Leafs,4,1,0,0,5,Blues,1,0,1,0,2,20191207,3,4,3,3,7,-3,2019,0,5,659,1
Sabres,0,3,2,0,5,Canucks,1,2,2,1,6,20191207,1,0,0,1,11,1,2019,1,5,2137,1
Blue Jackets,0,0,1,0,1,Panthers,1,1,2,0,4,20191207,1,2,3,3,5,3,2019,0,5,993,1
Sharks,0,0,1,0,1,Lightning,1,2,4,0,7,20191207,1,3,6,6,8,6,2019,0,5,2365,1
Penguins,2,1,2,0,5,Red Wings,0,1,2,0,3,20191207,2,2,2,2,8,-2,2019,0,5,205,1
Avalanche,1,2,1,0,4,Bruins,1,0,0,0,1,20191207,0,2,3,3,5,-3,2019,0,5,1765,1
Senators,1,1,1,0,3,Flyers,2,0,2,0,4,20191207,1,0,1,1,7,1,2019,0,5,373,1
Wild,1,1,0,0,2,Hurricanes,2,2,2,0,6,20191207,1,2,4,4,8,4,2019,0,5,995,1
Ducks,1,0,1,0,2,Jets,1,1,1,0,3,20191208,0,1,1,1,5,1,2019,0,6,1527,1
Sharks,1,0,0,0,1,Panthers,2,1,2,0,5,20191208,1,2,4,4,6,4,2019,0,6,2558,1
Coyotes,1,2,0,1,4,Blackhawks,3,0,0,0,3,20191208,-2,0,0,1,7,-1,2019,1,6,1450,1
Rangers,2,2,1,0,5,Golden Knights,0,0,0,0,0,20191208,2,4,5,5,5,-5,2019,0,6,2227,1
Sabres,2,0,0,1,3,Oilers,0,2,0,0,2,20191208,2,0,0,1,5,-1,2019,1,6,1734,1
Flames,0,2,2,1,5,Avalanche,1,1,2,0,4,20191209,-1,0,0,1,9,-1,2019,1,0,898,1
Islanders,0,2,3,0,5,Lightning,0,1,0,0,1,20191209,0,1,4,4,6,-4,2019,0,0,1004,1
Blue Jackets,1,1,3,0,5,Capitals,0,0,2,0,2,20191209,1,2,3,3,7,-3,2019,0,0,326,1
Bruins,1,0,1,0,2,Senators,2,1,2,0,5,20191209,1,2,3,3,7,3,2019,0,0,320,1
Canadiens,0,3,1,0,4,Penguins,1,0,0,0,1,20191210,-1,2,3,3,5,-3,2019,0,1,474,1
Blues,1,0,1,0,2,Sabres,1,1,3,0,5,20191210,0,1,3,3,7,3,2019,0,1,660,1
Sharks,0,0,1,0,1,Predators,0,0,3,0,3,20191210,0,0,2,2,4,2,2019,0,1,1934,1
Ducks,2,0,0,1,3,Wild,0,1,1,0,2,20191210,2,1,0,1,5,-1,2019,1,1,1521,1
Red Wings,0,1,0,0,1,Jets,1,3,1,0,5,20191210,1,3,4,4,6,4,2019,0,1,855,1
Devils,0,0,0,0,0,Stars,2,0,0,0,2,20191210,2,2,2,2,2,2,2019,0,1,1362,1
Hurricanes,3,0,3,0,6,Oilers,0,1,2,0,3,20191210,3,2,3,3,9,-3,2019,0,1,2076,1
Flames,2,2,1,0,5,Coyotes,0,1,1,0,2,20191210,2,3,3,3,7,-3,2019,0,1,1224,1
Maple Leafs,0,2,2,0,4,Canucks,0,0,1,0,1,20191210,0,2,3,3,5,-3,2019,0,1,2090,1
Blackhawks,0,0,1,0,1,Golden Knights,0,3,2,0,5,20191210,0,3,4,4,6,4,2019,0,1,1519,1
Rangers,0,0,1,0,1,Kings,1,1,1,0,3,20191210,1,2,2,2,4,2,2019,0,1,2445,1
Lightning,1,1,0,0,2,Panthers,0,0,1,0,1,20191210,1,2,1,1,3,-1,2019,0,1,205,1
Bruins,1,0,1,0,2,Capitals,0,2,1,0,3,20191211,-1,1,1,1,5,1,2019,0,2,394,1
Flyers,0,0,1,0,1,Avalanche,1,1,1,0,3,20191211,1,2,2,2,4,2,2019,0,2,1574,1
Senators,0,0,2,0,2,Canadiens,1,0,1,1,3,20191211,1,1,0,1,5,1,2019,1,2,104,1
Predators,2,1,0,0,3,Sabres,1,2,1,0,4,20191212,-1,0,1,1,7,1,2019,0,3,626,1
Rangers,0,2,4,0,6,Sharks,1,1,1,0,3,20191212,-1,0,3,3,9,-3,2019,0,3,2549,1
Hurricanes,0,0,0,0,0,Canucks,0,0,0,1,1,20191212,0,0,0,1,1,1,2019,1,3,2409,1
Blackhawks,0,1,1,0,2,Coyotes,3,1,1,0,5,20191212,3,3,3,3,7,3,2019,0,3,1450,1
Maple Leafs,1,1,0,0,2,Flames,1,0,3,0,4,20191212,0,-1,2,2,6,2,2019,0,3,1682,1
Kings,1,1,0,0,2,Ducks,0,0,1,0,1,20191212,1,2,1,1,3,-1,2019,0,3,0,1
Golden Knights,2,0,0,0,2,Blues,1,3,0,0,4,20191212,-1,2,2,2,6,2,2019,0,3,1375,1
Jets,0,2,0,0,2,Red Wings,2,2,1,0,5,20191212,2,2,3,3,7,3,2019,0,3,855,1
Blue Jackets,0,0,0,0,0,Penguins,0,0,0,1,1,20191212,0,0,0,1,1,1,2019,1,3,161,1
Islanders,0,2,1,0,3,Panthers,0,1,0,0,1,20191212,0,1,2,2,4,-2,2019,0,3,1091,1
Bruins,1,0,1,0,2,Lightning,0,1,2,0,3,20191212,-1,0,1,1,5,1,2019,0,3,1183,1
Oilers,1,1,3,0,5,Wild,2,2,2,0,6,20191212,1,2,1,1,11,1,2019,0,3,1083,1
Golden Knights,0,2,0,1,3,Stars,1,0,1,0,2,20191213,-1,1,0,1,5,-1,2019,1,4,1068,1
Devils,0,0,1,0,1,Avalanche,1,1,1,0,3,20191213,1,2,2,2,4,2,2019,0,4,1618,1
Flyers,1,0,0,0,1,Wild,2,1,1,0,4,20191214,1,2,3,3,5,3,2019,0,5,983,1
Canucks,0,0,2,0,2,Sharks,1,0,3,0,4,20191214,1,1,2,2,6,2,2019,0,5,821,1
Devils,1,0,1,0,2,Coyotes,1,0,0,0,1,20191214,0,0,1,1,3,-1,2019,0,5,2131,1
Blackhawks,0,1,2,0,3,Blues,0,0,4,0,4,20191214,0,-1,1,1,7,1,2019,0,5,260,1
Maple Leafs,1,1,2,0,4,Oilers,0,0,1,0,1,20191214,1,2,3,3,5,-3,2019,0,5,1683,1
Kings,2,0,2,0,4,Penguins,0,2,2,1,5,20191214,-2,0,0,1,9,1,2019,1,5,2132,1
Sabres,0,1,1,0,2,Islanders,1,0,1,1,3,20191214,1,0,0,1,5,1,2019,1,5,292,1
Capitals,1,0,4,0,5,Lightning,0,1,1,0,2,20191214,1,0,3,3,7,-3,2019,0,5,818,1
Red Wings,1,0,1,0,2,Canadiens,0,0,1,0,1,20191214,1,1,1,1,3,-1,2019,0,5,508,1
Stars,0,4,0,0,4,Predators,0,1,0,0,1,20191214,0,3,3,3,5,-3,2019,0,5,616,1
Rangers,2,0,1,0,3,Ducks,1,1,1,1,4,20191214,-1,0,0,1,7,1,2019,1,5,2445,1
Hurricanes,0,2,2,0,4,Flames,0,0,0,0,0,20191214,0,2,4,4,4,-4,2019,0,5,2038,1
Blue Jackets,1,0,2,0,3,Senators,2,1,0,1,4,20191214,1,2,0,1,7,1,2019,1,5,512,1
Bruins,1,2,1,0,4,Panthers,0,0,2,0,2,20191214,1,3,2,2,6,-2,2019,0,5,1257,1
Canucks,1,0,2,0,3,Golden Knights,2,2,2,0,6,20191215,1,3,3,3,9,3,2019,0,6,986,1
Wild,1,2,0,0,3,Blackhawks,2,1,2,0,5,20191215,1,0,2,2,8,2,2019,0,6,355,1
Flyers,0,2,1,0,3,Jets,2,4,1,0,7,20191215,2,4,4,4,10,4,2019,0,6,1273,1
Kings,1,2,1,0,4,Red Wings,0,0,2,0,2,20191215,1,3,2,2,6,-2,2019,0,6,1979,1
Oilers,2,0,0,0,2,Stars,0,0,1,0,1,20191216,2,2,1,1,3,-1,2019,0,0,1655,1
Senators,0,1,0,0,1,Panthers,1,5,0,0,6,20191216,1,5,5,5,7,5,2019,0,0,1370,1
Capitals,0,0,0,0,0,Blue Jackets,1,0,2,0,3,20191216,1,1,3,3,3,3,2019,0,0,326,1
Predators,1,2,2,0,5,Rangers,1,0,1,0,2,20191216,0,2,3,3,7,-3,2019,0,0,758,1
Avalanche,0,2,0,0,2,Blues,1,2,2,0,5,20191216,1,1,3,3,7,3,2019,0,0,794,1
Wild,1,0,1,0,2,Golden Knights,0,2,1,0,3,20191217,-1,1,1,1,5,1,2019,0,1,1293,1
Canadiens,0,1,2,0,3,Canucks,1,0,0,0,1,20191217,-1,0,2,2,4,-2,2019,0,1,2273,1
Penguins,0,2,2,0,4,Flames,1,0,0,0,1,20191217,-1,1,3,3,5,-3,2019,0,1,1777,1
Hurricanes,1,4,1,0,6,Jets,1,1,1,0,3,20191217,0,3,3,3,9,-3,2019,0,1,1350,1
Coyotes,1,1,1,0,3,Sharks,1,1,0,0,2,20191217,0,0,1,1,5,-1,2019,0,1,614,1
Ducks,0,1,0,0,1,Flyers,0,2,2,0,4,20191217,0,1,3,3,5,3,2019,0,1,2388,1
Predators,1,4,3,0,8,Islanders,0,3,0,0,3,20191217,1,2,5,5,11,-5,2019,0,1,758,1
Senators,1,2,0,0,3,Lightning,2,1,0,1,4,20191217,1,0,0,1,7,1,2019,1,1,1251,1
Kings,1,1,1,1,4,Bruins,1,1,1,0,3,20191217,0,0,0,1,7,-1,2019,1,1,2590,1
Blue Jackets,2,1,2,0,5,Red Wings,2,1,0,0,3,20191217,0,0,2,2,8,-2,2019,0,1,163,1
Sabres,0,0,3,0,3,Maple Leafs,1,2,2,0,5,20191217,1,3,2,2,8,2,2019,0,1,57,1
Avalanche,1,2,1,0,4,Blackhawks,1,0,0,0,1,20191218,0,2,3,3,5,-3,2019,0,2,916,1
Ducks,1,0,0,0,1,Devils,0,2,1,0,3,20191218,-1,1,2,2,4,2,2019,0,2,2436,1
Oilers,0,0,1,0,1,Blues,0,1,1,0,2,20191218,0,1,1,1,3,1,2019,0,2,1508,1
Islanders,0,2,0,1,3,Bruins,1,0,1,0,2,20191219,-1,1,0,1,5,-1,2019,1,3,190,1
Stars,1,1,1,1,4,Lightning,2,1,0,0,3,20191219,-1,-1,0,1,7,-1,2019,1,3,916,1
Kings,1,1,0,0,2,Blue Jackets,1,0,1,1,3,20191219,0,-1,0,1,5,1,2019,1,3,1973,1
Predators,1,0,3,0,4,Senators,0,3,1,1,5,20191219,-1,2,0,1,9,1,2019,1,3,845,1
Blackhawks,1,0,3,0,4,Jets,0,0,1,0,1,20191219,1,1,3,3,5,-3,2019,0,3,722,1
Hurricanes,0,0,3,0,3,Avalanche,0,0,1,0,1,20191219,0,0,2,2,4,-2,2019,0,3,1459,1
Canadiens,0,2,1,1,4,Flames,2,0,1,0,3,20191219,-2,0,0,1,7,-1,2019,1,3,1852,1
Wild,0,4,4,0,8,Coyotes,1,1,3,0,5,20191219,-1,2,3,3,13,-3,2019,0,3,1278,1
Golden Knights,1,2,1,0,4,Canucks,3,0,1,1,5,20191219,2,0,0,1,9,1,2019,1,3,986,1
Sabres,0,0,1,0,1,Flyers,3,3,0,0,6,20191219,3,6,5,5,7,5,2019,0,3,279,1
Penguins,2,1,2,0,5,Oilers,0,2,0,0,2,20191220,2,1,3,3,7,-3,2019,0,4,1797,1
Maple Leafs,2,1,3,0,6,Rangers,2,1,0,0,3,20191220,0,0,3,3,9,-3,2019,0,4,341,1
Stars,1,1,2,0,4,Panthers,2,5,0,0,7,20191220,1,5,3,3,11,3,2019,0,4,1110,1
Capitals,2,1,3,0,6,Devils,1,1,1,0,3,20191220,1,1,3,3,9,-3,2019,0,4,198,1
Kings,0,1,1,0,2,Sabres,0,2,1,0,3,20191221,0,1,1,1,5,1,2019,0,5,2193,1
Blues,0,2,3,0,5,Sharks,0,2,0,0,2,20191221,0,0,3,3,7,-3,2019,0,5,1719,1
Blackhawks,0,1,4,0,5,Avalanche,1,2,0,0,3,20191221,-1,-2,2,2,8,-2,2019,0,5,916,1
Canadiens,1,1,1,0,3,Oilers,2,1,1,0,4,20191221,1,1,1,1,7,1,2019,0,5,1826,1
Devils,1,0,0,0,1,Blue Jackets,2,1,2,0,5,20191221,1,2,4,4,6,4,2019,0,5,467,1
Penguins,0,1,0,0,1,Canucks,2,1,1,0,4,20191221,2,2,3,3,5,3,2019,0,5,2168,1
Lightning,0,0,1,0,1,Capitals,0,1,2,0,3,20191221,0,1,2,2,4,2,2019,0,5,818,1
Flyers,1,2,1,1,5,Senators,0,3,1,0,4,20191221,1,0,0,1,9,-1,2019,1,5,373,1
Red Wings,0,0,1,0,1,Maple Leafs,0,1,3,0,4,20191221,0,1,3,3,5,3,2019,0,5,205,1
Predators,0,1,2,1,4,Bruins,0,2,1,0,3,20191221,0,-1,0,1,7,-1,2019,1,5,941,1
Jets,2,1,3,0,6,Wild,0,0,0,0,0,20191221,2,3,6,6,6,-6,2019,0,5,388,1
Ducks,2,2,1,1,6,Islanders,2,2,1,0,5,20191221,0,0,0,1,11,-1,2019,1,5,2445,1
Panthers,1,1,2,0,4,Hurricanes,0,0,2,0,2,20191221,1,2,2,2,6,-2,2019,0,5,696,1
Ducks,1,0,0,0,1,Rangers,3,1,1,0,5,20191222,2,3,4,4,6,4,2019,0,6,2445,1
Coyotes,2,1,2,0,5,Red Wings,0,0,2,0,2,20191222,2,3,3,3,7,-3,2019,0,6,1687,1
Flames,1,2,2,0,5,Stars,1,0,0,0,1,20191222,0,2,4,4,6,-4,2019,0,6,1536,1
Golden Knights,0,1,2,0,3,Sharks,0,0,1,0,1,20191222,0,1,2,2,4,-2,2019,0,6,382,1
Devils,1,4,2,0,7,Blackhawks,1,0,0,0,1,20191223,0,4,6,6,8,-6,2019,0,0,703,1
Blues,4,0,0,0,4,Kings,1,0,0,0,1,20191223,3,3,3,3,5,-3,2019,0,0,1586,1
Avalanche,3,2,2,0,7,Golden Knights,1,1,1,0,3,20191223,2,3,4,4,10,-4,2019,0,0,604,1
Oilers,1,1,0,0,2,Canucks,1,0,3,0,4,20191223,0,-1,2,2,6,2,2019,0,0,514,1
Canadiens,2,3,1,0,6,Jets,1,1,0,0,2,20191223,1,3,4,4,8,-4,2019,0,0,1115,1
Hurricanes,2,3,1,0,6,Maple Leafs,3,0,5,0,8,20191223,1,-2,2,2,14,2,2019,0,0,544,1
Sabres,0,1,0,0,1,Senators,1,0,2,0,3,20191223,1,0,2,2,4,2,2019,0,0,219,1
Rangers,0,1,0,0,1,Flyers,0,1,4,0,5,20191223,0,0,4,4,6,4,2019,0,0,80,1
Blue Jackets,0,2,1,0,3,Islanders,1,1,0,0,2,20191223,-1,0,1,1,5,-1,2019,0,0,476,1
Panthers,0,1,0,0,1,Lightning,3,2,1,0,6,20191223,3,4,5,5,7,5,2019,0,0,205,1
Capitals,0,1,2,0,3,Bruins,4,1,2,0,7,20191223,4,4,4,4,10,4,2019,0,0,394,1
Flames,0,0,0,0,0,Wild,0,2,1,0,3,20191223,0,2,3,3,3,3,2019,0,0,1043,1
Coyotes,0,1,1,0,2,Predators,1,1,1,0,3,20191223,1,1,1,1,5,1,2019,0,0,1442,1
Flames,2,2,1,0,5,Oilers,1,0,0,0,1,20191227,1,3,4,4,6,-4,2019,0,4,171,1
Kings,0,0,2,1,3,Sharks,0,2,0,0,2,20191227,0,-2,0,1,5,-1,2019,1,4,305,1
Golden Knights,0,1,2,0,3,Ducks,0,3,1,0,4,20191227,0,2,1,1,7,1,2019,0,4,228,1
Islanders,1,0,1,0,2,Blackhawks,3,0,2,0,5,20191227,2,2,3,3,7,3,2019,0,4,711,1
Blue Jackets,0,1,0,0,1,Capitals,0,0,1,1,2,20191227,0,-1,0,1,3,1,2019,1,4,326,1
Blues,1,2,1,1,5,Jets,1,1,2,0,4,20191227,0,1,0,1,9,-1,2019,1,4,853,1
Penguins,3,2,0,0,5,Predators,1,0,1,0,2,20191227,2,4,3,3,7,-3,2019,0,4,471,1
Bruins,1,1,1,0,3,Sabres,0,0,0,0,0,20191227,1,2,3,3,3,-3,2019,0,4,399,1
Hurricanes,1,1,1,0,3,Rangers,1,3,1,0,5,20191227,0,2,2,2,8,2,2019,0,4,423,1
Wild,2,1,3,0,6,Avalanche,2,1,1,0,4,20191227,0,0,2,2,10,-2,2019,0,4,698,1
Maple Leafs,2,1,1,1,5,Devils,1,3,0,0,4,20191227,1,-1,0,1,9,-1,2019,1,4,333,1
Flyers,0,0,1,0,1,Sharks,1,2,3,0,6,20191228,1,3,5,5,7,5,2019,0,5,2499,1
Coyotes,1,0,0,0,1,Golden Knights,2,2,0,0,4,20191228,1,3,3,3,5,3,2019,0,5,256,1
Kings,0,1,1,0,2,Canucks,2,0,1,0,3,20191228,2,1,1,1,5,1,2019,0,5,1076,1
Avalanche,1,1,0,0,2,Stars,1,0,1,1,3,20191228,0,-1,0,1,5,1,2019,1,5,661,1
Capitals,0,2,2,0,4,Hurricanes,1,3,2,0,6,20191228,1,2,2,2,10,2,2019,0,5,233,1
Predators,0,3,1,0,4,Penguins,3,1,2,0,6,20191228,3,1,2,2,10,2,2019,0,5,471,1
Red Wings,2,1,1,0,4,Panthers,1,3,1,0,5,20191228,-1,1,1,1,9,1,2019,0,5,1155,1
Canadiens,2,1,1,0,4,Lightning,1,3,1,0,5,20191228,-1,1,1,1,9,1,2019,0,5,1311,1
Rangers,2,2,0,1,5,Maple Leafs,1,1,2,0,4,20191228,1,2,0,1,9,-1,2019,1,5,341,1
Canucks,3,0,2,0,5,Flames,0,1,1,0,2,20191229,3,2,3,3,7,-3,2019,0,6,426,1
Flyers,1,0,0,1,2,Ducks,1,0,0,0,1,20191229,0,0,0,1,3,-1,2019,1,6,2388,1
Stars,0,0,4,0,4,Coyotes,2,0,0,0,2,20191229,-2,-2,2,2,6,-2,2019,0,6,884,1
Canadiens,1,2,2,0,5,Panthers,2,3,1,0,6,20191229,1,2,1,1,11,1,2019,0,6,1418,1
Blackhawks,0,0,2,1,3,Blue Jackets,2,0,0,0,2,20191229,-2,-2,0,1,5,-1,2019,1,6,275,1
Sabres,0,1,1,0,2,Bruins,1,0,2,0,3,20191229,1,0,1,1,5,1,2019,0,6,399,1
Islanders,0,0,3,0,3,Wild,1,0,0,0,1,20191229,-1,-1,2,2,4,-2,2019,0,6,1016,1
Devils,1,2,0,1,4,Senators,0,2,1,0,3,20191229,1,1,0,1,7,-1,2019,1,6,330,1
Jets,0,1,0,0,1,Blues,1,1,2,0,4,20191229,1,1,3,3,5,3,2019,0,6,853,1
Red Wings,0,1,0,0,1,Lightning,0,1,1,0,2,20191229,0,0,1,1,3,1,2019,0,6,994,1
Senators,0,2,0,0,2,Penguins,2,2,1,0,5,20191230,2,2,3,3,7,3,2019,0,0,392,1
Flyers,0,1,2,0,3,Kings,4,0,1,0,5,20191231,4,3,2,2,8,2,2019,0,1,2388,1
Blues,1,0,0,0,1,Coyotes,1,0,2,0,3,20191231,0,0,2,2,4,2,2019,0,1,1270,1
Rangers,0,1,4,0,5,Oilers,3,3,1,0,7,20191231,3,5,2,2,12,2,2019,0,1,2024,1
Blackhawks,3,1,1,0,5,Flames,0,1,2,0,3,20191231,3,3,2,2,8,-2,2019,0,1,1397,1
Jets,1,2,4,0,7,Avalanche,1,1,2,0,4,20191231,0,1,3,3,11,-3,2019,0,1,797,1
Lightning,0,3,3,0,6,Sabres,1,3,0,0,4,20191231,-1,-1,2,2,10,-2,2019,0,1,1051,1
Panthers,0,1,0,0,1,Blue Jackets,1,1,2,0,4,20191231,1,1,3,3,5,3,2019,0,1,993,1
Canadiens,1,0,0,0,1,Hurricanes,1,1,1,0,3,20191231,0,1,2,2,4,2,2019,0,1,727,1
Maple Leafs,2,1,1,0,4,Wild,0,1,0,0,1,20191231,2,2,3,3,5,-3,2019,0,1,691,1
Ducks,1,0,1,0,2,Golden Knights,2,1,2,0,5,20191231,1,2,3,3,7,3,2019,0,1,228,1
Islanders,2,2,0,0,4,Capitals,2,1,0,0,3,20191231,0,1,1,1,7,-1,2019,0,1,204,1
Sharks,0,0,0,0,0,Red Wings,0,1,1,0,2,20191231,0,1,2,2,2,2,2019,0,1,2071,1
Bruins,1,1,0,0,2,Devils,0,1,1,1,3,20191231,-1,-1,0,1,5,1,2019,1,1,196,1
Predators,2,0,0,0,2,Stars,0,1,3,0,4,20200101,-2,-1,2,2,6,2,2019,0,2,616,1
Flyers,2,1,1,0,4,Golden Knights,4,1,0,0,5,20200102,2,2,1,1,9,1,2019,0,3,2171,1
Blackhawks,1,3,1,0,5,Canucks,1,3,3,0,7,20200102,0,0,2,2,12,2,2019,0,3,1775,1
Blues,0,2,1,0,3,Avalanche,1,3,3,0,7,20200102,1,2,4,4,10,4,2019,0,3,794,1
Ducks,1,1,0,0,2,Coyotes,1,0,3,0,4,20200102,0,-1,2,2,6,2,2019,0,3,356,1
Rangers,2,1,0,0,3,Flames,3,1,0,0,4,20200102,1,1,1,1,7,1,2019,0,3,2023,1
Maple Leafs,2,3,1,0,6,Jets,0,3,0,0,3,20200102,2,2,3,3,9,-3,2019,0,3,946,1
Sharks,2,0,0,1,3,Penguins,1,1,0,0,2,20200102,1,0,0,1,5,-1,2019,1,3,2242,1
Devils,0,1,1,0,2,Islanders,0,1,0,0,1,20200102,0,0,1,1,3,-1,2019,0,3,8,1
Lightning,2,0,0,0,2,Canadiens,1,0,0,0,1,20200102,1,1,1,1,3,-1,2019,0,3,1311,1
Oilers,2,0,0,0,2,Sabres,1,0,1,1,3,20200102,-1,-1,0,1,5,1,2019,1,3,1734,1
Panthers,1,4,1,0,6,Senators,2,0,1,0,3,20200102,-1,3,3,3,9,-3,2019,0,3,1370,1
Blue Jackets,0,0,1,1,2,Bruins,0,1,0,0,1,20200102,0,-1,0,1,3,-1,2019,1,3,642,1
Capitals,0,2,2,0,4,Hurricanes,0,0,3,0,3,20200103,0,2,1,1,7,-1,2019,0,4,233,1
Red Wings,1,0,0,0,1,Stars,1,2,1,0,4,20200103,0,2,3,3,5,3,2019,0,4,999,1
Rangers,1,0,0,0,1,Canucks,1,0,1,0,2,20200104,0,0,1,1,3,1,2019,0,5,2429,1
Flyers,0,0,2,0,2,Coyotes,3,1,2,0,6,20200104,3,4,4,4,8,4,2019,0,5,2078,1
Avalanche,0,2,3,0,5,Devils,0,0,2,0,2,20200104,0,2,3,3,7,-3,2019,0,5,1618,1
Lightning,0,2,3,0,5,Senators,0,3,0,0,3,20200104,0,-1,2,2,8,-2,2019,0,5,1251,1
Predators,2,0,2,0,4,Kings,0,1,0,0,1,20200104,2,1,3,3,5,-3,2019,0,5,1776,1
Islanders,0,0,0,0,0,Maple Leafs,0,2,1,0,3,20200104,0,2,3,3,3,3,2019,0,5,341,1
Blues,3,0,1,0,4,Golden Knights,0,2,2,1,5,20200104,-3,-1,0,1,9,1,2019,1,5,1375,1
Jets,0,1,1,0,2,Wild,1,0,1,1,3,20200104,1,0,0,1,5,1,2019,1,5,388,1
Panthers,0,0,2,0,2,Sabres,1,2,0,0,3,20200104,1,3,1,1,5,1,2019,0,5,1184,1
Sharks,0,2,1,0,3,Blue Jackets,0,1,1,0,2,20200104,0,1,1,1,5,-1,2019,0,5,2090,1
Oilers,0,2,2,0,4,Bruins,1,0,0,0,1,20200104,-1,1,3,3,5,-3,2019,0,5,2074,1
Penguins,1,0,1,1,3,Canadiens,1,1,0,0,2,20200104,0,-1,0,1,5,-1,2019,1,5,474,1
Red Wings,2,0,0,0,2,Blackhawks,0,2,2,0,4,20200105,-2,0,2,2,6,2,2019,0,6,238,1
Predators,1,1,2,0,4,Ducks,1,3,0,1,5,20200105,0,2,0,1,9,1,2019,1,6,1776,1
Lightning,2,1,0,0,3,Hurricanes,0,0,1,0,1,20200105,2,3,2,2,4,-2,2019,0,6,585,1
Panthers,2,0,2,0,4,Penguins,1,0,0,0,1,20200105,1,1,3,3,5,-3,2019,0,6,1013,1
Sharks,0,3,1,0,4,Capitals,0,2,2,1,5,20200105,0,-1,0,1,9,1,2019,1,6,2416,1
Flames,2,0,2,1,5,Wild,3,0,1,0,4,20200105,-1,-1,0,1,9,-1,2019,1,6,1043,1
Oilers,1,3,2,0,6,Maple Leafs,0,3,1,0,4,20200106,1,1,2,2,10,-2,2019,0,0,1683,1
Jets,0,2,1,0,3,Canadiens,0,1,1,0,2,20200106,0,1,1,1,5,-1,2019,0,0,1115,1
Avalanche,0,0,0,0,0,Islanders,0,0,1,0,1,20200106,0,0,1,1,1,1,2019,0,0,1627,1
Blue Jackets,0,2,2,0,4,Kings,1,0,1,0,2,20200106,-1,1,2,2,6,-2,2019,0,0,1973,1
Blue Jackets,1,2,1,0,4,Ducks,1,1,1,0,3,20200107,0,1,1,1,7,-1,2019,0,1,1973,1
Penguins,2,1,1,0,4,Golden Knights,0,2,1,0,3,20200107,2,1,1,1,7,-1,2019,0,1,1915,1
Flames,0,2,0,0,2,Blackhawks,1,0,0,0,1,20200107,-1,1,1,1,3,-1,2019,0,1,1397,1
Bruins,1,2,3,0,6,Predators,0,1,1,0,2,20200107,1,2,4,4,8,-4,2019,0,1,941,1
Sharks,0,0,2,0,2,Blues,0,2,1,0,3,20200107,0,2,1,1,5,1,2019,0,1,1719,1
Avalanche,2,1,0,0,3,Rangers,2,2,1,0,5,20200107,0,1,2,2,8,2,2019,0,1,1627,1
Flyers,2,1,1,0,4,Hurricanes,2,2,0,1,5,20200107,0,1,0,1,9,1,2019,1,1,345,1
Senators,1,0,0,0,1,Capitals,0,3,3,0,6,20200107,-1,2,5,5,7,5,2019,0,1,446,1
Islanders,2,0,1,1,4,Devils,1,1,1,0,3,20200107,1,0,0,1,7,-1,2019,1,1,8,1
Coyotes,0,3,2,0,5,Panthers,0,2,0,0,2,20200107,0,1,3,3,7,-3,2019,0,1,1978,1
Canucks,1,1,0,0,2,Lightning,0,6,3,0,9,20200107,-1,4,7,7,11,7,2019,0,1,2598,1
Canadiens,1,1,1,0,3,Red Wings,0,1,3,0,4,20200107,-1,-1,1,1,7,1,2019,0,1,508,1
Jets,2,1,0,1,4,Maple Leafs,1,1,1,0,3,20200108,1,1,0,1,7,-1,2019,1,2,946,1
Capitals,2,0,0,0,2,Flyers,2,1,0,0,3,20200108,0,1,1,1,5,1,2019,0,2,123,1
Stars,0,2,0,0,2,Kings,1,0,0,0,1,20200108,-1,1,1,1,3,-1,2019,0,2,1237,1
Jets,1,2,1,0,4,Bruins,1,2,2,0,5,20200109,0,0,1,1,9,1,2019,0,3,1349,1
Blue Jackets,0,1,0,0,1,Sharks,0,2,1,0,3,20200109,0,1,2,2,4,2,2019,0,3,2090,1
Kings,4,0,1,0,5,Golden Knights,0,2,0,0,2,20200109,4,2,3,3,7,-3,2019,0,3,228,1
Wild,0,1,0,0,1,Flames,1,1,0,0,2,20200109,1,1,1,1,3,1,2019,0,3,1043,1
Stars,1,1,1,0,3,Ducks,0,0,0,0,0,20200109,1,2,3,3,3,-3,2019,0,3,1237,1
Sabres,0,1,0,0,1,Blues,2,1,2,0,5,20200109,2,2,4,4,6,4,2019,0,3,660,1
Devils,2,1,0,0,3,Rangers,3,2,1,0,6,20200109,1,2,3,3,9,3,2019,0,3,8,1
Canucks,1,0,1,0,2,Panthers,3,1,1,0,5,20200109,2,3,3,3,7,3,2019,0,3,2803,1
Coyotes,0,0,0,0,0,Lightning,2,2,0,0,4,20200109,2,4,4,4,4,4,2019,0,3,1793,1
Oilers,0,1,3,0,4,Canadiens,1,1,0,0,2,20200109,-1,-1,2,2,6,-2,2019,0,3,1826,1
Predators,3,0,2,0,5,Blackhawks,0,1,1,0,2,20200109,3,2,3,3,7,-3,2019,0,3,395,1
Senators,0,2,0,0,2,Red Wings,1,1,0,1,3,20200110,1,0,0,1,5,1,2019,1,4,406,1
Coyotes,0,0,0,0,0,Hurricanes,1,2,0,0,3,20200110,1,3,3,3,3,3,2019,0,4,1898,1
Penguins,0,1,2,1,4,Avalanche,1,1,1,0,3,20200110,-1,-1,0,1,7,-1,2019,1,4,1317,1
Stars,1,0,0,0,1,Sharks,1,1,0,0,2,20200111,0,1,1,1,3,1,2019,0,5,1449,1
Blue Jackets,1,1,1,0,3,Golden Knights,0,0,0,0,0,20200111,1,2,3,3,3,-3,2019,0,5,1757,1
Oilers,2,1,0,0,3,Flames,2,1,1,0,4,20200111,0,0,1,1,7,1,2019,0,5,171,1
Ducks,1,0,1,0,2,Blackhawks,1,2,1,0,4,20200111,0,2,2,2,6,2,2019,0,5,1741,1
Devils,1,3,1,0,5,Capitals,0,1,0,0,1,20200111,1,3,4,4,6,-4,2019,0,5,198,1
Kings,0,0,0,0,0,Hurricanes,1,0,1,0,2,20200111,1,1,2,2,2,2,2019,0,5,2231,1
Rangers,1,1,0,0,2,Blues,2,3,0,0,5,20200111,1,3,3,3,7,3,2019,0,5,871,1
Canucks,1,1,4,0,6,Sabres,1,1,1,0,3,20200111,0,0,3,3,9,-3,2019,0,5,2137,1
Canadiens,1,0,0,1,2,Senators,0,0,1,0,1,20200111,1,1,0,1,3,-1,2019,1,5,104,1
Lightning,0,1,0,0,1,Flyers,0,0,0,0,0,20200111,0,1,1,1,1,-1,2019,0,5,928,1
Bruins,0,1,1,1,3,Islanders,1,0,1,0,2,20200111,-1,0,0,1,5,-1,2019,1,5,190,1
Predators,1,0,0,0,1,Jets,0,0,0,0,0,20200112,1,1,1,1,1,-1,2019,0,6,1084,1
Canucks,0,3,1,0,4,Wild,0,1,0,0,1,20200112,0,2,3,3,5,-3,2019,0,6,1427,1
Sabres,3,0,2,0,5,Red Wings,0,1,0,0,1,20200112,3,2,4,4,6,-4,2019,0,6,215,1
Penguins,1,1,1,1,4,Coyotes,1,1,1,0,3,20200112,0,0,0,1,7,-1,2019,1,6,1824,1
Lightning,0,1,0,0,1,Devils,0,2,1,0,3,20200112,0,1,2,2,4,2,2019,0,6,1000,1
Maple Leafs,0,3,1,0,4,Panthers,3,4,1,0,8,20200112,3,4,4,4,12,4,2019,0,6,1234,1
Flames,0,0,0,0,0,Canadiens,1,0,1,0,2,20200113,1,1,2,2,2,2,2019,0,0,1852,1
Islanders,1,0,1,0,2,Rangers,1,2,3,0,6,20200113,0,2,4,4,8,4,2019,0,0,0,1
Bruins,2,3,0,0,5,Flyers,1,3,1,1,6,20200113,-1,-1,0,1,11,1,2019,1,0,270,1
Hurricanes,0,0,0,0,0,Capitals,2,0,0,0,2,20200113,2,2,2,2,2,2,2019,0,0,233,1
Ducks,1,0,0,0,1,Blues,1,2,1,0,4,20200113,0,2,3,3,5,3,2019,0,0,1586,1
Canucks,0,0,0,0,0,Jets,2,1,1,0,4,20200114,2,3,4,4,4,4,2019,0,1,1157,1
Blackhawks,0,1,1,1,3,Senators,2,0,0,0,2,20200114,-2,-1,0,1,5,-1,2019,1,1,628,1
Golden Knights,0,1,1,0,2,Sabres,0,2,2,0,4,20200114,0,1,2,2,6,2,2019,0,1,1970,1
Devils,0,1,3,0,4,Maple Leafs,3,2,2,0,7,20200114,3,4,3,3,11,3,2019,0,1,333,1
Kings,2,0,1,0,3,Lightning,2,0,1,1,4,20200114,0,0,0,1,7,1,2019,1,1,2149,1
Red Wings,1,0,1,0,2,Islanders,4,2,2,0,8,20200114,3,5,6,6,10,6,2019,0,1,480,1
Wild,0,1,2,0,3,Penguins,2,2,3,0,7,20200114,2,3,4,4,10,4,2019,0,1,741,1
Bruins,0,0,0,0,0,Blue Jackets,1,0,2,0,3,20200114,1,1,3,3,3,3,2019,0,1,642,1
Stars,0,1,1,1,3,Avalanche,2,0,0,0,2,20200114,-2,-1,0,1,5,-1,2019,1,1,661,1
Predators,2,0,0,0,2,Oilers,2,1,1,0,4,20200114,0,1,2,2,6,2,2019,0,1,1758,1
Sharks,0,2,1,0,3,Coyotes,1,2,3,0,6,20200114,1,1,3,3,9,3,2019,0,1,614,1
Flyers,0,2,1,1,4,Blues,1,0,2,0,3,20200115,-1,1,0,1,7,-1,2019,1,2,808,1
Blackhawks,2,1,1,0,4,Canadiens,0,1,0,0,1,20200115,2,2,3,3,5,-3,2019,0,2,732,1
Sharks,0,0,0,0,0,Avalanche,2,2,0,0,4,20200116,2,4,4,4,4,4,2019,0,3,927,1
Penguins,1,0,0,0,1,Bruins,2,0,2,0,4,20200116,1,1,3,3,5,3,2019,0,3,481,1
Flames,0,1,0,1,2,Maple Leafs,0,0,1,0,1,20200116,0,1,0,1,3,-1,2019,1,3,1682,1
Kings,0,0,3,0,3,Panthers,1,1,2,0,4,20200116,1,2,1,1,7,1,2019,0,3,2335,1
Rangers,0,1,2,0,3,Islanders,1,0,1,0,2,20200116,-1,0,1,1,5,-1,2019,0,3,0,1
Canadiens,1,2,1,0,4,Flyers,1,0,0,0,1,20200116,0,2,3,3,5,-3,2019,0,3,400,1
Devils,0,1,1,0,2,Capitals,2,1,2,0,5,20200116,2,2,3,3,7,3,2019,0,3,198,1
Golden Knights,1,1,2,0,4,Senators,0,0,2,0,2,20200116,1,2,2,2,6,-2,2019,0,3,2119,1
Ducks,2,1,1,0,4,Predators,1,0,1,0,2,20200116,1,2,2,2,6,-2,2019,0,3,1776,1
Lightning,0,1,1,0,2,Wild,1,2,0,0,3,20200116,1,2,1,1,5,1,2019,0,3,1318,1
Sabres,1,1,2,0,4,Stars,0,1,0,0,1,20200116,1,1,3,3,5,-3,2019,0,3,1197,1
Coyotes,1,0,0,0,1,Canucks,1,1,1,0,3,20200116,0,1,2,2,4,2,2019,0,3,1228,1
Hurricanes,0,1,1,0,2,Blue Jackets,1,0,2,0,3,20200116,1,0,1,1,5,1,2019,0,3,374,1
Penguins,0,0,1,1,2,Red Wings,0,1,0,0,1,20200117,0,-1,0,1,3,-1,2019,1,4,205,1
Ducks,1,0,0,1,2,Hurricanes,1,0,0,0,1,20200117,0,0,0,1,3,-1,2019,1,4,2231,1
Lightning,3,2,2,0,7,Jets,0,1,0,0,1,20200117,3,4,6,6,8,-6,2019,0,4,1705,1
Blackhawks,3,3,0,0,6,Maple Leafs,0,2,0,0,2,20200118,3,4,4,4,8,-4,2019,0,5,436,1
Flames,0,0,2,0,2,Senators,1,2,2,0,5,20200118,1,3,3,3,7,3,2019,0,5,1773,1
Sharks,0,0,1,0,1,Canucks,0,1,3,0,4,20200118,0,1,3,3,5,3,2019,0,5,821,1
Stars,0,0,0,0,0,Wild,2,3,2,0,7,20200118,2,5,7,7,7,7,2019,0,5,863,1
Sabres,1,0,0,0,1,Predators,0,1,1,0,2,20200118,-1,0,1,1,3,1,2019,0,5,626,1
Devils,0,0,0,0,0,Blue Jackets,1,4,0,0,5,20200118,1,5,5,5,5,5,2019,0,5,467,1
Golden Knights,0,2,2,0,4,Canadiens,3,0,1,1,5,20200118,3,1,0,1,9,1,2019,1,5,2221,1
Panthers,2,0,2,0,4,Red Wings,0,1,0,0,1,20200118,2,1,3,3,5,-3,2019,0,5,1155,1
Coyotes,0,2,1,0,3,Oilers,3,3,1,0,7,20200118,3,4,4,4,10,4,2019,0,5,1392,1
Blues,1,1,1,0,3,Avalanche,1,3,1,0,5,20200118,0,2,2,2,8,2,2019,0,5,794,1
Kings,0,0,1,0,1,Flyers,1,2,1,0,4,20200118,1,3,3,3,5,3,2019,0,5,2388,1
Capitals,1,0,5,0,6,Islanders,2,2,0,0,4,20200118,-1,-3,2,2,10,-2,2019,0,5,204,1
Bruins,3,0,0,0,3,Penguins,1,1,2,0,4,20200119,-2,-1,1,1,7,1,2019,0,6,481,1
Islanders,0,1,0,0,1,Hurricanes,1,0,0,1,2,20200119,1,0,0,1,3,1,2019,1,6,423,1
Blue Jackets,0,0,2,0,2,Rangers,1,0,0,0,1,20200119,-1,-1,1,1,3,-1,2019,0,6,476,1
Jets,0,1,1,0,2,Blackhawks,2,0,3,0,5,20200119,2,1,3,3,7,3,2019,0,6,722,1
Red Wings,1,0,2,0,3,Avalanche,0,2,4,0,6,20200120,-1,1,3,3,9,3,2019,0,0,1154,1
Panthers,1,1,3,0,5,Wild,1,1,2,0,4,20200120,0,0,1,1,9,-1,2019,0,0,1513,1
Panthers,0,4,0,0,4,Blackhawks,0,1,2,0,3,20200121,0,3,1,1,7,-1,2019,0,1,1189,1
Golden Knights,1,1,0,0,2,Bruins,1,0,2,0,3,20200121,0,-1,1,1,5,1,2019,0,1,2369,1
Jets,1,0,0,0,1,Hurricanes,3,0,1,0,4,20200121,2,2,3,3,5,3,2019,0,1,1350,1
Islanders,2,1,1,0,4,Rangers,0,0,2,0,2,20200121,2,3,2,2,6,-2,2019,0,1,0,1
Penguins,0,0,0,0,0,Flyers,0,2,1,0,3,20200121,0,2,3,3,3,3,2019,0,1,257,1
Jets,2,1,0,0,3,Blue Jackets,1,2,1,0,4,20200122,-1,0,1,1,7,1,2019,0,2,975,1
Red Wings,2,0,0,0,2,Wild,1,3,0,0,4,20200122,-1,2,2,2,6,2,2019,0,2,542,1
Ducks,0,1,1,0,2,Sharks,2,1,1,0,4,20200127,2,2,2,2,6,2,2019,0,0,305,1
Blues,1,0,0,0,1,Canucks,0,2,1,0,3,20200127,-1,1,2,2,4,2,2019,0,0,1778,1
Maple Leafs,2,2,1,0,5,Predators,1,0,1,0,2,20200127,1,3,3,3,7,-3,2019,0,0,646,1
Devils,1,1,1,1,4,Senators,1,0,2,0,3,20200127,0,1,0,1,7,-1,2019,1,0,330,1
Capitals,1,2,1,0,4,Canadiens,1,0,1,0,2,20200127,0,2,2,2,6,-2,2019,0,0,495,1
Lightning,0,1,1,0,2,Stars,0,1,1,1,3,20200127,0,0,0,1,5,1,2019,1,0,916,1
Senators,1,1,3,0,5,Sabres,1,1,0,0,2,20200128,0,0,3,3,7,-3,2019,0,1,219,1
Blues,3,0,1,1,5,Flames,2,2,0,0,4,20200128,1,-1,0,1,9,-1,2019,1,1,1440,1
Predators,3,0,2,0,5,Capitals,2,2,0,0,4,20200129,1,-1,1,1,9,-1,2019,0,2,566,1
Maple Leafs,1,2,2,0,5,Stars,1,1,1,0,3,20200129,0,1,2,2,8,-2,2019,0,2,1201,1
Flames,1,2,0,1,4,Oilers,0,2,1,0,3,20200129,1,1,0,1,7,-1,2019,1,2,171,1
Coyotes,1,1,0,0,2,Ducks,2,2,0,0,4,20200129,1,2,2,2,6,2,2019,0,2,356,1
Lightning,0,2,2,0,4,Kings,1,1,0,0,2,20200129,-1,0,2,2,6,-2,2019,0,2,2149,1
Canucks,1,0,4,0,5,Sharks,1,1,0,0,2,20200129,0,-1,3,3,7,-3,2019,0,2,821,1
Canadiens,0,2,1,0,3,Sabres,1,0,0,0,1,20200130,-1,1,2,2,4,-2,2019,0,3,311,1
Predators,2,1,2,1,6,Devils,1,3,1,0,5,20200130,1,-1,0,1,11,-1,2019,1,3,750,1
Kings,1,0,1,1,3,Coyotes,0,2,0,0,2,20200130,1,-1,0,1,5,-1,2019,1,3,356,1
Lightning,2,1,1,0,4,Ducks,2,0,1,0,3,20200131,0,1,1,1,7,-1,2019,0,4,2149,1
Blues,0,1,1,0,2,Oilers,2,0,2,0,4,20200131,2,1,2,2,6,2,2019,0,4,1508,1
Red Wings,0,0,2,0,2,Rangers,0,3,1,0,4,20200131,0,3,2,2,6,2,2019,0,4,480,1
Golden Knights,2,0,2,0,4,Hurricanes,0,1,2,0,3,20200131,2,1,1,1,7,-1,2019,0,4,2028,1
Capitals,2,1,2,0,5,Senators,0,2,1,0,3,20200131,2,1,2,2,8,-2,2019,0,4,446,1
Flyers,1,1,1,0,3,Penguins,0,3,0,1,4,20200131,-1,1,0,1,7,1,2019,1,4,257,1
Bruins,1,0,1,0,2,Jets,1,0,0,0,1,20200131,0,0,1,1,3,-1,2019,0,4,1349,1
Lightning,0,1,2,0,3,Sharks,0,0,0,0,0,20200201,0,1,3,3,3,-3,2019,0,5,2365,1
Oilers,3,3,2,0,8,Flames,1,2,0,0,3,20200201,2,3,5,5,11,-5,2019,0,5,171,1
Blackhawks,1,1,0,1,3,Coyotes,0,2,0,0,2,20200201,1,0,0,1,5,-1,2019,1,5,1450,1
Bruins,1,3,2,0,6,Wild,0,0,1,0,1,20200201,1,4,5,5,7,-5,2019,0,5,1120,1
Golden Knights,0,1,2,0,3,Predators,0,0,0,0,0,20200201,0,1,3,3,3,-3,2019,0,5,1575,1
Ducks,1,2,0,0,3,Kings,0,1,0,0,1,20200201,1,2,2,2,4,-2,2019,0,5,0,1
Avalanche,0,2,1,0,3,Flyers,2,1,3,0,6,20200201,2,1,3,3,9,3,2019,0,5,1574,1
Stars,0,1,1,1,3,Devils,1,0,1,0,2,20200201,-1,0,0,1,5,-1,2019,1,5,1362,1
Rangers,1,0,0,0,1,Red Wings,0,0,0,0,0,20200201,1,1,1,1,1,-1,2019,0,5,480,1
Senators,0,1,0,0,1,Maple Leafs,0,1,0,1,2,20200201,0,0,0,1,3,1,2019,1,5,203,1
Panthers,0,0,0,0,0,Canadiens,1,2,1,0,4,20200201,1,3,4,4,4,4,2019,0,5,1418,1
Canucks,1,2,0,1,4,Islanders,1,1,1,0,3,20200201,0,1,0,1,7,-1,2019,1,5,2429,1
Blues,0,0,2,0,2,Jets,1,2,2,0,5,20200201,1,3,3,3,7,3,2019,0,5,853,1
Blue Jackets,0,0,1,0,1,Sabres,1,0,0,1,2,20200201,1,1,0,1,3,1,2019,1,5,293,1
Penguins,2,1,1,0,4,Capitals,1,0,2,0,3,20200202,1,2,1,1,7,-1,2019,0,6,190,1
Blue Jackets,1,2,1,0,4,Canadiens,0,1,2,0,3,20200202,1,2,1,1,7,-1,2019,0,6,605,1
Canucks,1,1,1,0,3,Hurricanes,0,2,1,1,4,20200202,-1,0,0,1,7,1,2019,1,6,2409,1
Panthers,1,0,4,0,5,Maple Leafs,0,2,1,0,3,20200203,1,-1,2,2,8,-2,2019,0,0,1234,1
Stars,2,2,1,0,5,Rangers,2,0,1,0,3,20200203,0,2,2,2,8,-2,2019,0,0,1370,1
Flyers,0,1,2,0,3,Red Wings,0,0,0,0,0,20200203,0,1,3,3,3,-3,2019,0,0,441,1
Oilers,0,0,0,0,0,Coyotes,0,2,1,0,3,20200204,0,2,3,3,3,3,2019,0,1,1392,1
Hurricanes,0,1,2,0,3,Blues,1,4,1,0,6,20200204,1,4,3,3,9,3,2019,0,1,665,1
Predators,1,0,0,1,2,Jets,1,0,0,0,1,20200204,0,0,0,1,3,-1,2019,1,1,1084,1
Blackhawks,0,0,2,0,2,Wild,0,2,0,1,3,20200204,0,2,0,1,5,1,2019,1,1,355,1
Ducks,1,1,0,1,3,Senators,0,1,1,0,2,20200204,1,1,0,1,5,-1,2019,1,1,2345,1
Sharks,0,2,1,0,3,Flames,0,1,0,0,1,20200204,0,1,2,2,4,-2,2019,0,1,1027,1
Kings,1,0,1,0,2,Capitals,0,1,3,0,4,20200204,-1,0,2,2,6,2,2019,0,1,2294,1
Canucks,0,0,0,0,0,Bruins,1,1,2,0,4,20200204,1,2,4,4,4,4,2019,0,1,2504,1
Avalanche,2,4,0,0,6,Sabres,1,0,0,0,1,20200204,1,5,5,5,7,-5,2019,0,1,1366,1
Panthers,0,0,0,0,0,Blue Jackets,0,0,0,1,1,20200204,0,0,0,1,1,1,2019,1,1,993,1
Canadiens,0,2,2,1,5,Devils,1,2,1,0,4,20200204,-1,-1,0,1,9,-1,2019,1,1,342,1
Stars,1,1,1,0,3,Islanders,1,1,1,1,4,20200204,0,0,0,1,7,1,2019,1,1,1370,1
Golden Knights,1,0,1,0,2,Lightning,2,0,2,0,4,20200204,1,1,2,2,6,2,2019,0,1,1985,1
Maple Leafs,1,1,1,0,3,Rangers,3,1,1,0,5,20200205,2,2,2,2,8,2,2019,0,2,341,1
Bruins,0,1,0,1,2,Blackhawks,0,1,0,0,1,20200205,0,0,0,1,3,-1,2019,1,2,849,1
Sharks,2,2,2,0,6,Oilers,2,0,1,0,3,20200206,0,2,3,3,9,-3,2019,0,3,1190,1
Hurricanes,0,3,2,0,5,Coyotes,1,1,1,0,3,20200206,-1,1,2,2,8,-2,2019,0,3,1898,1
Predators,2,1,0,0,3,Flames,1,1,0,0,2,20200206,1,1,1,1,5,-1,2019,0,3,1692,1
Canucks,0,1,1,0,2,Wild,3,0,1,0,4,20200206,3,2,2,2,6,2,2019,0,3,1427,1
Jets,1,1,2,0,4,Blues,0,2,0,0,2,20200206,1,0,2,2,6,-2,2019,0,3,853,1
Devils,1,1,3,0,5,Flyers,0,0,0,0,0,20200206,1,2,5,5,5,-5,2019,0,3,75,1
Kings,2,1,0,0,3,Islanders,0,2,3,0,5,20200206,-2,-1,2,2,8,2,2019,0,3,2445,1
Golden Knights,1,2,4,0,7,Panthers,1,1,0,0,2,20200206,0,1,5,5,9,-5,2019,0,3,2177,1
Penguins,0,1,1,0,2,Lightning,2,1,1,0,4,20200206,2,2,2,2,6,2,2019,0,3,874,1
Ducks,0,1,1,0,2,Canadiens,1,1,0,1,3,20200206,1,1,0,1,5,1,2019,1,3,2448,1
Red Wings,2,0,1,1,4,Sabres,0,0,3,0,3,20200206,2,2,0,1,7,-1,2019,1,3,215,1
Avalanche,1,2,1,0,4,Senators,1,0,0,0,1,20200206,0,2,3,3,5,-3,2019,0,3,1515,1
Wild,0,2,1,0,3,Stars,1,1,0,0,2,20200207,-1,0,1,1,5,-1,2019,0,4,863,1
Sabres,1,1,1,0,3,Rangers,0,0,2,0,2,20200207,1,2,1,1,5,-1,2019,0,4,292,1
Ducks,1,0,3,0,4,Maple Leafs,1,2,1,1,5,20200207,0,2,0,1,9,1,2019,1,4,2170,1
Red Wings,0,0,0,0,0,Blue Jackets,0,1,1,0,2,20200207,0,1,2,2,2,2,2019,0,4,163,1
Senators,0,2,0,0,2,Jets,1,3,1,0,5,20200208,1,2,3,3,7,3,2019,0,5,1033,1
Coyotes,0,1,1,0,2,Bruins,0,3,1,0,4,20200208,0,2,2,2,6,2,2019,0,5,2295,1
Maple Leafs,0,0,1,0,1,Canadiens,0,0,1,1,2,20200208,0,0,0,1,3,1,2019,1,5,303,1
Islanders,0,0,1,0,1,Lightning,0,1,2,0,3,20200208,0,1,2,2,4,2,2019,0,5,1004,1
Penguins,2,1,0,0,3,Panthers,1,1,0,0,2,20200208,1,1,1,1,5,-1,2019,0,5,1013,1
Kings,0,0,0,0,0,Devils,0,3,0,0,3,20200208,0,3,3,3,3,3,2019,0,5,2436,1
Flyers,1,3,3,0,7,Capitals,1,0,1,0,2,20200208,0,3,5,5,9,-5,2019,0,5,123,1
Avalanche,0,0,2,0,2,Blue Jackets,0,1,0,0,1,20200208,0,-1,1,1,3,-1,2019,0,5,1163,1
Predators,1,1,0,0,2,Oilers,0,1,2,0,3,20200208,-1,-1,1,1,5,1,2019,0,5,1758,1
Stars,1,1,0,1,3,Blues,2,0,0,0,2,20200208,-1,0,0,1,5,-1,2019,1,5,547,1
Flames,2,1,3,0,6,Canucks,2,0,0,0,2,20200208,0,1,4,4,8,-4,2019,0,5,426,1
Hurricanes,1,0,4,1,6,Golden Knights,2,1,2,0,5,20200208,-1,-2,0,1,11,-1,2019,1,5,2028,1
Blackhawks,2,0,0,0,2,Jets,0,1,4,0,5,20200209,-2,-1,3,3,7,3,2019,0,6,722,1
Avalanche,0,3,0,0,3,Wild,0,2,0,0,2,20200209,0,1,1,1,5,-1,2019,0,6,698,1
Ducks,3,0,0,0,3,Sabres,1,1,0,0,2,20200209,2,1,1,1,5,-1,2019,0,6,2193,1
Bruins,0,0,1,0,1,Red Wings,0,1,2,0,3,20200209,0,1,2,2,4,2,2019,0,6,611,1
Kings,0,0,1,0,1,Rangers,1,0,3,0,4,20200209,1,1,3,3,5,3,2019,0,6,2445,1
Islanders,3,2,0,0,5,Capitals,1,2,0,0,3,20200210,2,2,2,2,8,-2,2019,0,0,204,1
Lightning,1,0,0,1,2,Blue Jackets,0,1,0,0,1,20200210,1,0,0,1,3,-1,2019,1,0,830,1
Predators,0,2,0,0,2,Canucks,3,2,1,0,6,20200210,3,3,4,4,8,4,2019,0,0,2030,1
Flames,3,1,2,0,6,Sharks,1,1,0,0,2,20200210,2,2,4,4,8,-4,2019,0,0,1027,1
Coyotes,1,1,1,0,3,Canadiens,2,0,0,0,2,20200210,-1,0,1,1,5,-1,2019,0,0,2175,1
Panthers,1,0,0,0,1,Flyers,1,2,1,0,4,20200210,0,2,3,3,5,3,2019,0,0,1021,1
Red Wings,1,1,0,0,2,Sabres,1,1,1,0,3,20200211,0,0,1,1,5,1,2019,0,1,215,1
Coyotes,1,1,0,0,2,Maple Leafs,1,0,1,1,3,20200211,0,-1,0,1,5,1,2019,1,1,1885,1
Panthers,2,3,0,0,5,Devils,1,2,0,0,3,20200211,1,2,2,2,8,-2,2019,0,1,1090,1
Flyers,0,2,1,0,3,Islanders,3,0,2,0,5,20200211,3,1,2,2,8,2,2019,0,1,80,1
Lightning,0,1,0,1,2,Penguins,1,0,0,0,1,20200211,-1,0,0,1,3,-1,2019,1,1,874,1
Golden Knights,0,0,0,0,0,Wild,2,2,0,0,4,20200211,2,4,4,4,4,4,2019,0,1,1293,1
Rangers,1,1,2,0,4,Jets,0,0,1,0,1,20200211,1,2,3,3,5,-3,2019,0,1,1287,1
Hurricanes,1,0,0,0,1,Stars,1,2,1,0,4,20200211,0,2,3,3,5,3,2019,0,1,1055,1
Senators,0,0,0,0,0,Avalanche,1,0,2,0,3,20200211,1,1,3,3,3,3,2019,0,1,1515,1
Blackhawks,2,1,0,0,3,Oilers,2,2,1,0,5,20200211,0,1,2,2,8,2,2019,0,1,1437,1
Blackhawks,0,0,0,0,0,Canucks,1,1,1,0,3,20200212,1,2,3,3,3,3,2019,0,2,1775,1
Flames,0,1,2,0,3,Kings,0,2,3,0,5,20200212,0,1,2,2,8,2,2019,0,2,1197,1
Canadiens,0,1,0,0,1,Bruins,1,2,1,0,4,20200212,1,2,3,3,5,3,2019,0,2,270,1
Blue Jackets,1,1,1,0,3,Sabres,0,1,2,1,4,20200213,-1,-1,0,1,7,1,2019,1,3,293,1
Stars,1,1,1,0,3,Maple Leafs,0,1,1,0,2,20200213,1,1,1,1,5,-1,2019,0,3,1201,1
Oilers,0,1,0,0,1,Lightning,0,2,1,0,3,20200213,0,1,2,2,4,2,2019,0,3,2367,1
Flyers,3,1,2,0,6,Panthers,0,0,2,0,2,20200213,3,4,4,4,8,-4,2019,0,3,1021,1
Red Wings,0,1,0,0,1,Devils,0,0,4,0,4,20200213,0,-1,3,3,5,3,2019,0,3,471,1
Coyotes,0,1,1,0,2,Senators,2,0,1,0,3,20200213,2,1,1,1,5,1,2019,0,3,2071,1
Islanders,0,0,0,0,0,Predators,3,2,0,0,5,20200213,3,5,5,5,5,5,2019,0,3,758,1
Rangers,1,0,2,1,4,Wild,2,1,0,0,3,20200213,-1,-2,0,1,7,-1,2019,1,3,1016,1
Capitals,0,1,2,0,3,Avalanche,2,0,0,0,2,20200213,-2,-1,1,1,5,-1,2019,0,3,1489,1
Blues,3,1,1,0,5,Golden Knights,2,1,2,1,6,20200213,-1,-1,0,1,11,1,2019,1,3,1375,1
Flames,4,1,1,0,6,Ducks,0,0,0,0,0,20200213,4,5,6,6,6,-6,2019,0,3,1197,1
Canadiens,0,1,0,0,1,Penguins,0,3,1,0,4,20200214,0,2,3,3,5,3,2019,0,4,474,1
Rangers,1,0,2,0,3,Blue Jackets,0,1,0,0,1,20200214,1,0,2,2,4,-2,2019,0,4,476,1
Devils,1,0,1,0,2,Hurricanes,2,1,2,0,5,20200214,1,2,3,3,7,3,2019,0,4,419,1
Sharks,1,0,2,0,3,Jets,0,2,0,0,2,20200214,1,-1,1,1,5,-1,2019,0,4,1496,1
Red Wings,1,0,0,0,1,Bruins,0,3,1,0,4,20200215,-1,2,3,3,5,3,2019,0,5,611,1
Predators,2,1,1,0,4,Blues,0,3,0,0,3,20200215,2,0,1,1,7,-1,2019,0,5,253,1
Flyers,0,1,2,0,3,Lightning,2,1,2,0,5,20200215,2,2,2,2,8,2,2019,0,5,928,1
Islanders,0,0,0,0,0,Golden Knights,0,1,0,0,1,20200215,0,1,1,1,1,1,2019,0,5,2227,1
Capitals,0,1,0,0,1,Coyotes,0,1,2,0,3,20200215,0,0,2,2,4,2,2019,0,5,1977,1
Blackhawks,2,4,2,0,8,Flames,2,1,1,0,4,20200215,0,3,4,4,12,-4,2019,0,5,1397,1
Kings,1,0,2,0,3,Avalanche,0,1,0,0,1,20200215,1,0,2,2,4,-2,2019,0,5,830,1
Maple Leafs,1,2,1,0,4,Senators,0,1,1,0,2,20200215,1,2,2,2,6,-2,2019,0,5,203,1
Stars,0,2,1,1,4,Canadiens,1,2,0,0,3,20200215,-1,-1,0,1,7,-1,2019,1,5,1505,1
Sharks,0,0,2,0,2,Wild,0,0,0,0,0,20200215,0,0,2,2,2,-2,2019,0,5,1570,1
Oilers,1,0,3,0,4,Panthers,0,0,1,0,1,20200215,1,1,3,3,5,-3,2019,0,5,2569,1
Blue Jackets,2,0,1,0,3,Devils,0,3,0,1,4,20200216,-2,1,0,1,7,1,2019,1,6,467,1
Blues,0,1,0,0,1,Predators,0,1,1,0,2,20200216,0,0,1,1,3,1,2019,0,6,253,1
Blackhawks,1,1,0,0,2,Jets,0,2,1,0,3,20200216,-1,0,1,1,5,1,2019,0,6,722,1
Bruins,1,1,1,0,3,Rangers,0,0,1,0,1,20200216,1,2,2,2,4,-2,2019,0,6,190,1
Maple Leafs,0,1,1,0,2,Sabres,0,2,3,0,5,20200216,0,1,3,3,7,3,2019,0,6,57,1
Oilers,1,2,0,1,4,Hurricanes,1,1,1,0,3,20200216,0,1,0,1,7,-1,2019,1,6,2076,1
Ducks,2,1,2,0,5,Canucks,0,1,0,0,1,20200216,2,2,4,4,6,-4,2019,0,6,1076,1
Stars,2,0,1,0,3,Senators,2,0,1,1,4,20200216,0,0,0,1,7,1,2019,1,6,1404,1
Red Wings,1,0,0,0,1,Penguins,2,3,0,0,5,20200216,1,4,4,4,6,4,2019,0,6,205,1
Ducks,0,2,2,0,4,Flames,0,1,5,0,6,20200217,0,-1,2,2,10,2,2019,0,0,1197,1
Islanders,0,0,1,0,1,Coyotes,1,0,1,0,2,20200217,1,1,1,1,3,1,2019,0,0,2139,1
Panthers,1,1,3,0,5,Sharks,1,0,2,0,3,20200217,0,1,2,2,8,-2,2019,0,0,2558,1
Capitals,0,0,2,0,2,Golden Knights,2,1,0,0,3,20200217,2,3,1,1,5,1,2019,0,0,2080,1
Lightning,0,3,0,1,4,Avalanche,1,1,1,0,3,20200217,-1,1,0,1,7,-1,2019,1,0,1521,1
Kings,1,0,2,0,3,Jets,0,3,3,0,6,20200218,-1,2,3,3,9,3,2019,0,1,1527,1
Hurricanes,1,2,1,0,4,Predators,0,1,0,0,1,20200218,1,2,3,3,5,-3,2019,0,1,456,1
Maple Leafs,0,2,0,0,2,Penguins,2,3,0,0,5,20200218,2,3,3,3,7,3,2019,0,1,222,1
Sabres,2,2,0,0,4,Senators,4,1,2,0,7,20200218,2,1,3,3,11,3,2019,0,1,219,1
Canadiens,2,1,0,0,3,Red Wings,0,1,3,0,4,20200218,-2,-2,1,1,7,1,2019,0,1,508,1
Blue Jackets,0,1,0,0,1,Flyers,2,1,2,0,5,20200218,2,2,4,4,6,4,2019,0,1,414,1
Devils,0,0,0,0,0,Blues,0,1,2,0,3,20200218,0,1,3,3,3,3,2019,0,1,863,1
Wild,1,1,1,1,4,Canucks,0,1,2,0,3,20200219,1,1,0,1,7,-1,2019,1,2,1427,1
Panthers,1,2,1,0,4,Ducks,1,0,0,0,1,20200219,0,2,3,3,5,-3,2019,0,2,2335,1
Coyotes,0,2,0,0,2,Stars,1,1,1,0,3,20200219,1,0,1,1,5,1,2019,0,2,884,1
Bruins,1,0,0,1,2,Oilers,0,0,1,0,1,20200219,1,1,0,1,3,-1,2019,1,2,2074,1
Rangers,1,0,5,0,6,Blackhawks,0,1,2,0,3,20200219,1,0,3,3,9,-3,2019,0,2,711,1
Islanders,0,0,1,0,1,Avalanche,1,1,1,0,3,20200219,1,2,2,2,4,2,2019,0,2,1627,1
Penguins,0,0,0,0,0,Maple Leafs,0,3,1,0,4,20200220,0,3,4,4,4,4,2019,0,3,222,1
Sharks,1,0,0,0,1,Devils,0,1,1,0,2,20200220,-1,0,1,1,3,1,2019,0,3,2540,1
Canadiens,1,1,1,1,4,Capitals,1,1,1,0,3,20200220,0,0,0,1,7,-1,2019,1,3,495,1
Flyers,1,2,0,1,4,Blue Jackets,2,1,0,0,3,20200220,-1,0,0,1,7,-1,2019,1,3,414,1
Jets,2,2,1,0,5,Senators,1,0,0,0,1,20200220,1,3,4,4,6,-4,2019,0,3,1033,1
Coyotes,0,0,0,0,0,Blues,0,0,1,0,1,20200220,0,0,1,1,1,1,2019,0,3,1270,1
Lightning,1,1,1,0,3,Golden Knights,1,2,2,0,5,20200220,0,1,2,2,8,2,2019,0,3,1985,1
Panthers,2,1,1,0,4,Kings,2,2,1,0,5,20200220,0,1,1,1,9,1,2019,0,3,2335,1
Avalanche,0,1,0,0,1,Ducks,0,0,0,0,0,20200221,0,1,1,1,1,-1,2019,0,4,830,1
Wild,1,2,2,0,5,Oilers,2,1,0,0,3,20200221,-1,0,2,2,8,-2,2019,0,4,1083,1
Predators,0,1,0,0,1,Blackhawks,0,0,1,1,2,20200221,0,-1,0,1,3,1,2019,1,4,395,1
Blues,2,2,1,0,5,Stars,0,0,1,0,1,20200221,2,4,4,4,6,-4,2019,0,4,547,1
Rangers,1,2,2,0,5,Hurricanes,0,1,1,0,2,20200221,1,2,3,3,7,-3,2019,0,4,423,1
Bruins,3,1,0,0,4,Flames,3,0,0,0,3,20200221,0,1,1,1,7,-1,2019,0,4,2089,1
Red Wings,0,0,1,0,1,Islanders,1,1,2,0,4,20200221,1,2,3,3,5,3,2019,0,4,480,1
Avalanche,0,1,0,1,2,Kings,1,0,0,0,1,20200222,-1,0,0,1,3,-1,2019,1,5,830,1
Panthers,1,1,1,0,3,Golden Knights,1,2,2,0,5,20200222,0,1,2,2,8,2,2019,0,5,2177,1
Bruins,1,0,2,0,3,Canucks,2,3,4,0,9,20200222,1,4,6,6,12,6,2019,0,5,2504,1
Lightning,1,2,0,0,3,Coyotes,2,2,3,0,7,20200222,1,1,4,4,10,4,2019,0,5,1793,1
Blue Jackets,0,3,0,0,3,Predators,2,1,0,1,4,20200222,2,0,0,1,7,1,2019,1,5,333,1
Sharks,1,1,0,0,2,Rangers,1,1,1,0,3,20200222,0,0,1,1,5,1,2019,0,5,2549,1
Canadiens,2,1,0,0,3,Senators,0,0,0,0,0,20200222,2,3,3,3,3,-3,2019,0,5,104,1
Hurricanes,0,4,2,0,6,Maple Leafs,1,2,0,0,3,20200222,-1,1,3,3,9,-3,2019,0,5,544,1
Sabres,3,0,2,0,5,Penguins,0,1,1,0,2,20200222,3,2,3,3,7,-3,2019,0,5,178,1
Jets,0,1,1,0,2,Flyers,2,1,1,0,4,20200222,2,2,2,2,6,2,2019,0,5,1273,1
Capitals,0,1,1,0,2,Devils,1,1,1,0,3,20200222,1,1,1,1,5,1,2019,0,5,198,1
Oilers,1,2,1,0,4,Kings,0,1,1,0,2,20200223,1,2,2,2,6,-2,2019,0,6,1368,1
Golden Knights,1,2,2,1,6,Ducks,1,1,3,0,5,20200223,0,1,0,1,11,-1,2019,1,6,228,1
Blues,2,1,1,0,4,Wild,0,1,0,0,1,20200223,2,2,3,3,5,-3,2019,0,6,466,1
Jets,1,0,0,0,1,Sabres,1,0,1,0,2,20200223,0,0,1,1,3,1,2019,0,6,996,1
Sharks,1,0,0,0,1,Islanders,1,2,1,0,4,20200223,0,2,3,3,5,3,2019,0,6,2549,1
Blackhawks,0,1,0,0,1,Stars,1,1,0,0,2,20200223,1,1,1,1,3,1,2019,0,6,802,1
Penguins,0,2,1,0,3,Capitals,1,0,4,0,5,20200223,1,-1,2,2,8,2,2019,0,6,190,1
Flames,2,1,1,0,4,Red Wings,1,0,1,0,2,20200223,1,2,2,2,6,-2,2019,0,6,1573,1
Senators,1,1,1,0,3,Blue Jackets,1,1,1,1,4,20200224,0,0,0,1,7,1,2019,1,0,512,1
Oilers,0,1,2,0,3,Ducks,2,0,1,1,4,20200225,2,1,0,1,7,1,2019,1,1,1368,1
Panthers,0,1,1,0,2,Coyotes,1,0,0,0,1,20200225,-1,0,1,1,3,-1,2019,0,1,1978,1
Blackhawks,2,1,2,0,5,Blues,1,1,4,0,6,20200225,-1,-1,1,1,11,1,2019,0,1,260,1
Senators,2,0,0,0,2,Predators,1,2,0,0,3,20200225,-1,1,1,1,5,1,2019,0,1,845,1
Devils,1,2,1,0,4,Red Wings,0,0,1,0,1,20200225,1,3,3,3,5,-3,2019,0,1,471,1
Blue Jackets,1,0,3,0,4,Wild,2,2,1,0,5,20200225,1,3,1,1,9,1,2019,0,1,626,1
Jets,0,1,2,0,3,Capitals,2,1,0,1,4,20200225,2,2,0,1,7,1,2019,1,1,1247,1
Sharks,1,0,1,0,2,Flyers,1,2,1,0,4,20200225,0,2,2,2,6,2,2019,0,1,2499,1
Rangers,1,1,1,1,4,Islanders,0,1,2,0,3,20200225,1,1,0,1,7,-1,2019,1,1,0,1
Maple Leafs,2,2,0,0,4,Lightning,1,1,1,0,3,20200225,1,2,1,1,7,-1,2019,0,1,1096,1
Canucks,1,1,1,1,4,Canadiens,2,0,1,0,3,20200225,-1,0,0,1,7,-1,2019,1,1,2273,1
Stars,3,1,0,0,4,Hurricanes,0,1,0,0,1,20200225,3,3,3,3,5,-3,2019,0,1,1055,1
Flames,1,2,2,0,5,Bruins,0,1,1,0,2,20200225,1,2,3,3,7,-3,2019,0,1,2089,1
Sabres,1,1,0,0,2,Avalanche,1,1,1,0,3,20200226,0,0,1,1,5,1,2019,0,2,1366,1
Oilers,0,0,0,0,0,Golden Knights,1,0,2,0,3,20200226,1,1,3,3,3,3,2019,0,2,1204,1
Penguins,0,0,1,0,1,Kings,1,1,0,0,2,20200226,1,2,1,1,3,1,2019,0,2,2132,1
Devils,2,0,0,0,2,Sharks,0,2,0,1,3,20200227,-2,0,0,1,5,1,2019,1,3,2540,1
Capitals,0,0,0,0,0,Jets,1,0,2,0,3,20200227,1,1,3,3,3,3,2019,0,3,1247,1
Flames,0,2,1,0,3,Predators,1,0,2,1,4,20200227,1,-1,0,1,7,1,2019,1,3,1692,1
Islanders,2,0,0,0,2,Blues,1,0,1,1,3,20200227,-1,-1,0,1,5,1,2019,1,3,871,1
Maple Leafs,3,0,2,0,5,Panthers,3,0,0,0,3,20200227,0,0,2,2,8,-2,2019,0,3,1234,1
Canucks,0,1,1,0,2,Senators,2,0,3,0,5,20200227,2,1,3,3,7,3,2019,0,3,2191,1
Wild,3,3,1,0,7,Red Wings,0,1,0,0,1,20200227,3,5,6,6,8,-6,2019,0,3,542,1
Rangers,0,1,4,0,5,Canadiens,1,1,0,0,2,20200227,-1,-1,3,3,7,-3,2019,0,3,343,1
Blackhawks,0,0,5,0,5,Lightning,0,1,1,0,2,20200227,0,-1,3,3,7,-3,2019,0,3,1004,1
Stars,1,0,2,0,3,Bruins,1,2,1,0,4,20200227,0,2,1,1,7,1,2019,0,3,1548,1
Rangers,1,0,1,0,2,Flyers,1,2,2,0,5,20200228,0,2,3,3,7,3,2019,0,4,80,1
Wild,2,2,1,0,5,Blue Jackets,0,0,0,0,0,20200228,2,4,5,5,5,-5,2019,0,4,626,1
Avalanche,1,1,1,0,3,Hurricanes,0,0,2,0,2,20200228,1,2,1,1,5,-1,2019,0,4,1459,1
Sabres,1,0,1,0,2,Golden Knights,1,0,3,0,4,20200228,0,0,2,2,6,2,2019,0,4,1970,1
Penguins,0,1,1,0,2,Ducks,1,2,0,0,3,20200228,1,2,1,1,5,1,2019,0,4,2132,1
Penguins,0,0,0,0,0,Sharks,1,2,2,0,5,20200229,1,3,5,5,5,5,2019,0,5,2242,1
Jets,0,2,0,0,2,Oilers,1,1,1,0,3,20200229,1,0,1,1,5,1,2019,0,5,738,1
Sabres,2,0,0,0,2,Coyotes,0,3,2,0,5,20200229,-2,1,3,3,7,3,2019,0,5,1902,1
Stars,1,1,1,0,3,Blues,1,2,0,1,4,20200229,0,1,0,1,7,1,2019,1,5,547,1
Avalanche,0,2,1,0,3,Predators,0,0,2,0,2,20200229,0,2,1,1,5,-1,2019,0,5,1019,1
Canucks,2,0,0,0,2,Maple Leafs,2,0,2,0,4,20200229,0,0,2,2,6,2,2019,0,5,2090,1
Blackhawks,1,1,0,1,3,Panthers,1,0,1,0,2,20200229,0,1,0,1,5,-1,2019,1,5,1189,1
Devils,1,0,0,0,1,Kings,0,1,0,1,2,20200229,-1,0,0,1,3,1,2019,1,5,2436,1
Flames,0,2,1,0,3,Lightning,1,3,0,0,4,20200229,1,2,1,1,7,1,2019,0,5,2289,1
Bruins,2,0,2,0,4,Islanders,0,0,0,0,0,20200229,2,2,4,4,4,-4,2019,0,5,190,1
Red Wings,1,1,1,0,3,Senators,0,1,2,1,4,20200229,-1,-1,0,1,7,1,2019,1,5,406,1
Hurricanes,0,1,2,0,3,Canadiens,1,2,0,1,4,20200229,1,2,0,1,7,1,2019,1,5,727,1
Flyers,3,2,0,0,5,Rangers,0,1,2,0,3,20200301,3,4,2,2,8,-2,2019,0,6,80,1
Flames,1,1,1,0,3,Panthers,0,0,0,0,0,20200301,1,2,3,3,3,-3,2019,0,6,2493,1
Canucks,2,1,0,0,3,Blue Jackets,1,0,4,0,5,20200301,-1,-2,2,2,8,2,2019,0,6,2050,1
Capitals,3,0,1,0,4,Wild,2,0,1,0,3,20200301,1,1,1,1,7,-1,2019,0,6,931,1
Devils,1,1,1,0,3,Ducks,0,0,0,0,0,20200301,1,2,3,3,3,-3,2019,0,6,2436,1
Kings,2,2,0,0,4,Golden Knights,0,1,0,0,1,20200301,2,3,3,3,5,-3,2019,0,6,228,1
Oilers,2,1,5,0,8,Predators,0,3,0,0,3,20200302,2,0,5,5,11,-5,2019,0,0,1758,1
Avalanche,1,1,0,0,2,Red Wings,1,0,0,0,1,20200302,0,1,1,1,3,-1,2019,0,0,1154,1
Blues,0,1,2,0,3,Rangers,1,0,0,0,1,20200303,-1,0,2,2,4,-2,2019,0,1,871,1
Canadiens,3,1,2,0,6,Islanders,0,0,2,0,2,20200303,3,4,4,4,8,-4,2019,0,1,343,1
Maple Leafs,0,2,0,0,2,Sharks,1,1,3,0,5,20200303,1,0,3,3,7,3,2019,0,1,2249,1
Devils,0,0,0,0,0,Golden Knights,0,1,2,0,3,20200303,0,1,3,3,3,3,2019,0,1,2218,1
Oilers,0,1,0,1,2,Stars,0,0,1,0,1,20200303,0,1,0,1,3,-1,2019,1,1,1655,1
Ducks,0,1,1,0,2,Blackhawks,1,4,1,0,6,20200303,1,4,4,4,8,4,2019,0,1,1741,1
Predators,0,0,1,0,1,Wild,2,0,1,0,3,20200303,2,2,2,2,4,2,2019,0,1,696,1
Bruins,1,1,0,0,2,Lightning,0,1,0,0,1,20200303,1,1,1,1,3,-1,2019,0,1,1183,1
Sabres,0,1,0,0,1,Jets,2,1,0,0,3,20200303,2,2,2,2,4,2,2019,0,1,996,1
Senators,1,0,2,0,3,Penguins,3,1,3,0,7,20200303,2,3,4,4,10,4,2019,0,1,392,1
Flyers,0,3,2,0,5,Capitals,1,1,0,0,2,20200304,-1,1,3,3,7,-3,2019,0,2,123,1
Blue Jackets,2,0,0,0,2,Flames,0,0,2,1,3,20200304,-2,-2,0,1,5,1,2019,1,2,1670,1
Ducks,2,1,0,1,4,Avalanche,2,0,1,0,3,20200304,0,1,0,1,7,-1,2019,1,2,830,1
Coyotes,1,0,3,0,4,Canucks,0,0,2,0,2,20200304,1,1,2,2,6,-2,2019,0,2,1228,1
Wild,1,2,0,0,3,Sharks,1,0,1,0,2,20200305,0,2,1,1,5,-1,2019,0,3,1570,1
Maple Leafs,0,0,0,0,0,Kings,0,0,0,1,1,20200305,0,0,0,1,1,1,2019,1,3,2170,1
Stars,0,0,0,0,0,Predators,1,1,0,0,2,20200305,1,2,2,2,2,2,2019,0,3,616,1
Oilers,0,1,2,0,3,Blackhawks,1,3,0,0,4,20200305,1,3,1,1,7,1,2019,0,3,1437,1
Hurricanes,0,0,1,0,1,Flyers,1,1,2,0,4,20200305,1,2,3,3,5,3,2019,0,3,345,1
Capitals,1,2,2,0,5,Rangers,1,2,2,1,6,20200305,0,0,0,1,11,1,2019,1,3,204,1
Bruins,0,1,0,1,2,Panthers,0,1,0,0,1,20200305,0,0,0,1,3,-1,2019,1,3,1257,1
Canadiens,0,0,0,0,0,Lightning,2,1,1,0,4,20200305,2,3,4,4,4,4,2019,0,3,1311,1
Penguins,2,1,1,0,4,Sabres,1,0,1,0,2,20200305,1,2,2,2,6,-2,2019,0,3,178,1
Islanders,1,1,1,0,3,Senators,1,2,1,0,4,20200305,0,1,1,1,7,1,2019,0,3,334,1
Maple Leafs,0,0,1,0,1,Ducks,1,0,1,0,2,20200306,1,1,1,1,3,1,2019,0,4,2170,1
Avalanche,1,2,0,0,3,Canucks,2,2,2,0,6,20200306,1,1,3,3,9,3,2019,0,4,1105,1
Blues,1,0,1,0,2,Devils,1,2,1,0,4,20200306,0,2,2,2,6,2,2019,0,4,863,1
Golden Knights,0,0,0,0,0,Jets,3,1,0,0,4,20200306,3,4,4,4,4,4,2019,0,4,1303,1
Blackhawks,0,1,0,0,1,Red Wings,0,2,0,0,2,20200306,0,1,1,1,3,1,2019,0,4,238,1
Coyotes,1,1,0,0,2,Flames,2,1,0,0,3,20200306,1,1,1,1,5,1,2019,0,4,1224,1
Capitals,3,0,2,0,5,Penguins,0,0,2,0,2,20200307,3,3,3,3,7,-3,2019,0,5,190,1
Predators,0,1,0,0,1,Stars,0,0,0,0,0,20200307,0,1,1,1,1,-1,2019,0,5,616,1
Wild,0,1,2,0,3,Kings,1,2,4,0,7,20200307,1,2,4,4,10,4,2019,0,5,1521,1
Lightning,2,1,2,0,5,Bruins,0,2,1,0,3,20200307,2,1,2,2,8,-2,2019,0,5,1183,1
Canadiens,0,0,1,0,1,Panthers,0,1,3,0,4,20200307,0,1,3,3,5,3,2019,0,5,1418,1
Devils,1,4,1,0,6,Rangers,2,0,2,0,4,20200307,-1,3,2,2,10,-2,2019,0,5,8,1
Sabres,0,1,0,0,1,Flyers,0,1,2,0,3,20200307,0,0,2,2,4,2,2019,0,5,279,1
Senators,1,0,0,1,2,Sharks,1,0,0,0,1,20200307,0,0,0,1,3,-1,2019,1,5,2408,1
Blue Jackets,0,0,1,0,1,Oilers,1,0,3,0,4,20200307,1,1,3,3,5,3,2019,0,5,1703,1
Hurricanes,1,0,1,1,3,Islanders,0,1,1,0,2,20200307,1,0,0,1,5,-1,2019,1,5,423,1
Avalanche,1,2,1,0,4,Sharks,1,1,1,0,3,20200308,0,1,1,1,7,-1,2019,0,6,927,1
Hurricanes,1,2,3,0,6,Penguins,2,0,0,0,2,20200308,-1,1,4,4,8,-4,2019,0,6,330,1
Lightning,0,2,2,0,4,Red Wings,1,1,2,1,5,20200308,1,0,0,1,9,1,2019,1,6,994,1
Golden Knights,2,1,2,0,5,Flames,0,2,1,0,3,20200308,2,1,2,2,8,-2,2019,0,6,1033,1
Blues,0,1,1,0,2,Blackhawks,0,0,0,0,0,20200308,0,1,2,2,2,-2,2019,0,6,260,1
Wild,2,0,2,1,5,Ducks,1,2,1,0,4,20200308,1,-1,0,1,9,-1,2019,1,6,1521,1
Blue Jackets,0,2,0,0,2,Canucks,0,0,1,0,1,20200308,0,2,1,1,3,-1,2019,0,6,2050,1
Avalanche,0,0,1,0,1,Kings,2,0,1,0,3,20200309,2,2,2,2,4,2,2019,0,0,830,1
Golden Knights,1,0,1,1,3,Oilers,1,0,1,0,2,20200309,0,0,0,1,5,-1,2019,1,0,1204,1
Capitals,0,0,2,0,2,Sabres,1,1,0,1,3,20200309,1,2,0,1,5,1,2019,1,0,292,1
Coyotes,2,0,0,0,2,Jets,0,2,2,0,4,20200309,-2,0,2,2,6,2,2019,0,0,1365,1
Panthers,0,1,1,0,2,Blues,0,1,0,0,1,20200309,0,0,1,1,3,-1,2019,0,0,1061,1
Senators,0,1,1,0,2,Ducks,4,1,0,0,5,20200310,4,4,3,3,7,3,2019,0,1,2345,1
Rangers,2,2,0,0,4,Stars,0,0,2,0,2,20200310,2,4,2,2,6,-2,2019,0,1,1370,1
Hurricanes,1,1,3,0,5,Red Wings,1,1,0,0,2,20200310,0,0,3,3,7,-3,2019,0,1,511,1
Islanders,2,1,1,0,4,Canucks,2,2,0,1,5,20200310,0,1,0,1,9,1,2019,1,1,2429,1
Penguins,1,1,3,0,5,Devils,1,0,1,0,2,20200310,0,1,3,3,7,-3,2019,0,1,306,1
Predators,0,4,0,0,4,Canadiens,0,0,2,0,2,20200310,0,4,2,2,6,-2,2019,0,1,937,1
Lightning,0,1,0,0,1,Maple Leafs,1,0,1,0,2,20200310,1,0,1,1,3,1,2019,0,1,1096,1
Bruins,0,1,1,0,2,Flyers,0,0,0,0,0,20200310,0,1,2,2,2,-2,2019,0,1,270,1
Sharks,1,0,1,0,2,Blackhawks,0,3,3,0,6,20200311,-1,2,4,4,8,4,2019,0,2,1837,1
Jets,0,2,2,0,4,Oilers,0,2,0,0,2,20200311,0,0,2,2,6,-2,2019,0,2,738,1
Blues,2,1,1,0,4,Ducks,1,1,0,0,2,20200311,1,1,2,2,6,-2,2019,0,2,1586,1
Rangers,1,0,1,0,2,Avalanche,1,1,0,1,3,20200311,0,1,0,1,5,1,2019,1,2,1627,1
Senators,1,0,1,0,2,Kings,1,0,2,0,3,20200311,0,0,1,1,5,1,2019,0,2,2345,1
Canadiens,1,1,0,1,3,Penguins,0,2,0,0,2,20200801,1,0,0,1,5,-1,2019,1,5,474,1
Jets,1,0,0,0,1,Flames,0,3,1,0,4,20200801,-1,2,3,3,5,3,2019,0,5,740,1
Blackhawks,4,2,0,0,6,Oilers,1,1,2,0,4,20200801,3,4,2,2,10,-2,2019,0,5,1437,1
Rangers,0,1,1,0,2,Hurricanes,1,1,1,0,3,20200801,1,1,1,1,5,1,2019,0,5,423,1
Panthers,0,0,1,0,1,Islanders,1,1,0,0,2,20200801,1,2,1,1,3,1,2019,0,5,1091,1
Coyotes,3,1,0,0,4,Predators,1,0,2,0,3,20200802,2,3,1,1,7,-1,2019,0,6,1442,1
Flyers,0,3,1,0,4,Bruins,0,1,0,0,1,20200802,0,2,3,3,5,-3,2019,0,6,270,1
Blues,1,0,0,0,1,Avalanche,0,0,2,0,2,20200802,-1,-1,1,1,3,1,2019,0,6,794,1
Blue Jackets,0,0,2,0,2,Maple Leafs,0,0,0,0,0,20200802,0,0,2,2,2,-2,2019,0,6,313,1
Wild,1,1,1,0,3,Canucks,0,0,0,0,0,20200802,1,2,3,3,3,-3,2019,0,6,1427,1
Blackhawks,1,2,0,0,3,Oilers,2,2,2,0,6,20200803,1,1,3,3,9,3,2019,0,0,1437,1
Stars,0,3,0,0,3,Golden Knights,1,0,4,0,5,20200803,1,-2,2,2,8,2,2019,0,0,1068,1
Canadiens,0,0,1,0,1,Penguins,1,0,2,0,3,20200803,1,1,2,2,4,2,2019,0,0,474,1
Jets,1,1,1,0,3,Flames,0,2,0,0,2,20200803,1,0,1,1,5,-1,2019,0,0,740,1
Rangers,1,0,0,0,1,Hurricanes,1,2,1,0,4,20200803,0,2,3,3,5,3,2019,0,0,423,1
Capitals,0,2,0,0,2,Lightning,1,1,0,1,3,20200803,1,0,0,1,5,1,2019,1,0,818,1
Panthers,1,1,0,0,2,Islanders,0,3,1,0,4,20200804,-1,1,2,2,6,2,2019,0,1,1091,1
Coyotes,0,0,2,0,2,Predators,2,1,1,0,4,20200804,2,3,2,2,6,2,2019,0,1,1442,1
Blue Jackets,0,0,0,0,0,Maple Leafs,0,1,2,0,3,20200804,0,1,3,3,3,3,2019,0,1,313,1
Flames,1,3,2,0,6,Jets,1,1,0,0,2,20200804,0,2,4,4,8,-4,2019,0,1,740,1
Hurricanes,0,1,3,0,4,Rangers,0,1,0,0,1,20200804,0,0,3,3,5,-3,2019,0,1,423,1
Wild,1,0,2,0,3,Canucks,1,2,1,0,4,20200804,0,2,1,1,7,1,2019,0,1,1427,1
Penguins,2,1,0,0,3,Canadiens,1,2,1,0,4,20200805,-1,0,1,1,7,1,2019,0,2,474,1
Oilers,1,2,0,0,3,Blackhawks,2,0,2,0,4,20200805,1,-1,1,1,7,1,2019,0,2,1437,1
Avalanche,2,1,1,0,4,Stars,0,0,0,0,0,20200805,2,3,4,4,4,-4,2019,0,2,661,1
Lightning,2,0,1,0,3,Bruins,0,1,1,0,2,20200805,2,1,1,1,5,-1,2019,0,2,1183,1
Predators,0,1,0,0,1,Coyotes,1,0,3,0,4,20200805,1,0,3,3,5,3,2019,0,2,1442,1
Islanders,0,1,1,0,2,Panthers,0,1,2,0,3,20200805,0,0,1,1,5,1,2019,0,2,1091,1
Canucks,0,1,2,0,3,Wild,0,0,0,0,0,20200806,0,1,3,3,3,-3,2019,0,3,1427,1
Capitals,0,0,1,0,1,Flyers,1,1,1,0,3,20200806,1,2,2,2,4,2,2019,0,3,123,1
Golden Knights,0,3,3,0,6,Blues,1,3,0,0,4,20200806,-1,-1,2,2,10,-2,2019,0,3,1375,1
Maple Leafs,1,2,0,0,3,Blue Jackets,0,1,2,1,4,20200806,-1,-2,0,1,7,1,2019,1,3,313,1
Flames,2,0,2,0,4,Jets,0,0,0,0,0,20200806,2,2,4,4,4,-4,2019,0,3,740,1
Canucks,1,2,1,1,5,Wild,2,2,0,0,4,20200807,-1,-1,0,1,9,-1,2019,1,4,1427,1
Maple Leafs,0,0,3,1,4,Blue Jackets,1,1,1,0,3,20200807,-1,-2,0,1,7,-1,2019,1,4,313,1
Oilers,1,1,0,0,2,Blackhawks,2,0,1,0,3,20200807,1,0,1,1,5,1,2019,0,4,1437,1
Penguins,0,0,0,0,0,Canadiens,0,0,2,0,2,20200807,0,0,2,2,2,2,2019,0,4,474,1
Predators,0,2,1,0,3,Coyotes,1,1,1,1,4,20200807,1,0,0,1,7,1,2019,1,4,1442,1
Islanders,2,1,2,0,5,Panthers,1,0,0,0,1,20200807,1,2,4,4,6,-4,2019,0,4,1091,1
Golden Knights,0,2,1,1,4,Avalanche,0,2,1,0,3,20200808,0,0,0,1,7,-1,2019,1,5,604,1
Flyers,2,1,1,0,4,Lightning,0,1,0,0,1,20200808,2,2,3,3,5,-3,2019,0,5,928,1
Bruins,0,0,1,0,1,Capitals,1,0,1,0,2,20200809,1,1,1,1,3,1,2019,0,6,394,1
Stars,0,0,1,1,2,Blues,1,0,0,0,1,20200809,-1,-1,0,1,3,-1,2019,1,6,547,1
Blue Jackets,1,0,2,0,3,Maple Leafs,0,0,0,0,0,20200809,1,1,3,3,3,-3,2019,0,6,313,1
Flames,2,1,0,0,3,Stars,0,2,0,0,2,20200811,2,1,1,1,5,-1,2019,0,1,1536,1
Blackhawks,0,1,0,0,1,Golden Knights,0,2,2,0,4,20200811,0,1,3,3,5,3,2019,0,1,1519,1
Blue Jackets,1,1,0,0,2,Lightning,1,0,1,1,3,20200811,0,-1,0,1,5,1,2019,1,1,830,1
Hurricanes,1,1,1,0,3,Bruins,1,1,1,1,4,20200812,0,0,0,1,7,1,2019,1,2,609,1
Islanders,0,1,3,0,4,Capitals,0,2,0,0,2,20200812,0,-1,2,2,6,-2,2019,0,2,204,1
Coyotes,0,0,0,0,0,Avalanche,0,0,3,0,3,20200812,0,0,3,3,3,3,2019,0,2,585,1
Canadiens,0,1,0,0,1,Flyers,1,1,0,0,2,20200812,1,1,1,1,3,1,2019,0,2,400,1
Canucks,1,1,3,0,5,Blues,1,1,0,0,2,20200812,0,0,3,3,7,-3,2019,0,2,1778,1
Flames,1,1,2,0,4,Stars,2,2,1,0,5,20200813,1,2,1,1,9,1,2019,0,3,1536,1
Blue Jackets,2,0,1,0,3,Lightning,1,0,0,0,1,20200813,1,1,2,2,4,-2,2019,0,3,830,1
Blackhawks,0,3,0,0,3,Golden Knights,2,1,0,1,4,20200813,2,0,0,1,7,1,2019,1,3,1519,1
Hurricanes,0,2,1,0,3,Bruins,1,1,0,0,2,20200813,-1,0,1,1,5,-1,2019,0,3,609,1
Stars,0,0,0,0,0,Flames,0,1,1,0,2,20200814,0,1,2,2,2,2,2019,0,4,1536,1
Islanders,0,3,2,0,5,Capitals,1,1,0,0,2,20200814,-1,1,3,3,7,-3,2019,0,4,204,1
Coyotes,1,1,0,0,2,Avalanche,1,1,1,0,3,20200814,0,0,1,1,5,1,2019,0,4,585,1
Canadiens,2,2,1,0,5,Flyers,0,0,0,0,0,20200814,2,4,5,5,5,-5,2019,0,4,400,1
Canucks,1,1,1,1,4,Blues,0,1,2,0,3,20200814,1,1,0,1,7,-1,2019,1,4,1778,1
Lightning,1,2,0,0,3,Blue Jackets,0,1,1,0,2,20200815,1,2,1,1,5,-1,2019,0,5,830,1
Bruins,0,1,2,0,3,Hurricanes,0,0,1,0,1,20200815,0,1,2,2,4,-2,2019,0,5,609,1
Avalanche,0,1,1,0,2,Coyotes,1,1,2,0,4,20200815,1,1,2,2,6,2,2019,0,5,585,1
Golden Knights,1,1,0,0,2,Blackhawks,0,0,1,0,1,20200815,1,2,1,1,3,-1,2019,0,5,1519,1
Stars,1,2,1,1,5,Flames,0,3,1,0,4,20200816,1,0,0,1,9,-1,2019,1,6,1536,1
Blues,0,2,0,1,3,Canucks,0,2,0,0,2,20200816,0,0,0,1,5,-1,2019,1,6,1778,1
Flyers,1,0,0,0,1,Canadiens,0,0,0,0,0,20200816,1,1,1,1,1,-1,2019,0,6,400,1
Capitals,0,1,0,0,1,Islanders,1,0,0,1,2,20200816,1,0,0,1,3,1,2019,1,6,204,1
Golden Knights,1,0,0,0,1,Blackhawks,2,0,1,0,3,20200816,1,1,2,2,4,2,2019,0,6,1519,1
Lightning,0,2,0,0,2,Blue Jackets,0,1,0,0,1,20200817,0,1,1,1,3,-1,2019,0,0,830,1
Avalanche,3,1,3,0,7,Coyotes,0,1,0,0,1,20200817,3,3,6,6,8,-6,2019,0,0,585,1
Bruins,0,0,4,0,4,Hurricanes,1,1,1,0,3,20200817,-1,-2,1,1,7,-1,2019,0,0,609,1
Blues,1,2,0,0,3,Canucks,0,1,0,0,1,20200817,1,2,2,2,4,-2,2019,0,0,1778,1
Flyers,1,1,0,0,2,Canadiens,0,0,0,0,0,20200818,1,2,2,2,2,-2,2019,0,1,400,1
Flames,1,0,0,0,1,Stars,1,0,1,0,2,20200818,0,0,1,1,3,1,2019,0,1,1536,1
Capitals,0,2,1,0,3,Islanders,2,0,0,0,2,20200818,-2,0,1,1,5,-1,2019,0,1,204,1
Blackhawks,2,1,0,0,3,Golden Knights,1,2,1,0,4,20200818,-1,0,1,1,7,1,2019,0,1,1519,1
Blue Jackets,1,2,1,0,4,Lightning,2,0,2,1,5,20200819,1,-1,0,1,9,1,2019,1,2,830,1
Hurricanes,1,0,0,0,1,Bruins,0,2,0,0,2,20200819,-1,1,1,1,3,1,2019,0,2,609,1
Coyotes,0,0,1,0,1,Avalanche,3,3,1,0,7,20200819,3,6,6,6,8,6,2019,0,2,585,1
Canadiens,1,2,2,0,5,Flyers,0,2,1,0,3,20200819,1,1,2,2,8,-2,2019,0,2,400,1
Canucks,1,3,0,0,4,Blues,2,1,0,0,3,20200819,-1,1,1,1,7,-1,2019,0,2,1778,1
Islanders,1,1,2,0,4,Capitals,0,0,0,0,0,20200820,1,2,4,4,4,-4,2019,0,3,204,1
Stars,1,5,1,0,7,Flames,3,0,0,0,3,20200820,-2,3,4,4,10,-4,2019,0,3,1536,1
Blues,0,0,2,0,2,Canucks,1,3,2,0,6,20200821,1,4,4,4,8,4,2019,0,4,1778,1
Flyers,2,1,0,0,3,Canadiens,1,1,0,0,2,20200821,1,1,1,1,5,-1,2019,0,4,400,1
Stars,3,1,1,0,5,Avalanche,1,2,0,0,3,20200822,2,1,2,2,8,-2,2019,0,5,661,1
Canucks,0,0,0,0,0,Golden Knights,1,3,1,0,5,20200823,1,4,5,5,5,5,2019,0,6,986,1
Bruins,1,1,1,0,3,Lightning,0,0,2,0,2,20200823,1,2,1,1,5,-1,2019,0,6,1183,1
Islanders,1,0,3,0,4,Flyers,0,0,0,0,0,20200824,1,1,4,4,4,-4,2019,0,0,80,1
Stars,0,4,1,0,5,Avalanche,1,1,0,0,2,20200824,-1,2,3,3,7,-3,2019,0,0,661,1
Bruins,1,1,1,0,3,Lightning,1,1,1,1,4,20200825,0,0,0,1,7,1,2019,1,1,1183,1
Canucks,2,1,2,0,5,Golden Knights,0,1,1,0,2,20200825,2,2,3,3,7,-3,2019,0,1,986,1
Islanders,0,1,2,0,3,Flyers,3,0,0,1,4,20200826,3,2,0,1,7,1,2019,1,2,80,1
Lightning,2,4,1,0,7,Bruins,0,1,0,0,1,20200826,2,5,6,6,8,-6,2019,0,2,1183,1
Avalanche,0,3,3,0,6,Stars,1,0,3,0,4,20200826,-1,2,2,2,10,-2,2019,0,2,661,1
Flyers,1,0,0,0,1,Islanders,0,2,1,0,3,20200829,-1,1,2,2,4,2,2019,0,5,80,1
Golden Knights,2,0,1,0,3,Canucks,0,0,0,0,0,20200829,2,2,3,3,3,-3,2019,0,5,986,1
Lightning,1,2,0,0,3,Bruins,0,0,1,0,1,20200829,1,3,2,2,4,-2,2019,0,5,1183,1
Avalanche,0,2,2,0,4,Stars,3,0,2,0,5,20200830,3,1,1,1,9,1,2019,0,6,661,1
Flyers,0,1,1,0,2,Islanders,0,1,2,0,3,20200830,0,0,1,1,5,1,2019,0,6,80,1
Golden Knights,2,0,3,0,5,Canucks,1,2,0,0,3,20200830,1,-1,2,2,8,-2,2019,0,6,986,1
Bruins,0,1,1,0,2,Lightning,0,1,1,1,3,20200831,0,0,0,1,5,1,2019,1,0,1183,1
Stars,0,2,1,0,3,Avalanche,5,1,0,0,6,20200831,5,4,3,3,9,3,2019,0,0,661,1
Islanders,0,1,2,0,3,Flyers,0,2,1,1,4,20200901,0,1,0,1,7,1,2019,1,1,80,1
Canucks,0,1,1,0,2,Golden Knights,0,1,0,0,1,20200901,0,0,1,1,3,-1,2019,0,1,986,1
Avalanche,1,1,2,0,4,Stars,1,0,0,0,1,20200902,0,1,3,3,5,-3,2019,0,2,661,1
Golden Knights,0,0,0,0,0,Canucks,1,0,3,0,4,20200903,1,1,4,4,4,4,2019,0,3,986,1
Flyers,2,1,1,1,5,Islanders,1,3,0,0,4,20200903,1,-1,0,1,9,-1,2019,1,3,80,1
Canucks,0,0,0,0,0,Golden Knights,0,0,3,0,3,20200904,0,0,3,3,3,3,2019,0,4,986,1
Stars,1,1,2,1,5,Avalanche,2,1,1,0,4,20200904,-1,-1,0,1,9,-1,2019,1,4,661,1
Islanders,2,1,1,0,4,Flyers,0,0,0,0,0,20200905,2,3,4,4,4,-4,2019,0,5,80,1
Stars,1,0,0,0,1,Golden Knights,0,0,0,0,0,20200906,1,1,1,1,1,-1,2019,0,6,1068,1
Islanders,1,0,1,0,2,Lightning,3,2,3,0,8,20200907,2,4,6,6,10,6,2019,0,0,1004,1
Stars,0,0,0,0,0,Golden Knights,0,3,0,0,3,20200908,0,3,3,3,3,3,2019,0,1,1068,1
Islanders,1,0,0,0,1,Lightning,1,0,1,0,2,20200909,0,0,1,1,3,1,2019,0,2,1004,1
Golden Knights,0,0,2,0,2,Stars,0,1,1,1,3,20200910,0,1,0,1,5,1,2019,1,3,1068,1
Lightning,1,0,2,0,3,Islanders,1,2,2,0,5,20200911,0,2,2,2,8,2,2019,0,4,1004,1
Golden Knights,0,1,0,0,1,Stars,0,2,0,0,2,20200912,0,1,1,1,3,1,2019,0,5,1068,1
Lightning,0,2,2,0,4,Islanders,0,1,0,0,1,20200913,0,1,3,3,5,-3,2019,0,6,1004,1
Stars,0,0,2,1,3,Golden Knights,1,0,1,0,2,20200914,-1,-1,0,1,5,-1,2019,1,0,1068,1
Islanders,1,0,0,1,2,Lightning,0,1,0,0,1,20200915,1,0,0,1,3,-1,2019,1,1,1004,1
Lightning,1,0,0,1,2,Islanders,1,0,0,0,1,20200917,0,0,0,1,3,-1,2019,1,3,1004,1
Stars,1,2,1,0,4,Lightning,1,0,0,0,1,20200919,0,2,3,3,5,-3,2019,0,5,916,1
Stars,0,1,1,0,2,Lightning,3,0,0,0,3,20200921,3,2,1,1,5,1,2019,0,0,916,1
Lightning,2,3,0,0,5,Stars,1,0,1,0,2,20200923,1,4,3,3,7,-3,2019,0,2,916,1
Lightning,1,2,1,1,5,Stars,2,1,1,0,4,20200925,-1,0,0,1,9,-1,2019,1,4,916,1
Stars,1,0,1,1,3,Lightning,0,1,1,0,2,20200926,1,0,0,1,5,-1,2019,1,5,916,1
Lightning,1,1,0,0,2,Stars,0,0,0,0,0,20200928,1,2,2,2,2,-2,2019,0,0,916,1
Blues,2,0,2,0,4,Avalanche,1,0,0,0,1,20210113,1,1,3,3,5,-3,2020,0,2,794,0
Canucks,1,1,3,0,5,Oilers,0,1,2,0,3,20210113,1,1,2,2,8,-2,2020,0,2,514,0
Canadiens,2,1,1,0,4,Maple Leafs,1,2,1,1,5,20210113,-1,0,0,1,9,1,2020,1,2,303,0
Penguins,1,1,1,0,3,Flyers,2,1,3,0,6,20210113,1,1,3,3,9,3,2020,0,2,257,0
Blackhawks,0,0,1,0,1,Lightning,3,1,1,0,5,20210113,3,4,4,4,6,4,2020,0,2,1004,0
Ducks,2,0,0,0,2,Golden Knights,2,0,3,0,5,20210114,0,0,3,3,7,3,2020,0,3,228,0
Wild,1,0,2,1,4,Kings,1,2,0,0,3,20210114,0,-2,0,1,7,-1,2020,1,3,1521,0
Sharks,2,0,1,1,4,Coyotes,0,1,2,0,3,20210114,2,1,0,1,7,-1,2020,1,3,614,0
Flames,3,0,0,0,3,Jets,1,2,0,1,4,20210114,-2,0,0,1,7,1,2020,1,3,740,0
Canucks,0,2,0,0,2,Oilers,2,2,1,0,5,20210114,2,2,3,3,7,3,2020,0,3,514,0
Hurricanes,1,0,2,0,3,Red Wings,0,0,0,0,0,20210114,1,1,3,3,3,-3,2020,0,3,511,0
Islanders,3,1,0,0,4,Rangers,0,0,0,0,0,20210114,3,4,4,4,4,-4,2020,0,3,0,0
Bruins,1,0,1,1,3,Devils,0,0,2,0,2,20210114,1,1,0,1,5,-1,2020,1,3,196,0
Capitals,2,2,2,0,6,Sabres,1,1,2,0,4,20210114,1,2,2,2,10,-2,2020,0,3,292,0
Blue Jackets,1,0,0,0,1,Predators,0,1,2,0,3,20210114,-1,0,2,2,4,2,2020,0,3,333,0
Blues,0,0,0,0,0,Avalanche,0,4,4,0,8,20210115,0,4,8,8,8,8,2020,0,4,794,0
Capitals,0,1,1,0,2,Sabres,0,0,1,0,1,20210115,0,1,1,1,3,-1,2020,0,4,292,0
Penguins,2,0,0,0,2,Flyers,3,0,2,0,5,20210115,1,1,3,3,7,3,2020,0,4,257,0
Blackhawks,0,2,0,0,2,Lightning,0,3,2,0,5,20210115,0,1,3,3,7,3,2020,0,4,1004,0
Maple Leafs,1,1,1,0,3,Senators,1,3,1,0,5,20210115,0,2,2,2,8,2,2020,0,4,203,0
Wild,1,0,2,1,4,Kings,1,2,0,0,3,20210116,0,-2,0,1,7,-1,2020,1,5,1521,0
Hurricanes,0,0,2,0,2,Red Wings,0,1,3,0,4,20210116,0,1,2,2,6,2,2020,0,5,511,0
Ducks,0,1,0,0,1,Golden Knights,0,0,1,1,2,20210116,0,-1,0,1,3,1,2020,1,5,228,0
Canucks,0,0,0,0,0,Flames,1,1,1,0,3,20210116,1,2,3,3,3,3,2020,0,5,426,0
Blue Jackets,1,0,1,0,2,Predators,1,0,4,0,5,20210116,0,0,3,3,7,3,2020,0,5,333,0
Islanders,0,0,0,0,0,Rangers,2,2,1,0,5,20210116,2,4,5,5,5,5,2020,0,5,0,0
Maple Leafs,1,1,1,0,3,Senators,1,0,1,0,2,20210116,0,1,1,1,5,-1,2020,0,5,203,0
Sharks,2,0,1,0,3,Coyotes,2,2,1,0,5,20210116,0,2,2,2,8,2,2020,0,5,614,0
Bruins,0,1,0,0,1,Devils,1,0,0,1,2,20210116,1,0,0,1,3,1,2020,1,5,196,0
Canadiens,1,3,1,0,5,Oilers,0,0,1,0,1,20210116,1,4,4,4,6,-4,2020,0,5,1826,0
Capitals,2,1,0,0,3,Penguins,1,2,0,1,4,20210117,-1,0,0,1,7,1,2020,1,6,190,0
Blackhawks,0,1,1,0,2,Panthers,0,2,3,0,5,20210117,0,1,3,3,7,3,2020,0,6,1189,0
Wild,0,0,0,0,0,Ducks,0,0,1,0,1,20210118,0,0,1,1,1,1,2020,0,0,1521,0
Blue Jackets,0,1,2,0,3,Red Wings,1,0,1,0,2,20210118,-1,0,1,1,5,-1,2020,0,0,163,0
Bruins,0,0,0,0,0,Islanders,0,0,1,0,1,20210118,0,0,1,1,1,1,2020,0,0,190,0
Jets,0,1,0,0,1,Maple Leafs,0,2,1,0,3,20210118,0,1,2,2,4,2,2020,0,0,946,0
Sabres,1,3,2,0,6,Flyers,0,0,1,0,1,20210118,1,4,5,5,7,-5,2020,0,0,279,0
Sharks,2,1,1,0,4,Blues,0,4,1,0,5,20210118,-2,1,1,1,9,1,2020,0,0,1719,0
Hurricanes,0,1,3,0,4,Predators,0,1,1,0,2,20210118,0,0,2,2,6,-2,2020,0,0,456,0
Canucks,1,0,1,0,2,Flames,0,3,2,0,5,20210118,-1,2,3,3,7,3,2020,0,0,426,0
Canadiens,1,1,1,0,3,Oilers,0,0,1,0,1,20210118,1,2,2,2,4,-2,2020,0,0,1826,0
Coyotes,1,1,0,0,2,Golden Knights,0,1,3,0,4,20210118,-1,-1,2,2,6,2,2020,0,0,256,0
Jets,1,1,1,1,4,Senators,2,1,0,0,3,20210119,-1,-1,0,1,7,-1,2020,1,1,1033,0
Blue Jackets,0,1,1,0,2,Red Wings,0,2,0,1,3,20210119,0,1,0,1,5,1,2020,1,1,163,0
Avalanche,1,2,0,0,3,Kings,0,0,2,0,2,20210119,1,3,1,1,5,-1,2020,0,1,830,0
Blackhawks,1,2,1,0,4,Panthers,2,1,1,1,5,20210119,1,0,0,1,9,1,2020,1,1,1189,0
Sabres,0,0,0,0,0,Flyers,0,1,2,0,3,20210119,0,1,3,3,3,3,2020,0,1,279,0
Capitals,3,1,0,0,4,Penguins,1,3,0,1,5,20210119,-2,0,0,1,9,1,2020,1,1,190,0
Devils,1,3,0,0,4,Rangers,0,2,1,0,3,20210119,1,2,1,1,7,-1,2020,0,1,8,0
Oilers,1,0,2,0,3,Maple Leafs,0,0,1,0,1,20210120,1,1,2,2,4,-2,2020,0,2,1683,0
Sharks,0,1,0,1,2,Blues,0,1,0,0,1,20210120,0,0,0,1,3,-1,2020,1,2,1719,0
Wild,1,1,1,0,3,Ducks,0,2,0,0,2,20210120,1,0,1,1,5,-1,2020,0,2,1521,0
Canadiens,0,3,2,0,5,Canucks,1,2,2,1,6,20210120,1,0,0,1,11,1,2020,1,2,2273,0
Coyotes,0,1,1,0,2,Golden Knights,2,1,2,0,5,20210120,2,2,3,3,7,3,2020,0,2,256,0
Canadiens,2,4,1,0,7,Canucks,2,0,1,0,3,20210121,0,4,4,4,10,-4,2020,0,3,2273,0
Flyers,0,2,2,0,4,Bruins,0,0,4,1,5,20210121,0,-2,0,1,9,1,2020,1,3,270,0
Devils,0,1,0,0,1,Islanders,2,0,2,0,4,20210121,2,1,3,3,5,3,2020,0,3,8,0
Lightning,0,2,0,1,3,Blue Jackets,1,0,1,0,2,20210121,-1,1,0,1,5,-1,2020,1,3,830,0
Jets,1,3,0,0,4,Senators,0,0,1,0,1,20210121,1,4,3,3,5,-3,2020,0,3,1033,0
Avalanche,2,0,0,0,2,Kings,0,2,2,0,4,20210121,-2,0,2,2,6,2,2020,0,3,830,0
Golden Knights,0,1,1,0,2,Coyotes,1,2,2,0,5,20210122,1,2,3,3,7,3,2020,0,4,256,0
Predators,0,0,0,0,0,Stars,0,5,2,0,7,20210122,0,5,7,7,7,7,2020,0,4,616,0
Sharks,1,0,0,0,1,Wild,1,1,2,0,4,20210122,0,1,3,3,5,3,2020,0,4,1570,0
Avalanche,1,0,1,1,3,Ducks,0,1,1,0,2,20210122,1,0,0,1,5,-1,2020,1,4,830,0
Oilers,0,1,1,0,2,Maple Leafs,0,2,2,0,4,20210122,0,1,2,2,6,2,2020,0,4,1683,0
Rangers,0,3,0,0,3,Penguins,1,1,1,1,4,20210122,1,-1,0,1,7,1,2020,1,4,314,0
Sabres,1,2,0,0,3,Capitals,1,2,0,1,4,20210122,0,0,0,1,7,1,2020,1,4,292,0
Red Wings,0,0,1,0,1,Blackhawks,1,1,2,0,4,20210122,1,2,3,3,5,3,2020,0,4,238,0
Senators,0,3,0,0,3,Jets,1,1,4,0,6,20210123,1,-1,3,3,9,3,2020,0,5,1033,0
Kings,0,2,0,0,2,Blues,1,2,1,0,4,20210123,1,1,2,2,6,2,2020,0,5,1586,0
Flyers,0,1,0,0,1,Bruins,1,2,3,0,6,20210123,1,2,5,5,7,5,2020,0,5,270,0
Lightning,2,0,0,0,2,Blue Jackets,3,0,2,0,5,20210123,1,1,3,3,7,3,2020,0,5,830,0
Canadiens,1,1,3,0,5,Canucks,0,0,2,0,2,20210123,1,2,3,3,7,-3,2020,0,5,2273,0
Red Wings,0,1,1,0,2,Blackhawks,2,1,3,0,6,20210124,2,2,4,4,8,4,2020,0,6,238,0
Sabres,0,2,1,1,4,Capitals,1,1,1,0,3,20210124,-1,0,0,1,7,-1,2020,1,6,292,0
Maple Leafs,1,1,1,0,3,Flames,0,1,1,0,2,20210124,1,1,1,1,5,-1,2020,0,6,1682,0
Golden Knights,0,0,1,0,1,Coyotes,0,0,0,0,0,20210124,0,0,1,1,1,-1,2020,0,6,256,0
Islanders,0,0,0,0,0,Devils,2,0,0,0,2,20210124,2,2,2,2,2,2,2020,0,6,8,0
Rangers,1,1,0,0,2,Penguins,0,1,2,0,3,20210124,-1,-1,1,1,5,1,2020,0,6,314,0
Kings,2,3,1,0,6,Blues,1,0,2,0,3,20210124,1,4,3,3,9,-3,2020,0,6,1586,0
Sharks,1,2,2,0,5,Wild,1,1,1,0,3,20210124,0,1,2,2,8,-2,2020,0,6,1570,0
Predators,0,1,1,0,2,Stars,1,1,1,0,3,20210124,1,1,1,1,5,1,2020,0,6,616,0
Avalanche,0,0,1,0,1,Ducks,1,1,1,0,3,20210124,1,2,2,2,4,2,2020,0,6,830,0
Oilers,0,2,2,0,4,Jets,1,0,2,0,3,20210124,-1,1,1,1,7,-1,2020,0,6,738,0
Senators,0,1,0,0,1,Canucks,2,2,3,0,7,20210125,2,3,6,6,8,6,2020,0,0,2191,0
Maple Leafs,2,1,1,0,4,Flames,0,2,1,0,3,20210126,2,1,1,1,7,-1,2020,0,1,1682,0
Sharks,1,1,1,0,3,Avalanche,3,4,0,0,7,20210126,2,5,4,4,10,4,2020,0,1,927,0
Islanders,1,1,0,0,2,Capitals,1,1,1,0,3,20210126,0,0,1,1,5,1,2020,0,1,204,0
Blues,3,1,0,1,5,Golden Knights,1,1,2,0,4,20210126,2,2,0,1,9,-1,2020,1,1,1375,0
Red Wings,1,0,0,0,1,Stars,0,1,0,1,2,20210126,-1,0,0,1,3,1,2020,1,1,999,0
Ducks,1,0,0,0,1,Coyotes,0,0,0,0,0,20210126,1,1,1,1,1,-1,2020,0,1,356,0
Kings,0,1,1,0,2,Wild,0,0,1,0,1,20210126,0,1,1,1,3,-1,2020,0,1,1521,0
Flyers,1,1,3,0,5,Devils,0,2,1,0,3,20210126,1,0,2,2,8,-2,2020,0,1,75,0
Blackhawks,1,1,0,0,2,Predators,0,1,1,1,3,20210126,-1,-1,0,1,5,1,2020,1,1,395,0
Panthers,1,1,1,1,4,Blue Jackets,2,0,1,0,3,20210126,-1,0,0,1,7,-1,2020,1,1,993,0
Rangers,2,0,0,0,2,Sabres,1,2,0,0,3,20210126,-1,1,1,1,5,1,2020,0,1,292,0
Penguins,0,0,2,0,2,Bruins,1,1,0,1,3,20210126,1,2,0,1,5,1,2020,1,1,481,0
Oilers,3,0,1,0,4,Jets,2,0,4,0,6,20210126,-1,-1,2,2,10,2,2020,0,1,738,0
Blackhawks,0,0,1,0,1,Predators,0,0,1,1,2,20210127,0,0,0,1,3,1,2020,1,2,395,0
Senators,1,0,0,0,1,Canucks,1,3,1,0,5,20210127,0,3,4,4,6,4,2020,0,2,2191,0
Senators,0,1,0,0,1,Canucks,2,1,1,0,4,20210128,2,2,3,3,5,3,2020,0,3,2191,0
Maple Leafs,2,0,2,0,4,Oilers,0,1,2,0,3,20210128,2,1,1,1,7,-1,2020,0,3,1683,0
Sharks,0,0,0,0,0,Avalanche,0,0,3,0,3,20210128,0,0,3,3,3,3,2020,0,3,927,0
Red Wings,0,1,2,0,3,Stars,1,2,4,0,7,20210128,1,2,4,4,10,4,2020,0,3,999,0
Kings,0,2,1,0,3,Wild,3,1,1,0,5,20210128,3,2,2,2,8,2,2020,0,3,1521,0
Flames,0,0,2,0,2,Canadiens,2,2,0,0,4,20210128,2,4,2,2,6,2,2020,0,3,1852,0
Ducks,1,0,1,0,2,Coyotes,0,1,2,0,3,20210128,-1,0,1,1,5,1,2020,0,3,356,0
Lightning,0,0,0,0,0,Hurricanes,0,0,0,1,1,20210128,0,0,0,1,1,1,2020,1,3,585,0
Islanders,3,0,0,0,3,Capitals,0,5,1,0,6,20210128,-3,2,3,3,9,3,2020,0,3,204,0
Flyers,1,0,2,0,3,Devils,1,0,0,0,1,20210128,0,0,2,2,4,-2,2020,0,3,75,0
Rangers,1,1,0,1,3,Sabres,1,0,1,0,2,20210128,0,1,0,1,5,-1,2020,1,3,292,0
Penguins,1,0,0,0,1,Bruins,2,1,1,0,4,20210128,1,2,3,3,5,3,2020,0,3,481,0
Panthers,0,1,1,0,2,Blue Jackets,1,0,1,1,3,20210128,1,0,0,1,5,1,2020,1,3,993,0
Blue Jackets,1,1,0,0,2,Blackhawks,0,1,0,0,1,20210129,1,1,1,1,3,-1,2020,0,4,275,0
Canucks,2,1,1,0,4,Jets,1,0,0,0,1,20210130,1,2,3,3,5,-3,2020,0,5,1157,0
Blues,3,1,2,0,6,Ducks,1,0,0,0,1,20210130,2,3,5,5,7,-5,2020,0,5,1586,0
Avalanche,2,1,2,0,5,Wild,1,0,0,0,1,20210130,1,2,4,4,6,-4,2020,0,5,698,0
Maple Leafs,1,2,0,0,3,Oilers,2,1,0,1,4,20210130,1,0,0,1,7,1,2020,1,5,1683,0
Flames,1,0,1,0,2,Canadiens,0,0,0,0,0,20210130,1,1,2,2,2,-2,2020,0,5,1852,0
Panthers,2,0,0,1,3,Red Wings,2,0,0,0,2,20210130,0,0,0,1,5,-1,2020,1,5,1155,0
Bruins,0,1,2,0,3,Capitals,1,2,0,1,4,20210130,1,2,0,1,7,1,2020,1,5,394,0
Stars,0,0,1,0,1,Hurricanes,2,2,0,0,4,20210130,2,4,3,3,5,3,2020,0,5,1055,0
Islanders,0,2,0,0,2,Flyers,2,0,0,1,3,20210130,2,0,0,1,5,1,2020,1,5,80,0
Penguins,2,1,1,1,5,Rangers,1,3,0,0,4,20210130,1,-1,0,1,9,-1,2020,1,5,314,0
Devils,0,1,2,0,3,Sabres,0,1,2,1,4,20210130,0,0,0,1,7,1,2020,1,5,284,0
Predators,1,0,2,0,3,Lightning,0,4,0,0,4,20210130,-1,3,1,1,7,1,2020,0,5,621,0
Avalanche,1,1,1,0,3,Wild,1,1,1,1,4,20210131,0,0,0,1,7,1,2020,1,6,698,0
Blues,0,2,2,0,4,Ducks,1,0,0,0,1,20210131,-1,1,3,3,5,-3,2020,0,6,1586,0
Senators,3,0,2,0,5,Oilers,5,3,0,0,8,20210131,2,5,3,3,13,3,2020,0,6,1754,0
Blue Jackets,1,0,0,0,1,Blackhawks,1,0,2,0,3,20210131,0,0,2,2,4,2,2020,0,6,275,0
Panthers,0,2,1,0,3,Red Wings,1,0,1,0,2,20210131,-1,1,1,1,5,-1,2020,0,6,1155,0
Stars,0,1,2,0,3,Hurricanes,1,1,1,1,4,20210131,1,1,0,1,7,1,2020,1,6,1055,0
Devils,2,1,2,0,5,Sabres,0,2,1,0,3,20210131,2,1,2,2,8,-2,2020,0,6,284,0
Islanders,0,1,2,0,3,Flyers,1,2,0,1,4,20210131,1,2,0,1,7,1,2020,1,6,80,0
Penguins,1,0,0,0,1,Rangers,0,1,2,0,3,20210201,-1,0,2,2,4,2,2020,0,0,314,0
Bruins,0,1,4,0,5,Capitals,2,1,0,0,3,20210201,-2,-2,2,2,8,-2,2020,0,0,394,0
Predators,0,0,2,0,2,Lightning,3,1,1,0,5,20210201,3,4,3,3,7,3,2020,0,0,621,0
Canucks,1,0,1,0,2,Canadiens,3,3,0,0,6,20210201,2,5,4,4,8,4,2020,0,0,2273,0
Flames,0,1,2,1,4,Jets,2,0,1,0,3,20210201,-2,-1,0,1,7,-1,2020,1,0,740,0
Ducks,1,1,1,0,3,Kings,0,1,0,0,1,20210202,1,1,2,2,4,-2,2020,0,1,0,0
Senators,0,1,1,0,2,Oilers,3,1,0,0,4,20210202,3,3,2,2,6,2,2020,0,1,1754,0
Wild,0,1,0,0,1,Avalanche,1,1,0,0,2,20210202,1,1,1,1,3,1,2020,0,1,698,0
Flames,1,0,1,0,2,Jets,3,0,0,0,3,20210202,2,2,1,1,5,1,2020,0,1,740,0
Hurricanes,2,0,1,1,4,Blackhawks,2,0,1,0,3,20210202,0,0,0,1,7,-1,2020,1,1,641,0
Canucks,0,1,2,0,3,Canadiens,2,2,1,0,5,20210202,2,3,2,2,8,2,2020,0,1,2273,0
Stars,1,4,1,0,6,Blue Jackets,0,1,2,0,3,20210202,1,4,3,3,9,-3,2020,0,1,912,0
Coyotes,1,1,1,0,3,Blues,1,2,1,0,4,20210202,0,1,1,1,7,1,2020,0,1,1270,0
Red Wings,0,1,0,0,1,Lightning,3,2,0,0,5,20210203,3,4,4,4,6,4,2020,0,2,994,0
Bruins,1,0,2,1,4,Flyers,0,1,2,0,3,20210203,1,0,0,1,7,-1,2020,1,2,270,0
Hurricanes,1,2,1,0,4,Blackhawks,3,0,3,0,6,20210204,2,0,2,2,10,2,2020,0,3,641,0
Flames,1,0,0,0,1,Jets,0,3,1,0,4,20210204,-1,2,3,3,5,3,2020,0,3,740,0
Coyotes,2,1,1,0,4,Blues,0,0,3,0,3,20210204,2,3,1,1,7,-1,2020,0,3,1270,0
Canucks,1,1,1,0,3,Maple Leafs,2,3,2,0,7,20210204,1,3,4,4,10,4,2020,0,3,2090,0
Capitals,0,1,1,0,2,Rangers,1,1,2,0,4,20210204,1,1,2,2,6,2,2020,0,3,204,0
Stars,0,2,1,0,3,Blue Jackets,2,1,1,0,4,20210204,2,1,1,1,7,1,2020,0,3,912,0
Predators,2,1,2,1,6,Panthers,2,3,0,0,5,20210204,0,-2,0,1,11,-1,2020,1,3,816,0
Senators,2,1,0,0,3,Canadiens,1,0,1,0,2,20210204,1,2,1,1,5,-1,2020,0,3,104,0
Bruins,0,0,2,0,2,Flyers,0,0,1,0,1,20210205,0,0,1,1,3,-1,2020,0,4,270,0
Red Wings,1,0,0,0,1,Lightning,1,1,1,0,3,20210205,0,1,2,2,4,2,2020,0,4,994,0
Predators,1,0,0,0,1,Panthers,0,2,0,0,2,20210205,-1,1,1,1,3,1,2020,0,4,816,0
Kings,0,0,2,0,2,Golden Knights,3,2,0,0,5,20210205,3,5,3,3,7,3,2020,0,4,228,0
Sharks,1,0,3,1,5,Ducks,0,3,1,0,4,20210205,1,-2,0,1,9,-1,2020,1,4,305,0
Canadiens,1,0,1,0,2,Senators,1,0,0,0,1,20210206,0,0,1,1,3,-1,2020,0,5,104,0
Coyotes,1,1,1,0,3,Blues,1,0,0,0,1,20210206,0,1,2,2,4,-2,2020,0,5,1270,0
Penguins,1,1,1,0,3,Islanders,2,0,2,0,4,20210206,1,0,1,1,7,1,2020,0,5,314,0
Canucks,0,0,1,0,1,Maple Leafs,2,1,2,0,5,20210206,2,3,4,4,6,4,2020,0,5,2090,0
Oilers,2,0,2,0,4,Flames,1,2,3,0,6,20210206,-1,1,2,2,10,2,2020,0,5,171,0
Sharks,1,0,0,0,1,Ducks,0,1,0,1,2,20210206,-1,0,0,1,3,1,2020,1,5,305,0
Blackhawks,0,1,0,1,2,Stars,0,0,1,0,1,20210207,0,1,0,1,3,-1,2020,1,6,802,0
Hurricanes,1,3,2,0,6,Blue Jackets,2,1,2,0,5,20210207,-1,1,1,1,11,-1,2020,0,6,374,0
Kings,2,1,0,0,3,Golden Knights,3,0,1,0,4,20210207,1,0,1,1,7,1,2020,0,6,228,0
Flyers,1,3,3,0,7,Capitals,2,2,0,0,4,20210207,-1,0,3,3,11,-3,2020,0,6,123,0
Red Wings,0,2,2,0,4,Panthers,0,0,1,0,1,20210207,0,2,3,3,5,-3,2020,0,6,1155,0
Islanders,0,0,2,0,2,Rangers,0,0,0,0,0,20210208,0,0,2,2,2,-2,2020,0,0,0,0
Hurricanes,0,2,0,0,2,Blue Jackets,1,1,1,0,3,20210208,1,0,1,1,5,1,2020,0,0,374,0
Oilers,0,1,2,0,3,Senators,0,1,0,0,1,20210208,0,0,2,2,4,-2,2020,0,0,1754,0
Canucks,0,1,0,0,1,Maple Leafs,1,0,2,0,3,20210208,1,0,2,2,4,2,2020,0,0,2090,0
Lightning,1,1,2,0,4,Predators,0,0,1,0,1,20210208,1,2,3,3,5,-3,2020,0,0,621,0
Coyotes,0,2,1,1,4,Blues,1,1,1,0,3,20210208,-1,0,0,1,7,-1,2020,1,0,1270,0
Sharks,2,0,1,1,4,Kings,0,2,1,0,3,20210209,2,0,0,1,7,-1,2020,1,1,305,0
Ducks,0,1,3,0,4,Golden Knights,2,2,1,0,5,20210209,2,3,1,1,9,1,2020,0,1,228,0
Jets,0,2,0,0,2,Flames,0,2,1,0,3,20210209,0,0,1,1,5,1,2020,0,1,740,0
Blackhawks,0,1,0,1,2,Stars,1,0,0,0,1,20210209,-1,0,0,1,3,-1,2020,1,1,802,0
Oilers,2,1,0,0,3,Senators,1,0,1,0,2,20210209,1,2,1,1,5,-1,2020,0,1,1754,0
Red Wings,1,0,0,0,1,Panthers,1,1,0,0,2,20210209,0,1,1,1,3,1,2020,0,1,1155,0
Lightning,3,0,3,0,6,Predators,1,0,0,0,1,20210209,2,2,5,5,7,-5,2020,0,1,621,0
Bruins,0,1,1,1,3,Rangers,1,0,1,0,2,20210210,-1,0,0,1,5,-1,2020,1,2,190,0
Maple Leafs,0,1,3,0,4,Canadiens,1,0,1,0,2,20210210,-1,0,2,2,6,-2,2020,0,2,303,0
Hurricanes,1,2,2,0,5,Stars,0,3,0,0,3,20210211,1,0,2,2,8,-2,2020,0,3,1055,0
Ducks,0,0,1,0,1,Golden Knights,0,0,0,0,0,20210211,0,0,1,1,1,-1,2020,0,3,228,0
Flames,1,1,1,0,3,Canucks,0,1,0,0,1,20210211,1,1,2,2,4,-2,2020,0,3,426,0
Sharks,1,1,0,0,2,Kings,3,0,3,0,6,20210211,2,1,4,4,8,4,2020,0,3,305,0
Senators,0,0,1,0,1,Jets,0,3,2,0,5,20210211,0,3,4,4,6,4,2020,0,3,1033,0
Red Wings,1,1,0,0,2,Predators,1,1,1,0,3,20210211,0,0,1,1,5,1,2020,0,3,470,0
Blue Jackets,1,1,4,0,6,Blackhawks,0,3,2,0,5,20210211,1,-1,1,1,11,-1,2020,0,3,275,0
Lightning,0,1,1,0,2,Panthers,1,3,1,0,5,20210211,1,3,3,3,7,3,2020,0,3,205,0
Penguins,1,1,1,1,4,Islanders,2,0,1,0,3,20210211,-1,0,0,1,7,-1,2020,1,3,314,0
Oilers,1,1,1,0,3,Canadiens,0,0,0,0,0,20210211,1,2,3,3,3,-3,2020,0,3,1826,0
Bruins,0,1,0,0,1,Rangers,0,0,0,0,0,20210212,0,1,1,1,1,-1,2020,0,4,190,0
Blues,1,0,3,0,4,Coyotes,0,1,0,0,1,20210212,1,0,3,3,5,-3,2020,0,4,1270,0
Flames,0,1,0,0,1,Canucks,0,1,2,0,3,20210213,0,0,2,2,4,2,2020,0,5,426,0
Blues,2,1,1,1,5,Coyotes,1,1,2,0,4,20210213,1,1,0,1,9,-1,2020,1,5,1270,0
Hurricanes,0,2,1,1,4,Stars,0,1,2,0,3,20210213,0,1,0,1,7,-1,2020,1,5,1055,0
Red Wings,2,1,1,0,4,Predators,0,0,2,0,2,20210213,2,3,2,2,6,-2,2020,0,5,470,0
Blue Jackets,1,1,0,0,2,Blackhawks,0,1,1,1,3,20210213,-1,-1,0,1,5,1,2020,1,5,275,0
Canadiens,0,0,2,0,2,Maple Leafs,1,0,0,0,1,20210213,-1,-1,1,1,3,-1,2020,0,5,303,0
Bruins,1,1,0,0,2,Islanders,2,0,2,0,4,20210213,1,0,2,2,6,2,2020,0,5,190,0
Golden Knights,1,1,1,0,3,Sharks,0,1,0,0,1,20210213,1,1,2,2,4,-2,2020,0,5,382,0
Senators,0,1,1,0,2,Jets,0,1,0,0,1,20210213,0,0,1,1,3,-1,2020,0,5,1033,0
Lightning,0,4,2,0,6,Panthers,0,0,1,0,1,20210213,0,4,5,5,7,-5,2020,0,5,205,0
Capitals,1,2,0,0,3,Penguins,2,2,2,0,6,20210214,1,1,3,3,9,3,2020,0,6,190,0
Avalanche,0,0,0,0,0,Golden Knights,0,1,0,0,1,20210214,0,1,1,1,1,1,2020,0,6,604,0
Jets,2,3,1,0,6,Oilers,1,3,1,0,5,20210215,1,1,1,1,11,-1,2020,0,0,738,0
Ducks,1,0,1,0,2,Sharks,1,2,0,0,3,20210215,0,2,1,1,5,1,2020,0,0,305,0
Flames,1,2,0,1,4,Canucks,2,0,1,0,3,20210215,-1,1,0,1,7,-1,2020,1,0,426,0
Blackhawks,2,0,0,1,3,Red Wings,1,0,1,0,2,20210215,1,1,0,1,5,-1,2020,1,0,238,0
Blues,0,0,0,0,0,Coyotes,0,1,0,0,1,20210215,0,1,1,1,1,1,2020,0,0,1270,0
Blue Jackets,3,0,0,0,3,Hurricanes,2,3,2,0,7,20210215,-1,2,4,4,10,4,2020,0,0,374,0
Senators,1,1,3,1,6,Maple Leafs,2,3,0,0,5,20210215,-1,-3,0,1,11,-1,2020,1,0,203,0
Islanders,2,1,0,0,3,Sabres,0,1,0,0,1,20210215,2,2,2,2,4,-2,2020,0,0,292,0
Panthers,1,4,1,0,6,Lightning,1,3,0,0,4,20210215,0,1,2,2,10,-2,2020,0,0,205,0
Avalanche,1,1,1,0,3,Golden Knights,0,1,1,0,2,20210216,1,1,1,1,5,-1,2020,0,1,604,0
Devils,0,2,3,0,5,Rangers,0,2,0,0,2,20210216,0,0,3,3,7,-3,2020,0,1,8,0
Wild,0,0,0,0,0,Kings,1,1,2,0,4,20210216,1,2,4,4,4,4,2020,0,1,1521,0
Islanders,2,0,1,0,3,Sabres,0,0,0,0,0,20210216,2,2,3,3,3,-3,2020,0,1,292,0
Capitals,0,2,1,0,3,Penguins,0,0,1,0,1,20210216,0,2,2,2,4,-2,2020,0,1,190,0
Panthers,0,1,2,1,4,Hurricanes,2,0,1,0,3,20210217,-2,-1,0,1,7,-1,2020,1,2,696,0
Senators,0,1,0,0,1,Maple Leafs,0,1,1,0,2,20210217,0,0,1,1,3,1,2020,0,2,203,0
Blackhawks,0,1,1,0,2,Red Wings,0,0,0,0,0,20210217,0,1,2,2,2,-2,2020,0,2,238,0
Canucks,1,3,1,0,5,Flames,0,1,0,0,1,20210217,1,3,4,4,6,-4,2020,0,2,426,0
Jets,1,0,1,0,2,Oilers,2,1,0,0,3,20210217,1,2,1,1,5,1,2020,0,2,738,0
Sharks,0,2,0,0,2,Blues,1,0,1,1,3,20210218,1,-1,0,1,5,1,2020,1,3,1719,0
Wild,2,0,1,0,3,Ducks,0,1,0,0,1,20210218,2,1,2,2,4,-2,2020,0,3,1521,0
Kings,2,0,0,1,3,Coyotes,0,2,0,0,2,20210218,2,0,0,1,5,-1,2020,1,3,356,0
Senators,1,1,1,0,3,Maple Leafs,3,3,1,0,7,20210218,2,4,4,4,10,4,2020,0,3,203,0
Sabres,0,0,1,0,1,Capitals,1,1,1,0,3,20210218,1,2,2,2,4,2,2020,0,3,292,0
Islanders,0,0,1,0,1,Penguins,1,1,2,0,4,20210218,1,2,3,3,5,3,2020,0,3,314,0
Rangers,0,1,1,1,3,Flyers,1,0,1,0,2,20210218,-1,0,0,1,5,-1,2020,1,3,80,0
Devils,0,3,0,0,3,Bruins,0,1,1,0,2,20210218,0,2,1,1,5,-1,2020,0,3,196,0
Predators,0,0,0,0,0,Blue Jackets,1,1,1,0,3,20210218,1,2,3,3,3,3,2020,0,3,333,0
Blackhawks,0,2,1,0,3,Hurricanes,1,1,3,0,5,20210219,1,0,2,2,8,2,2020,0,4,641,0
Panthers,4,1,2,0,7,Red Wings,1,0,1,0,2,20210219,3,4,5,5,9,-5,2020,0,4,1155,0
Oilers,1,1,0,0,2,Flames,0,1,0,0,1,20210219,1,1,1,1,3,-1,2020,0,4,171,0
Jets,1,0,1,0,2,Canucks,0,0,0,0,0,20210219,1,1,2,2,2,-2,2020,0,4,1157,0
Flames,1,0,0,0,1,Oilers,3,3,1,0,7,20210220,2,5,6,6,8,6,2020,0,5,171,0
Wild,2,1,2,0,5,Ducks,0,1,0,0,1,20210220,2,2,4,4,6,-4,2020,0,5,1521,0
Sharks,2,2,1,0,5,Blues,0,4,0,0,4,20210220,2,0,1,1,9,-1,2020,0,5,1719,0
Lightning,0,0,0,0,0,Hurricanes,0,2,2,0,4,20210220,0,2,4,4,4,4,2020,0,5,585,0
Kings,0,1,3,0,4,Coyotes,0,1,1,0,2,20210220,0,0,2,2,6,-2,2020,0,5,356,0
Maple Leafs,0,4,1,0,5,Canadiens,0,2,1,0,3,20210220,0,2,2,2,8,-2,2020,0,5,303,0
Golden Knights,0,1,1,0,2,Avalanche,1,1,1,0,3,20210220,1,1,1,1,5,1,2020,0,5,604,0
Islanders,0,1,1,0,2,Penguins,0,1,2,0,3,20210220,0,0,1,1,5,1,2020,0,5,314,0
Panthers,1,0,0,0,1,Red Wings,0,2,0,0,2,20210220,-1,1,1,1,3,1,2020,0,5,1155,0
Rangers,1,2,1,0,4,Capitals,0,1,0,0,1,20210220,1,2,3,3,5,-3,2020,0,5,204,0
Sabres,1,2,0,0,3,Devils,0,0,2,0,2,20210220,1,3,1,1,5,-1,2020,0,5,284,0
Predators,2,0,2,0,4,Blue Jackets,0,2,0,0,2,20210220,2,0,2,2,6,-2,2020,0,5,333,0
Jets,0,1,2,1,4,Canucks,2,0,1,0,3,20210221,-2,-1,0,1,7,-1,2020,1,6,1157,0
Flyers,2,0,1,0,3,Bruins,2,4,1,0,7,20210221,0,4,4,4,10,4,2020,0,6,270,0
Canadiens,1,0,1,0,2,Senators,1,0,1,1,3,20210221,0,0,0,1,5,1,2020,1,6,104,0
Devils,1,1,1,0,3,Capitals,0,1,3,0,4,20210221,-1,-1,1,1,7,1,2020,0,6,198,0
Ducks,2,1,0,0,3,Coyotes,0,3,1,0,4,20210222,-2,0,1,1,7,1,2020,0,0,356,0
Golden Knights,0,3,0,0,3,Avalanche,0,0,0,0,0,20210222,0,3,3,3,3,-3,2020,0,0,604,0
Kings,1,1,1,0,3,Blues,0,0,0,0,0,20210222,1,2,3,3,3,-3,2020,0,0,1586,0
Wild,2,3,1,0,6,Sharks,1,1,0,0,2,20210222,1,3,4,4,8,-4,2020,0,0,1570,0
Stars,1,0,0,0,1,Panthers,0,2,1,0,3,20210222,-1,1,2,2,4,2,2020,0,0,1110,0
Flames,1,1,1,0,3,Maple Leafs,0,0,0,0,0,20210222,1,2,3,3,3,-3,2020,0,0,1682,0
Lightning,0,2,2,0,4,Hurricanes,1,1,0,0,2,20210222,-1,0,2,2,6,-2,2020,0,0,585,0
Sabres,1,0,1,0,2,Islanders,0,1,2,0,3,20210222,-1,0,1,1,5,1,2020,0,0,292,0
Sabres,0,1,3,0,4,Devils,0,0,1,0,1,20210223,0,1,3,3,5,-3,2020,0,1,284,0
Penguins,1,1,0,1,3,Capitals,0,2,0,0,2,20210223,1,0,0,1,5,-1,2020,1,1,190,0
Blackhawks,2,2,1,1,6,Blue Jackets,1,2,2,0,5,20210223,1,1,0,1,11,-1,2020,1,1,275,0
Canadiens,1,2,1,0,4,Senators,2,1,1,1,5,20210223,1,0,0,1,9,1,2020,1,1,104,0
Predators,0,0,2,0,2,Red Wings,0,0,0,0,0,20210223,0,0,2,2,2,-2,2020,0,1,470,0
Oilers,1,0,3,0,4,Canucks,3,0,0,0,3,20210223,-2,-2,1,1,7,-1,2020,0,1,514,0
Wild,1,2,3,0,6,Avalanche,0,1,1,0,2,20210224,1,2,4,4,8,-4,2020,0,2,698,0
Kings,0,2,0,0,2,Blues,0,0,1,0,1,20210224,0,2,1,1,3,-1,2020,0,2,1586,0
Ducks,1,2,0,0,3,Coyotes,0,0,3,1,4,20210224,-1,-3,0,1,7,1,2020,1,2,356,0
Rangers,1,1,1,0,3,Flyers,2,2,0,0,4,20210224,1,2,1,1,7,1,2020,0,2,80,0
Stars,1,0,2,0,3,Panthers,0,0,0,0,0,20210224,1,1,3,3,3,-3,2020,0,2,1110,0
Hurricanes,0,0,0,0,0,Lightning,2,0,1,0,3,20210224,2,2,3,3,3,3,2020,0,2,585,0
Flames,0,0,1,0,1,Maple Leafs,0,0,1,1,2,20210224,0,0,0,1,3,1,2020,1,2,1682,0
Flames,0,1,0,0,1,Senators,2,2,2,0,6,20210225,2,3,5,5,7,5,2020,0,3,1773,0
Bruins,1,1,0,0,2,Islanders,2,0,5,0,7,20210225,1,0,5,5,9,5,2020,0,3,190,0
Penguins,0,0,2,0,2,Capitals,1,0,4,0,5,20210225,1,1,3,3,7,3,2020,0,3,190,0
Hurricanes,1,0,0,0,1,Lightning,0,1,2,0,3,20210225,-1,0,2,2,4,2,2020,0,3,585,0
Stars,0,2,0,0,2,Panthers,0,0,3,0,3,20210225,0,-2,1,1,5,1,2020,0,3,1110,0
Blackhawks,0,0,2,0,2,Blue Jackets,0,0,0,0,0,20210225,0,0,2,2,2,-2,2020,0,3,275,0
Devils,0,1,2,1,4,Sabres,1,1,1,0,3,20210225,-1,-1,0,1,7,-1,2020,1,3,284,0
Predators,1,0,1,0,2,Red Wings,1,1,3,0,5,20210225,0,1,3,3,7,3,2020,0,3,470,0
Canadiens,2,1,0,0,3,Jets,0,3,3,0,6,20210225,-2,0,3,3,9,3,2020,0,3,1115,0
Oilers,0,1,2,0,3,Canucks,0,0,0,0,0,20210225,0,1,3,3,3,-3,2020,0,3,514,0
Bruins,0,1,1,0,2,Rangers,1,3,2,0,6,20210226,1,3,4,4,8,4,2020,0,4,190,0
Kings,0,0,1,0,1,Wild,3,0,0,0,3,20210226,3,3,2,2,4,2,2020,0,4,1521,0
Avalanche,0,1,2,0,3,Coyotes,0,0,2,0,2,20210226,0,1,1,1,5,-1,2020,0,4,585,0
Kings,0,2,1,0,3,Wild,2,1,0,1,4,20210227,2,1,0,1,7,1,2020,1,5,1521,0
Avalanche,1,1,4,0,6,Coyotes,0,1,1,0,2,20210227,1,1,4,4,8,-4,2020,0,5,585,0
Red Wings,1,2,2,0,5,Blackhawks,0,1,2,0,3,20210227,1,2,2,2,8,-2,2020,0,5,238,0
Blues,1,3,3,0,7,Sharks,2,2,2,0,6,20210227,-1,0,1,1,13,-1,2020,0,5,1719,0
Canadiens,0,1,0,0,1,Jets,0,1,0,1,2,20210227,0,0,0,1,3,1,2020,1,5,1115,0
Maple Leafs,2,1,1,0,4,Oilers,0,0,0,0,0,20210227,2,3,4,4,4,-4,2020,0,5,1683,0
Golden Knights,1,1,0,1,3,Ducks,1,0,1,0,2,20210227,0,1,0,1,5,-1,2020,1,5,228,0
Stars,0,0,0,0,0,Lightning,1,3,1,0,5,20210227,1,4,5,5,5,5,2020,0,5,916,0
Flyers,1,2,0,0,3,Sabres,0,0,0,0,0,20210227,1,3,3,3,3,-3,2020,0,5,279,0
Capitals,3,0,2,0,5,Devils,1,1,0,0,2,20210227,2,1,3,3,7,-3,2020,0,5,198,0
Hurricanes,1,0,2,1,4,Panthers,0,0,3,0,3,20210227,1,1,0,1,7,-1,2020,1,5,696,0
Blue Jackets,1,0,0,0,1,Predators,0,2,0,0,2,20210227,-1,1,1,1,3,1,2020,0,5,333,0
Penguins,0,2,1,1,4,Islanders,1,2,0,0,3,20210227,-1,-1,0,1,7,-1,2020,1,5,314,0
Flames,3,3,0,0,6,Senators,1,1,1,0,3,20210227,2,4,3,3,9,-3,2020,0,5,1773,0
Bruins,2,1,1,0,4,Rangers,0,0,1,0,1,20210228,2,3,3,3,5,-3,2020,0,6,190,0
Flyers,0,3,0,0,3,Sabres,0,0,0,0,0,20210228,0,3,3,3,3,-3,2020,0,6,279,0
Blue Jackets,1,0,0,0,1,Predators,1,1,1,0,3,20210228,0,1,2,2,4,2,2020,0,6,333,0
Capitals,1,2,0,0,3,Devils,1,1,0,0,2,20210228,0,1,1,1,5,-1,2020,0,6,198,0
Penguins,0,0,0,0,0,Islanders,1,1,0,0,2,20210228,1,2,2,2,2,2,2020,0,6,314,0
Red Wings,1,0,1,0,2,Blackhawks,2,0,5,0,7,20210228,1,1,5,5,9,5,2020,0,6,238,0
Flames,0,1,0,0,1,Senators,0,3,2,0,5,20210301,0,2,4,4,6,4,2020,0,0,1773,0
Canucks,3,0,1,0,4,Jets,0,0,0,0,0,20210301,3,3,4,4,4,-4,2020,0,0,1157,0
Maple Leafs,3,0,0,0,3,Oilers,0,0,0,0,0,20210301,3,3,3,3,3,-3,2020,0,0,1683,0
Wild,0,4,0,0,4,Golden Knights,0,2,2,1,5,20210301,0,-2,0,1,9,1,2020,1,0,1293,0
Blues,1,3,1,0,5,Ducks,1,0,3,0,4,20210301,0,3,1,1,9,-1,2020,0,0,1586,0
Avalanche,1,1,0,0,2,Sharks,0,2,4,0,6,20210301,-1,0,4,4,8,4,2020,0,0,927,0
Hurricanes,1,0,1,1,3,Panthers,0,0,2,0,2,20210301,1,1,0,1,5,-1,2020,1,0,696,0
Canucks,1,1,0,0,2,Jets,2,1,2,0,5,20210302,1,1,3,3,7,3,2020,0,1,1157,0
Hurricanes,2,1,1,0,4,Predators,0,0,2,0,2,20210302,2,3,2,2,6,-2,2020,0,1,456,0
Lightning,1,0,1,0,2,Stars,0,0,0,0,0,20210302,1,1,2,2,2,-2,2020,0,1,916,0
Senators,0,1,0,0,1,Canadiens,0,2,1,0,3,20210302,0,1,2,2,4,2,2020,0,1,104,0
Flyers,0,1,1,0,2,Penguins,0,3,2,0,5,20210302,0,2,3,3,7,3,2020,0,1,257,0
Sabres,1,1,0,0,2,Rangers,2,1,0,0,3,20210302,1,1,1,1,5,1,2020,0,1,292,0
Islanders,0,0,2,0,2,Devils,0,0,1,0,1,20210302,0,0,1,1,3,-1,2020,0,1,8,0
Red Wings,1,0,0,0,1,Blue Jackets,1,3,0,0,4,20210302,0,3,3,3,5,3,2020,0,1,163,0
Capitals,0,0,1,1,2,Bruins,0,0,1,0,1,20210303,0,0,0,1,3,-1,2020,1,2,394,0
Maple Leafs,1,4,1,0,6,Oilers,0,1,0,0,1,20210303,1,4,5,5,7,-5,2020,0,2,1683,0
Blues,1,1,1,0,3,Ducks,0,1,1,0,2,20210303,1,1,1,1,5,-1,2020,0,2,1586,0
Wild,0,1,0,0,1,Golden Knights,1,1,3,0,5,20210303,1,1,4,4,6,4,2020,0,2,1293,0
Coyotes,0,3,0,0,3,Kings,0,1,1,0,2,20210303,0,2,1,1,5,-1,2020,0,2,356,0
Avalanche,0,1,3,0,4,Sharks,0,0,0,0,0,20210303,0,1,4,4,4,-4,2020,0,2,927,0
Maple Leafs,1,0,0,0,1,Canucks,1,1,1,0,3,20210304,0,1,2,2,4,2,2020,0,3,2090,0
Senators,1,0,2,0,3,Flames,4,1,2,0,7,20210304,3,4,4,4,10,4,2020,0,3,1773,0
Blue Jackets,0,1,2,0,3,Stars,0,0,2,0,2,20210304,0,1,1,1,5,-1,2020,0,3,912,0
Panthers,2,2,1,0,5,Predators,0,2,2,0,4,20210304,2,2,1,1,9,-1,2020,0,3,816,0
Lightning,0,0,2,1,3,Blackhawks,0,2,0,0,2,20210304,0,-2,0,1,5,-1,2020,1,3,1004,0
Red Wings,1,1,0,0,2,Hurricanes,1,1,3,0,5,20210304,0,0,3,3,7,3,2020,0,3,511,0
Rangers,0,2,4,0,6,Devils,1,0,0,0,1,20210304,-1,1,5,5,7,-5,2020,0,3,8,0
Jets,2,0,1,1,4,Canadiens,0,2,1,0,3,20210304,2,0,0,1,7,-1,2020,1,3,1115,0
Flyers,1,1,2,0,4,Penguins,3,0,0,0,3,20210304,-2,-1,1,1,7,-1,2020,0,3,257,0
Sabres,0,1,1,0,2,Islanders,2,1,2,0,5,20210304,2,2,3,3,7,3,2020,0,3,292,0
Golden Knights,2,1,1,1,5,Sharks,0,2,2,0,4,20210305,2,1,0,1,9,-1,2020,1,4,382,0
Blues,1,0,1,1,3,Kings,0,1,1,0,2,20210305,1,0,0,1,5,-1,2020,1,4,1586,0
Wild,3,1,1,0,5,Coyotes,0,0,1,0,1,20210305,3,4,4,4,6,-4,2020,0,4,1278,0
Lightning,2,0,1,0,3,Blackhawks,1,1,1,1,4,20210305,-1,0,0,1,7,1,2020,1,4,1004,0
Capitals,0,0,1,0,1,Bruins,1,3,1,0,5,20210305,1,4,4,4,6,4,2020,0,4,394,0
Ducks,1,1,0,0,2,Avalanche,0,2,0,1,3,20210305,-1,0,0,1,5,1,2020,1,4,830,0
Golden Knights,1,2,1,0,4,Sharks,0,0,0,0,0,20210306,1,3,4,4,4,-4,2020,0,5,382,0
Flames,1,0,1,0,2,Oilers,0,1,2,0,3,20210306,-1,0,1,1,5,1,2020,0,5,171,0
Ducks,1,1,2,1,5,Avalanche,0,2,2,0,4,20210306,1,0,0,1,9,-1,2020,1,5,830,0
Blue Jackets,0,0,0,0,0,Stars,2,1,2,0,5,20210306,2,3,5,5,5,5,2020,0,5,912,0
Wild,2,0,0,0,2,Coyotes,0,2,3,0,5,20210306,-2,0,3,3,7,3,2020,0,5,1278,0
Blues,3,0,0,0,3,Kings,1,2,0,1,4,20210306,-2,0,0,1,7,1,2020,1,5,1586,0
Jets,0,0,1,0,1,Canadiens,1,4,2,0,7,20210306,1,5,6,6,8,6,2020,0,5,1115,0
Panthers,1,3,2,0,6,Predators,1,0,1,0,2,20210306,0,3,4,4,8,-4,2020,0,5,816,0
Flyers,1,2,0,0,3,Penguins,2,1,1,0,4,20210306,1,0,1,1,7,1,2020,0,5,257,0
Sabres,1,0,1,0,2,Islanders,0,4,1,0,5,20210306,-1,3,3,3,7,3,2020,0,5,292,0
Rangers,3,1,2,0,6,Devils,2,0,1,0,3,20210306,1,2,3,3,9,-3,2020,0,5,8,0
Maple Leafs,1,1,0,0,2,Canucks,1,0,3,0,4,20210306,0,-1,2,2,6,2,2020,0,5,2090,0
Senators,2,1,0,1,4,Flames,0,1,2,0,3,20210307,2,2,0,1,7,-1,2020,1,6,1773,0
Predators,2,1,0,1,4,Stars,0,0,3,0,3,20210307,2,3,0,1,7,-1,2020,1,6,616,0
Rangers,1,0,0,0,1,Penguins,3,0,2,0,5,20210307,2,2,4,4,6,4,2020,0,6,314,0
Capitals,0,2,1,0,3,Flyers,1,0,0,0,1,20210307,-1,1,2,2,4,-2,2020,0,6,123,0
Panthers,0,1,1,0,2,Hurricanes,1,1,2,0,4,20210307,1,1,2,2,6,2,2020,0,6,696,0
Lightning,0,4,2,0,6,Blackhawks,2,1,0,0,3,20210307,-2,1,3,3,9,-3,2020,0,6,1004,0
Sabres,0,0,2,0,2,Islanders,0,3,2,0,5,20210307,0,3,3,3,7,3,2020,0,6,292,0
Devils,0,0,1,0,1,Bruins,0,0,0,0,0,20210307,0,0,1,1,1,-1,2020,0,6,196,0
Canadiens,1,0,0,0,1,Canucks,0,0,1,1,2,20210308,-1,-1,0,1,3,1,2020,1,0,2273,0
Kings,1,2,2,0,5,Ducks,2,3,0,1,6,20210308,1,2,0,1,11,1,2020,1,0,0,0
Blues,1,1,0,0,2,Sharks,0,1,1,1,3,20210308,-1,-1,0,1,5,1,2020,1,0,1719,0
Golden Knights,0,0,0,0,0,Wild,1,0,1,0,2,20210308,1,1,2,2,2,2,2020,0,0,1293,0
Senators,1,1,0,0,2,Oilers,1,2,0,0,3,20210308,0,1,1,1,5,1,2020,0,0,1754,0
Coyotes,2,0,1,0,3,Avalanche,0,2,0,0,2,20210308,2,0,1,1,5,-1,2020,0,0,585,0
Lightning,2,0,1,1,4,Red Wings,1,2,0,0,3,20210309,1,-1,0,1,7,-1,2020,1,1,994,0
Jets,1,2,1,0,4,Maple Leafs,2,0,1,0,3,20210309,-1,1,1,1,7,-1,2020,0,1,946,0
Panthers,1,2,1,0,4,Blue Jackets,0,1,1,0,2,20210309,1,2,2,2,6,-2,2020,0,1,993,0
Predators,0,2,0,0,2,Hurricanes,0,2,0,1,3,20210309,0,0,0,1,5,1,2020,1,1,456,0
Blackhawks,0,1,0,0,1,Stars,2,3,1,0,6,20210309,2,4,5,5,7,5,2020,0,1,802,0
Sabres,3,1,0,0,4,Flyers,1,2,1,1,5,20210309,-2,-1,0,1,9,1,2020,1,1,279,0
Bruins,1,0,0,0,1,Islanders,0,1,0,1,2,20210309,-1,0,0,1,3,1,2020,1,1,190,0
Rangers,1,0,1,0,2,Penguins,1,2,1,0,4,20210309,0,2,2,2,6,2,2020,0,1,314,0
Devils,0,1,3,0,4,Capitals,1,3,0,1,5,20210309,1,3,0,1,9,1,2020,1,1,198,0
Golden Knights,1,0,2,0,3,Wild,1,0,3,0,4,20210310,0,0,1,1,7,1,2020,0,2,1293,0
Senators,0,0,1,0,1,Oilers,4,2,1,0,7,20210310,4,6,6,6,8,6,2020,0,2,1754,0
Coyotes,0,1,0,0,1,Avalanche,1,0,0,1,2,20210310,1,0,0,1,3,1,2020,1,2,585,0
Kings,1,2,2,0,5,Ducks,0,1,0,0,1,20210310,1,2,4,4,6,-4,2020,0,2,0,0
Canadiens,1,2,2,0,5,Canucks,0,1,0,0,1,20210310,1,2,4,4,6,-4,2020,0,2,2273,0
Jets,1,1,1,0,3,Maple Leafs,0,1,2,1,4,20210311,-1,-1,0,1,7,1,2020,1,3,946,0
Canadiens,0,0,1,0,1,Flames,0,2,0,0,2,20210311,0,2,1,1,3,1,2020,0,3,1852,0
Blackhawks,1,3,0,0,4,Stars,0,0,2,0,2,20210311,1,4,2,2,6,-2,2020,0,3,802,0
Lightning,2,0,2,0,4,Red Wings,3,2,1,0,6,20210311,1,3,2,2,10,2,2020,0,3,994,0
Panthers,0,1,3,1,5,Blue Jackets,0,2,2,0,4,20210311,0,-1,0,1,9,-1,2020,1,3,993,0
Penguins,1,2,2,0,5,Sabres,1,1,0,0,2,20210311,0,1,3,3,7,-3,2020,0,3,178,0
Capitals,2,2,1,0,5,Flyers,1,0,2,0,3,20210311,1,3,2,2,8,-2,2020,0,3,123,0
Rangers,0,0,0,0,0,Bruins,2,2,0,0,4,20210311,2,4,4,4,4,4,2020,0,3,190,0
Predators,0,0,1,0,1,Hurricanes,3,1,1,0,5,20210311,3,4,4,4,6,4,2020,0,3,456,0
Devils,0,0,3,0,3,Islanders,2,2,1,0,5,20210311,2,4,2,2,8,2,2020,0,3,8,0
Golden Knights,2,1,1,1,5,Blues,0,2,2,0,4,20210312,2,1,0,1,9,-1,2020,1,4,1375,0
Coyotes,0,0,0,0,0,Wild,0,0,4,0,4,20210312,0,0,4,4,4,4,2020,0,4,1278,0
Senators,1,1,0,0,2,Oilers,2,2,2,0,6,20210312,1,2,4,4,8,4,2020,0,4,1754,0
Kings,0,0,0,0,0,Avalanche,0,1,1,0,2,20210312,0,1,2,2,2,2,2020,0,4,830,0
Sharks,1,1,4,0,6,Ducks,0,0,0,0,0,20210312,1,2,6,6,6,-6,2020,0,4,305,0
Oilers,0,1,0,0,1,Canucks,0,1,1,0,2,20210313,0,0,1,1,3,1,2020,0,5,514,0
Golden Knights,1,0,4,0,5,Blues,0,0,1,0,1,20210313,1,1,4,4,6,-4,2020,0,5,1375,0
Canadiens,0,1,0,0,1,Flames,2,1,0,0,3,20210313,2,2,2,2,4,2,2020,0,5,1852,0
Jets,0,2,3,0,5,Maple Leafs,0,2,0,0,2,20210313,0,0,3,3,7,-3,2020,0,5,946,0
Blackhawks,0,1,1,0,2,Panthers,0,3,1,0,4,20210313,0,2,2,2,6,2,2020,0,5,1189,0
Sharks,1,1,1,0,3,Ducks,0,1,0,0,1,20210313,1,1,2,2,4,-2,2020,0,5,305,0
Capitals,2,2,1,0,5,Flyers,0,2,2,0,4,20210313,2,2,1,1,9,-1,2020,0,5,123,0
Islanders,1,0,2,0,3,Devils,1,1,0,0,2,20210313,0,-1,1,1,5,-1,2020,0,5,8,0
Penguins,0,1,2,0,3,Sabres,0,0,0,0,0,20210313,0,1,3,3,3,-3,2020,0,5,178,0
Stars,1,1,1,0,3,Blue Jackets,1,2,0,1,4,20210313,0,1,0,1,7,1,2020,1,5,912,0
Rangers,1,1,2,0,4,Bruins,0,0,0,0,0,20210313,1,2,4,4,4,-4,2020,0,5,190,0
Predators,0,1,2,0,3,Lightning,2,2,2,0,6,20210313,2,3,3,3,9,3,2020,0,5,621,0
Kings,0,0,1,0,1,Avalanche,1,2,1,0,4,20210314,1,3,3,3,5,3,2020,0,6,830,0
Islanders,2,0,0,1,3,Devils,1,1,0,0,2,20210314,1,0,0,1,5,-1,2020,1,6,8,0
Maple Leafs,1,0,2,0,3,Senators,2,2,0,0,4,20210314,1,3,1,1,7,1,2020,0,6,203,0
Hurricanes,0,1,1,0,2,Red Wings,0,0,1,0,1,20210314,0,1,1,1,3,-1,2020,0,6,511,0
Coyotes,1,0,0,0,1,Wild,0,1,3,0,4,20210314,-1,0,3,3,5,3,2020,0,6,1278,0
Stars,1,0,0,1,2,Blue Jackets,0,0,1,0,1,20210314,1,1,0,1,3,-1,2020,1,6,912,0
Predators,0,3,1,0,4,Lightning,0,0,1,0,1,20210315,0,3,3,3,5,-3,2020,0,0,621,0
Flyers,2,1,1,1,5,Rangers,0,3,1,0,4,20210315,2,0,0,1,9,-1,2020,1,0,80,0
Blackhawks,1,2,0,0,3,Panthers,1,2,3,0,6,20210315,0,0,3,3,9,3,2020,0,0,1189,0
Bruins,1,0,0,0,1,Penguins,2,1,1,0,4,20210315,1,2,3,3,5,3,2020,0,0,481,0
Canucks,2,0,0,1,3,Senators,0,1,1,0,2,20210315,2,1,0,1,5,-1,2020,1,0,2191,0
Capitals,1,3,2,0,6,Sabres,0,0,0,0,0,20210315,1,4,6,6,6,-6,2020,0,0,292,0
Canadiens,1,2,1,0,4,Jets,0,1,1,0,2,20210315,1,2,2,2,6,-2,2020,0,0,1115,0
Oilers,0,2,1,0,3,Flames,0,3,1,0,4,20210315,0,1,1,1,7,1,2020,0,0,171,0
Sharks,0,0,1,0,1,Golden Knights,1,0,1,0,2,20210315,1,1,1,1,3,1,2020,0,0,382,0
Coyotes,0,0,0,0,0,Wild,1,0,2,0,3,20210316,1,1,3,3,3,3,2020,0,1,1278,0
Lightning,1,1,1,1,4,Stars,0,1,2,0,3,20210316,1,1,0,1,7,-1,2020,1,1,916,0
Hurricanes,1,1,0,0,2,Red Wings,2,1,1,0,4,20210316,1,1,2,2,6,2,2020,0,1,511,0
Ducks,4,0,0,0,4,Avalanche,2,2,4,0,8,20210316,-2,0,4,4,12,4,2020,0,1,830,0
Islanders,0,0,1,0,1,Capitals,0,2,1,0,3,20210316,0,2,2,2,4,2,2020,0,1,204,0
Sabres,0,2,0,0,2,Devils,1,1,1,0,3,20210316,1,0,1,1,5,1,2020,0,1,284,0
Bruins,1,0,1,0,2,Penguins,1,0,0,0,1,20210316,0,0,1,1,3,-1,2020,0,1,481,0
Blues,0,1,0,0,1,Kings,3,0,1,0,4,20210317,3,2,3,3,5,3,2020,0,2,1586,0
Sharks,0,3,1,0,4,Golden Knights,1,0,4,0,5,20210317,1,-2,1,1,9,1,2020,0,2,382,0
Oilers,2,1,4,0,7,Flames,0,1,2,0,3,20210317,2,2,4,4,10,-4,2020,0,2,171,0
Canucks,2,0,0,1,3,Senators,0,1,1,0,2,20210317,2,1,0,1,5,-1,2020,1,2,2191,0
Flyers,0,0,0,0,0,Rangers,2,7,0,0,9,20210317,2,9,9,9,9,9,2020,0,2,80,0
Canadiens,0,1,2,0,3,Jets,2,1,0,1,4,20210317,2,2,0,1,7,1,2020,1,2,1115,0
Penguins,0,1,1,0,2,Devils,1,2,0,0,3,20210318,1,2,1,1,5,1,2020,0,3,306,0
Bruins,1,2,1,0,4,Sabres,0,1,0,0,1,20210318,1,2,3,3,5,-3,2020,0,3,399,0
Flyers,0,3,1,0,4,Islanders,0,0,3,0,3,20210318,0,3,1,1,7,-1,2020,0,3,80,0
Blue Jackets,1,1,0,1,3,Hurricanes,0,2,0,0,2,20210318,1,0,0,1,5,-1,2020,1,3,374,0
Blackhawks,2,0,0,0,2,Lightning,2,0,2,0,4,20210318,0,0,2,2,6,2,2020,0,3,1004,0
Predators,0,1,1,0,2,Panthers,1,0,0,0,1,20210318,-1,0,1,1,3,-1,2020,0,3,816,0
Stars,0,0,2,0,2,Red Wings,1,1,1,0,3,20210318,1,2,1,1,5,1,2020,0,3,999,0
Jets,0,1,0,0,1,Oilers,0,2,0,0,2,20210318,0,1,1,1,3,1,2020,0,3,738,0
Wild,0,1,0,0,1,Avalanche,2,1,2,0,5,20210318,2,2,4,4,6,4,2020,0,3,698,0
Coyotes,2,0,0,0,2,Ducks,0,2,0,1,3,20210318,-2,0,0,1,5,1,2020,1,3,356,0
Golden Knights,2,1,1,0,4,Kings,1,1,0,0,2,20210319,1,1,2,2,6,-2,2020,0,4,228,0
Flames,3,1,0,0,4,Maple Leafs,2,1,0,0,3,20210319,1,1,1,1,7,-1,2020,0,4,1682,0
Blues,0,0,1,1,2,Sharks,0,1,0,0,1,20210319,0,-1,0,1,3,-1,2020,1,4,1719,0
Rangers,1,0,0,0,1,Capitals,0,0,2,0,2,20210319,-1,-1,1,1,3,1,2020,0,4,204,0
Canucks,0,2,0,1,3,Canadiens,1,0,1,0,2,20210319,-1,1,0,1,5,-1,2020,1,4,2273,0
Rangers,1,0,2,0,3,Capitals,0,0,1,0,1,20210320,1,1,2,2,4,-2,2020,0,5,204,0
Jets,2,0,0,0,2,Oilers,1,0,3,0,4,20210320,-1,-1,2,2,6,2,2020,0,5,738,0
Blues,2,0,3,0,5,Sharks,1,1,0,0,2,20210320,1,0,3,3,7,-3,2020,0,5,1719,0
Coyotes,3,1,1,0,5,Ducks,0,0,1,0,1,20210320,3,4,4,4,6,-4,2020,0,5,356,0
Flames,0,0,0,0,0,Maple Leafs,1,1,0,0,2,20210320,1,2,2,2,2,2,2020,0,5,1682,0
Canucks,0,2,2,0,4,Canadiens,1,2,1,1,5,20210320,1,1,0,1,9,1,2020,1,5,2273,0
Predators,0,0,0,0,0,Panthers,0,1,1,0,2,20210320,0,1,2,2,2,2,2020,0,5,816,0
Blue Jackets,0,0,2,1,3,Hurricanes,0,1,1,0,2,20210320,0,-1,0,1,5,-1,2020,1,5,374,0
Flyers,1,0,0,0,1,Islanders,4,0,2,0,6,20210320,3,3,5,5,7,5,2020,0,5,80,0
Blackhawks,0,0,1,0,1,Lightning,1,3,0,0,4,20210320,1,4,3,3,5,3,2020,0,5,1004,0
Wild,0,0,0,0,0,Avalanche,2,3,1,0,6,20210320,2,5,6,6,6,6,2020,0,5,698,0
Penguins,0,2,1,0,3,Devils,1,0,0,0,1,20210320,-1,1,2,2,4,-2,2020,0,5,306,0
Stars,0,1,2,0,3,Red Wings,0,0,0,0,0,20210320,0,1,3,3,3,-3,2020,0,5,999,0
Devils,0,1,0,1,2,Penguins,1,0,0,0,1,20210321,-1,0,0,1,3,-1,2020,1,6,306,0
Panthers,1,1,1,0,3,Lightning,1,1,3,0,5,20210321,0,0,2,2,8,2,2020,0,6,205,0
Golden Knights,0,0,1,0,1,Kings,0,2,1,0,3,20210321,0,2,2,2,4,2,2020,0,6,228,0
Predators,1,1,1,1,4,Stars,2,1,0,0,3,20210321,-1,-1,0,1,7,-1,2020,1,6,616,0
Kings,0,1,0,0,1,Sharks,1,0,1,0,2,20210322,1,0,1,1,3,1,2020,0,0,305,0
Blues,0,1,0,0,1,Golden Knights,1,0,4,0,5,20210322,1,0,4,4,6,4,2020,0,0,1375,0
Avalanche,2,1,2,0,5,Coyotes,0,0,1,0,1,20210322,2,3,4,4,6,-4,2020,0,0,585,0
Jets,1,0,3,0,4,Canucks,0,0,0,0,0,20210322,1,1,4,4,4,-4,2020,0,0,1157,0
Ducks,0,1,0,0,1,Wild,0,1,1,0,2,20210322,0,0,1,1,3,1,2020,0,0,1521,0
Flames,0,0,1,0,1,Senators,1,0,1,0,2,20210322,1,1,1,1,3,1,2020,0,0,1773,0
Sabres,0,1,2,0,3,Rangers,0,3,2,0,5,20210322,0,2,2,2,8,2,2020,0,0,292,0
Islanders,0,0,1,1,2,Flyers,0,1,0,0,1,20210322,0,-1,0,1,3,-1,2020,1,0,80,0
Hurricanes,1,2,0,0,3,Blue Jackets,0,0,0,0,0,20210322,1,3,3,3,3,-3,2020,0,0,374,0
Devils,2,2,0,0,4,Flyers,1,0,2,0,3,20210323,1,3,1,1,7,-1,2020,0,1,75,0
Panthers,0,1,1,0,2,Blackhawks,2,1,0,0,3,20210323,2,2,1,1,5,1,2020,0,1,1189,0
Red Wings,0,0,0,0,0,Predators,1,1,0,0,2,20210323,1,2,2,2,2,2,2020,0,1,470,0
Lightning,0,2,0,0,2,Stars,1,0,0,0,1,20210323,-1,1,1,1,3,-1,2020,0,1,916,0
Avalanche,2,1,1,0,4,Coyotes,2,0,2,1,5,20210323,0,-1,0,1,9,1,2020,1,1,585,0
Flames,0,1,0,0,1,Senators,0,0,3,0,3,20210324,0,-1,2,2,4,2,2020,0,2,1773,0
Ducks,1,1,0,0,2,Wild,2,1,0,0,3,20210324,1,1,1,1,5,1,2020,0,2,1521,0
Sabres,1,0,1,0,2,Penguins,2,2,1,0,5,20210324,1,3,3,3,7,3,2020,0,2,178,0
Jets,0,3,2,0,5,Canucks,0,0,1,0,1,20210324,0,3,4,4,6,-4,2020,0,2,1157,0
Kings,0,1,1,0,2,Sharks,0,2,2,0,4,20210324,0,1,2,2,6,2,2020,0,2,305,0
Blues,0,0,0,0,0,Wild,0,2,0,0,2,20210325,0,2,2,2,2,2,2020,0,3,466,0
Golden Knights,1,0,0,0,1,Avalanche,0,4,1,0,5,20210325,-1,3,4,4,6,4,2020,0,3,604,0
Lightning,0,2,1,0,3,Stars,0,3,1,0,4,20210325,0,1,1,1,7,1,2020,0,3,916,0
Panthers,0,0,0,0,0,Blackhawks,0,2,1,0,3,20210325,0,2,3,3,3,3,2020,0,3,1189,0
Sabres,0,0,0,0,0,Penguins,1,1,2,0,4,20210325,1,2,4,4,4,4,2020,0,3,178,0
Red Wings,1,0,0,0,1,Predators,4,1,2,0,7,20210325,3,4,6,6,8,6,2020,0,3,470,0
Hurricanes,0,2,1,1,4,Blue Jackets,0,1,2,0,3,20210325,0,1,0,1,7,-1,2020,1,3,374,0
Devils,1,1,1,0,3,Capitals,1,2,1,0,4,20210325,0,1,1,1,7,1,2020,0,3,198,0
Rangers,3,3,2,0,8,Flyers,0,2,1,0,3,20210325,3,4,5,5,11,-5,2020,0,3,80,0
Islanders,0,1,2,1,4,Bruins,2,0,1,0,3,20210325,-2,-1,0,1,7,-1,2020,1,3,190,0
Maple Leafs,0,1,1,1,3,Senators,1,0,1,0,2,20210325,-1,0,0,1,5,-1,2020,1,3,203,0
Devils,0,0,0,0,0,Capitals,2,0,2,0,4,20210326,2,2,4,4,4,4,2020,0,4,198,0
Ducks,0,2,2,0,4,Blues,0,0,1,0,1,20210326,0,2,3,3,5,-3,2020,0,4,1586,0
Jets,1,1,1,0,3,Flames,0,0,2,0,2,20210326,1,2,1,1,5,-1,2020,0,4,740,0
Sharks,0,1,1,0,2,Coyotes,1,1,3,0,5,20210326,1,1,3,3,7,3,2020,0,4,614,0
Sharks,0,0,0,0,0,Coyotes,0,2,2,0,4,20210327,0,2,4,4,4,4,2020,0,5,614,0
Jets,0,2,0,0,2,Flames,2,0,2,0,4,20210327,2,0,2,2,6,2,2020,0,5,740,0
Panthers,2,1,0,1,4,Stars,2,0,1,0,3,20210327,0,1,0,1,7,-1,2020,1,5,1110,0
Predators,1,1,1,0,3,Blackhawks,0,1,0,0,1,20210327,1,1,2,2,4,-2,2020,0,5,395,0
Islanders,0,1,2,0,3,Penguins,2,3,1,0,6,20210327,2,4,3,3,9,3,2020,0,5,314,0
Blue Jackets,0,1,0,0,1,Red Wings,2,0,1,0,3,20210327,2,1,2,2,4,2,2020,0,5,163,0
Lightning,2,0,1,0,3,Hurricanes,0,3,1,0,4,20210327,-2,1,1,1,7,1,2020,0,5,585,0
Golden Knights,1,1,0,1,3,Avalanche,2,0,0,0,2,20210327,-1,0,0,1,5,-1,2020,1,5,604,0
Sabres,1,1,0,0,2,Bruins,0,1,2,0,3,20210327,-1,-1,1,1,5,1,2020,0,5,399,0
Rangers,1,0,0,0,1,Flyers,0,1,1,0,2,20210327,-1,0,1,1,3,1,2020,0,5,80,0
Oilers,0,3,0,0,3,Maple Leafs,0,1,2,1,4,20210327,0,-2,0,1,7,1,2020,1,5,1683,0
Devils,1,0,0,0,1,Bruins,0,0,0,0,0,20210328,1,1,1,1,1,-1,2020,0,6,196,0
Panthers,3,0,1,0,4,Stars,1,0,0,0,1,20210328,2,2,3,3,5,-3,2020,0,6,1110,0
Predators,2,0,1,0,3,Blackhawks,0,0,2,0,2,20210328,2,2,1,1,5,-1,2020,0,6,395,0
Ducks,0,1,1,1,3,Blues,2,0,0,0,2,20210328,-2,-1,0,1,5,-1,2020,1,6,1586,0
Rangers,0,0,4,0,4,Capitals,0,3,2,0,5,20210328,0,3,1,1,9,1,2020,0,6,204,0
Blue Jackets,0,1,0,0,1,Red Wings,1,0,3,0,4,20210328,1,0,3,3,5,3,2020,0,6,163,0
Kings,1,0,0,0,1,Golden Knights,0,3,1,0,4,20210329,-1,2,3,3,5,3,2020,0,0,228,0
Jets,2,2,1,0,5,Flames,1,0,0,0,1,20210329,1,3,4,4,6,-4,2020,0,0,740,0
Ducks,1,0,1,0,2,Avalanche,1,2,2,0,5,20210329,0,2,3,3,7,3,2020,0,0,830,0
Wild,2,0,1,0,3,Sharks,1,1,1,1,4,20210329,-1,0,0,1,7,1,2020,1,0,1570,0
Islanders,0,1,0,0,1,Penguins,2,0,0,0,2,20210329,2,1,1,1,3,1,2020,0,0,314,0
Flyers,0,0,3,1,4,Sabres,1,2,0,0,3,20210329,-1,-3,0,1,7,-1,2020,1,0,279,0
Oilers,1,0,1,1,3,Maple Leafs,2,0,0,0,2,20210329,-1,-1,0,1,5,-1,2020,1,0,1683,0
Devils,2,2,0,0,4,Bruins,1,1,2,1,5,20210330,-1,-2,0,1,9,1,2020,1,1,196,0
Capitals,2,0,0,0,2,Rangers,1,0,4,0,5,20210330,-1,-1,3,3,7,3,2020,0,1,204,0
Blue Jackets,0,2,1,0,3,Lightning,0,0,1,0,1,20210330,0,2,2,2,4,-2,2020,0,1,830,0
Red Wings,0,1,0,0,1,Panthers,3,1,0,0,4,20210330,3,3,3,3,5,3,2020,0,1,1155,0
Oilers,0,0,0,0,0,Canadiens,3,1,0,0,4,20210330,3,4,4,4,4,4,2020,0,1,1826,0
Hurricanes,0,1,0,0,1,Blackhawks,0,2,0,0,2,20210330,0,1,1,1,3,1,2020,0,1,641,0
Stars,0,2,0,0,2,Predators,0,1,1,1,3,20210330,0,-1,0,1,5,1,2020,1,1,616,0
Kings,2,2,0,0,4,Golden Knights,0,1,1,0,2,20210331,2,3,2,2,6,-2,2020,0,2,228,0
Coyotes,2,1,0,0,3,Avalanche,5,1,3,0,9,20210331,3,3,6,6,12,6,2020,0,2,585,0
Wild,0,0,2,0,2,Sharks,0,2,2,0,4,20210331,0,2,2,2,6,2,2020,0,2,1570,0
Flyers,0,1,0,0,1,Sabres,2,2,2,0,6,20210331,2,3,5,5,7,5,2020,0,2,279,0
Maple Leafs,2,1,0,0,3,Jets,0,1,0,0,1,20210331,2,2,2,2,4,-2,2020,0,2,946,0
Stars,1,1,2,0,4,Predators,1,0,0,0,1,20210401,0,1,3,3,5,-3,2020,0,3,616,0
Hurricanes,1,1,2,0,4,Blackhawks,0,1,2,0,3,20210401,1,1,1,1,7,-1,2020,0,3,641,0
Canadiens,1,1,2,0,4,Senators,0,0,1,0,1,20210401,1,2,3,3,5,-3,2020,0,3,104,0
Red Wings,1,0,1,0,2,Panthers,1,0,1,1,3,20210401,0,0,0,1,5,1,2020,1,3,1155,0
Wild,1,0,1,1,3,Golden Knights,1,0,1,0,2,20210401,0,0,0,1,5,-1,2020,1,3,1293,0
Capitals,2,2,0,0,4,Islanders,4,2,2,0,8,20210401,2,2,4,4,12,4,2020,0,3,204,0
Rangers,0,1,1,1,3,Sabres,1,0,1,0,2,20210401,-1,0,0,1,5,-1,2020,1,3,292,0
Penguins,0,2,2,0,4,Bruins,0,0,1,0,1,20210401,0,2,3,3,5,-3,2020,0,3,481,0
Blue Jackets,0,1,1,0,2,Lightning,1,0,2,0,3,20210401,1,0,1,1,5,1,2020,0,3,830,0
Capitals,0,1,0,1,2,Devils,0,1,0,0,1,20210402,0,0,0,1,3,-1,2020,1,4,198,0
Maple Leafs,0,1,0,1,2,Jets,0,1,0,0,1,20210402,0,0,0,1,3,-1,2020,1,4,946,0
Flames,1,1,0,0,2,Oilers,0,2,1,0,3,20210402,-1,0,1,1,5,1,2020,0,4,171,0
Blues,1,1,0,0,2,Avalanche,2,1,0,0,3,20210402,1,1,1,1,5,1,2020,0,4,794,0
Coyotes,1,1,2,0,4,Ducks,1,1,0,0,2,20210402,0,0,2,2,6,-2,2020,0,4,356,0
Sharks,1,1,1,0,3,Kings,0,0,0,0,0,20210402,1,2,3,3,3,-3,2020,0,4,305,0
Blue Jackets,0,0,2,0,2,Panthers,0,3,2,0,5,20210403,0,3,3,3,7,3,2020,0,5,993,0
Wild,0,0,2,0,2,Golden Knights,1,0,0,0,1,20210403,-1,-1,1,1,3,-1,2020,0,5,1293,0
Blues,1,0,0,0,1,Avalanche,1,0,1,0,2,20210403,0,0,1,1,3,1,2020,0,5,794,0
Sharks,1,1,1,0,3,Kings,1,1,0,0,2,20210403,0,0,1,1,5,-1,2020,0,5,305,0
Stars,1,1,1,0,3,Hurricanes,1,1,0,0,2,20210403,0,0,1,1,5,-1,2020,0,5,1055,0
Senators,2,2,2,0,6,Canadiens,1,2,0,0,3,20210403,1,1,3,3,9,-3,2020,0,5,104,0
Rangers,1,1,0,0,2,Sabres,1,0,1,1,3,20210403,0,-1,0,1,5,1,2020,1,5,292,0
Penguins,1,2,2,0,5,Bruins,0,5,2,0,7,20210403,-1,2,2,2,12,2,2020,0,5,481,0
Flyers,0,0,2,0,2,Islanders,1,1,0,1,3,20210403,1,2,0,1,5,1,2020,1,5,80,0
Blackhawks,0,0,0,0,0,Predators,1,1,1,0,3,20210403,1,2,3,3,3,3,2020,0,5,395,0
Red Wings,0,0,1,0,1,Lightning,2,0,0,0,2,20210403,2,2,1,1,3,1,2020,0,5,994,0
Red Wings,1,3,1,0,5,Lightning,0,0,1,0,1,20210404,1,4,4,4,6,-4,2020,0,6,994,0
Capitals,1,2,2,0,5,Devils,1,1,2,0,4,20210404,0,1,1,1,9,-1,2020,0,6,198,0
Blue Jackets,0,0,0,0,0,Panthers,0,1,2,0,3,20210404,0,1,3,3,3,3,2020,0,6,993,0
Stars,0,0,0,0,0,Hurricanes,0,1,0,0,1,20210404,0,1,1,1,1,1,2020,0,6,1055,0
Maple Leafs,1,1,2,0,4,Flames,2,0,0,0,2,20210404,-1,0,2,2,6,-2,2020,0,6,1682,0
Coyotes,1,0,1,1,3,Ducks,2,0,0,0,2,20210404,-1,-1,0,1,5,-1,2020,1,6,356,0
Oilers,1,1,0,0,2,Canadiens,0,0,2,1,3,20210405,-1,-2,0,1,5,1,2020,1,0,1826,0
Senators,0,1,2,0,3,Jets,1,3,0,0,4,20210405,1,3,1,1,7,1,2020,0,0,1033,0
Flyers,1,0,1,1,3,Bruins,1,1,0,0,2,20210405,0,-1,0,1,5,-1,2020,1,0,270,0
Golden Knights,2,4,0,0,6,Blues,1,0,0,0,1,20210405,1,5,5,5,7,-5,2020,0,0,1375,0
Avalanche,0,4,1,0,5,Wild,1,0,3,0,4,20210405,-1,3,1,1,9,-1,2020,0,0,698,0
Maple Leafs,0,2,3,0,5,Flames,0,1,2,0,3,20210405,0,1,2,2,8,-2,2020,0,0,1682,0
Coyotes,3,1,1,0,5,Kings,1,0,1,0,2,20210405,2,3,3,3,7,-3,2020,0,0,356,0
Ducks,1,3,1,0,5,Sharks,0,1,0,0,1,20210406,1,3,4,4,6,-4,2020,0,1,305,0
Stars,0,0,2,0,2,Blackhawks,1,2,1,0,4,20210406,1,3,2,2,6,2,2020,0,1,802,0
Panthers,1,1,0,0,2,Hurricanes,0,1,4,0,5,20210406,-1,-1,3,3,7,3,2020,0,1,696,0
Predators,0,0,2,1,3,Red Wings,1,0,1,0,2,20210406,-1,-1,0,1,5,-1,2020,1,1,470,0
Penguins,1,1,2,0,4,Rangers,4,1,3,0,8,20210406,3,3,4,4,12,4,2020,0,1,314,0
Bruins,2,0,2,0,4,Flyers,0,2,0,0,2,20210406,2,0,2,2,6,-2,2020,0,1,270,0
Sabres,2,1,2,0,5,Devils,2,1,0,0,3,20210406,0,0,2,2,8,-2,2020,0,1,284,0
Lightning,0,0,2,0,2,Blue Jackets,1,1,2,0,4,20210406,1,2,2,2,6,2,2020,0,1,830,0
Capitals,0,0,0,0,0,Islanders,0,0,1,0,1,20210406,0,0,1,1,1,1,2020,0,1,204,0
Oilers,1,1,2,0,4,Senators,0,1,1,0,2,20210407,1,1,2,2,6,-2,2020,0,2,1754,0
Canadiens,1,0,1,0,2,Maple Leafs,1,0,2,0,3,20210407,0,0,1,1,5,1,2020,0,2,303,0
Golden Knights,0,0,1,0,1,Blues,2,0,1,0,3,20210407,2,2,2,2,4,2,2020,0,2,1375,0
Avalanche,0,3,0,0,3,Wild,3,2,3,0,8,20210407,3,2,5,5,11,5,2020,0,2,698,0
Coyotes,2,1,0,0,3,Kings,1,0,3,0,4,20210407,-1,-2,1,1,7,1,2020,0,2,356,0
Bruins,2,1,1,0,4,Capitals,0,2,0,0,2,20210408,2,1,2,2,6,-2,2020,0,3,394,0
Stars,1,3,1,0,5,Blackhawks,1,0,0,0,1,20210408,0,3,4,4,6,-4,2020,0,3,802,0
Predators,0,3,4,0,7,Red Wings,0,1,0,0,1,20210408,0,2,6,6,8,-6,2020,0,3,470,0
Oilers,0,1,2,0,3,Senators,0,1,0,0,1,20210408,0,0,2,2,4,-2,2020,0,3,1754,0
Jets,3,0,1,0,4,Canadiens,1,1,0,0,2,20210408,2,1,2,2,6,-2,2020,0,3,1115,0
Flyers,1,1,0,0,2,Islanders,2,0,0,1,3,20210408,1,0,0,1,5,1,2020,1,3,80,0
Panthers,0,0,0,0,0,Hurricanes,1,1,1,0,3,20210408,1,2,3,3,3,3,2020,0,3,696,0
Penguins,1,2,2,0,5,Rangers,0,1,1,0,2,20210408,1,2,3,3,7,-3,2020,0,3,314,0
Devils,3,0,3,0,6,Sabres,1,2,0,0,3,20210408,2,0,3,3,9,-3,2020,0,3,284,0
Lightning,4,2,0,0,6,Blue Jackets,1,1,2,0,4,20210408,3,4,2,2,10,-2,2020,0,3,830,0
Coyotes,0,1,3,0,4,Golden Knights,4,1,2,0,7,20210409,4,4,3,3,11,3,2020,0,4,256,0
Avalanche,0,1,1,0,2,Ducks,0,0,0,0,0,20210409,0,1,2,2,2,-2,2020,0,4,830,0
Kings,1,0,1,0,2,Sharks,3,0,2,0,5,20210409,2,2,3,3,7,3,2020,0,4,305,0
Wild,1,0,0,0,1,Blues,4,3,2,0,9,20210409,3,6,8,8,10,8,2020,0,4,466,0
Rangers,0,2,2,0,4,Islanders,0,1,0,0,1,20210409,0,1,3,3,5,-3,2020,0,4,0,0
Capitals,2,1,1,0,4,Sabres,1,1,1,0,3,20210409,1,1,1,1,7,-1,2020,0,4,292,0
Penguins,2,1,3,0,6,Devils,1,1,2,0,4,20210409,1,1,2,2,10,-2,2020,0,4,306,0
Kings,1,3,0,0,4,Sharks,1,0,1,0,2,20210410,0,3,2,2,6,-2,2020,0,5,305,0
Wild,1,1,0,0,2,Blues,0,1,1,1,3,20210410,-1,-1,0,1,5,1,2020,1,5,466,0
Lightning,1,1,1,0,3,Predators,0,0,0,0,0,20210410,1,2,3,3,3,-3,2020,0,5,621,0
Senators,0,3,2,0,5,Maple Leafs,2,2,2,0,6,20210410,2,1,1,1,11,1,2020,0,5,203,0
Oilers,0,0,0,0,0,Flames,0,4,1,0,5,20210410,0,4,5,5,5,5,2020,0,5,171,0
Blackhawks,2,2,0,0,4,Blue Jackets,2,0,1,0,3,20210410,0,2,1,1,7,-1,2020,0,5,275,0
Red Wings,2,1,1,1,5,Hurricanes,2,1,1,0,4,20210410,0,0,0,1,9,-1,2020,1,5,511,0
Panthers,0,1,0,0,1,Stars,3,0,1,0,4,20210410,3,2,3,3,5,3,2020,0,5,1110,0
Bruins,1,1,0,0,2,Flyers,2,0,1,0,3,20210410,1,0,1,1,5,1,2020,0,5,270,0
Jets,0,3,2,0,5,Canadiens,0,0,0,0,0,20210410,0,3,5,5,5,-5,2020,0,5,1115,0
Stars,1,1,0,0,2,Predators,1,1,0,1,3,20210411,0,0,0,1,5,1,2020,1,6,616,0
Sabres,0,2,3,0,5,Flyers,2,0,1,0,3,20210411,-2,0,2,2,8,-2,2020,0,6,279,0
Coyotes,0,0,0,0,0,Golden Knights,0,0,1,0,1,20210411,0,0,1,1,1,1,2020,0,6,256,0
Avalanche,1,1,2,0,4,Ducks,0,0,1,0,1,20210411,1,2,3,3,5,-3,2020,0,6,830,0
Penguins,2,1,2,0,5,Devils,1,0,1,0,2,20210411,1,2,3,3,7,-3,2020,0,6,306,0
Rangers,0,2,0,0,2,Islanders,2,0,0,1,3,20210411,2,0,0,1,5,1,2020,1,6,0,0
Capitals,3,3,2,0,8,Bruins,0,0,1,0,1,20210411,3,6,7,7,9,-7,2020,0,6,394,0
Golden Knights,0,2,2,0,4,Kings,1,1,0,0,2,20210412,-1,0,2,2,6,-2,2020,0,0,228,0
Maple Leafs,0,2,0,0,2,Canadiens,2,1,1,0,4,20210412,2,1,2,2,6,2,2020,0,0,303,0
Ducks,3,0,1,0,4,Sharks,0,0,0,0,0,20210412,3,3,4,4,4,-4,2020,0,0,305,0
Coyotes,0,0,2,0,2,Avalanche,1,2,1,0,4,20210412,1,3,2,2,6,2,2020,0,0,585,0
Blackhawks,1,0,2,1,4,Blue Jackets,1,1,1,0,3,20210412,0,-1,0,1,7,-1,2020,1,0,275,0
Red Wings,0,0,3,0,3,Hurricanes,0,0,1,0,1,20210412,0,0,2,2,4,-2,2020,0,0,511,0
Jets,2,0,0,0,2,Senators,2,0,2,0,4,20210412,0,0,2,2,6,2,2020,0,0,1033,0
Rangers,1,0,2,0,3,Devils,0,0,0,0,0,20210413,1,1,3,3,3,-3,2020,0,1,8,0
Sabres,1,0,1,0,2,Bruins,1,1,0,1,3,20210413,0,1,0,1,5,1,2020,1,1,399,0
Flyers,1,0,0,0,1,Capitals,4,1,1,0,6,20210413,3,4,5,5,7,5,2020,0,1,123,0
Flames,1,1,0,1,3,Maple Leafs,1,0,1,0,2,20210413,0,1,0,1,5,-1,2020,1,1,1682,0
Lightning,0,1,1,0,2,Predators,3,1,3,0,7,20210413,3,3,5,5,9,5,2020,0,1,621,0
Panthers,1,1,0,1,3,Stars,1,0,1,0,2,20210413,0,1,0,1,5,-1,2020,1,1,1110,0
Coyotes,0,1,1,0,2,Wild,1,2,2,0,5,20210414,1,2,3,3,7,3,2020,0,2,1278,0
Flames,1,1,2,0,4,Canadiens,0,1,0,0,1,20210414,1,1,3,3,5,-3,2020,0,2,1852,0
Jets,1,0,2,0,3,Senators,1,0,1,0,2,20210414,0,0,1,1,5,-1,2020,0,2,1033,0
Avalanche,1,3,0,0,4,Blues,1,0,2,0,3,20210414,0,3,1,1,7,-1,2020,0,2,794,0
Golden Knights,3,1,2,0,6,Kings,1,1,0,0,2,20210414,2,2,4,4,8,-4,2020,0,2,228,0
Ducks,1,2,1,0,4,Sharks,0,0,1,0,1,20210414,1,3,3,3,5,-3,2020,0,2,305,0
Jets,3,0,2,0,5,Maple Leafs,1,1,0,0,2,20210415,2,1,3,3,7,-3,2020,0,3,946,0
Flyers,0,0,1,1,2,Penguins,0,1,0,0,1,20210415,0,-1,0,1,3,-1,2020,1,3,257,0
Blackhawks,1,0,0,0,1,Red Wings,0,3,1,0,4,20210415,-1,2,3,3,5,3,2020,0,3,238,0
Blue Jackets,1,0,0,0,1,Stars,0,2,2,0,4,20210415,-1,1,3,3,5,3,2020,0,3,912,0
Panthers,1,0,1,0,2,Lightning,0,1,1,1,3,20210415,-1,0,0,1,5,1,2020,1,3,205,0
Sabres,1,3,1,0,5,Capitals,1,1,0,0,2,20210415,0,2,3,3,7,-3,2020,0,3,292,0
Devils,0,0,0,0,0,Rangers,3,1,0,0,4,20210415,3,4,4,4,4,4,2020,0,3,8,0
Islanders,0,1,0,0,1,Bruins,2,0,2,0,4,20210415,2,1,3,3,5,3,2020,0,3,190,0
Predators,0,0,1,0,1,Hurricanes,1,2,1,0,4,20210415,1,3,3,3,5,3,2020,0,3,456,0
Flames,0,0,1,0,1,Canadiens,0,1,1,0,2,20210416,0,1,1,1,3,1,2020,0,4,1852,0
Islanders,0,0,0,0,0,Bruins,1,1,1,0,3,20210416,1,2,3,3,3,3,2020,0,4,190,0
Sharks,1,0,1,0,2,Wild,1,2,0,0,3,20210416,0,2,1,1,5,1,2020,0,4,1570,0
Golden Knights,0,3,1,0,4,Ducks,0,0,0,0,0,20210416,0,3,4,4,4,-4,2020,0,4,228,0
Blue Jackets,1,0,0,0,1,Stars,1,4,0,0,5,20210417,0,4,4,4,6,4,2020,0,5,912,0
Sharks,1,0,1,0,2,Wild,3,2,0,0,5,20210417,2,4,3,3,7,3,2020,0,5,1570,0
Oilers,0,1,2,0,3,Jets,0,0,0,0,0,20210417,0,1,3,3,3,-3,2020,0,5,738,0
Blackhawks,1,1,2,0,4,Red Wings,0,0,0,0,0,20210417,1,2,4,4,4,-4,2020,0,5,238,0
Panthers,3,1,1,0,5,Lightning,1,1,1,0,3,20210417,2,2,2,2,8,-2,2020,0,5,205,0
Penguins,1,2,0,0,3,Sabres,0,1,1,0,2,20210417,1,2,1,1,5,-1,2020,0,5,178,0
Blues,2,0,0,0,2,Coyotes,0,2,1,0,3,20210417,-2,0,1,1,5,1,2020,0,5,1270,0
Senators,1,1,2,0,4,Canadiens,0,0,0,0,0,20210417,1,2,4,4,4,-4,2020,0,5,104,0
Capitals,1,3,2,0,6,Flyers,1,1,1,0,3,20210417,0,2,3,3,9,-3,2020,0,5,123,0
Devils,0,1,2,0,3,Rangers,3,1,2,0,6,20210417,3,3,3,3,9,3,2020,0,5,8,0
Predators,0,1,0,0,1,Hurricanes,1,0,2,0,3,20210417,1,0,2,2,4,2,2020,0,5,456,0
Islanders,0,0,0,1,1,Flyers,0,0,0,0,0,20210418,0,0,0,1,1,-1,2020,1,6,80,0
Maple Leafs,1,1,0,0,2,Canucks,0,1,1,1,3,20210418,-1,-1,0,1,5,1,2020,1,6,2090,0
Golden Knights,2,2,1,0,5,Ducks,1,1,0,0,2,20210418,1,2,3,3,7,-3,2020,0,6,228,0
Rangers,2,1,2,0,5,Devils,0,1,2,0,3,20210418,2,2,2,2,8,-2,2020,0,6,8,0
Capitals,1,2,0,0,3,Bruins,2,3,1,0,6,20210418,1,2,3,3,9,3,2020,0,6,394,0
Penguins,0,0,2,0,2,Sabres,1,1,2,0,4,20210418,1,2,2,2,6,2,2020,0,6,178,0
Sharks,1,1,0,0,2,Golden Knights,0,1,1,1,3,20210419,-1,-1,0,1,5,1,2020,1,0,382,0
Hurricanes,0,1,1,0,2,Lightning,1,1,0,1,3,20210419,1,1,0,1,5,1,2020,1,0,585,0
Blue Jackets,0,1,1,0,2,Panthers,1,2,1,0,4,20210419,1,2,2,2,6,2,2020,0,0,993,0
Red Wings,0,2,0,0,2,Stars,1,1,0,1,3,20210419,1,0,0,1,5,1,2020,1,0,999,0
Blackhawks,1,1,0,0,2,Predators,1,2,2,0,5,20210419,0,1,3,3,7,3,2020,0,0,395,0
Senators,1,1,2,0,4,Flames,1,0,1,0,2,20210419,0,1,2,2,6,-2,2020,0,0,1773,0
Canadiens,0,1,0,0,1,Oilers,0,0,4,0,4,20210419,0,-1,3,3,5,3,2020,0,0,1826,0
Wild,1,2,2,0,5,Coyotes,1,0,1,0,2,20210419,0,2,3,3,7,-3,2020,0,0,1278,0
Maple Leafs,1,1,1,0,3,Canucks,0,2,4,0,6,20210420,-1,0,3,3,9,3,2020,0,1,2090,0
Red Wings,0,1,1,0,2,Stars,3,1,1,0,5,20210420,3,3,3,3,7,3,2020,0,1,999,0
Devils,0,0,6,0,6,Penguins,4,2,1,0,7,20210420,4,6,1,1,13,1,2020,0,1,306,0
Ducks,0,0,1,0,1,Kings,1,2,1,0,4,20210420,1,3,3,3,5,3,2020,0,1,0,0
Hurricanes,0,3,1,0,4,Lightning,0,1,0,0,1,20210420,0,2,3,3,5,-3,2020,0,1,585,0
Rangers,0,1,0,0,1,Islanders,1,2,3,0,6,20210420,1,2,5,5,7,5,2020,0,1,0,0
Bruins,1,1,0,0,2,Sabres,0,0,0,0,0,20210420,1,2,2,2,2,-2,2020,0,1,399,0
Blue Jackets,1,0,0,0,1,Panthers,2,3,0,0,5,20210420,1,4,4,4,6,4,2020,0,1,993,0
Sharks,1,1,0,0,2,Golden Knights,1,2,2,0,5,20210421,0,1,3,3,7,3,2020,0,2,382,0
Canadiens,1,1,2,0,4,Oilers,0,1,2,0,3,20210421,1,1,1,1,7,-1,2020,0,2,1826,0
Predators,1,2,1,0,4,Blackhawks,1,0,3,1,5,20210421,0,-2,0,1,9,1,2020,1,2,395,0
Wild,0,1,3,0,4,Coyotes,1,0,0,0,1,20210421,-1,0,3,3,5,-3,2020,0,2,1278,0
Senators,2,0,1,0,3,Canucks,0,0,0,0,0,20210422,2,2,3,3,3,-3,2020,0,3,2191,0
Avalanche,1,1,2,0,4,Blues,1,0,1,0,2,20210422,0,1,2,2,6,-2,2020,0,3,794,0
Stars,0,2,1,0,3,Red Wings,3,1,3,0,7,20210422,3,2,4,4,10,4,2020,0,3,999,0
Devils,1,0,0,0,1,Penguins,2,3,0,0,5,20210422,1,4,4,4,6,4,2020,0,3,306,0
Flyers,0,1,2,0,3,Rangers,1,0,1,0,2,20210422,-1,0,1,1,5,-1,2020,0,3,80,0
Blue Jackets,1,0,0,0,1,Lightning,0,1,2,0,3,20210422,-1,0,2,2,4,2,2020,0,3,830,0
Capitals,0,0,0,1,1,Islanders,0,0,0,0,0,20210422,0,0,0,1,1,-1,2020,1,3,204,0
Bruins,1,1,3,0,5,Sabres,0,1,0,0,1,20210422,1,1,4,4,6,-4,2020,0,3,399,0
Maple Leafs,3,1,1,0,5,Jets,2,1,0,0,3,20210422,1,1,2,2,8,-2,2020,0,3,946,0
Hurricanes,0,3,1,0,4,Panthers,1,0,1,0,2,20210422,-1,2,2,2,6,-2,2020,0,3,696,0
Canadiens,1,1,0,0,2,Flames,1,2,2,0,5,20210424,0,1,3,3,7,3,2020,0,5,1852,0
Senators,1,0,1,0,2,Canucks,1,1,2,0,4,20210424,0,1,2,2,6,2,2020,0,5,2191,0
Golden Knights,2,1,2,0,5,Ducks,0,0,1,0,1,20210424,2,3,4,4,6,-4,2020,0,5,228,0
Wild,3,1,2,0,6,Sharks,0,0,3,0,3,20210424,3,4,3,3,9,-3,2020,0,5,1570,0
Maple Leafs,2,1,1,0,4,Jets,1,0,0,0,1,20210424,1,2,3,3,5,-3,2020,0,5,946,0
Coyotes,1,1,2,0,4,Kings,0,0,0,0,0,20210424,1,2,4,4,4,-4,2020,0,5,356,0
Hurricanes,1,1,1,0,3,Panthers,1,0,2,1,4,20210424,0,-1,0,1,7,1,2020,1,5,696,0
Capitals,2,2,2,0,6,Islanders,1,2,0,0,3,20210424,1,1,3,3,9,-3,2020,0,5,204,0
Avalanche,2,1,0,0,3,Blues,3,0,2,0,5,20210424,1,0,2,2,8,2,2020,0,5,794,0
Devils,0,1,1,0,2,Penguins,2,1,1,0,4,20210424,2,2,2,2,6,2,2020,0,5,306,0
Stars,0,0,1,1,2,Red Wings,1,0,0,0,1,20210424,-1,-1,0,1,3,-1,2020,1,5,999,0
Bruins,0,0,0,0,0,Penguins,0,0,1,0,1,20210425,0,0,1,1,1,1,2020,0,6,481,0
Sabres,1,1,1,0,3,Rangers,3,1,2,0,6,20210425,2,2,3,3,9,3,2020,0,6,292,0
Devils,1,1,1,0,3,Flyers,1,0,2,1,4,20210425,0,-1,0,1,7,1,2020,1,6,75,0
Blue Jackets,2,0,1,0,3,Lightning,1,1,1,1,4,20210425,-1,0,0,1,7,1,2020,1,6,830,0
Coyotes,0,2,2,0,4,Sharks,2,2,2,0,6,20210426,2,2,2,2,10,2,2020,0,0,614,0
Ducks,0,1,0,0,1,Kings,2,0,2,0,4,20210426,2,1,3,3,5,3,2020,0,0,0,0
Oilers,2,4,0,0,6,Jets,0,1,0,0,1,20210426,2,5,5,5,7,-5,2020,0,0,738,0
Panthers,1,0,0,0,1,Predators,1,1,2,0,4,20210426,0,1,3,3,5,3,2020,0,0,816,0
Avalanche,0,1,0,0,1,Blues,2,2,0,0,4,20210426,2,3,3,3,5,3,2020,0,0,794,0
Canucks,1,0,0,0,1,Senators,1,1,0,0,2,20210426,0,1,1,1,3,1,2020,0,0,2191,0
Canadiens,1,1,0,0,2,Flames,1,0,0,0,1,20210426,0,1,1,1,3,-1,2020,0,0,1852,0
Hurricanes,0,2,1,0,3,Stars,2,1,0,1,4,20210426,2,1,0,1,7,1,2020,1,0,1055,0
Islanders,0,0,0,0,0,Capitals,1,0,0,0,1,20210427,1,1,1,1,1,1,2020,0,1,204,0
Flyers,0,1,3,0,4,Devils,1,2,3,0,6,20210427,1,2,2,2,10,2,2020,0,1,75,0
Sabres,0,1,0,0,1,Rangers,0,1,2,0,3,20210427,0,0,2,2,4,2,2020,0,1,292,0
Bruins,0,1,2,0,3,Penguins,0,0,1,0,1,20210427,0,1,2,2,4,-2,2020,0,1,481,0
Red Wings,0,0,0,0,0,Blue Jackets,0,0,0,1,1,20210427,0,0,0,1,1,1,2020,1,1,163,0
Lightning,3,3,1,0,7,Blackhawks,2,1,1,0,4,20210427,1,3,3,3,11,-3,2020,0,1,1004,0
Panthers,1,2,4,0,7,Predators,1,3,0,0,4,20210427,0,-1,3,3,11,-3,2020,0,1,816,0
Hurricanes,2,1,2,0,5,Stars,0,1,0,0,1,20210427,2,2,4,4,6,-4,2020,0,1,1055,0
Coyotes,1,1,0,0,2,Sharks,3,0,1,0,4,20210428,2,1,2,2,6,2,2020,0,2,614,0
Ducks,0,2,1,0,3,Kings,0,2,0,0,2,20210428,0,0,1,1,5,-1,2020,0,2,0,0
Avalanche,1,1,0,0,2,Golden Knights,1,2,2,0,5,20210428,0,1,3,3,7,3,2020,0,2,604,0
Blues,0,1,3,0,4,Wild,1,2,0,0,3,20210428,-1,-2,1,1,7,-1,2020,0,2,466,0
Maple Leafs,2,1,1,0,4,Canadiens,0,1,0,0,1,20210428,2,2,3,3,5,-3,2020,0,2,303,0
Canucks,0,2,1,0,3,Senators,1,4,1,0,6,20210428,1,3,3,3,9,3,2020,0,2,2191,0
Oilers,1,1,1,0,3,Jets,0,1,0,0,1,20210428,1,1,2,2,4,-2,2020,0,2,738,0
Flames,1,1,1,0,3,Oilers,1,0,0,0,1,20210429,0,1,2,2,4,-2,2020,0,3,171,0
Panthers,0,2,1,1,4,Blackhawks,1,1,1,0,3,20210429,-1,0,0,1,7,-1,2020,1,3,1189,0
Canucks,0,1,0,0,1,Maple Leafs,1,2,1,0,4,20210429,1,2,3,3,5,3,2020,0,3,2090,0
Red Wings,0,1,0,0,1,Hurricanes,0,2,1,0,3,20210429,0,1,2,2,4,2,2020,0,3,511,0
Blues,1,2,1,1,5,Wild,0,1,3,0,4,20210429,1,2,0,1,9,-1,2020,1,3,466,0
Islanders,2,1,1,0,4,Rangers,0,0,0,0,0,20210429,2,3,4,4,4,-4,2020,0,3,0,0
Flyers,0,2,1,0,3,Devils,2,1,2,0,5,20210429,2,1,2,2,8,2,2020,0,3,75,0
Sabres,1,0,1,0,2,Bruins,2,0,3,0,5,20210429,1,1,3,3,7,3,2020,0,3,399,0
Stars,0,0,0,0,0,Lightning,1,0,2,0,3,20210429,1,1,3,3,3,3,2020,0,3,916,0
Penguins,1,2,1,1,5,Capitals,1,2,1,0,4,20210429,0,0,0,1,9,-1,2020,1,3,190,0
Jets,1,2,0,0,3,Canadiens,0,3,2,0,5,20210430,-1,0,2,2,8,2,2020,0,4,1115,0
Sharks,0,0,0,0,0,Avalanche,2,0,1,0,3,20210430,2,2,3,3,3,3,2020,0,4,927,0
Golden Knights,0,0,0,0,0,Coyotes,1,0,2,0,3,20210430,1,1,3,3,3,3,2020,0,4,256,0
Kings,0,0,2,0,2,Ducks,1,0,0,0,1,20210430,-1,-1,1,1,3,-1,2020,0,4,0,0
Blues,2,1,0,0,3,Wild,0,1,2,1,4,20210501,-2,-2,0,1,7,1,2020,1,5,466,0
Kings,0,0,2,0,2,Ducks,1,2,3,0,6,20210501,1,3,4,4,8,4,2020,0,5,0,0
Golden Knights,1,1,0,1,3,Coyotes,0,0,2,0,2,20210501,1,2,0,1,5,-1,2020,1,5,256,0
Flames,0,1,0,0,1,Oilers,2,0,2,0,4,20210501,2,1,3,3,5,3,2020,0,5,171,0
Sharks,0,1,2,0,3,Avalanche,0,2,2,0,4,20210501,0,1,1,1,7,1,2020,0,5,927,0
Stars,0,0,0,0,0,Predators,0,0,0,1,1,20210501,0,0,0,1,1,1,2020,1,5,616,0
Panthers,1,2,2,0,5,Blackhawks,0,2,2,0,4,20210501,1,1,1,1,9,-1,2020,0,5,1189,0
Rangers,0,0,0,0,0,Islanders,2,1,0,0,3,20210501,2,3,3,3,3,3,2020,0,5,0,0
Senators,0,1,1,0,2,Canadiens,0,0,2,1,3,20210501,0,-1,0,1,5,1,2020,1,5,104,0
Blue Jackets,1,0,0,0,1,Hurricanes,1,0,0,1,2,20210501,0,0,0,1,3,1,2020,1,5,374,0
Penguins,1,2,0,0,3,Capitals,0,0,0,0,0,20210501,1,3,3,3,3,-3,2020,0,5,190,0
Devils,1,1,2,0,4,Flyers,0,0,1,0,1,20210501,1,2,3,3,5,-3,2020,0,5,75,0
Lightning,0,0,0,0,0,Red Wings,0,0,0,1,1,20210501,0,0,0,1,1,1,2020,1,5,994,0
Sabres,1,0,1,0,2,Bruins,2,1,3,0,6,20210501,1,2,4,4,8,4,2020,0,5,399,0
Canucks,1,0,0,0,1,Maple Leafs,1,1,3,0,5,20210501,0,1,4,4,6,4,2020,0,5,2090,0
Lightning,1,1,0,0,2,Red Wings,0,1,0,0,1,20210502,1,1,1,1,3,-1,2020,0,6,994,0
Stars,2,0,2,0,4,Panthers,3,1,0,1,5,20210503,1,2,0,1,9,1,2020,1,0,1110,0
Avalanche,1,0,3,1,5,Sharks,1,2,1,0,4,20210503,0,-2,0,1,9,-1,2020,1,0,927,0
Oilers,1,3,1,0,5,Canucks,1,1,1,0,3,20210503,0,2,2,2,8,-2,2020,0,0,514,0
Kings,1,2,0,0,3,Coyotes,1,1,0,0,2,20210503,0,1,1,1,5,-1,2020,0,0,356,0
Golden Knights,3,2,0,0,5,Wild,2,1,3,0,6,20210503,-1,-2,1,1,11,1,2020,0,0,1293,0
Ducks,0,1,0,0,1,Blues,0,1,2,0,3,20210503,0,0,2,2,4,2,2020,0,0,1586,0
Jets,0,0,1,0,1,Senators,1,0,1,0,2,20210503,1,1,1,1,3,1,2020,0,0,1033,0
Maple Leafs,1,1,0,0,2,Canadiens,0,1,1,1,3,20210503,-1,-1,0,1,5,1,2020,1,0,303,0
Predators,0,3,0,1,4,Blue Jackets,0,0,3,0,3,20210503,0,3,0,1,7,-1,2020,1,0,333,0
Blackhawks,0,1,1,0,2,Hurricanes,2,2,1,0,5,20210503,2,3,3,3,7,3,2020,0,0,641,0
Penguins,0,0,2,0,2,Flyers,3,1,3,0,7,20210503,3,4,5,5,9,5,2020,0,0,257,0
Capitals,2,1,3,0,6,Rangers,1,2,0,0,3,20210503,1,0,3,3,9,-3,2020,0,0,204,0
Bruins,0,2,1,0,3,Devils,0,0,0,0,0,20210503,0,2,3,3,3,-3,2020,0,0,196,0
Islanders,1,1,0,0,2,Sabres,0,1,3,0,4,20210503,-1,-1,2,2,6,2,2020,0,0,292,0
Islanders,1,2,0,0,3,Sabres,1,1,1,1,4,20210504,0,-1,0,1,7,1,2020,1,1,292,0
Bruins,0,2,1,0,3,Devils,1,0,2,1,4,20210504,1,-1,0,1,7,1,2020,1,1,196,0
Penguins,1,2,4,0,7,Flyers,0,2,1,0,3,20210504,1,1,4,4,10,-4,2020,0,1,257,0
Blackhawks,2,0,1,0,3,Hurricanes,0,2,4,0,6,20210504,-2,0,3,3,9,3,2020,0,1,641,0
Oilers,0,3,1,0,4,Canucks,1,0,0,0,1,20210504,-1,2,3,3,5,-3,2020,0,1,514,0
Avalanche,0,2,0,0,2,Sharks,0,1,2,0,3,20210505,0,-1,1,1,5,1,2020,0,2,927,0
Jets,1,2,1,0,4,Flames,0,0,0,0,0,20210505,1,3,4,4,4,-4,2020,0,2,740,0
Golden Knights,0,1,1,1,3,Wild,0,0,2,0,2,20210505,0,1,0,1,5,-1,2020,1,2,1293,0
Ducks,0,1,1,1,3,Blues,1,0,1,0,2,20210505,-1,0,0,1,5,-1,2020,1,2,1586,0
Kings,2,0,2,0,4,Coyotes,2,0,0,0,2,20210505,0,0,2,2,6,-2,2020,0,2,356,0
Predators,1,1,0,0,2,Blue Jackets,0,2,2,0,4,20210505,-1,0,2,2,6,2,2020,0,2,333,0
Capitals,0,3,1,0,4,Rangers,0,0,2,0,2,20210505,0,3,2,2,6,-2,2020,0,2,204,0
Canadiens,1,0,0,0,1,Senators,1,2,2,0,5,20210505,0,2,4,4,6,4,2020,0,2,104,0
Stars,1,0,1,0,2,Lightning,1,2,3,0,6,20210505,0,2,4,4,8,4,2020,0,2,916,0
Rangers,0,0,0,0,0,Bruins,2,1,1,0,4,20210506,2,3,4,4,4,4,2020,0,3,190,0
Devils,1,1,0,0,2,Islanders,0,1,0,0,1,20210506,1,1,1,1,3,-1,2020,0,3,8,0
Sabres,1,2,1,0,4,Penguins,2,3,3,0,8,20210506,1,2,4,4,12,4,2020,0,3,178,0
Canadiens,0,1,1,0,2,Maple Leafs,4,0,1,0,5,20210506,4,3,3,3,7,3,2020,0,3,303,0
Blackhawks,0,0,1,1,2,Hurricanes,1,0,0,0,1,20210506,-1,-1,0,1,3,-1,2020,1,3,641,0
Canucks,4,1,1,0,6,Oilers,2,0,1,0,3,20210506,2,3,3,3,9,-3,2020,0,3,514,0
Coyotes,0,2,3,0,5,Sharks,1,1,0,0,2,20210507,-1,0,3,3,7,-3,2020,0,4,614,0
Avalanche,1,2,0,0,3,Kings,1,0,1,0,2,20210507,0,2,1,1,5,-1,2020,0,4,830,0
Blues,1,2,0,0,3,Golden Knights,1,1,1,1,4,20210507,0,-1,0,1,7,1,2020,1,4,1375,0
Red Wings,0,3,2,0,5,Blue Jackets,1,1,0,0,2,20210507,-1,1,3,3,7,-3,2020,0,4,163,0
Stars,1,3,1,0,5,Lightning,0,1,1,0,2,20210507,1,3,3,3,7,-3,2020,0,4,916,0
Flyers,1,2,1,0,4,Capitals,1,1,0,0,2,20210507,0,1,2,2,6,-2,2020,0,4,123,0
Ducks,1,1,1,0,3,Wild,2,0,1,1,4,20210507,1,0,0,1,7,1,2020,1,4,1521,0
Hurricanes,0,0,1,0,1,Predators,0,1,2,0,3,20210508,0,1,2,2,4,2,2020,0,5,456,0
Avalanche,2,1,0,0,3,Kings,1,0,1,0,2,20210508,1,2,1,1,5,-1,2020,0,5,830,0
Blues,0,1,0,0,1,Golden Knights,2,0,2,0,4,20210508,2,1,3,3,5,3,2020,0,5,1375,0
Canucks,0,3,0,0,3,Oilers,1,3,0,0,4,20210508,1,1,1,1,7,1,2020,0,5,514,0
Ducks,1,0,2,0,3,Wild,1,2,0,1,4,20210508,0,2,0,1,7,1,2020,1,5,1521,0
Senators,2,0,2,0,4,Jets,0,1,1,0,2,20210508,2,1,2,2,6,-2,2020,0,5,1033,0
Coyotes,2,1,1,1,5,Sharks,2,1,1,0,4,20210508,0,0,0,1,9,-1,2020,1,5,614,0
Red Wings,1,1,2,0,4,Blue Jackets,1,1,2,1,5,20210508,0,0,0,1,9,1,2020,1,5,163,0
Lightning,0,1,0,0,1,Panthers,1,3,1,0,5,20210508,1,3,4,4,6,4,2020,0,5,205,0
Flyers,0,0,1,0,1,Capitals,0,0,1,1,2,20210508,0,0,0,1,3,1,2020,1,5,123,0
Devils,0,1,0,0,1,Islanders,1,2,2,0,5,20210508,1,2,4,4,6,4,2020,0,5,8,0
Sabres,0,0,0,0,0,Penguins,0,1,0,0,1,20210508,0,1,1,1,1,1,2020,0,5,178,0
Rangers,0,1,4,0,5,Bruins,0,1,3,0,4,20210508,0,0,1,1,9,-1,2020,0,5,190,0
Canadiens,1,1,0,0,2,Maple Leafs,0,3,0,0,3,20210508,-1,1,1,1,5,1,2020,0,5,303,0
Stars,1,0,1,0,2,Blackhawks,3,0,1,0,4,20210509,2,2,2,2,6,2,2020,0,6,802,0
Senators,0,1,0,0,1,Flames,1,3,2,0,6,20210509,1,3,5,5,7,5,2020,0,6,1773,0
Blues,0,0,1,1,2,Kings,0,0,1,0,1,20210510,0,0,0,1,3,-1,2020,1,0,1586,0
Avalanche,0,1,1,0,2,Golden Knights,1,0,0,0,1,20210510,-1,0,1,1,3,-1,2020,0,0,604,0
Canucks,2,0,1,0,3,Jets,1,0,0,0,1,20210510,1,1,2,2,4,-2,2020,0,0,1157,0
Stars,1,1,2,1,5,Blackhawks,2,1,1,0,4,20210510,-1,-1,0,1,9,-1,2020,1,0,802,0
Devils,2,0,0,0,2,Flyers,1,1,2,0,4,20210510,-1,0,2,2,6,2,2020,0,0,75,0
Islanders,0,2,0,0,2,Bruins,1,1,0,1,3,20210510,1,0,0,1,5,1,2020,1,0,190,0
Oilers,2,1,0,1,4,Canadiens,1,1,1,0,3,20210510,1,1,0,1,7,-1,2020,1,0,1826,0
Lightning,0,0,0,0,0,Panthers,1,1,2,0,4,20210510,1,2,4,4,4,4,2020,0,0,205,0
Hurricanes,0,0,0,0,0,Predators,2,2,1,0,5,20210510,2,4,5,5,5,5,2020,0,0,456,0
Bruins,0,1,0,0,1,Capitals,0,1,1,0,2,20210511,0,0,1,1,3,1,2020,0,1,394,0
Canucks,0,0,0,0,0,Jets,1,2,2,0,5,20210511,1,3,5,5,5,5,2020,0,1,1157,0
Kings,0,0,0,0,0,Avalanche,3,3,0,0,6,20210512,3,6,6,6,6,6,2020,0,2,830,0
Wild,0,0,0,0,0,Blues,2,2,0,0,4,20210512,2,4,4,4,4,4,2020,0,2,466,0
Maple Leafs,0,2,1,0,3,Senators,1,2,0,1,4,20210512,1,1,0,1,7,1,2020,1,2,203,0
Oilers,2,1,0,1,4,Canadiens,2,0,1,0,3,20210512,0,1,0,1,7,-1,2020,1,2,1826,0
Golden Knights,2,2,2,0,6,Sharks,0,0,0,0,0,20210512,2,4,6,6,6,-6,2020,0,2,382,0
Wild,3,0,0,0,3,Blues,0,4,3,0,7,20210513,-3,1,4,4,10,4,2020,0,3,466,0
Canucks,1,0,0,0,1,Flames,2,0,2,0,4,20210513,1,1,3,3,5,3,2020,0,3,426,0
Kings,1,0,0,0,1,Avalanche,0,5,0,0,5,20210513,-1,4,4,4,6,4,2020,0,3,830,0
Maple Leafs,1,1,0,0,2,Jets,0,2,2,0,4,20210514,-1,0,2,2,6,2,2020,0,4,946,0
Canucks,0,1,3,0,4,Oilers,1,0,0,0,1,20210515,-1,0,3,3,5,-3,2020,0,5,514,1
Bruins,1,1,0,0,2,Capitals,1,1,0,1,3,20210515,0,0,0,1,5,1,2020,1,5,394,1
Lightning,1,2,2,0,5,Panthers,2,0,2,0,4,20210516,-1,1,1,1,9,-1,2020,0,6,205,1
Flames,1,4,0,1,6,Canucks,0,1,4,0,5,20210516,1,4,0,1,11,-1,2020,1,6,426,1
Wild,0,0,0,1,1,Golden Knights,0,0,0,0,0,20210516,0,0,0,1,1,-1,2020,1,6,1293,1
Islanders,1,0,2,1,4,Penguins,1,1,1,0,3,20210516,0,-1,0,1,7,-1,2020,1,6,314,1
Bruins,2,0,1,1,4,Capitals,2,0,1,0,3,20210517,0,0,0,1,7,-1,2020,1,0,394,1
Predators,1,1,0,0,2,Hurricanes,1,1,3,0,5,20210517,0,0,3,3,7,3,2020,0,0,456,1
Blues,0,1,0,0,1,Avalanche,1,0,3,0,4,20210517,1,0,3,3,5,3,2020,0,0,794,1
Flames,0,0,2,0,2,Canucks,2,0,2,0,4,20210518,2,2,2,2,6,2,2020,0,1,426,1
Islanders,0,1,0,0,1,Penguins,2,0,0,0,2,20210518,2,1,1,1,3,1,2020,0,1,314,1
Lightning,2,0,1,0,3,Panthers,0,1,0,0,1,20210518,2,1,2,2,4,-2,2020,0,1,205,1
Wild,0,1,0,0,1,Golden Knights,0,2,1,0,3,20210518,0,1,2,2,4,2,2020,0,1,1293,1
Jets,0,1,3,0,4,Oilers,0,1,0,0,1,20210519,0,0,3,3,5,-3,2020,0,2,738,1
Predators,0,0,0,0,0,Hurricanes,1,0,2,0,3,20210519,1,1,3,3,3,3,2020,0,2,456,1
Blues,0,1,2,0,3,Avalanche,2,1,3,0,6,20210519,2,2,3,3,9,3,2020,0,2,794,1
Canucks,0,2,0,0,2,Flames,3,2,1,0,6,20210519,3,3,4,4,8,4,2020,0,2,426,1
Capitals,0,2,0,0,2,Bruins,0,1,1,1,3,20210519,0,-1,0,1,5,1,2020,1,2,394,1
Panthers,2,1,2,1,6,Lightning,0,5,0,0,5,20210520,2,-2,0,1,11,-1,2020,1,3,205,1
Penguins,1,2,2,0,5,Islanders,0,1,3,0,4,20210520,1,2,1,1,9,-1,2020,0,3,314,1
Canadiens,1,0,1,0,2,Maple Leafs,0,1,0,0,1,20210520,1,0,1,1,3,-1,2020,0,3,303,1
Golden Knights,0,3,2,0,5,Wild,2,0,0,0,2,20210520,-2,1,3,3,7,-3,2020,0,3,1293,1
Capitals,0,0,1,0,1,Bruins,0,1,3,0,4,20210521,0,1,3,3,5,3,2020,0,4,394,1
Hurricanes,1,2,1,0,4,Predators,2,1,1,1,5,20210521,1,0,0,1,9,1,2020,1,4,456,1
Jets,0,0,0,1,1,Oilers,0,0,0,0,0,20210521,0,0,0,1,1,-1,2020,1,4,738,1
Avalanche,0,3,2,0,5,Blues,0,1,0,0,1,20210521,0,2,4,4,6,-4,2020,0,4,794,1
Golden Knights,1,2,1,0,4,Wild,0,0,0,0,0,20210522,1,3,4,4,4,-4,2020,0,5,1293,1
Canadiens,1,0,0,0,1,Maple Leafs,1,2,2,0,5,20210522,0,2,4,4,6,4,2020,0,5,303,1
Penguins,0,0,1,0,1,Islanders,0,2,2,0,4,20210522,0,2,3,3,5,3,2020,0,5,314,1
Panthers,1,1,0,0,2,Lightning,3,2,1,0,6,20210522,2,3,4,4,8,4,2020,0,5,205,1
Hurricanes,1,1,1,0,3,Predators,1,1,1,1,4,20210523,0,0,0,1,7,1,2020,1,6,456,1
Avalanche,0,2,3,0,5,Blues,0,1,1,0,2,20210523,0,1,3,3,7,-3,2020,0,6,794,1
Bruins,0,2,1,0,3,Capitals,0,0,1,0,1,20210523,0,2,2,2,4,-2,2020,0,6,394,1
Oilers,2,1,1,0,4,Jets,0,1,3,1,5,20210523,-2,-2,0,1,9,1,2020,1,6,738,1
Islanders,1,0,1,1,3,Penguins,1,1,0,0,2,20210524,0,-1,0,1,5,-1,2020,1,0,314,1
Maple Leafs,0,2,0,0,2,Canadiens,0,1,0,0,1,20210524,0,1,1,1,3,-1,2020,0,0,303,1
Lightning,1,0,0,0,1,Panthers,0,2,2,0,4,20210524,-1,1,3,3,5,3,2020,0,0,205,1
Oilers,1,2,0,0,3,Jets,2,0,1,1,4,20210524,1,-1,0,1,7,1,2020,1,0,738,1
Wild,3,0,1,0,4,Golden Knights,1,1,0,0,2,20210524,2,1,2,2,6,-2,2020,0,0,1293,1
Predators,1,1,0,0,2,Hurricanes,1,0,1,1,3,20210525,0,-1,0,1,5,1,2020,1,1,456,1
Maple Leafs,0,3,1,0,4,Canadiens,0,0,0,0,0,20210525,0,3,4,4,4,-4,2020,0,1,303,1
Penguins,2,1,0,0,3,Islanders,2,3,0,0,5,20210526,0,2,2,2,8,2,2020,0,2,314,1
Panthers,0,0,0,0,0,Lightning,1,1,2,0,4,20210526,1,2,4,4,4,4,2020,0,2,205,1
Golden Knights,0,0,0,0,0,Wild,0,0,3,0,3,20210526,0,0,3,3,3,3,2020,0,2,1293,1
Canadiens,2,1,0,1,4,Maple Leafs,0,1,2,0,3,20210527,2,2,0,1,7,-1,2020,1,3,303,1
Hurricanes,1,1,1,1,4,Predators,1,2,0,0,3,20210527,0,-1,0,1,7,-1,2020,1,3,456,1
Wild,1,1,0,0,2,Golden Knights,1,3,2,0,6,20210528,0,2,4,4,8,4,2020,0,4,1293,1
Maple Leafs,0,0,2,0,2,Canadiens,0,0,2,1,3,20210529,0,0,0,1,5,1,2020,1,5,303,1
Islanders,1,1,0,0,2,Bruins,1,1,3,0,5,20210529,0,0,3,3,7,3,2020,0,5,190,1
Golden Knights,0,1,0,0,1,Avalanche,2,4,1,0,7,20210530,2,5,6,6,8,6,2020,0,6,604,1
Lightning,0,1,1,0,2,Hurricanes,0,0,1,0,1,20210530,0,1,1,1,3,-1,2020,0,6,585,1
Islanders,0,3,0,1,4,Bruins,1,0,2,0,3,20210531,-1,2,0,1,7,-1,2020,1,0,190,1
Canadiens,0,2,1,0,3,Maple Leafs,0,0,1,0,1,20210531,0,2,2,2,4,-2,2020,0,0,303,1
Lightning,0,1,1,0,2,Hurricanes,0,0,1,0,1,20210601,0,1,1,1,3,-1,2020,0,1,585,1
Canadiens,3,0,2,0,5,Jets,1,0,2,0,3,20210602,2,2,2,2,8,-2,2020,0,2,1115,1
Golden Knights,1,1,0,0,2,Avalanche,2,0,0,1,3,20210602,1,0,0,1,5,1,2020,1,2,604,1
Bruins,1,0,0,1,2,Islanders,0,0,1,0,1,20210603,1,1,0,1,3,-1,2020,1,3,190,1
Hurricanes,0,2,0,1,3,Lightning,0,2,0,0,2,20210603,0,0,0,1,5,-1,2020,1,3,585,1
Canadiens,0,1,0,0,1,Jets,0,0,0,0,0,20210604,0,1,1,1,1,-1,2020,0,4,1115,1
Avalanche,0,1,1,0,2,Golden Knights,0,1,2,0,3,20210604,0,0,1,1,5,1,2020,0,4,604,1
Hurricanes,0,4,0,0,4,Lightning,1,4,1,0,6,20210605,1,1,2,2,10,2,2020,0,5,585,1
Bruins,0,1,0,0,1,Islanders,0,1,3,0,4,20210605,0,0,3,3,5,3,2020,0,5,190,1
Avalanche,1,0,0,0,1,Golden Knights,1,2,2,0,5,20210606,0,2,4,4,6,4,2020,0,6,604,1
Jets,0,1,0,0,1,Canadiens,1,2,2,0,5,20210606,1,2,4,4,6,4,2020,0,6,1115,1
Jets,0,2,0,0,2,Canadiens,2,0,0,1,3,20210607,2,0,0,1,5,1,2020,1,0,1115,1
Islanders,1,3,1,0,5,Bruins,1,1,2,0,4,20210607,0,2,1,1,9,-1,2020,0,0,190,1
Lightning,0,1,1,0,2,Hurricanes,0,0,0,0,0,20210608,0,1,2,2,2,-2,2020,0,1,585,1
Golden Knights,0,0,2,1,3,Avalanche,1,1,0,0,2,20210608,-1,-2,0,1,5,-1,2020,1,1,604,1
Bruins,1,0,1,0,2,Islanders,1,3,2,0,6,20210609,0,3,4,4,8,4,2020,0,2,190,1
Avalanche,1,2,0,0,3,Golden Knights,2,2,2,0,6,20210610,1,1,3,3,9,3,2020,0,3,604,1
Islanders,0,1,1,0,2,Lightning,0,0,1,0,1,20210613,0,1,1,1,3,-1,2020,0,6,1004,1
Canadiens,0,1,0,0,1,Golden Knights,1,2,1,0,4,20210614,1,2,3,3,5,3,2020,0,0,2221,1
Islanders,1,0,1,0,2,Lightning,1,1,2,0,4,20210615,0,1,2,2,6,2,2020,0,1,1004,1
Canadiens,2,1,0,0,3,Golden Knights,0,1,1,0,2,20210616,2,2,1,1,5,-1,2020,0,2,2221,1
Lightning,1,1,0,0,2,Islanders,0,1,0,0,1,20210617,1,1,1,1,3,-1,2020,0,3,1004,1
Golden Knights,0,1,1,0,2,Canadiens,0,1,1,1,3,20210618,0,0,0,1,5,1,2020,1,4,2221,1
Lightning,0,0,2,0,2,Islanders,0,3,0,0,3,20210619,0,3,1,1,5,1,2020,0,5,1004,1
Golden Knights,0,0,1,1,2,Canadiens,0,1,0,0,1,20210620,0,-1,0,1,3,-1,2020,1,6,2221,1
Islanders,0,0,0,0,0,Lightning,3,3,2,0,8,20210621,3,6,8,8,8,8,2020,0,0,1004,1
Canadiens,1,2,1,0,4,Golden Knights,0,0,1,0,1,20210622,1,3,3,3,5,-3,2020,0,1,2221,1
Lightning,1,1,0,0,2,Islanders,0,1,1,1,3,20210623,-1,-1,0,1,5,1,2020,1,2,1004,1
Golden Knights,1,0,1,0,2,Canadiens,1,1,0,1,3,20210624,0,1,0,1,5,1,2020,1,3,2221,1
Islanders,0,0,0,0,0,Lightning,0,1,0,0,1,20210625,0,1,1,1,1,1,2020,0,4,1004,1
Canadiens,0,1,0,0,1,Lightning,1,1,3,0,5,20210628,1,1,4,4,6,4,2020,0,0,1311,1
Canadiens,0,1,0,0,1,Lightning,0,2,1,0,3,20210630,0,1,2,2,4,2,2020,0,2,1311,1
Lightning,2,2,2,0,6,Canadiens,1,1,1,0,3,20210702,1,2,3,3,9,-3,2020,0,4,1311,1
Lightning,0,1,1,0,2,Canadiens,1,0,1,1,3,20210705,1,0,0,1,5,1,2020,1,0,1311,1
Canadiens,0,0,0,0,0,Lightning,0,1,0,0,1,20210707,0,1,1,1,1,1,2020,0,2,1311,1
Kraken,0,2,1,0,3,Golden Knights,2,1,1,0,4,20211012,2,1,1,1,7,1,2021,0,1,871,0
Penguins,0,2,4,0,6,Lightning,0,0,2,0,2,20211012,0,2,4,4,8,-4,2021,0,1,874,0
Canadiens,1,0,0,0,1,Maple Leafs,1,0,1,0,2,20211013,0,0,1,1,3,1,2021,0,2,303,0
Rangers,0,0,1,0,1,Capitals,1,2,2,0,5,20211013,1,3,4,4,6,4,2021,0,2,204,0
Blackhawks,1,0,1,0,2,Avalanche,3,1,0,0,4,20211013,2,3,2,2,6,2,2021,0,2,916,0
Canucks,0,0,2,0,2,Oilers,1,1,0,1,3,20211013,1,2,0,1,5,1,2021,1,2,514,0
Jets,0,1,0,0,1,Ducks,2,1,1,0,4,20211013,2,2,3,3,5,3,2021,0,2,1527,0
Lightning,0,3,3,1,7,Red Wings,1,3,2,0,6,20211014,-1,-1,0,1,13,-1,2021,1,3,994,0
Golden Knights,1,0,1,0,2,Kings,2,2,2,0,6,20211014,1,3,4,4,8,4,2021,0,3,228,0
Kraken,2,1,1,0,4,Predators,1,1,1,0,3,20211014,1,1,1,1,7,-1,2021,0,3,1970,0
Coyotes,0,1,1,0,2,Blue Jackets,2,3,3,0,8,20211014,2,4,6,6,10,6,2021,0,3,1664,0
Stars,1,1,0,1,3,Rangers,0,2,0,0,2,20211014,1,0,0,1,5,-1,2021,1,3,1370,0
Penguins,0,2,2,0,4,Panthers,1,1,2,1,5,20211014,1,0,0,1,9,1,2021,1,3,1013,0
Maple Leafs,0,0,2,0,2,Senators,3,0,0,0,3,20211014,3,3,1,1,5,1,2021,0,3,203,0
Canadiens,0,1,0,0,1,Sabres,2,2,1,0,5,20211014,2,3,4,4,6,4,2021,0,3,311,0
Islanders,1,2,0,0,3,Hurricanes,2,2,2,0,6,20211014,1,1,3,3,9,3,2021,0,3,423,0
Blackhawks,0,1,2,0,3,Devils,1,1,1,1,4,20211015,1,1,0,1,7,1,2021,1,4,703,0
Canucks,0,4,0,1,5,Flyers,1,1,2,0,4,20211015,-1,2,0,1,9,-1,2021,1,4,2404,0
Wild,0,1,1,0,2,Ducks,0,1,0,0,1,20211015,0,0,1,1,3,-1,2021,0,4,1521,0
Hurricanes,1,0,2,0,3,Predators,0,1,1,0,2,20211016,1,0,1,1,5,-1,2021,0,5,456,0
Blues,1,2,2,0,5,Avalanche,0,1,2,0,3,20211016,1,2,2,2,8,-2,2021,0,5,794,0
Kraken,0,1,0,0,1,Blue Jackets,0,0,1,1,2,20211016,0,-1,0,1,3,1,2021,1,5,2008,0
Jets,1,1,1,0,3,Sharks,0,2,2,0,4,20211016,-1,0,1,1,7,1,2021,0,5,1496,0
Wild,0,3,0,0,3,Kings,0,1,1,0,2,20211016,0,2,1,1,5,-1,2021,0,5,1521,0
Flames,0,1,1,0,2,Oilers,2,1,2,0,5,20211016,2,2,3,3,7,3,2021,0,5,171,0
Lightning,0,0,1,1,2,Capitals,0,1,0,0,1,20211016,0,-1,0,1,3,-1,2021,1,5,818,0
Coyotes,1,0,0,0,1,Sabres,0,1,0,1,2,20211016,-1,0,0,1,3,1,2021,1,5,1902,0
Canucks,0,1,0,0,1,Red Wings,1,1,1,0,3,20211016,1,1,2,2,4,2,2021,0,5,1967,0
Rangers,0,1,2,0,3,Canadiens,0,0,1,0,1,20211016,0,1,2,2,4,-2,2021,0,5,343,0
Senators,0,1,0,0,1,Maple Leafs,2,0,1,0,3,20211016,2,1,2,2,4,2,2021,0,5,203,0
Stars,0,1,0,0,1,Bruins,1,0,2,0,3,20211016,1,0,2,2,4,2,2021,0,5,1548,0
Islanders,0,0,1,0,1,Panthers,1,2,2,0,5,20211016,1,3,4,4,6,4,2021,0,5,1091,0
Blackhawks,0,1,1,0,2,Penguins,4,1,0,0,5,20211016,4,4,3,3,7,3,2021,0,5,409,0
Stars,1,0,1,0,2,Senators,1,2,0,0,3,20211017,0,2,1,1,5,1,2021,0,6,1404,0
Rangers,1,0,0,1,2,Maple Leafs,0,1,0,0,1,20211018,1,0,0,1,3,-1,2021,1,0,341,0
Kraken,0,1,0,0,1,Flyers,3,2,1,0,6,20211018,3,4,5,5,7,5,2021,0,0,2373,0
Ducks,1,0,1,1,3,Flames,1,1,0,0,2,20211018,0,-1,0,1,5,-1,2021,1,0,1197,0
Blues,1,5,1,0,7,Coyotes,1,1,2,0,4,20211018,0,4,3,3,11,-3,2021,0,0,1270,0
Ducks,2,2,1,0,5,Oilers,3,0,3,0,6,20211019,1,-1,1,1,11,1,2021,0,1,1368,0
Jets,2,1,2,0,5,Wild,2,1,2,1,6,20211019,0,0,0,1,11,1,2021,1,1,388,0
Kings,0,1,0,0,1,Predators,0,0,2,0,2,20211019,0,-1,1,1,3,1,2021,0,1,1776,0
Islanders,0,1,3,0,4,Blackhawks,0,0,1,0,1,20211019,0,1,3,3,5,-3,2021,0,1,711,0
Avalanche,1,1,1,0,3,Capitals,2,2,2,0,6,20211019,1,2,3,3,9,3,2021,0,1,1489,0
Blue Jackets,0,0,1,0,1,Red Wings,0,0,4,0,4,20211019,0,0,3,3,5,3,2021,0,1,163,0
Kraken,0,1,1,0,2,Devils,2,1,1,0,4,20211019,2,2,2,2,6,2,2021,0,1,2393,0
Panthers,0,1,3,0,4,Lightning,0,0,1,0,1,20211019,0,1,3,3,5,-3,2021,0,1,205,0
Sharks,3,1,1,0,5,Canadiens,0,0,0,0,0,20211019,3,4,5,5,5,-5,2021,0,1,2508,0
Canucks,2,0,0,0,2,Sabres,1,1,3,0,5,20211019,-1,0,3,3,7,3,2021,0,1,2137,0
Stars,1,0,0,1,2,Penguins,0,1,0,0,1,20211019,1,0,0,1,3,-1,2021,1,1,1069,0
Bruins,1,2,0,0,3,Flyers,2,1,3,0,6,20211020,1,0,3,3,9,3,2021,0,2,270,0
Blues,0,1,2,0,3,Golden Knights,1,0,0,0,1,20211020,-1,0,2,2,4,-2,2021,0,2,1375,0
Canucks,1,2,1,0,4,Blackhawks,1,0,0,0,1,20211021,0,2,3,3,5,-3,2021,0,3,1775,0
Ducks,1,0,0,0,1,Jets,1,1,3,0,5,20211021,0,1,4,4,6,4,2021,0,3,1527,0
Rangers,1,0,2,0,3,Predators,0,1,0,0,1,20211021,1,0,2,2,4,-2,2021,0,3,758,0
Flames,2,0,1,0,3,Red Wings,0,0,0,0,0,20211021,2,2,3,3,3,-3,2021,0,3,1573,0
Sharks,0,2,0,0,2,Senators,1,0,0,0,1,20211021,-1,1,1,1,3,-1,2021,0,3,2408,0
Capitals,2,1,1,0,4,Devils,0,0,1,0,1,20211021,2,3,3,3,5,-3,2021,0,3,198,0
Avalanche,1,0,0,0,1,Panthers,1,2,1,0,4,20211021,0,2,3,3,5,3,2021,0,3,1724,0
Hurricanes,0,2,2,0,4,Canadiens,0,1,0,0,1,20211021,0,1,3,3,5,-3,2021,0,3,727,0
Oilers,1,2,2,0,5,Coyotes,0,0,1,0,1,20211021,1,3,4,4,6,-4,2021,0,3,1392,0
Islanders,0,1,1,0,2,Blue Jackets,0,2,0,1,3,20211021,0,1,0,1,5,1,2021,1,3,476,0
Kings,1,1,0,0,2,Stars,1,0,1,1,3,20211022,0,-1,0,1,5,1,2021,1,4,1237,0
Oilers,1,2,2,0,5,Golden Knights,1,1,1,0,3,20211022,0,1,2,2,8,-2,2021,0,4,1204,0
Sharks,0,3,2,0,5,Maple Leafs,0,2,1,0,3,20211022,0,1,2,2,8,-2,2021,0,4,2249,0
Bruins,2,1,1,0,4,Sabres,0,0,1,0,1,20211022,2,3,3,3,5,-3,2021,0,4,399,0
Canucks,0,1,3,0,4,Kraken,1,0,1,0,2,20211023,-1,0,2,2,6,-2,2021,0,5,116,0
Islanders,1,1,1,0,3,Coyotes,0,0,0,0,0,20211023,1,2,3,3,3,-3,2021,0,5,2139,0
Kings,1,0,2,0,3,Blues,2,3,2,0,7,20211023,1,4,4,4,10,4,2021,0,5,1586,0
Predators,1,1,2,0,4,Jets,1,3,2,0,6,20211023,0,2,2,2,10,2,2021,0,5,1084,0
Maple Leafs,1,0,0,0,1,Penguins,1,4,2,0,7,20211023,0,4,6,6,8,6,2021,0,5,222,0
Panthers,1,1,2,0,4,Flyers,0,2,0,0,2,20211023,1,0,2,2,6,-2,2021,0,5,1021,0
Hurricanes,2,1,2,0,5,Blue Jackets,0,1,0,0,1,20211023,2,2,4,4,6,-4,2021,0,5,374,0
Avalanche,1,1,1,1,4,Lightning,0,1,2,0,3,20211023,1,1,0,1,7,-1,2021,1,5,1521,0
Red Wings,1,0,0,0,1,Canadiens,2,3,1,0,6,20211023,1,4,5,5,7,5,2021,0,5,508,0
Ducks,2,1,0,0,3,Wild,2,1,0,1,4,20211023,0,0,0,1,7,1,2021,1,5,1521,0
Flames,3,0,0,1,4,Capitals,0,3,0,0,3,20211023,3,0,0,1,7,-1,2021,1,5,1967,0
Rangers,0,0,3,0,3,Senators,1,0,1,0,2,20211023,-1,-1,1,1,5,-1,2021,0,5,334,0
Sabres,1,0,0,0,1,Devils,0,0,1,1,2,20211023,-1,-1,0,1,3,1,2021,1,5,284,0
Sharks,1,0,2,0,3,Bruins,3,1,0,0,4,20211024,2,3,1,1,7,1,2021,0,6,2678,0
Predators,3,2,0,0,5,Wild,0,2,0,0,2,20211024,3,3,3,3,7,-3,2021,0,6,696,0
Red Wings,1,4,1,0,6,Blackhawks,1,1,1,0,3,20211024,0,3,3,3,9,-3,2021,0,6,238,0
Islanders,1,0,1,0,2,Golden Knights,0,0,0,0,0,20211024,1,1,2,2,2,-2,2021,0,6,2227,0
Kings,0,0,0,0,0,Blues,0,0,3,0,3,20211025,0,0,3,3,3,3,2021,0,0,1586,0
Stars,0,0,1,0,1,Blue Jackets,1,1,2,0,4,20211025,1,2,3,3,5,3,2021,0,0,912,0
Maple Leafs,1,0,0,0,1,Hurricanes,0,3,1,0,4,20211025,-1,2,3,3,5,3,2021,0,0,544,0
Capitals,4,2,1,0,7,Senators,1,3,1,0,5,20211025,3,2,2,2,12,-2,2021,0,0,446,0
Coyotes,1,0,2,0,3,Panthers,1,2,2,0,5,20211025,0,2,2,2,8,2,2021,0,0,1978,0
Lightning,1,0,0,0,1,Sabres,1,1,3,0,5,20211025,0,1,4,4,6,4,2021,0,0,1051,0
Flames,1,1,3,0,5,Rangers,0,0,1,0,1,20211025,1,2,4,4,6,-4,2021,0,0,2023,0
Jets,0,1,3,0,4,Ducks,0,1,2,0,3,20211026,0,0,1,1,7,-1,2021,0,1,1527,0
Wild,1,1,1,0,3,Canucks,0,1,1,0,2,20211026,1,1,1,1,5,-1,2021,0,1,1427,0
Sharks,0,0,1,0,1,Predators,1,1,1,0,3,20211026,1,2,2,2,4,2,2021,0,1,1934,0
Canadiens,1,0,0,0,1,Kraken,2,2,1,0,5,20211026,1,3,4,4,6,4,2021,0,1,2262,0
Lightning,0,3,2,0,5,Penguins,0,0,1,0,1,20211026,0,3,4,4,6,-4,2021,0,1,874,0
Flames,4,0,1,0,5,Devils,0,1,2,0,3,20211026,4,3,2,2,8,-2,2021,0,1,2015,0
Golden Knights,2,0,1,0,3,Avalanche,0,1,0,0,1,20211026,2,1,2,2,4,-2,2021,0,1,604,0
Bruins,1,0,0,0,1,Panthers,1,1,2,0,4,20211027,0,1,3,3,5,3,2021,0,2,1257,0
Red Wings,0,1,1,1,3,Capitals,1,1,0,0,2,20211027,-1,-1,0,1,5,-1,2021,1,2,394,0
Maple Leafs,0,1,1,1,3,Blackhawks,2,0,0,0,2,20211027,-2,-1,0,1,5,-1,2021,1,2,436,0
Golden Knights,1,0,1,1,3,Stars,1,1,0,0,2,20211027,0,-1,0,1,5,-1,2021,1,2,1068,0
Flyers,3,0,2,0,5,Oilers,2,1,0,0,3,20211027,1,0,2,2,8,-2,2021,0,2,2011,0
Canadiens,1,2,1,0,4,Sharks,0,0,0,0,0,20211028,1,3,4,4,4,-4,2021,0,3,2508,0
Jets,1,0,2,0,3,Kings,1,1,0,0,2,20211028,0,-1,1,1,5,-1,2021,0,3,1527,0
Wild,1,0,0,0,1,Kraken,1,1,2,0,4,20211028,0,1,3,3,5,3,2021,0,3,1391,0
Flyers,2,0,0,0,2,Canucks,1,0,0,0,1,20211028,1,1,1,1,3,-1,2021,0,3,2404,0
Sabres,1,2,0,1,4,Ducks,0,2,1,0,3,20211028,1,1,0,1,7,-1,2021,1,3,2193,0
Bruins,0,0,0,0,0,Hurricanes,1,1,1,0,3,20211028,1,2,3,3,3,3,2021,0,3,609,0
Coyotes,0,0,1,0,1,Lightning,3,1,1,0,5,20211028,3,4,4,4,6,4,2021,0,3,1793,0
Avalanche,1,2,1,0,4,Blues,1,0,2,0,3,20211028,0,2,1,1,7,-1,2021,0,3,794,0
Flames,1,0,3,0,4,Penguins,0,0,0,0,0,20211028,1,1,4,4,4,-4,2021,0,3,1777,0
Panthers,2,0,0,1,3,Red Wings,0,1,1,0,2,20211029,2,1,0,1,5,-1,2021,1,4,1155,0
Blue Jackets,0,0,0,0,0,Rangers,2,0,2,0,4,20211029,2,2,4,4,4,4,2021,0,4,476,0
Coyotes,0,0,0,0,0,Capitals,0,0,2,0,2,20211029,0,0,2,2,2,2,2021,0,4,1977,0
Blackhawks,2,0,1,0,3,Hurricanes,4,2,0,0,6,20211029,2,4,3,3,9,3,2021,0,4,641,0
Ducks,0,1,3,0,4,Golden Knights,1,1,2,1,5,20211029,1,1,0,1,9,1,2021,1,4,228,0
Senators,2,1,1,0,4,Stars,0,1,0,0,1,20211029,2,2,3,3,5,-3,2021,0,4,1404,0
Panthers,0,1,1,0,2,Bruins,1,0,1,1,3,20211030,1,0,0,1,5,1,2021,1,5,1257,0
Oilers,1,1,0,0,2,Canucks,0,0,1,0,1,20211030,1,2,1,1,3,-1,2021,0,5,514,0
Flyers,0,0,0,0,0,Flames,0,1,3,0,4,20211030,0,1,4,4,4,4,2021,0,5,2003,0
Wild,0,1,0,0,1,Avalanche,1,1,2,0,4,20211030,1,1,3,3,5,3,2021,0,5,698,0
Blackhawks,0,0,0,0,0,Blues,0,0,1,0,1,20211030,0,0,1,1,1,1,2021,0,5,260,0
Islanders,1,1,0,0,2,Predators,0,1,1,1,3,20211030,-1,-1,0,1,5,1,2021,1,5,758,0
Devils,1,1,2,0,4,Penguins,1,0,1,0,2,20211030,0,1,2,2,6,-2,2021,0,5,306,0
Red Wings,0,1,3,0,4,Maple Leafs,1,1,3,0,5,20211030,1,1,1,1,9,1,2021,0,5,205,0
Canadiens,1,0,1,0,2,Kings,0,2,3,0,5,20211030,-1,1,3,3,7,3,2021,0,5,2448,0
Jets,0,0,1,0,1,Sharks,0,1,0,1,2,20211030,0,1,0,1,3,1,2021,1,5,1496,0
Blue Jackets,2,0,1,1,4,Devils,1,2,0,0,3,20211031,1,-1,0,1,7,-1,2021,1,6,467,0
Rangers,1,0,2,0,3,Kraken,0,1,0,0,1,20211031,1,0,2,2,4,-2,2021,0,6,2401,0
Sabres,0,2,0,0,2,Kings,0,1,2,0,3,20211031,0,-1,1,1,5,1,2021,0,6,2193,0
Coyotes,1,0,0,0,1,Hurricanes,0,1,1,0,2,20211031,-1,0,1,1,3,1,2021,0,6,1898,0
Canadiens,1,1,0,0,2,Ducks,2,0,2,0,4,20211031,1,0,2,2,6,2,2021,0,6,2448,0
Capitals,1,0,1,0,2,Lightning,0,2,1,0,3,20211101,-1,1,1,1,5,1,2021,0,0,818,0
Senators,0,0,1,0,1,Blackhawks,1,1,3,0,5,20211101,1,2,4,4,6,4,2021,0,0,628,0
Kraken,1,1,0,0,2,Oilers,2,1,2,0,5,20211101,1,1,3,3,7,3,2021,0,0,564,0
Sabres,1,1,1,0,3,Sharks,2,1,2,0,5,20211102,1,1,2,2,8,2,2021,0,1,2279,0
Devils,0,0,0,0,0,Ducks,1,1,2,0,4,20211102,1,2,4,4,4,4,2021,0,1,2436,0
Rangers,0,2,0,0,2,Canucks,0,0,2,1,3,20211102,0,-2,0,1,5,1,2021,1,1,2429,0
Stars,1,0,2,0,3,Jets,1,2,0,1,4,20211102,0,2,0,1,7,1,2021,1,1,1183,0
Predators,2,0,0,1,3,Flames,1,0,1,0,2,20211102,1,1,0,1,5,-1,2021,1,1,1692,0
Coyotes,0,0,0,0,0,Flyers,0,0,3,0,3,20211102,0,0,3,3,3,3,2021,0,1,2078,0
Red Wings,0,0,0,0,0,Canadiens,2,0,1,0,3,20211102,2,2,3,3,3,3,2021,0,1,508,0
Golden Knights,0,0,0,0,0,Maple Leafs,1,2,1,0,4,20211102,1,3,4,4,4,4,2021,0,1,1946,0
Senators,1,3,0,0,4,Wild,3,1,0,1,5,20211102,2,0,0,1,9,1,2021,1,1,838,0
Hurricanes,1,1,2,0,4,Blackhawks,1,2,0,0,3,20211103,0,-1,1,1,7,-1,2021,0,2,641,0
Predators,1,0,1,0,2,Oilers,1,1,3,0,5,20211103,0,1,3,3,7,3,2021,0,2,1758,0
Blue Jackets,0,1,3,1,5,Avalanche,0,2,2,0,4,20211103,0,-1,0,1,9,-1,2021,1,2,1163,0
Blues,0,1,1,0,2,Kings,0,0,2,1,3,20211103,0,-1,0,1,5,1,2021,1,2,1586,0
Flyers,0,1,1,0,2,Penguins,1,1,0,1,3,20211104,1,1,0,1,5,1,2021,1,3,257,0
Blues,1,3,1,0,5,Sharks,2,1,0,0,3,20211104,-1,1,2,2,8,-2,2021,0,3,1719,0
Sabres,0,2,0,0,2,Kraken,1,1,3,0,5,20211104,1,0,3,3,7,3,2021,0,3,2110,0
Capitals,0,3,1,0,4,Panthers,2,2,0,1,5,20211104,2,1,0,1,9,1,2021,1,3,924,0
Stars,1,1,1,1,4,Flames,0,2,1,0,3,20211104,1,0,0,1,7,-1,2021,1,3,1536,0
Islanders,1,4,1,0,6,Canadiens,0,0,2,0,2,20211104,1,5,4,4,8,-4,2021,0,3,343,0
Golden Knights,0,3,2,0,5,Senators,0,1,0,0,1,20211104,0,2,4,4,6,-4,2021,0,3,2119,0
Lightning,1,0,0,0,1,Maple Leafs,0,0,1,1,2,20211104,-1,-1,0,1,3,1,2021,1,3,1096,0
Red Wings,0,0,1,0,1,Bruins,1,2,2,0,5,20211104,1,3,4,4,6,4,2021,0,3,611,0
Blackhawks,0,0,1,0,1,Jets,2,2,1,0,5,20211105,2,4,4,4,6,4,2021,0,4,722,0
Rangers,1,3,1,0,5,Oilers,1,1,3,1,6,20211105,0,-2,0,1,11,1,2021,1,4,2024,0
Predators,1,2,0,0,3,Canucks,1,1,0,0,2,20211105,0,1,1,1,5,-1,2021,0,4,2030,0
Coyotes,0,0,1,0,1,Ducks,2,1,0,0,3,20211105,2,3,2,2,4,2,2021,0,4,356,0
Devils,0,0,2,0,2,Kings,0,1,1,1,3,20211105,0,1,0,1,5,1,2021,1,4,2436,0
Devils,0,1,1,1,3,Sharks,0,1,1,0,2,20211106,0,0,0,1,5,-1,2021,1,5,2540,0
Rangers,0,0,0,0,0,Flames,1,2,3,0,6,20211106,1,3,6,6,6,6,2021,0,5,2023,0
Islanders,1,0,1,0,2,Jets,0,0,0,0,0,20211106,1,1,2,2,2,-2,2021,0,5,1287,0
Avalanche,1,1,0,0,2,Blue Jackets,1,0,3,0,4,20211106,0,-1,2,2,6,2,2021,0,5,1163,0
Flyers,0,2,0,0,2,Capitals,0,0,1,0,1,20211106,0,2,1,1,3,-1,2021,0,5,123,0
Kraken,3,0,1,0,4,Coyotes,1,1,3,0,5,20211106,-2,-1,1,1,9,1,2021,0,5,1114,0
Golden Knights,0,3,2,0,5,Canadiens,2,0,0,0,2,20211106,-2,1,3,3,7,-3,2021,0,5,2221,0
Bruins,1,0,1,0,2,Maple Leafs,1,2,2,0,5,20211106,0,2,3,3,7,3,2021,0,5,430,0
Red Wings,1,0,2,1,4,Sabres,0,2,1,0,3,20211106,1,-1,0,1,7,-1,2021,1,5,215,0
Hurricanes,0,2,0,0,2,Panthers,4,0,1,0,5,20211106,4,2,3,3,7,3,2021,0,5,696,0
Lightning,1,1,3,0,5,Senators,0,2,1,0,3,20211106,1,0,2,2,8,-2,2021,0,5,1251,0
Wild,1,1,2,1,5,Penguins,2,1,1,0,4,20211106,-1,-1,0,1,9,-1,2021,1,5,741,0
Golden Knights,1,0,1,0,2,Red Wings,3,1,1,0,5,20211107,2,3,3,3,7,3,2021,0,6,1757,0
Predators,0,1,0,0,1,Blackhawks,0,1,0,1,2,20211107,0,0,0,1,3,1,2021,1,6,395,0
Islanders,1,1,0,0,2,Wild,0,1,4,0,5,20211107,-1,-1,3,3,7,3,2021,0,6,1016,0
Blues,1,0,0,0,1,Ducks,0,1,3,0,4,20211107,-1,0,3,3,5,3,2021,0,6,1586,0
Stars,1,1,1,0,3,Canucks,0,4,2,0,6,20211107,-1,2,3,3,9,3,2021,0,6,1766,0
Kings,2,1,2,0,5,Maple Leafs,0,1,0,0,1,20211108,2,2,4,4,6,-4,2021,0,0,2170,0
Sabres,0,1,2,0,3,Capitals,1,2,2,0,5,20211108,1,2,2,2,8,2,2021,0,0,292,0
Panthers,0,0,3,0,3,Rangers,2,2,0,0,4,20211108,2,4,1,1,7,1,2021,0,0,1091,0
Kraken,1,1,0,0,2,Golden Knights,1,1,2,0,4,20211109,0,0,2,2,6,2,2021,0,1,871,0
Senators,1,1,0,0,2,Bruins,0,3,0,0,3,20211109,-1,1,1,1,5,1,2021,0,1,320,0
Kings,0,1,1,1,3,Canadiens,1,0,1,0,2,20211109,-1,0,0,1,5,-1,2021,1,1,2448,0
Hurricanes,0,0,1,1,2,Lightning,0,1,0,0,1,20211109,0,-1,0,1,3,-1,2021,1,1,585,0
Panthers,1,2,0,0,3,Devils,2,2,3,0,7,20211109,1,1,4,4,10,4,2021,0,1,1090,0
Oilers,0,1,1,0,2,Red Wings,1,2,1,0,4,20211109,1,2,2,2,6,2,2021,0,1,1592,0
Blues,1,0,1,1,3,Jets,0,1,1,0,2,20211109,1,0,0,1,5,-1,2021,1,1,853,0
Penguins,0,0,2,0,2,Blackhawks,0,2,0,1,3,20211109,0,2,0,1,5,1,2021,1,1,409,0
Sharks,0,1,3,0,4,Flames,0,1,0,0,1,20211109,0,0,3,3,5,-3,2021,0,1,1027,0
Ducks,1,0,1,1,3,Canucks,0,0,2,0,2,20211109,1,1,0,1,5,-1,2021,1,1,1076,0
Predators,1,2,1,0,4,Stars,0,1,1,0,2,20211110,1,2,2,2,6,-2,2021,0,2,616,0
Wild,2,3,0,0,5,Coyotes,1,0,1,0,2,20211110,1,4,3,3,7,-3,2021,0,2,1278,0
Maple Leafs,0,1,2,0,3,Flyers,0,0,0,0,0,20211110,0,1,3,3,3,-3,2021,0,2,334,0
Ducks,1,3,3,0,7,Kraken,0,2,2,0,4,20211111,1,2,3,3,11,-3,2021,0,3,960,0
Wild,0,0,2,0,2,Golden Knights,2,1,0,0,3,20211111,2,3,1,1,5,1,2021,0,3,1293,0
Sharks,1,0,0,0,1,Jets,1,2,1,0,4,20211111,0,2,3,3,5,3,2021,0,3,1496,0
Predators,0,2,1,1,4,Blues,2,0,1,0,3,20211111,-2,0,0,1,7,-1,2021,1,3,253,0
Capitals,2,0,0,0,2,Red Wings,0,0,0,0,0,20211111,2,2,2,2,2,-2,2021,0,3,394,0
Canucks,0,0,1,0,1,Avalanche,3,3,1,0,7,20211111,3,6,6,6,8,6,2021,0,3,1105,0
Islanders,0,0,0,0,0,Devils,1,1,2,0,4,20211111,1,2,4,4,4,4,2021,0,3,8,0
Kings,0,1,1,0,2,Senators,0,0,0,0,0,20211111,0,1,2,2,2,-2,2021,0,3,2345,0
Flames,2,0,0,0,2,Canadiens,1,1,2,0,4,20211111,-1,0,2,2,6,2,2021,0,3,1852,0
Oilers,1,1,3,0,5,Bruins,1,2,0,0,3,20211111,0,-1,2,2,8,-2,2021,0,3,2074,0
Panthers,1,0,1,0,2,Penguins,1,1,0,1,3,20211111,0,1,0,1,5,1,2021,1,3,1013,0
Oilers,0,2,0,0,2,Sabres,0,3,0,0,3,20211112,0,1,1,1,5,1,2021,0,4,1734,0
Flames,0,0,1,0,1,Maple Leafs,0,0,1,1,2,20211112,0,0,0,1,3,1,2021,1,4,1682,0
Flyers,0,0,2,0,2,Hurricanes,0,1,0,0,1,20211112,0,-1,1,1,3,-1,2021,0,4,345,0
Capitals,1,2,1,0,4,Blue Jackets,1,2,0,0,3,20211112,0,0,1,1,7,-1,2021,0,4,326,0
Coyotes,0,0,1,0,1,Blackhawks,0,1,1,0,2,20211112,0,1,1,1,3,1,2021,0,4,1450,0
Flyers,0,1,1,0,2,Stars,1,2,2,0,5,20211113,1,2,3,3,7,3,2021,0,5,1297,0
Sharks,1,0,1,0,2,Avalanche,2,2,2,0,6,20211113,1,3,4,4,8,4,2021,0,5,927,0
Panthers,0,2,0,0,2,Lightning,1,1,0,1,3,20211113,1,0,0,1,5,1,2021,1,5,205,0
Wild,1,2,1,0,4,Kraken,0,0,2,0,2,20211113,1,3,2,2,6,-2,2021,0,5,1391,0
Coyotes,0,0,1,0,1,Predators,2,1,1,0,4,20211113,2,3,3,3,5,3,2021,0,5,1442,0
Canucks,2,1,1,0,4,Golden Knights,1,2,4,0,7,20211113,-1,0,3,3,11,3,2021,0,5,986,0
Blues,0,1,1,0,2,Hurricanes,1,1,1,0,3,20211113,1,1,1,1,5,1,2021,0,5,665,0
Penguins,0,0,3,0,3,Senators,0,4,2,0,6,20211113,0,4,3,3,9,3,2021,0,5,392,0
Rangers,1,3,1,0,5,Blue Jackets,1,1,1,0,3,20211113,0,2,2,2,8,-2,2021,0,5,476,0
Canadiens,1,0,1,0,2,Red Wings,0,2,0,1,3,20211113,-1,1,0,1,5,1,2021,1,5,508,0
Maple Leafs,1,2,2,0,5,Sabres,1,1,2,0,4,20211113,0,1,1,1,9,-1,2021,0,5,57,0
Bruins,1,2,2,0,5,Devils,0,2,0,0,2,20211113,1,1,3,3,7,-3,2021,0,5,196,0
Kings,1,1,0,0,2,Jets,1,0,1,1,3,20211113,0,-1,0,1,5,1,2021,1,5,1527,0
Flames,1,2,1,0,4,Senators,0,0,0,0,0,20211114,1,3,4,4,4,-4,2021,0,6,1773,0
Canadiens,1,1,0,0,2,Bruins,0,1,4,0,5,20211114,-1,-1,3,3,7,3,2021,0,6,270,0
Devils,1,1,1,0,3,Rangers,0,2,1,1,4,20211114,-1,0,0,1,7,1,2021,1,6,8,0
Penguins,1,0,0,0,1,Capitals,2,2,2,0,6,20211114,1,3,5,5,7,5,2021,0,6,190,0
Oilers,1,3,1,0,5,Blues,1,1,2,0,4,20211114,0,2,1,1,9,-1,2021,0,6,1508,0
Canucks,1,0,0,0,1,Ducks,1,2,2,0,5,20211114,0,2,4,4,6,4,2021,0,6,1076,0
Red Wings,1,1,1,0,3,Blue Jackets,0,2,3,0,5,20211115,-1,0,2,2,8,2,2021,0,0,163,0
Islanders,1,0,0,0,1,Lightning,2,0,2,0,4,20211115,1,1,3,3,5,3,2021,0,0,1004,0
Oilers,0,0,2,0,2,Jets,1,3,1,0,5,20211116,1,4,3,3,7,3,2021,0,1,738,0
Sharks,2,1,1,0,4,Wild,0,1,0,0,1,20211116,2,2,3,3,5,-3,2021,0,1,1570,0
Capitals,0,0,2,0,2,Ducks,1,0,1,1,3,20211116,1,1,0,1,5,1,2021,1,1,2294,0
Red Wings,0,2,0,0,2,Stars,1,2,2,0,5,20211116,1,1,3,3,7,3,2021,0,1,999,0
Coyotes,1,1,1,0,3,Blues,1,1,0,0,2,20211116,0,0,1,1,5,-1,2021,0,1,1270,0
Hurricanes,2,0,2,0,4,Golden Knights,0,2,0,0,2,20211116,2,0,2,2,6,-2,2021,0,1,2028,0
Flames,1,0,0,0,1,Flyers,0,1,0,1,2,20211116,-1,0,0,1,3,1,2021,1,1,2003,0
Canadiens,0,1,1,0,2,Rangers,1,1,1,0,3,20211116,1,1,1,1,5,1,2021,0,1,343,0
Islanders,0,1,0,0,1,Panthers,4,1,1,0,6,20211116,4,4,5,5,7,5,2021,0,1,1091,0
Predators,0,0,0,0,0,Maple Leafs,1,0,2,0,3,20211116,1,1,3,3,3,3,2021,0,1,646,0
Sabres,0,2,0,0,2,Penguins,0,0,1,0,1,20211116,0,2,1,1,3,-1,2021,0,1,178,0
Avalanche,1,0,3,0,4,Canucks,0,1,1,0,2,20211117,1,0,2,2,6,-2,2021,0,2,1105,0
Blackhawks,1,1,2,0,4,Kraken,0,0,2,0,2,20211117,1,2,2,2,6,-2,2021,0,2,1732,0
Capitals,0,0,2,0,2,Kings,0,0,0,0,0,20211117,0,0,2,2,2,-2,2021,0,2,2294,0
Blue Jackets,1,2,1,1,5,Coyotes,1,2,1,0,4,20211118,0,0,0,1,9,-1,2021,1,3,1664,0
Jets,0,0,1,0,1,Oilers,0,0,1,1,2,20211118,0,0,0,1,3,1,2021,1,3,738,0
Stars,0,0,2,0,2,Wild,2,1,4,0,7,20211118,2,3,5,5,9,5,2021,0,3,863,0
Sharks,0,1,0,0,1,Blues,1,2,1,0,4,20211118,1,2,3,3,5,3,2021,0,3,1719,0
Rangers,0,0,1,0,1,Maple Leafs,1,1,0,0,2,20211118,1,2,1,1,3,1,2021,0,3,341,0
Devils,1,0,0,0,1,Panthers,1,3,0,0,4,20211118,0,3,3,3,5,3,2021,0,3,1090,0
Penguins,3,2,1,0,6,Canadiens,0,0,0,0,0,20211118,3,5,6,6,6,-6,2021,0,3,474,0
Red Wings,0,1,1,0,2,Golden Knights,0,4,1,0,5,20211118,0,3,3,3,7,3,2021,0,3,1757,0
Flames,1,4,0,0,5,Sabres,0,0,0,0,0,20211118,1,5,5,5,5,-5,2021,0,3,1731,0
Lightning,0,2,1,1,4,Flyers,2,0,1,0,3,20211118,-2,0,0,1,7,-1,2021,1,3,928,0
Hurricanes,1,0,1,0,2,Ducks,1,0,0,0,1,20211118,0,0,1,1,3,-1,2021,0,3,2231,0
Avalanche,2,4,1,0,7,Kraken,0,0,3,0,3,20211119,2,6,4,4,10,-4,2021,0,4,1019,0
Jets,0,1,1,0,2,Canucks,1,2,0,0,3,20211119,1,2,1,1,5,1,2021,0,4,1157,0
Blackhawks,1,0,1,0,2,Oilers,4,0,1,0,5,20211120,3,3,3,3,7,3,2021,0,5,1437,0
Capitals,2,0,2,0,4,Sharks,0,0,0,0,0,20211120,2,2,4,4,4,-4,2021,0,5,2416,0
Blue Jackets,2,0,0,0,2,Golden Knights,0,1,2,0,3,20211120,-2,-1,1,1,5,1,2021,0,5,1757,0
Blues,0,1,0,0,1,Stars,0,2,2,0,4,20211120,0,1,3,3,5,3,2021,0,5,547,0
Bruins,1,2,2,0,5,Flyers,0,2,0,0,2,20211120,1,1,3,3,7,-3,2021,0,5,270,0
Red Wings,1,0,0,0,1,Coyotes,0,0,1,1,2,20211120,-1,-1,0,1,3,1,2021,1,5,1687,0
Predators,0,0,3,0,3,Canadiens,1,4,1,0,6,20211120,1,5,3,3,9,3,2021,0,5,937,0
Penguins,2,0,0,0,2,Maple Leafs,0,0,0,0,0,20211120,2,2,2,2,2,-2,2021,0,5,222,0
Wild,0,1,3,0,4,Panthers,1,2,2,0,5,20211120,1,2,1,1,9,1,2021,0,5,1513,0
Hurricanes,2,3,0,0,5,Kings,2,2,0,0,4,20211120,0,1,1,1,9,-1,2021,0,5,2231,0
Devils,1,0,4,0,5,Lightning,2,1,0,0,3,20211120,-1,-2,2,2,8,-2,2021,0,5,1000,0
Flames,2,1,2,0,5,Islanders,1,0,1,0,2,20211120,1,2,3,3,7,-3,2021,0,5,2023,0
Capitals,1,0,1,0,2,Kraken,1,3,1,0,5,20211121,0,3,3,3,7,3,2021,0,6,2322,0
Wild,1,1,2,0,4,Lightning,2,1,1,1,5,20211121,1,1,0,1,9,1,2021,1,6,1318,0
Sabres,1,3,0,0,4,Rangers,1,3,1,0,5,20211121,0,0,1,1,9,1,2021,0,6,292,0
Flames,1,1,2,0,4,Bruins,0,0,0,0,0,20211121,1,2,4,4,4,-4,2021,0,6,2089,0
Maple Leafs,1,0,2,0,3,Islanders,0,0,0,0,0,20211121,1,1,3,3,3,-3,2021,0,6,341,0
Blackhawks,0,0,1,0,1,Canucks,0,0,0,0,0,20211121,0,0,1,1,1,-1,2021,0,6,1775,0
Coyotes,0,0,1,1,2,Kings,0,1,0,0,1,20211121,0,-1,0,1,3,-1,2021,1,6,356,0
Senators,2,1,2,0,5,Avalanche,2,1,4,0,7,20211122,0,0,2,2,12,2,2021,0,0,1515,0
Penguins,0,1,2,0,3,Jets,1,0,0,0,1,20211122,-1,0,2,2,4,-2,2021,0,0,1060,0
Hurricanes,0,1,0,0,1,Sharks,0,0,1,1,2,20211122,0,-1,0,1,3,1,2021,1,0,2382,0
Golden Knights,2,0,0,0,2,Blues,3,1,1,0,5,20211122,1,2,3,3,7,3,2021,0,0,1375,0
Blue Jackets,2,3,2,0,7,Sabres,2,2,0,0,4,20211122,0,1,3,3,11,-3,2021,0,0,293,0
Ducks,0,1,1,0,2,Predators,1,1,1,0,3,20211122,1,1,1,1,5,1,2021,0,0,1776,0
Flyers,0,0,0,0,0,Lightning,1,2,1,0,4,20211123,1,3,4,4,4,4,2021,0,1,928,0
Oilers,0,1,0,0,1,Stars,2,1,1,0,4,20211123,2,2,3,3,5,3,2021,0,1,1655,0
Blackhawks,1,1,0,0,2,Flames,2,0,3,0,5,20211123,1,0,3,3,7,3,2021,0,1,1397,0
Senators,1,2,0,0,3,Sharks,1,2,3,0,6,20211124,0,0,3,3,9,3,2021,0,2,2408,0
Hurricanes,1,0,0,0,1,Kraken,0,1,1,0,2,20211124,-1,0,1,1,3,1,2021,0,2,2361,0
Maple Leafs,1,4,1,0,6,Kings,0,1,1,0,2,20211124,1,4,4,4,8,-4,2021,0,2,2170,0
Oilers,1,1,3,0,5,Coyotes,1,0,2,0,3,20211124,0,1,2,2,8,-2,2021,0,2,1392,0
Ducks,1,0,1,0,2,Avalanche,1,2,2,0,5,20211124,0,2,3,3,7,3,2021,0,2,830,0
Golden Knights,1,2,2,0,5,Predators,0,0,2,0,2,20211124,1,3,3,3,7,-3,2021,0,2,1575,0
Wild,2,0,0,1,3,Devils,0,0,2,0,2,20211124,2,2,0,1,5,-1,2021,1,2,1007,0
Rangers,0,2,2,0,4,Islanders,0,0,1,0,1,20211124,0,2,3,3,5,-3,2021,0,2,0,0
Jets,0,0,0,0,0,Blue Jackets,1,0,2,0,3,20211124,1,1,3,3,3,3,2021,0,2,975,0
Canadiens,1,1,1,0,3,Capitals,3,1,2,0,6,20211124,2,2,3,3,9,3,2021,0,2,495,0
Canucks,0,0,1,0,1,Penguins,0,3,1,0,4,20211124,0,3,3,3,5,3,2021,0,2,2168,0
Flyers,1,0,0,0,1,Panthers,0,0,1,1,2,20211124,-1,-1,0,1,3,1,2021,1,2,1021,0
Bruins,4,0,1,0,5,Sabres,1,0,0,0,1,20211124,3,3,4,4,6,-4,2021,0,2,399,0
Blues,1,0,1,0,2,Red Wings,1,1,2,0,4,20211124,0,1,2,2,6,2,2021,0,2,454,0
Maple Leafs,2,2,0,0,4,Sharks,1,0,0,0,1,20211126,1,3,3,3,5,-3,2021,0,4,2249,0
Avalanche,0,0,1,0,1,Stars,2,1,0,0,3,20211126,2,3,2,2,4,2,2021,0,4,661,0
Penguins,0,1,0,0,1,Islanders,0,0,0,0,0,20211126,0,1,1,1,1,-1,2021,0,4,314,0
Canucks,1,1,0,0,2,Blue Jackets,1,1,2,0,4,20211126,0,0,2,2,6,2,2021,0,4,2050,0
Kraken,0,0,0,0,0,Lightning,1,1,1,0,3,20211126,1,2,3,3,3,3,2021,0,4,2526,0
Canadiens,1,0,0,0,1,Sabres,1,2,1,0,4,20211126,0,2,3,3,5,3,2021,0,4,311,0
Senators,0,0,0,0,0,Ducks,1,2,1,0,4,20211126,1,3,4,4,4,4,2021,0,4,2345,0
Panthers,1,1,1,0,3,Capitals,0,3,1,0,4,20211126,-1,1,1,1,7,1,2021,0,4,924,0
Jets,0,0,1,0,1,Wild,2,3,2,0,7,20211126,2,5,6,6,8,6,2021,0,4,388,0
Blues,2,0,0,0,2,Blackhawks,0,1,1,1,3,20211126,-2,-1,0,1,5,1,2021,1,4,260,0
Hurricanes,1,4,1,0,6,Flyers,2,1,0,0,3,20211126,-1,2,3,3,9,-3,2021,0,4,345,0
Rangers,1,1,3,0,5,Bruins,1,1,0,0,2,20211126,0,0,3,3,7,-3,2021,0,4,190,0
Devils,0,0,2,0,2,Predators,1,1,2,0,4,20211126,1,2,2,2,6,2,2021,0,4,750,0
Jets,1,1,2,0,4,Flames,2,0,0,0,2,20211127,-1,0,2,2,6,-2,2021,0,5,740,0
Predators,0,1,1,0,2,Avalanche,2,1,3,0,6,20211127,2,2,4,4,8,4,2021,0,5,1019,0
Stars,2,1,0,0,3,Coyotes,1,1,0,0,2,20211127,1,1,1,1,5,-1,2021,0,5,884,0
Blue Jackets,1,0,2,0,3,Blues,0,3,3,0,6,20211127,-1,2,3,3,9,3,2021,0,5,395,0
Senators,1,1,0,0,2,Kings,1,2,1,0,4,20211127,0,1,2,2,6,2,2021,0,5,2345,0
Canadiens,0,1,5,0,6,Penguins,0,0,3,0,3,20211127,0,1,3,3,9,-3,2021,0,5,474,0
Sabres,0,1,1,0,2,Red Wings,0,2,0,1,3,20211127,0,1,0,1,5,1,2021,1,5,215,0
Kraken,2,0,2,0,4,Panthers,1,0,0,0,1,20211127,1,1,3,3,5,-3,2021,0,5,2730,0
Oilers,2,1,0,0,3,Golden Knights,0,1,1,0,2,20211127,2,2,1,1,5,-1,2021,0,5,1204,0
Maple Leafs,0,2,3,0,5,Ducks,0,0,1,0,1,20211128,0,2,4,4,6,-4,2021,0,6,2170,0
Capitals,0,2,2,0,4,Hurricanes,0,0,2,0,2,20211128,0,2,2,2,6,-2,2021,0,6,233,0
Lightning,1,1,0,0,2,Wild,2,0,2,0,4,20211128,1,0,2,2,6,2,2021,0,6,1318,0
Canucks,1,1,0,0,2,Bruins,1,0,2,0,3,20211128,0,-1,1,1,5,1,2021,0,6,2504,0
Flyers,1,0,1,0,2,Devils,1,1,3,0,5,20211128,0,1,3,3,7,3,2021,0,6,75,0
Sharks,0,1,1,0,2,Blackhawks,0,0,0,0,0,20211128,0,1,2,2,2,-2,2021,0,6,1837,0
Coyotes,0,1,0,0,1,Jets,0,0,0,0,0,20211129,0,1,1,1,1,-1,2021,0,0,1365,0
Penguins,0,0,1,0,1,Flames,0,1,0,1,2,20211129,0,1,0,1,3,1,2021,1,0,1777,0
Kraken,3,2,2,0,7,Sabres,0,2,2,0,4,20211129,3,3,3,3,11,-3,2021,0,0,2110,0
Canucks,1,1,0,0,2,Canadiens,1,0,0,0,1,20211129,0,1,1,1,3,-1,2021,0,0,2273,0
Hurricanes,0,0,1,0,1,Stars,1,1,2,0,4,20211130,1,2,3,3,5,3,2021,0,1,1055,0
Coyotes,1,0,1,0,2,Wild,1,3,1,0,5,20211130,0,3,3,3,7,3,2021,0,1,1278,0
Blue Jackets,0,0,0,0,0,Predators,3,2,1,0,6,20211130,3,5,6,6,6,6,2021,0,1,333,0
Ducks,0,2,2,1,5,Kings,0,1,3,0,4,20211130,0,1,0,1,9,-1,2021,1,1,0,0
Sharks,1,3,1,0,5,Devils,0,0,2,0,2,20211130,1,4,3,3,7,-3,2021,0,1,2540,0
Capitals,2,2,0,0,4,Panthers,1,0,4,0,5,20211130,-1,-3,1,1,9,1,2021,0,1,924,0
Red Wings,0,1,1,0,2,Bruins,0,0,1,0,1,20211130,0,1,1,1,3,-1,2021,0,1,611,0
Lightning,3,0,0,0,3,Blues,0,2,1,1,4,20211130,-3,-1,0,1,7,1,2021,1,1,861,0
Flyers,0,1,0,0,1,Rangers,2,1,1,0,4,20211201,2,2,3,3,5,3,2021,0,2,80,0
Avalanche,1,1,1,0,3,Maple Leafs,3,2,3,0,8,20211201,2,3,5,5,11,5,2021,0,2,1341,0
Canucks,1,2,3,0,6,Senators,1,0,1,0,2,20211201,0,2,4,4,8,-4,2021,0,2,2191,0
Kraken,0,2,1,0,3,Red Wings,0,2,1,1,4,20211201,0,0,0,1,7,1,2021,1,2,1933,0
Penguins,1,1,0,0,2,Oilers,2,0,3,0,5,20211201,1,0,3,3,7,3,2021,0,2,1797,0
Golden Knights,0,2,3,0,5,Ducks,0,4,2,0,6,20211201,0,2,1,1,11,1,2021,0,2,228,0
Devils,0,2,0,0,2,Wild,2,2,1,0,5,20211202,2,2,3,3,7,3,2021,0,3,1007,0
Flames,2,1,0,0,3,Kings,1,1,0,0,2,20211202,1,1,1,1,5,-1,2021,0,3,1197,0
Blue Jackets,1,1,0,0,2,Stars,1,2,0,0,3,20211202,0,1,1,1,5,1,2021,0,3,912,0
Bruins,1,1,0,0,2,Predators,0,0,0,0,0,20211202,1,2,2,2,2,-2,2021,0,3,941,0
Sharks,1,0,0,1,2,Islanders,1,0,0,0,1,20211202,0,0,0,1,3,-1,2021,1,3,2549,0
Blackhawks,1,1,1,1,4,Capitals,0,2,1,0,3,20211202,1,0,0,1,7,-1,2021,1,3,594,0
Sabres,3,1,0,0,4,Panthers,0,3,4,0,7,20211202,-3,-1,3,3,11,3,2021,0,3,1184,0
Blues,0,1,1,0,2,Lightning,1,0,3,0,4,20211202,1,0,2,2,6,2,2021,0,3,861,0
Avalanche,0,2,2,0,4,Canadiens,0,1,0,0,1,20211202,0,1,3,3,5,-3,2021,0,3,1618,0
Senators,1,0,2,0,3,Hurricanes,0,0,2,0,2,20211202,1,1,1,1,5,-1,2021,0,3,673,0
Oilers,1,1,1,0,3,Kraken,2,2,0,0,4,20211203,1,2,1,1,7,1,2021,0,4,564,0
Sharks,0,0,0,0,0,Rangers,1,0,0,0,1,20211203,1,1,1,1,1,1,2021,0,4,2549,0
Devils,2,2,0,0,4,Jets,3,3,2,0,8,20211203,1,2,4,4,12,4,2021,0,4,1280,0
Golden Knights,2,4,1,0,7,Coyotes,1,0,0,0,1,20211203,1,5,6,6,8,-6,2021,0,4,256,0
Flames,0,3,0,1,4,Ducks,0,2,1,0,3,20211203,0,1,0,1,7,-1,2021,1,4,1197,0
Sabres,1,1,0,0,2,Hurricanes,2,3,1,0,6,20211204,1,3,4,4,8,4,2021,0,5,491,0
Maple Leafs,0,3,0,0,3,Wild,1,2,0,1,4,20211204,1,0,0,1,7,1,2021,1,5,691,0
Canadiens,0,2,1,0,3,Predators,1,1,1,1,4,20211204,1,0,0,1,7,1,2021,1,5,937,0
Blue Jackets,0,0,1,0,1,Capitals,1,1,1,0,3,20211204,1,2,2,2,4,2,2021,0,5,326,0
Blues,1,1,1,0,3,Panthers,1,1,1,1,4,20211204,0,0,0,1,7,1,2021,1,5,1061,0
Avalanche,2,1,2,0,5,Senators,2,3,0,1,6,20211204,0,2,0,1,11,1,2021,1,5,1515,0
Lightning,1,1,0,1,3,Bruins,0,1,1,0,2,20211204,1,1,0,1,5,-1,2021,1,5,1183,0
Blackhawks,1,0,1,0,2,Rangers,0,2,1,0,3,20211204,-1,1,1,1,5,1,2021,0,5,711,0
Islanders,1,1,1,0,3,Red Wings,2,1,0,1,4,20211204,1,1,0,1,7,1,2021,1,5,480,0
Penguins,0,3,1,0,4,Canucks,0,1,0,0,1,20211204,0,2,3,3,5,-3,2021,0,5,2168,0
Flames,0,0,2,0,2,Golden Knights,1,0,2,0,3,20211205,1,1,1,1,5,1,2021,0,6,1033,0
Kings,1,1,3,0,5,Oilers,0,1,0,0,1,20211205,1,1,4,4,6,-4,2021,0,6,1368,0
Maple Leafs,1,2,0,0,3,Jets,1,4,1,0,6,20211205,0,2,3,3,9,3,2021,0,6,946,0
Sharks,1,2,1,0,4,Blue Jackets,1,2,3,0,6,20211205,0,0,2,2,10,2,2021,0,6,2090,0
Lightning,2,3,2,0,7,Flyers,0,0,1,0,1,20211205,2,5,6,6,8,-6,2021,0,6,928,0
Blackhawks,1,0,1,1,3,Islanders,0,1,1,0,2,20211205,1,0,0,1,5,-1,2021,1,6,711,0
Avalanche,4,1,2,0,7,Flyers,3,0,2,0,5,20211206,1,2,2,2,12,-2,2021,0,0,1574,0
Ducks,0,3,0,0,3,Capitals,1,2,0,1,4,20211206,1,0,0,1,7,1,2021,1,0,2294,0
Senators,0,2,0,1,3,Devils,1,1,0,0,2,20211206,-1,0,0,1,5,-1,2021,1,0,330,0
Coyotes,0,1,0,0,1,Stars,1,0,3,0,4,20211206,1,0,3,3,5,3,2021,0,0,884,0
Kings,0,0,0,0,0,Canucks,0,2,2,0,4,20211206,0,2,4,4,4,4,2021,0,0,1076,0
Penguins,3,2,1,0,6,Kraken,0,1,0,0,1,20211206,3,4,5,5,7,-5,2021,0,0,2132,0
Lightning,1,0,2,0,3,Canadiens,0,2,0,0,2,20211207,1,-1,1,1,5,-1,2021,0,1,1311,0
Rangers,1,1,4,0,6,Blackhawks,2,0,0,0,2,20211207,-1,0,4,4,8,-4,2021,0,1,711,0
Hurricanes,1,2,1,0,4,Jets,0,2,0,0,2,20211207,1,1,2,2,6,-2,2021,0,1,1350,0
Panthers,1,1,1,0,3,Blues,0,2,1,1,4,20211207,-1,0,0,1,7,1,2021,1,1,1061,0
Blue Jackets,0,1,3,0,4,Maple Leafs,3,2,0,0,5,20211207,3,4,1,1,9,1,2021,0,1,313,0
Predators,2,0,3,0,5,Red Wings,0,1,1,0,2,20211207,2,1,3,3,7,-3,2021,0,1,470,0
Islanders,0,3,2,0,5,Senators,0,1,2,0,3,20211207,0,2,2,2,8,-2,2021,0,1,334,0
Wild,2,0,2,0,4,Oilers,0,1,0,0,1,20211207,2,1,3,3,5,-3,2021,0,1,1083,0
Ducks,0,1,1,0,2,Sabres,0,0,0,0,0,20211207,0,1,2,2,2,-2,2021,0,1,2193,0
Flames,2,1,0,0,3,Sharks,1,3,1,0,5,20211207,-1,1,2,2,8,2,2021,0,1,1027,0
Stars,1,2,1,0,4,Golden Knights,0,2,3,0,5,20211208,-1,-1,1,1,9,1,2021,0,2,1068,0
Bruins,0,0,1,0,1,Canucks,0,1,0,1,2,20211208,0,1,0,1,3,1,2021,1,2,2504,0
Avalanche,1,5,1,0,7,Rangers,2,0,1,0,3,20211208,-1,4,4,4,10,-4,2021,0,2,1627,0
Flyers,0,0,0,0,0,Devils,0,2,1,0,3,20211208,0,2,3,3,3,3,2021,0,2,75,0
Wild,1,2,2,0,5,Sharks,0,0,2,0,2,20211209,1,3,3,3,7,-3,2021,0,3,1570,0
Jets,1,0,2,0,3,Kraken,0,0,0,0,0,20211209,1,1,3,3,3,-3,2021,0,3,1148,0
Bruins,1,1,1,0,3,Oilers,0,1,1,0,2,20211209,1,1,1,1,5,-1,2021,0,3,2074,0
Hurricanes,1,0,0,1,2,Flames,0,1,0,0,1,20211209,1,0,0,1,3,-1,2021,1,3,2038,0
Stars,0,0,0,0,0,Kings,0,1,3,0,4,20211209,0,1,4,4,4,4,2021,0,3,1237,0
Predators,2,0,2,0,4,Islanders,1,1,1,0,3,20211209,1,0,1,1,7,-1,2021,0,3,758,0
Ducks,1,0,0,1,2,Blue Jackets,1,0,0,0,1,20211209,0,0,0,1,3,-1,2021,1,3,1973,0
Blackhawks,0,1,1,0,2,Canadiens,0,0,0,0,0,20211209,0,1,2,2,2,-2,2021,0,3,732,0
Lightning,2,2,1,0,5,Maple Leafs,2,0,1,0,3,20211209,0,2,2,2,8,-2,2021,0,3,1096,0
Red Wings,0,1,1,0,2,Blues,2,1,3,0,6,20211209,2,2,4,4,8,4,2021,0,3,454,0
Rangers,1,1,0,0,2,Sabres,0,0,1,0,1,20211210,1,2,1,1,3,-1,2021,0,4,292,0
Penguins,1,2,1,0,4,Capitals,0,0,2,0,2,20211210,1,3,2,2,6,-2,2021,0,4,190,0
Predators,0,2,1,0,3,Devils,0,1,1,0,2,20211210,0,1,1,1,5,-1,2021,0,4,750,0
Red Wings,1,2,0,0,3,Avalanche,3,3,1,0,7,20211210,2,3,4,4,10,4,2021,0,4,1154,0
Panthers,3,0,0,0,3,Coyotes,1,0,0,0,1,20211210,2,2,2,2,4,-2,2021,0,4,1978,0
Jets,1,2,0,0,3,Canucks,2,1,0,1,4,20211210,1,0,0,1,7,1,2021,1,4,1157,0
Flyers,1,1,2,0,4,Golden Knights,1,1,1,0,3,20211210,0,0,1,1,7,-1,2021,0,4,2171,0
Hurricanes,1,1,1,0,3,Oilers,0,1,0,0,1,20211211,1,1,2,2,4,-2,2021,0,5,2076,0
Blue Jackets,0,4,0,1,5,Kraken,0,1,3,0,4,20211211,0,3,0,1,9,-1,2021,1,5,2008,0
Bruins,1,2,1,0,4,Flames,0,1,1,0,2,20211211,1,2,2,2,6,-2,2021,0,5,2089,0
Stars,0,0,1,0,1,Sharks,1,1,0,0,2,20211211,1,2,1,1,3,1,2021,0,5,1449,0
Wild,0,1,0,0,1,Kings,0,1,1,0,2,20211211,0,0,1,1,3,1,2021,0,5,1521,0
Flyers,1,3,1,0,5,Coyotes,1,1,1,0,3,20211211,0,2,2,2,8,-2,2021,0,5,2078,0
Ducks,0,0,0,0,0,Penguins,1,0,0,0,1,20211211,1,1,1,1,1,1,2021,0,5,2132,0
Canadiens,0,0,1,0,1,Blues,1,2,1,0,4,20211211,1,3,3,3,5,3,2021,0,5,962,0
Devils,2,0,0,0,2,Islanders,1,2,1,0,4,20211211,-1,1,2,2,6,2,2021,0,5,8,0
Blackhawks,1,1,2,0,4,Maple Leafs,3,1,1,0,5,20211211,2,2,1,1,9,1,2021,0,5,436,0
Capitals,1,0,1,1,3,Sabres,1,1,0,0,2,20211211,0,-1,0,1,5,-1,2021,1,5,292,0
Lightning,0,0,0,0,0,Senators,1,2,1,0,4,20211211,1,3,4,4,4,4,2021,0,5,1251,0
Predators,0,1,0,0,1,Rangers,0,0,0,0,0,20211212,0,1,1,1,1,-1,2021,0,6,758,0
Ducks,1,0,1,1,3,Blues,0,1,1,0,2,20211212,1,0,0,1,5,-1,2021,1,6,1586,0
Panthers,0,0,2,0,2,Avalanche,0,1,2,0,3,20211212,0,1,1,1,5,1,2021,0,6,1724,0
Wild,2,1,1,0,4,Golden Knights,2,2,2,0,6,20211212,0,1,2,2,10,2,2021,0,6,1293,0
Hurricanes,0,0,1,0,1,Canucks,1,1,0,0,2,20211212,1,2,1,1,3,1,2021,0,6,2409,0
Blue Jackets,3,0,0,0,3,Canucks,0,1,3,0,4,20211214,-3,-2,1,1,7,1,2021,0,1,2050,0
Maple Leafs,1,2,2,0,5,Oilers,0,0,1,0,1,20211214,1,3,4,4,6,-4,2021,0,1,1683,0
Rangers,0,1,1,0,2,Avalanche,2,1,1,0,4,20211214,2,2,2,2,6,2,2021,0,1,1627,0
Blues,0,1,3,0,4,Stars,0,1,0,0,1,20211214,0,0,3,3,5,-3,2021,0,1,547,0
Sabres,1,2,1,0,4,Jets,1,1,0,0,2,20211214,0,1,2,2,6,-2,2021,0,1,996,0
Kraken,0,0,3,0,3,Sharks,0,0,1,0,1,20211214,0,0,2,2,4,-2,2021,0,1,709,0
Canadiens,0,2,0,0,2,Penguins,1,2,2,0,5,20211214,1,1,3,3,7,3,2021,0,1,474,0
Devils,0,1,0,0,1,Flyers,2,3,1,0,6,20211214,2,4,5,5,7,5,2021,0,1,75,0
Senators,1,3,4,0,8,Panthers,1,1,0,0,2,20211214,0,2,6,6,10,-6,2021,0,1,1370,0
Kings,1,1,0,0,2,Lightning,1,1,0,1,3,20211214,0,0,0,1,5,1,2021,1,1,2149,0
Golden Knights,3,1,0,0,4,Bruins,0,0,1,0,1,20211214,3,4,3,3,5,-3,2021,0,1,2369,0
Islanders,0,0,1,0,1,Red Wings,0,1,1,0,2,20211214,0,1,1,1,3,1,2021,0,1,480,0
Capitals,0,2,2,0,4,Blackhawks,0,3,1,1,5,20211215,0,1,0,1,9,1,2021,1,2,594,0
Rangers,0,1,2,0,3,Coyotes,1,0,1,0,2,20211215,-1,0,1,1,5,-1,2021,0,2,2139,0
Kraken,0,1,0,0,1,Ducks,2,1,1,0,4,20211215,2,2,3,3,5,3,2021,0,2,960,0
Canucks,2,1,2,0,5,Sharks,1,0,1,0,2,20211216,1,2,3,3,7,-3,2021,0,3,821,0
Blue Jackets,0,0,2,0,2,Oilers,3,1,1,0,5,20211216,3,4,3,3,7,3,2021,0,3,1703,0
Sabres,0,1,1,1,3,Wild,1,1,0,0,2,20211216,-1,-1,0,1,5,-1,2021,1,3,729,0
Avalanche,0,1,1,0,2,Predators,1,2,2,0,5,20211216,1,2,3,3,7,3,2021,0,3,1019,0
Bruins,0,0,1,0,1,Islanders,1,1,1,0,3,20211216,1,2,2,2,4,2,2021,0,3,190,0
Red Wings,2,1,0,0,3,Hurricanes,3,0,2,0,5,20211216,1,0,2,2,8,2,2021,0,3,511,0
Kings,1,2,1,0,4,Panthers,1,0,0,0,1,20211216,0,2,3,3,5,-3,2021,0,3,2335,0
Senators,1,0,0,0,1,Lightning,0,2,0,0,2,20211216,-1,1,1,1,3,1,2021,0,3,1251,0
Flyers,0,2,0,0,2,Canadiens,1,0,1,1,3,20211216,1,-1,0,1,5,1,2021,1,3,400,0
Golden Knights,1,1,3,0,5,Devils,1,0,2,0,3,20211216,0,1,2,2,8,-2,2021,0,3,2218,0
Golden Knights,1,0,1,1,3,Rangers,0,2,0,0,2,20211217,1,-1,0,1,5,-1,2021,1,4,2227,0
Sabres,0,1,1,0,2,Penguins,1,1,0,1,3,20211217,1,1,0,1,5,1,2021,1,4,178,0
Stars,0,0,1,0,1,Blues,0,2,2,0,4,20211217,0,2,3,3,5,3,2021,0,4,547,0
Capitals,0,2,3,0,5,Jets,0,1,1,0,2,20211217,0,1,3,3,7,-3,2021,0,4,1247,0
Predators,1,0,1,1,3,Blackhawks,1,0,1,0,2,20211217,0,0,0,1,5,-1,2021,1,4,395,0
Coyotes,2,1,2,1,6,Ducks,3,0,2,0,5,20211217,-1,0,0,1,11,-1,2021,1,4,356,0
Oilers,2,1,2,0,5,Kraken,2,1,0,0,3,20211218,0,0,2,2,8,-2,2021,0,5,564,0
Blackhawks,0,2,1,0,3,Stars,2,1,0,1,4,20211218,2,1,0,1,7,1,2021,1,5,802,0
Senators,0,2,1,0,3,Flyers,2,0,1,1,4,20211218,2,0,0,1,7,1,2021,1,5,373,0
Kings,0,1,0,0,1,Hurricanes,2,2,1,0,5,20211218,2,3,4,4,6,4,2021,0,5,2231,0
Devils,1,1,0,0,2,Red Wings,1,3,1,0,5,20211218,0,2,3,3,7,3,2021,0,5,471,0
Golden Knights,1,0,2,1,4,Islanders,1,0,2,0,3,20211219,0,0,0,1,7,-1,2021,1,6,2227,0
Blues,0,1,1,0,2,Jets,0,2,2,0,4,20211219,0,1,2,2,6,2,2021,0,6,853,0
Penguins,1,1,1,0,3,Devils,0,1,1,0,2,20211219,1,1,1,1,5,-1,2021,0,6,306,0
Kings,0,1,2,0,3,Capitals,1,1,0,0,2,20211219,-1,-1,1,1,5,-1,2021,0,6,2294,0
Wild,2,1,1,0,4,Stars,3,1,3,0,7,20211220,1,1,3,3,11,3,2021,0,0,863,0
Lightning,1,2,1,0,4,Golden Knights,1,2,0,0,3,20211221,0,0,1,1,7,-1,2021,0,1,1985,0
Coyotes,2,2,3,0,7,Sharks,2,3,2,1,8,20211228,0,1,0,1,15,1,2021,1,1,614,0
Canadiens,1,1,2,0,4,Lightning,2,1,1,1,5,20211228,1,1,0,1,9,1,2021,1,1,1311,0
Golden Knights,3,2,1,0,6,Kings,1,1,1,0,3,20211228,2,3,3,3,9,-3,2021,0,1,228,0
Devils,2,0,2,0,4,Sabres,0,2,1,0,3,20211229,2,0,1,1,7,-1,2021,0,2,284,0
Rangers,1,1,1,0,3,Panthers,0,1,3,0,4,20211229,-1,-1,1,1,7,1,2021,0,2,1091,0
Predators,0,3,0,0,3,Capitals,3,0,2,0,5,20211229,3,0,2,2,8,2,2021,0,2,566,0
Oilers,1,1,0,0,2,Blues,2,1,1,0,4,20211229,1,1,2,2,6,2,2021,0,2,1508,0
Flyers,1,0,1,1,3,Kraken,1,0,1,0,2,20211229,0,0,0,1,5,-1,2021,1,2,2373,0
Canucks,0,0,1,1,2,Ducks,1,0,0,0,1,20211229,-1,-1,0,1,3,-1,2021,1,2,1076,0
Flames,1,2,3,0,6,Kraken,1,1,2,0,4,20211230,0,1,2,2,10,-2,2021,0,3,445,0
Flyers,1,0,1,0,2,Sharks,0,2,0,1,3,20211230,-1,1,0,1,5,1,2021,1,3,2499,0
Canucks,0,0,1,0,1,Kings,0,1,0,1,2,20211230,0,1,0,1,3,1,2021,1,3,1076,0
Canadiens,0,0,0,0,0,Hurricanes,2,1,1,0,4,20211230,2,3,4,4,4,4,2021,0,3,727,0
Predators,1,2,0,0,3,Blue Jackets,1,1,1,1,4,20211230,0,-1,0,1,7,1,2021,1,3,333,0
Lightning,1,1,1,0,3,Panthers,3,3,3,0,9,20211230,2,4,6,6,12,6,2021,0,3,205,0
Sabres,1,0,0,0,1,Islanders,1,2,1,0,4,20211230,0,2,3,3,5,3,2021,0,3,292,0
Oilers,2,1,2,0,5,Devils,3,0,2,1,6,20211231,1,0,0,1,11,1,2021,1,4,2016,0
Ducks,0,0,1,0,1,Golden Knights,2,1,0,0,3,20211231,2,3,2,2,4,2,2021,0,4,228,0
Rangers,0,2,1,1,4,Lightning,1,1,1,0,3,20211231,-1,0,0,1,7,-1,2021,1,4,1004,0
Capitals,0,1,2,0,3,Red Wings,0,1,0,0,1,20211231,0,0,2,2,4,-2,2021,0,4,394,0
Flyers,1,0,2,0,3,Kings,2,2,2,0,6,20220101,1,3,3,3,9,3,2021,0,5,2388,0
Canucks,2,0,3,0,5,Kraken,0,1,1,0,2,20220101,2,1,3,3,7,-3,2021,0,5,116,0
Blues,1,5,0,0,6,Wild,1,1,2,0,4,20220101,0,4,2,2,10,-2,2021,0,5,466,0
Senators,0,0,0,0,0,Maple Leafs,2,1,3,0,6,20220101,2,3,6,6,6,6,2021,0,5,203,0
Hurricanes,0,2,5,0,7,Blue Jackets,3,1,0,0,4,20220101,-3,-2,3,3,11,-3,2021,0,5,374,0
Oilers,0,2,0,0,2,Islanders,1,0,1,1,3,20220101,1,-1,0,1,5,1,2021,1,5,2024,0
Canadiens,1,1,0,0,2,Panthers,1,2,2,0,5,20220101,0,1,3,3,7,3,2021,0,5,1418,0
Sabres,1,2,0,0,3,Bruins,0,1,2,1,4,20220101,-1,-2,0,1,7,1,2021,1,5,399,0
Blackhawks,0,1,0,0,1,Predators,3,2,1,0,6,20220101,3,4,5,5,7,5,2021,0,5,395,0
Ducks,1,1,0,0,2,Avalanche,0,1,3,0,4,20220102,-1,-1,2,2,6,2,2021,0,6,830,0
Flames,1,2,2,0,5,Blackhawks,1,0,0,0,1,20220102,0,2,4,4,6,-4,2021,0,6,1397,0
Devils,2,1,0,1,4,Capitals,1,0,2,0,3,20220102,1,2,0,1,7,-1,2021,1,6,198,0
Jets,0,2,2,1,5,Golden Knights,2,0,2,0,4,20220102,-2,0,0,1,9,-1,2021,1,6,1303,0
Bruins,1,1,3,0,5,Red Wings,1,0,0,0,1,20220102,0,1,4,4,6,-4,2021,0,6,611,0
Lightning,0,0,0,0,0,Rangers,3,1,0,0,4,20220102,3,4,4,4,4,4,2021,0,6,1004,0
Sharks,1,1,3,0,5,Penguins,6,0,2,0,8,20220102,5,4,3,3,13,3,2021,0,6,2242,0
Oilers,0,1,0,0,1,Rangers,1,1,2,0,4,20220103,1,1,3,3,5,3,2021,0,0,2024,0
Flyers,1,0,0,0,1,Ducks,2,1,1,0,4,20220104,1,2,3,3,5,3,2021,0,1,2388,0
Predators,0,2,1,0,3,Golden Knights,0,0,2,0,2,20220104,0,2,1,1,5,-1,2021,0,1,1575,0
Jets,1,1,1,0,3,Coyotes,0,0,1,0,1,20220104,1,2,2,2,4,-2,2021,0,1,1365,0
Avalanche,2,0,1,1,4,Blackhawks,0,1,2,0,3,20220104,2,1,0,1,7,-1,2021,1,1,916,0
Lightning,3,2,2,0,7,Blue Jackets,0,2,0,0,2,20220104,3,3,5,5,9,-5,2021,0,1,830,0
Flames,2,0,0,0,2,Panthers,3,1,2,0,6,20220104,1,2,4,4,8,4,2021,0,1,2493,0
Devils,0,2,1,0,3,Bruins,1,2,2,0,5,20220104,1,1,2,2,8,2,2021,0,1,196,0
Sharks,0,1,1,0,2,Red Wings,1,3,2,0,6,20220104,1,3,4,4,8,4,2021,0,1,2071,0
Oilers,2,0,0,0,2,Maple Leafs,2,0,2,0,4,20220105,0,0,2,2,6,2,2021,0,2,1683,0
Blues,0,3,0,0,3,Penguins,0,2,3,0,5,20220105,0,-1,2,2,8,2,2021,0,2,557,0
Jets,1,0,0,0,1,Avalanche,1,3,3,0,7,20220106,0,3,6,6,8,6,2021,0,3,797,0
Predators,2,1,1,0,4,Kings,0,1,1,0,2,20220106,2,2,2,2,6,-2,2021,0,3,1776,0
Blackhawks,0,2,2,0,4,Coyotes,2,1,3,0,6,20220106,2,1,2,2,10,2,2021,0,3,1450,0
Panthers,1,3,1,0,5,Stars,1,3,1,1,6,20220106,0,0,0,1,11,1,2021,1,3,1110,0
Rangers,0,1,0,0,1,Golden Knights,1,2,2,0,5,20220106,1,2,4,4,6,4,2021,0,3,2227,0
Blue Jackets,1,0,0,0,1,Devils,1,0,2,0,3,20220106,0,0,2,2,4,2,2021,0,3,467,0
Flames,0,0,1,0,1,Lightning,0,1,3,0,4,20220106,0,1,3,3,5,3,2021,0,3,2289,0
Sharks,3,0,0,0,3,Sabres,0,1,1,0,2,20220106,3,2,1,1,5,-1,2021,0,3,2279,0
Wild,2,1,0,0,3,Bruins,1,1,0,0,2,20220106,1,1,1,1,5,-1,2021,0,3,1120,0
Penguins,3,0,3,0,6,Flyers,0,1,1,0,2,20220106,3,2,4,4,8,-4,2021,0,3,257,0
Flames,1,1,1,0,3,Hurricanes,1,3,2,0,6,20220107,0,2,3,3,9,3,2021,0,4,2038,0
Capitals,1,0,0,0,1,Blues,1,3,1,0,5,20220107,0,3,4,4,6,4,2021,0,4,708,0
Red Wings,0,0,0,0,0,Kings,2,1,1,0,4,20220108,2,3,4,4,4,4,2021,0,5,1979,0
Rangers,0,1,3,0,4,Ducks,0,1,0,0,1,20220108,0,0,3,3,5,-3,2021,0,5,2445,0
Blackhawks,0,2,0,0,2,Golden Knights,1,0,0,0,1,20220108,-1,1,1,1,3,-1,2021,0,5,1519,0
Predators,3,0,1,0,4,Coyotes,0,0,2,0,2,20220108,3,3,2,2,6,-2,2021,0,5,1442,0
Capitals,0,2,0,0,2,Wild,0,1,1,1,3,20220108,0,-1,0,1,5,1,2021,1,5,931,0
Maple Leafs,3,1,0,0,4,Avalanche,1,1,2,1,5,20220108,-2,-2,0,1,9,1,2021,1,5,1341,0
Panthers,2,1,0,1,4,Hurricanes,1,1,1,0,3,20220108,1,1,0,1,7,-1,2021,1,5,696,0
Sharks,0,0,2,1,3,Flyers,0,0,2,0,2,20220108,0,0,0,1,5,-1,2021,1,5,2499,0
Bruins,2,2,1,0,5,Lightning,0,0,2,0,2,20220108,2,4,3,3,7,-3,2021,0,5,1183,0
Penguins,2,0,0,0,2,Stars,0,1,2,0,3,20220108,-2,-1,1,1,5,1,2021,0,5,1069,0
Devils,2,1,0,0,3,Blue Jackets,2,1,1,0,4,20220108,0,0,1,1,7,1,2021,0,5,467,0
Stars,0,1,0,0,1,Blues,0,0,2,0,2,20220109,0,-1,1,1,3,1,2021,0,6,547,0
Red Wings,0,2,1,0,3,Ducks,1,1,1,1,4,20220109,1,0,0,1,7,1,2021,1,6,1979,0
Bruins,2,4,1,0,7,Capitals,2,1,0,0,3,20220110,0,3,4,4,10,-4,2021,0,0,394,0
Kraken,1,2,0,0,3,Avalanche,1,1,2,0,4,20220110,0,-1,1,1,7,1,2021,0,0,1019,0
Rangers,0,0,1,0,1,Kings,0,2,1,0,3,20220110,0,2,2,2,4,2,2021,0,0,2445,0
Penguins,1,2,1,0,4,Ducks,0,1,0,0,1,20220111,1,2,3,3,5,-3,2021,0,1,2132,0
Red Wings,0,1,1,0,2,Sharks,1,0,1,1,3,20220111,1,0,0,1,5,1,2021,1,1,2071,0
Maple Leafs,1,2,0,1,4,Golden Knights,1,0,2,0,3,20220111,0,2,0,1,7,-1,2021,1,1,1946,0
Avalanche,0,2,2,0,4,Predators,2,1,1,1,5,20220111,2,1,0,1,9,1,2021,1,1,1019,0
Blackhawks,1,1,2,0,4,Blue Jackets,1,0,1,0,2,20220111,0,1,2,2,6,-2,2021,0,1,275,0
Canucks,1,0,1,0,2,Panthers,2,3,0,0,5,20220111,1,4,3,3,7,3,2021,0,1,2803,0
Lightning,2,3,1,0,6,Sabres,0,0,1,0,1,20220111,2,5,5,5,7,-5,2021,0,1,1051,0
Canadiens,0,1,0,0,1,Bruins,3,1,1,0,5,20220112,3,3,4,4,6,4,2021,0,2,270,0
Kraken,1,1,0,0,2,Stars,3,1,1,0,5,20220112,2,2,3,3,7,3,2021,0,2,1679,0
Maple Leafs,0,0,1,0,1,Coyotes,1,0,1,0,2,20220112,1,1,1,1,3,1,2021,0,2,1885,0
Rangers,1,0,2,0,3,Sharks,0,0,0,0,0,20220113,1,1,3,3,3,-3,2021,0,3,2549,0
Penguins,1,0,1,0,2,Kings,1,1,4,0,6,20220113,0,1,4,4,8,4,2021,0,3,2132,0
Senators,2,1,1,0,4,Flames,0,0,1,0,1,20220113,2,3,3,3,5,-3,2021,0,3,1773,0
Canadiens,0,2,0,0,2,Blackhawks,1,0,1,1,3,20220113,1,-1,0,1,5,1,2021,1,3,732,0
Kraken,1,0,0,0,1,Blues,0,0,2,0,2,20220113,-1,-1,1,1,3,1,2021,0,3,1720,0
Sabres,1,1,2,0,4,Predators,0,1,0,0,1,20220113,1,1,3,3,5,-3,2021,0,3,626,0
Jets,1,1,1,0,3,Red Wings,0,0,0,0,0,20220113,1,2,3,3,3,-3,2021,0,3,855,0
Blue Jackets,1,1,4,0,6,Hurricanes,0,0,0,0,0,20220113,1,2,6,6,6,-6,2021,0,3,374,0
Canucks,1,0,1,0,2,Lightning,2,0,2,0,4,20220113,1,1,2,2,6,2,2021,0,3,2598,0
Flyers,0,2,0,0,2,Bruins,2,1,0,0,3,20220113,2,1,1,1,5,1,2021,0,3,270,0
Devils,1,0,1,0,2,Islanders,1,1,1,0,3,20220113,0,1,1,1,5,1,2021,0,3,8,0
Stars,0,0,1,0,1,Panthers,2,4,1,0,7,20220114,2,6,6,6,8,6,2021,0,4,1110,0
Ducks,1,0,2,0,3,Wild,3,0,4,0,7,20220114,2,2,4,4,10,4,2021,0,4,1521,0
Coyotes,1,1,1,0,3,Avalanche,2,0,1,1,4,20220114,1,0,0,1,7,1,2021,1,4,585,0
Ducks,0,0,0,0,0,Blackhawks,0,1,2,0,3,20220115,0,1,3,3,3,3,2021,0,5,1741,0
Penguins,1,0,0,1,2,Sharks,1,0,0,0,1,20220115,0,0,0,1,3,-1,2021,1,5,2242,0
Senators,1,0,5,0,6,Oilers,1,2,1,0,4,20220115,0,-2,2,2,10,-2,2021,0,5,1754,0
Kings,1,1,1,0,3,Kraken,0,1,0,0,1,20220115,1,1,2,2,4,-2,2021,0,5,960,0
Avalanche,1,3,1,0,5,Coyotes,0,0,0,0,0,20220115,1,4,5,5,5,-5,2021,0,5,585,0
Maple Leafs,3,1,2,0,6,Blues,1,3,1,0,5,20220115,2,0,1,1,11,-1,2021,0,5,659,0
Capitals,1,0,1,0,2,Islanders,0,0,0,0,0,20220115,1,1,2,2,2,-2,2021,0,5,204,0
Stars,1,0,0,0,1,Lightning,1,0,2,0,3,20220115,0,0,2,2,4,2,2021,0,5,916,0
Sabres,0,0,0,0,0,Red Wings,2,0,2,0,4,20220115,2,2,4,4,4,4,2021,0,5,215,0
Blue Jackets,0,0,2,0,2,Panthers,4,2,3,0,9,20220115,4,6,7,7,11,7,2021,0,5,993,0
Canucks,1,0,0,0,1,Hurricanes,1,2,1,0,4,20220115,0,2,3,3,5,3,2021,0,5,2409,0
Predators,1,1,1,0,3,Bruins,2,0,1,1,4,20220115,1,0,0,1,7,1,2021,1,5,941,0
Rangers,1,0,2,0,3,Flyers,1,0,1,0,2,20220115,0,0,1,1,5,-1,2021,0,5,80,0
Canucks,0,3,1,0,4,Capitals,1,0,1,0,2,20220116,-1,2,2,2,6,-2,2021,0,6,2359,0
Penguins,0,2,3,0,5,Golden Knights,3,0,0,0,3,20220117,-3,-1,2,2,8,-2,2021,0,0,1915,0
Predators,2,0,1,0,3,Blues,2,2,1,0,5,20220117,0,2,2,2,8,2,2021,0,0,253,0
Flyers,0,1,0,0,1,Islanders,0,2,2,0,4,20220117,0,1,3,3,5,3,2021,0,0,80,0
Blackhawks,0,2,0,0,2,Kraken,0,1,1,1,3,20220117,0,-1,0,1,5,1,2021,1,0,1732,0
Canadiens,1,1,0,0,2,Coyotes,2,2,1,0,5,20220117,1,2,3,3,7,3,2021,0,0,2175,0
Wild,0,1,2,0,3,Avalanche,2,0,1,1,4,20220117,2,1,0,1,7,1,2021,1,0,698,0
Red Wings,0,0,2,1,3,Sabres,1,0,1,0,2,20220117,-1,-1,0,1,5,-1,2021,1,0,215,0
Kings,1,0,1,0,2,Sharks,4,2,0,0,6,20220117,3,5,4,4,8,4,2021,0,0,305,0
Canadiens,0,2,3,0,5,Stars,0,1,2,0,3,20220118,0,1,2,2,8,-2,2021,0,1,1505,0
Panthers,0,1,0,0,1,Flames,2,1,2,0,5,20220118,2,2,4,4,6,4,2021,0,1,2493,0
Lightning,1,2,3,0,6,Kings,0,3,1,0,4,20220118,1,0,2,2,10,-2,2021,0,1,2149,0
Canucks,0,1,2,0,3,Predators,0,1,0,0,1,20220118,0,0,2,2,4,-2,2021,0,1,2030,0
Sabres,1,0,2,0,3,Senators,0,1,0,0,1,20220118,1,0,2,2,4,-2,2021,0,1,219,0
Jets,2,0,1,0,3,Capitals,1,1,1,1,4,20220118,-1,0,0,1,7,1,2021,1,1,1247,0
Hurricanes,5,0,2,0,7,Bruins,1,0,0,0,1,20220118,4,4,6,6,8,-6,2021,0,1,609,0
Islanders,1,1,1,1,4,Flyers,1,1,1,0,3,20220118,0,0,0,1,7,-1,2021,1,1,80,0
Coyotes,0,3,1,0,4,Devils,1,0,0,0,1,20220119,-1,2,3,3,5,-3,2021,0,2,2131,0
Maple Leafs,3,0,0,0,3,Rangers,1,2,3,0,6,20220119,-2,0,3,3,9,3,2021,0,2,341,0
Avalanche,0,1,1,0,2,Ducks,0,0,0,0,0,20220119,0,1,2,2,2,-2,2021,0,2,830,0
Sharks,1,0,1,0,2,Kraken,0,2,1,0,3,20220120,-1,1,1,1,5,1,2021,0,3,709,0
Canadiens,1,1,1,0,3,Golden Knights,1,1,1,1,4,20220120,0,0,0,1,7,1,2021,1,3,2221,0
Avalanche,1,1,2,0,4,Kings,0,1,0,0,1,20220120,1,1,3,3,5,-3,2021,0,3,830,0
Panthers,0,2,4,0,6,Oilers,0,0,0,0,0,20220120,0,2,6,6,6,-6,2021,0,3,2569,0
Blue Jackets,0,1,1,0,2,Flyers,0,0,1,0,1,20220120,0,1,1,1,3,-1,2021,0,3,414,0
Senators,1,0,3,0,4,Penguins,3,2,1,0,6,20220120,2,4,2,2,10,2,2021,0,3,392,0
Stars,1,2,2,0,5,Sabres,2,2,0,0,4,20220120,-1,-1,1,1,9,-1,2021,0,3,1197,0
Capitals,1,1,1,0,3,Bruins,1,1,2,0,4,20220120,0,0,1,1,7,1,2021,0,3,394,0
Jets,0,1,1,0,2,Predators,3,1,1,0,5,20220120,3,3,3,3,7,3,2021,0,3,1084,0
Blues,2,0,3,0,5,Kraken,0,0,0,0,0,20220121,2,2,5,5,5,-5,2021,0,4,1720,0
Lightning,0,0,1,0,1,Ducks,2,1,2,0,5,20220121,2,3,4,4,6,4,2021,0,4,2149,0
Wild,3,2,0,0,5,Blackhawks,0,0,1,0,1,20220121,3,5,4,4,6,-4,2021,0,4,355,0
Panthers,0,0,1,1,2,Canucks,1,0,0,0,1,20220121,-1,-1,0,1,3,-1,2021,1,4,2803,0
Stars,1,2,1,1,5,Red Wings,1,2,1,0,4,20220121,0,0,0,1,9,-1,2021,1,4,999,0
Penguins,2,0,3,0,5,Blue Jackets,2,0,0,0,2,20220121,0,0,3,3,7,-3,2021,0,4,161,0
Rangers,0,1,2,0,3,Hurricanes,2,3,1,0,6,20220121,2,4,3,3,9,3,2021,0,4,423,0
Coyotes,0,0,0,0,0,Islanders,2,0,2,0,4,20220121,2,2,4,4,4,4,2021,0,4,2139,0
Lightning,4,1,2,0,7,Sharks,1,0,0,0,1,20220122,3,4,6,6,8,-6,2021,0,5,2365,0
Flames,2,1,0,0,3,Oilers,0,3,2,0,5,20220122,-2,0,2,2,8,2,2021,0,5,171,0
Blackhawks,2,0,1,0,3,Wild,1,0,2,1,4,20220122,-1,-1,0,1,7,1,2021,1,5,355,0
Maple Leafs,2,1,0,0,3,Islanders,1,0,0,0,1,20220122,1,2,2,2,4,-2,2021,0,5,341,0
Canadiens,0,1,1,0,2,Avalanche,1,1,0,1,3,20220122,1,1,0,1,5,1,2021,1,5,1618,0
Red Wings,0,1,0,0,1,Predators,0,2,2,0,4,20220122,0,1,3,3,5,3,2021,0,5,470,0
Coyotes,2,1,0,0,3,Rangers,1,4,2,0,7,20220122,-1,2,4,4,10,4,2021,0,5,2139,0
Hurricanes,2,2,0,0,4,Devils,2,3,2,0,7,20220122,0,1,3,3,11,3,2021,0,5,419,0
Jets,2,0,0,0,2,Bruins,1,1,1,0,3,20220122,-1,0,1,1,5,1,2021,0,5,1349,0
Flyers,2,0,1,0,3,Sabres,4,1,1,0,6,20220122,2,3,3,3,9,3,2021,0,5,279,0
Senators,1,1,0,0,2,Capitals,0,0,2,1,3,20220122,-1,-2,0,1,5,1,2021,1,5,446,0
Jets,1,1,0,0,2,Penguins,0,0,2,1,3,20220123,-1,-2,0,1,5,1,2021,1,6,1060,0
Senators,1,1,0,0,2,Blue Jackets,1,0,0,0,1,20220123,0,1,1,1,3,-1,2021,0,6,512,0
Kings,1,1,1,0,3,Devils,2,0,0,0,2,20220123,-1,0,1,1,5,-1,2021,0,6,2436,0
Panthers,1,2,0,0,3,Kraken,0,3,2,0,5,20220123,-1,0,2,2,8,2,2021,0,6,2730,0
Blues,1,2,0,0,3,Canucks,1,0,0,0,1,20220123,0,2,2,2,4,-2,2021,0,6,1778,0
Blues,1,0,0,0,1,Flames,3,4,0,0,7,20220124,2,6,6,6,8,6,2021,0,0,1440,0
Blackhawks,0,0,0,0,0,Avalanche,0,1,1,0,2,20220124,0,1,2,2,2,2,2021,0,0,916,0
Golden Knights,0,1,0,0,1,Capitals,0,0,0,0,0,20220124,0,1,1,1,1,-1,2021,0,0,2080,0
Canadiens,1,0,1,0,2,Wild,2,3,3,0,8,20220124,1,4,6,6,10,6,2021,0,0,938,0
Kings,0,2,0,0,2,Rangers,1,0,1,1,3,20220124,1,-1,0,1,5,1,2021,1,0,2445,0
Stars,1,0,2,0,3,Flyers,0,1,0,0,1,20220124,1,0,2,2,4,-2,2021,0,0,1297,0
Ducks,1,2,2,0,5,Bruins,0,2,1,0,3,20220124,1,1,2,2,8,-2,2021,0,0,2590,0
Predators,1,2,1,0,4,Kraken,1,1,0,0,2,20220125,0,1,2,2,6,-2,2021,0,1,1970,0
Panthers,3,1,1,0,5,Jets,2,1,0,0,3,20220125,1,1,2,2,8,-2,2021,0,1,1899,0
Flyers,2,0,1,0,3,Islanders,2,1,1,0,4,20220125,0,1,1,1,7,1,2021,0,1,80,0
Oilers,0,0,2,1,3,Canucks,0,2,0,0,2,20220125,0,-2,0,1,5,-1,2021,1,1,514,0
Coyotes,0,2,1,0,3,Penguins,0,2,4,0,6,20220125,0,0,3,3,9,3,2021,0,1,1824,0
Stars,3,1,1,0,5,Devils,0,1,0,0,1,20220125,3,3,4,4,6,-4,2021,0,1,1362,0
Sabres,0,0,0,0,0,Senators,3,1,1,0,5,20220125,3,4,5,5,5,5,2021,0,1,219,0
Golden Knights,0,1,2,0,3,Hurricanes,0,2,1,1,4,20220125,0,1,0,1,7,1,2021,1,1,2028,0
Ducks,1,1,1,0,3,Maple Leafs,2,1,0,1,4,20220126,1,1,0,1,7,1,2021,1,2,2170,0
Sharks,1,1,2,0,4,Capitals,0,0,1,0,1,20220126,1,2,3,3,5,-3,2021,0,2,2416,0
Flames,1,2,3,0,6,Blue Jackets,0,0,0,0,0,20220126,1,3,6,6,6,-6,2021,0,2,1670,0
Blackhawks,4,0,4,0,8,Red Wings,0,3,2,0,5,20220126,4,1,3,3,13,-3,2021,0,2,238,0
Bruins,0,3,0,0,3,Avalanche,1,0,2,1,4,20220126,1,-2,0,1,7,1,2021,1,2,1765,0
Kraken,0,0,1,1,2,Penguins,0,0,1,0,1,20220127,0,0,0,1,3,-1,2021,1,3,2132,0
Canucks,1,2,2,0,5,Jets,1,0,0,0,1,20220127,0,2,4,4,6,-4,2021,0,3,1157,0
Flames,1,0,0,0,1,Blues,2,1,2,0,5,20220127,1,2,4,4,6,4,2021,0,3,1440,0
Predators,1,1,0,0,2,Oilers,1,1,0,1,3,20220127,0,0,0,1,5,1,2021,1,3,1758,0
Kings,1,1,1,0,3,Islanders,0,0,2,0,2,20220127,1,2,1,1,5,-1,2021,0,3,2445,0
Devils,1,0,1,0,2,Lightning,0,2,1,0,3,20220127,-1,1,1,1,5,1,2021,0,3,1000,0
Hurricanes,0,1,1,1,3,Senators,0,1,1,0,2,20220127,0,0,0,1,5,-1,2021,1,3,673,0
Ducks,3,2,0,0,5,Canadiens,0,2,2,0,4,20220127,3,3,1,1,9,-1,2021,0,3,2448,0
Rangers,2,0,1,0,3,Blue Jackets,2,2,1,0,5,20220127,0,2,2,2,8,2,2021,0,3,476,0
Golden Knights,1,0,0,0,1,Panthers,1,1,2,0,4,20220127,0,1,3,3,5,3,2021,0,3,2177,0
Red Wings,1,1,0,1,3,Penguins,0,1,1,0,2,20220128,1,1,0,1,5,-1,2021,1,4,205,0
Wild,0,2,1,0,3,Rangers,2,0,0,0,2,20220128,-2,0,1,1,5,-1,2021,0,4,1016,0
Avalanche,0,2,4,0,6,Blackhawks,0,0,4,0,4,20220128,0,2,2,2,10,-2,2021,0,4,916,0
Capitals,3,2,0,0,5,Stars,0,0,0,0,0,20220128,3,5,5,5,5,-5,2021,0,4,1181,0
Bruins,1,1,0,0,2,Coyotes,1,0,0,0,1,20220128,0,1,1,1,3,-1,2021,0,4,2295,0
Canucks,0,0,0,0,0,Flames,0,0,0,1,1,20220129,0,0,0,1,1,1,2021,1,5,426,0
Sabres,2,1,0,0,3,Coyotes,0,0,1,0,1,20220129,2,3,2,2,4,-2,2021,0,5,1902,0
Devils,1,0,0,0,1,Hurricanes,2,0,0,0,2,20220129,1,1,1,1,3,1,2021,0,5,419,0
Golden Knights,1,1,0,1,3,Lightning,0,0,2,0,2,20220129,1,2,0,1,5,-1,2021,1,5,1985,0
Maple Leafs,1,1,5,0,7,Red Wings,1,3,0,0,4,20220129,0,-2,3,3,11,-3,2021,0,5,205,0
Kings,0,1,2,0,3,Flyers,1,1,1,1,4,20220129,1,1,0,1,7,1,2021,1,5,2388,0
Sharks,2,1,1,0,4,Panthers,1,0,3,1,5,20220129,-1,-2,0,1,9,1,2021,1,5,2558,0
Jets,1,2,1,0,4,Blues,1,0,0,0,1,20220129,0,2,3,3,5,-3,2021,0,5,853,0
Ducks,1,0,1,0,2,Senators,1,0,0,0,1,20220129,0,0,1,1,3,-1,2021,0,5,2345,0
Oilers,3,3,1,0,7,Canadiens,0,2,0,0,2,20220129,3,4,5,5,9,-5,2021,0,5,1826,0
Bruins,0,0,1,0,1,Stars,2,2,2,0,6,20220130,2,4,5,5,7,5,2021,0,6,1548,0
Sabres,0,1,0,0,1,Avalanche,1,2,1,0,4,20220130,1,2,3,3,5,3,2021,0,6,1366,0
Blue Jackets,4,0,2,0,6,Canadiens,1,1,1,0,3,20220130,3,2,3,3,9,-3,2021,0,6,605,0
Wild,2,1,1,0,4,Islanders,1,1,1,0,3,20220130,1,1,1,1,7,-1,2021,0,6,1016,0
Kings,0,3,1,0,4,Penguins,0,1,2,0,3,20220130,0,2,1,1,7,-1,2021,0,6,2132,0
Sharks,0,0,1,0,1,Hurricanes,1,0,1,0,2,20220130,1,1,1,1,3,1,2021,0,6,2382,0
Kraken,0,1,1,0,2,Rangers,1,1,1,0,3,20220130,1,1,1,1,5,1,2021,0,6,2401,0
Panthers,4,3,1,0,8,Blue Jackets,2,2,0,0,4,20220131,2,3,4,4,12,-4,2021,0,0,993,0
Oilers,1,0,1,0,2,Senators,1,1,0,1,3,20220131,0,1,0,1,5,1,2021,1,0,1754,0
Ducks,0,1,0,0,1,Red Wings,1,0,0,1,2,20220131,1,0,0,1,3,1,2021,1,0,1979,0
Canucks,1,1,1,0,3,Blackhawks,0,0,1,0,1,20220131,1,2,2,2,4,-2,2021,0,0,1775,0
Devils,3,1,0,0,4,Maple Leafs,2,0,4,0,6,20220131,-1,-2,2,2,10,2,2021,0,0,333,0
Sabres,0,1,1,0,2,Golden Knights,2,2,1,0,5,20220201,2,3,3,3,7,3,2021,0,1,1970,0
Coyotes,0,1,1,1,3,Avalanche,0,2,0,0,2,20220201,0,-1,0,1,5,-1,2021,1,1,585,0
Flames,1,0,3,0,4,Stars,2,1,0,0,3,20220201,-1,-2,1,1,7,-1,2021,0,1,1536,0
Canucks,2,0,0,0,2,Predators,2,1,1,0,4,20220201,0,1,2,2,6,2,2021,0,1,2030,0
Senators,1,0,0,0,1,Islanders,1,2,1,0,4,20220201,0,2,3,3,5,3,2021,0,1,334,0
Maple Leafs,4,2,1,0,7,Devils,0,0,1,0,1,20220201,4,6,6,6,8,-6,2021,0,1,333,0
Jets,1,0,0,0,1,Flyers,0,1,2,0,3,20220201,-1,0,2,2,4,2,2021,0,1,1273,0
Panthers,1,1,0,0,2,Rangers,1,2,2,0,5,20220201,0,1,3,3,7,3,2021,0,1,1091,0
Sharks,0,1,1,0,2,Lightning,0,2,0,1,3,20220201,0,1,0,1,5,1,2021,1,1,2365,0
Kraken,0,0,2,0,2,Bruins,0,2,1,0,3,20220201,0,2,1,1,5,1,2021,0,1,2485,0
Capitals,2,1,0,1,4,Penguins,2,1,0,0,3,20220201,0,0,0,1,7,-1,2021,1,1,190,0
Flames,2,1,1,0,4,Coyotes,1,1,0,0,2,20220202,1,1,2,2,6,-2,2021,0,2,1224,0
Wild,0,3,2,0,5,Blackhawks,0,0,0,0,0,20220202,0,3,5,5,5,-5,2021,0,2,355,0
Oilers,3,0,2,0,5,Capitals,1,1,1,0,3,20220202,2,1,2,2,8,-2,2021,0,2,1985,0
Kraken,0,0,3,0,3,Islanders,0,0,0,0,0,20220202,0,0,3,3,3,-3,2021,0,2,2401,0
Kings,0,2,3,0,5,Red Wings,1,0,2,0,3,20220202,-1,1,2,2,8,-2,2021,0,2,1979,0
Hurricanes,1,0,2,0,3,Maple Leafs,0,2,1,1,4,20220207,-1,1,0,1,7,1,2021,1,0,544,0
Devils,1,0,0,0,1,Senators,1,2,1,0,4,20220207,0,2,3,3,5,3,2021,0,0,330,0
Golden Knights,2,1,1,0,4,Oilers,0,0,0,0,0,20220208,2,3,4,4,4,-4,2021,0,1,1204,0
Coyotes,0,1,0,0,1,Canucks,0,3,2,0,5,20220208,0,2,4,4,6,4,2021,0,1,1228,0
Blue Jackets,0,3,2,0,5,Capitals,1,2,1,0,4,20220208,-1,0,1,1,9,-1,2021,0,1,326,0
Wild,0,0,0,0,0,Jets,1,0,1,0,2,20220208,1,1,2,2,2,2,2021,0,1,388,0
Penguins,0,3,1,0,4,Bruins,2,0,0,0,2,20220208,-2,1,2,2,6,-2,2021,0,1,481,0
Hurricanes,0,0,3,0,3,Senators,2,2,0,0,4,20220208,2,4,1,1,7,1,2021,0,1,673,0
Devils,2,3,2,0,7,Canadiens,0,1,0,0,1,20220208,2,4,6,6,8,-6,2021,0,1,342,0
Coyotes,1,1,3,0,5,Kraken,0,0,2,0,2,20220209,1,2,3,3,7,-3,2021,0,2,1114,0
Red Wings,2,2,2,0,6,Flyers,2,1,0,0,3,20220209,0,1,3,3,9,-3,2021,0,2,441,0
Predators,1,2,0,0,3,Stars,1,2,1,0,4,20220209,0,0,1,1,7,1,2021,0,2,616,0
Blackhawks,2,0,2,0,4,Oilers,0,1,0,0,1,20220209,2,1,3,3,5,-3,2021,0,2,1437,0
Golden Knights,0,0,0,0,0,Flames,3,1,2,0,6,20220209,3,4,6,6,6,6,2021,0,2,1033,0
Islanders,5,0,1,0,6,Canucks,1,2,0,0,3,20220209,4,2,3,3,9,-3,2021,0,2,2429,0
Maple Leafs,0,1,1,0,2,Flames,0,4,1,0,5,20220210,0,3,3,3,7,3,2021,0,3,1682,0
Lightning,1,1,0,0,2,Avalanche,2,1,0,0,3,20220210,1,1,1,1,5,1,2021,0,3,1521,0
Devils,2,0,5,0,7,Blues,1,2,1,0,4,20220210,1,-1,3,3,11,-3,2021,0,3,863,0
Penguins,0,1,1,0,2,Senators,0,0,0,0,0,20220210,0,1,2,2,2,-2,2021,0,3,392,0
Hurricanes,1,3,2,0,6,Bruins,0,0,0,0,0,20220210,1,4,6,6,6,-6,2021,0,3,609,0
Blue Jackets,1,0,2,1,4,Sabres,0,2,1,0,3,20220210,1,-1,0,1,7,-1,2021,1,3,293,0
Capitals,2,2,1,0,5,Canadiens,0,2,0,0,2,20220210,2,2,3,3,7,-3,2021,0,3,495,0
Jets,0,2,1,0,3,Stars,0,2,1,1,4,20220211,0,0,0,1,7,1,2021,1,4,1183,0
Islanders,0,1,0,0,1,Oilers,1,1,1,0,3,20220211,1,1,2,2,4,2,2021,0,4,2024,0
Lightning,2,0,2,0,4,Coyotes,1,0,2,0,3,20220211,1,1,1,1,7,-1,2021,0,4,1793,0
Kraken,2,1,1,0,4,Ducks,1,2,0,0,3,20220211,1,0,1,1,7,-1,2021,0,4,960,0
Maple Leafs,0,2,0,0,2,Canucks,2,1,0,0,3,20220212,2,1,1,1,5,1,2021,0,5,2090,0
Flyers,0,1,1,0,2,Red Wings,1,1,2,0,4,20220212,1,1,2,2,6,2,2021,0,5,441,0
Bruins,2,0,0,0,2,Senators,0,0,0,0,0,20220212,2,2,2,2,2,-2,2021,0,5,320,0
Blue Jackets,1,0,1,0,2,Canadiens,0,0,1,0,1,20220212,1,1,1,1,3,-1,2021,0,5,605,0
Jets,1,1,3,0,5,Predators,2,0,0,0,2,20220212,-1,0,3,3,7,-3,2021,0,5,1084,0
Hurricanes,0,0,2,0,2,Wild,0,1,2,0,3,20220212,0,1,1,1,5,1,2021,0,5,995,0
Blackhawks,0,1,0,0,1,Blues,2,1,2,0,5,20220212,2,2,4,4,6,4,2021,0,5,260,0
Islanders,1,1,0,0,2,Flames,2,1,2,0,5,20220212,1,1,3,3,7,3,2021,0,5,2023,0
Penguins,0,1,3,0,4,Devils,0,1,1,0,2,20220213,0,0,2,2,6,-2,2021,0,6,306,0
Avalanche,2,0,2,0,4,Stars,0,0,0,0,0,20220213,2,2,4,4,4,-4,2021,0,6,661,0
Sabres,1,2,2,0,5,Canadiens,0,3,0,0,3,20220213,1,0,2,2,8,-2,2021,0,6,311,0
Senators,2,1,1,0,4,Capitals,0,1,0,0,1,20220213,2,2,3,3,5,-3,2021,0,6,446,0
Oilers,2,0,1,0,3,Sharks,0,0,0,0,0,20220214,2,2,3,3,3,-3,2021,0,0,1190,0
Maple Leafs,3,1,2,0,6,Kraken,1,0,1,0,2,20220214,2,3,4,4,8,-4,2021,0,0,2066,0
Red Wings,2,0,2,0,4,Wild,2,2,3,0,7,20220214,0,2,3,3,11,3,2021,0,0,542,0
Blackhawks,0,1,2,0,3,Jets,0,0,1,0,1,20220214,0,1,2,2,4,-2,2021,0,0,722,0
Blues,1,2,2,0,5,Senators,1,1,0,0,2,20220215,0,1,3,3,7,-3,2021,0,1,860,0
Lightning,1,2,3,0,6,Devils,2,1,0,0,3,20220215,-1,0,3,3,9,-3,2021,0,1,1000,0
Flyers,1,3,0,0,4,Penguins,2,0,2,1,5,20220215,1,-2,0,1,9,1,2021,1,1,257,0
Islanders,1,1,1,0,3,Sabres,1,2,3,0,6,20220215,0,1,3,3,9,3,2021,0,1,292,0
Bruins,1,0,0,0,1,Rangers,0,0,1,1,2,20220215,-1,-1,0,1,3,1,2021,1,1,190,0
Capitals,1,0,3,0,4,Predators,0,0,1,0,1,20220215,1,1,3,3,5,-3,2021,0,1,566,0
Blue Jackets,1,0,1,0,2,Flames,2,2,2,0,6,20220215,1,3,4,4,8,4,2021,0,1,1670,0
Stars,1,2,1,0,4,Avalanche,0,1,0,0,1,20220215,1,2,3,3,5,-3,2021,0,1,661,0
Oilers,0,1,4,0,5,Kings,1,0,1,0,2,20220215,-1,0,3,3,7,-3,2021,0,1,1368,0
Avalanche,0,0,2,0,2,Golden Knights,0,0,0,0,0,20220216,0,0,2,2,2,-2,2021,0,2,604,0
Wild,1,0,2,0,3,Jets,0,2,4,0,6,20220216,-1,1,3,3,9,3,2021,0,2,388,0
Panthers,0,1,1,1,3,Hurricanes,1,0,1,0,2,20220216,-1,0,0,1,5,-1,2021,1,2,696,0
Ducks,0,1,1,0,2,Flames,2,2,2,0,6,20220216,2,3,4,4,8,4,2021,0,2,1197,0
Blue Jackets,3,1,3,0,7,Blackhawks,2,1,1,0,4,20220217,1,1,3,3,11,-3,2021,0,3,275,0
Kraken,2,0,1,0,3,Jets,1,2,2,0,5,20220217,-1,1,2,2,8,2,2021,0,3,1148,0
Canucks,2,1,1,1,5,Sharks,0,2,2,0,4,20220217,2,1,0,1,9,-1,2021,1,3,821,0
Bruins,1,0,0,0,1,Islanders,0,1,3,0,4,20220217,-1,0,3,3,5,3,2021,0,3,190,0
Ducks,2,0,1,0,3,Oilers,1,3,3,0,7,20220217,-1,2,4,4,10,4,2021,0,3,1368,0
Blues,1,0,1,0,2,Canadiens,1,0,1,1,3,20220217,0,0,0,1,5,1,2021,1,3,962,0
Penguins,0,0,1,0,1,Maple Leafs,1,2,1,0,4,20220217,1,3,3,3,5,3,2021,0,3,222,0
Capitals,1,1,3,0,5,Flyers,0,2,1,0,3,20220217,1,0,2,2,8,-2,2021,0,3,123,0
Red Wings,1,1,0,1,3,Rangers,0,1,1,0,2,20220217,1,1,0,1,5,-1,2021,1,3,480,0
Senators,0,1,2,0,3,Sabres,1,0,0,0,1,20220217,-1,0,2,2,4,-2,2021,0,3,219,0
Predators,0,1,2,0,3,Hurricanes,1,2,2,0,5,20220218,1,2,2,2,8,2,2021,0,4,456,0
Panthers,2,1,3,0,6,Wild,1,0,1,0,2,20220218,1,2,4,4,8,-4,2021,0,4,1513,0
Stars,0,0,0,1,1,Blackhawks,0,0,0,0,0,20220218,0,0,0,1,1,-1,2021,1,4,802,0
Kings,1,2,0,1,4,Golden Knights,2,1,0,0,3,20220218,-1,0,0,1,7,-1,2021,1,4,228,0
Ducks,3,3,1,0,7,Canucks,0,2,2,0,4,20220219,3,4,3,3,11,-3,2021,0,5,1076,0
Kraken,1,0,0,0,1,Flames,1,0,1,0,2,20220219,0,0,1,1,3,1,2021,0,5,445,0
Kings,1,1,3,0,5,Coyotes,1,2,0,0,3,20220219,0,-1,2,2,8,-2,2021,0,5,356,0
Avalanche,3,0,2,0,5,Sabres,2,1,0,0,3,20220219,1,0,2,2,8,-2,2021,0,5,1366,0
Bruins,0,2,0,1,3,Senators,0,1,1,0,2,20220219,0,1,0,1,5,-1,2021,1,5,320,0
Oilers,1,2,1,0,4,Jets,0,0,2,0,2,20220219,1,3,2,2,6,-2,2021,0,5,738,0
Blues,2,1,3,0,6,Maple Leafs,1,2,0,0,3,20220219,1,0,3,3,9,-3,2021,0,5,659,0
Golden Knights,2,1,1,0,4,Sharks,0,0,1,0,1,20220220,2,3,3,3,5,-3,2021,0,6,382,0
Wild,4,2,1,0,7,Oilers,1,1,1,0,3,20220220,3,4,4,4,10,-4,2021,0,6,1083,0
Sabres,2,1,0,0,3,Blue Jackets,2,3,2,0,7,20220220,0,2,4,4,10,4,2021,0,6,293,0
Stars,0,1,0,0,1,Coyotes,0,2,1,0,3,20220220,0,1,2,2,4,2,2021,0,6,884,0
Panthers,1,1,3,0,5,Blackhawks,1,0,1,0,2,20220220,0,1,3,3,7,-3,2021,0,6,1189,0
Canadiens,1,1,0,1,3,Islanders,0,1,1,0,2,20220220,1,1,0,1,5,-1,2021,1,6,343,0
Hurricanes,1,1,2,0,4,Penguins,0,2,1,0,3,20220220,1,0,1,1,7,-1,2021,0,6,330,0
Rangers,1,1,0,0,2,Senators,1,0,0,0,1,20220220,0,1,1,1,3,-1,2021,0,6,334,0
Avalanche,0,1,0,0,1,Bruins,1,3,1,0,5,20220221,1,3,4,4,6,4,2021,0,0,1765,0
Hurricanes,0,2,1,1,4,Flyers,0,1,2,0,3,20220221,0,1,0,1,7,-1,2021,1,0,345,0
Jets,0,1,0,0,1,Flames,0,1,2,0,3,20220221,0,0,2,2,4,2,2021,0,0,740,0
Maple Leafs,0,0,2,0,2,Canadiens,2,3,0,0,5,20220221,2,5,3,3,7,3,2021,0,0,303,0
Kraken,2,0,0,0,2,Canucks,1,2,2,0,5,20220221,-1,1,3,3,7,3,2021,0,0,116,0
Islanders,2,2,1,0,5,Kraken,0,1,1,0,2,20220222,2,3,3,3,7,-3,2021,0,1,2401,0
Sharks,2,1,0,0,3,Ducks,1,2,0,1,4,20220222,-1,0,0,1,7,1,2021,1,1,305,0
Blues,1,0,3,0,4,Flyers,0,0,1,0,1,20220222,1,1,3,3,5,-3,2021,0,1,808,0
Wild,0,2,1,0,3,Senators,2,1,1,0,4,20220222,2,1,1,1,7,1,2021,0,1,838,0
Predators,1,2,3,0,6,Panthers,1,2,1,0,4,20220222,0,0,2,2,10,-2,2021,0,1,816,0
Maple Leafs,1,1,1,0,3,Blue Jackets,0,1,2,1,4,20220222,-1,-1,0,1,7,1,2021,1,1,313,0
Oilers,1,1,1,0,3,Lightning,2,2,1,0,5,20220223,1,2,2,2,8,2,2021,0,2,2367,0
Jets,1,0,1,0,2,Stars,0,1,1,1,3,20220223,-1,0,0,1,5,1,2021,1,2,1183,0
Avalanche,2,1,2,0,5,Red Wings,0,1,1,0,2,20220223,2,2,3,3,7,-3,2021,0,2,1154,0
Sabres,0,0,0,0,0,Canadiens,1,1,2,0,4,20220223,1,2,4,4,4,4,2021,0,2,311,0
Kings,0,2,1,0,3,Coyotes,0,2,0,0,2,20220223,0,0,1,1,5,-1,2021,0,2,356,0
Islanders,1,2,0,0,3,Sharks,2,1,0,1,4,20220224,1,0,0,1,7,1,2021,1,3,2549,0
Bruins,1,1,0,1,3,Kraken,1,1,0,0,2,20220224,0,0,0,1,5,-1,2021,1,3,2485,0
Stars,0,1,0,0,1,Predators,1,0,0,1,2,20220224,1,0,0,1,3,1,2021,1,3,616,0
Flames,0,0,1,0,1,Canucks,0,5,2,0,7,20220224,0,5,6,6,8,6,2021,0,3,426,0
Capitals,0,0,1,0,1,Rangers,1,1,2,0,4,20220224,1,2,3,3,5,3,2021,0,3,204,0
Wild,0,1,0,0,1,Maple Leafs,0,1,2,0,3,20220224,0,0,2,2,4,2,2021,0,3,691,0
Devils,3,2,1,0,6,Penguins,0,1,0,0,1,20220224,3,4,5,5,7,-5,2021,0,3,306,0
Blue Jackets,1,1,4,0,6,Panthers,1,0,2,0,3,20220224,0,1,3,3,9,-3,2021,0,3,993,0
Blue Jackets,0,0,0,0,0,Hurricanes,0,2,2,0,4,20220225,0,2,4,4,4,4,2021,0,4,374,0
Sabres,1,1,1,0,3,Blues,2,1,2,0,5,20220225,1,1,2,2,8,2,2021,0,4,660,0
Devils,2,1,2,0,5,Blackhawks,1,3,4,0,8,20220225,-1,1,3,3,13,3,2021,0,4,703,0
Jets,3,0,0,0,3,Avalanche,0,3,3,0,6,20220225,-3,0,3,3,9,3,2021,0,4,797,0
Golden Knights,0,1,0,0,1,Coyotes,0,1,2,0,3,20220225,0,0,2,2,4,2,2021,0,4,256,0
Kings,1,3,0,0,4,Ducks,0,0,1,0,1,20220225,1,4,3,3,5,-3,2021,0,4,0,0
Canadiens,1,1,0,0,2,Senators,0,1,0,0,1,20220226,1,1,1,1,3,-1,2021,0,5,104,0
Islanders,0,1,1,0,2,Kings,2,2,1,0,5,20220226,2,3,3,3,7,3,2021,0,5,2445,0
Bruins,1,0,2,0,3,Sharks,0,1,0,0,1,20220226,1,0,2,2,4,-2,2021,0,5,2678,0
Avalanche,1,0,2,0,3,Golden Knights,2,0,0,0,2,20220226,-1,-1,1,1,5,-1,2021,0,5,604,0
Wild,1,0,2,0,3,Flames,3,2,2,0,7,20220226,2,4,4,4,10,4,2021,0,5,1043,0
Capitals,0,1,0,0,1,Flyers,2,0,0,0,2,20220226,2,1,1,1,3,1,2021,0,5,123,0
Lightning,0,2,1,0,3,Predators,1,0,1,0,2,20220226,-1,1,1,1,5,-1,2021,0,5,621,0
Rangers,0,0,0,0,0,Penguins,0,0,1,0,1,20220226,0,0,1,1,1,1,2021,0,5,314,0
Oilers,1,3,0,0,4,Panthers,2,0,1,0,3,20220226,-1,2,1,1,7,-1,2021,0,5,2569,0
Maple Leafs,3,4,3,0,10,Red Wings,1,1,5,0,7,20220226,2,5,3,3,17,-3,2021,0,5,205,0
Penguins,1,0,2,0,3,Blue Jackets,1,1,0,0,2,20220227,0,-1,1,1,5,-1,2021,0,6,161,0
Islanders,1,1,2,0,4,Ducks,0,0,0,0,0,20220227,1,2,4,4,4,-4,2021,0,6,2445,0
Canucks,2,2,1,0,5,Rangers,0,0,2,0,2,20220227,2,4,3,3,7,-3,2021,0,6,2429,0
Kraken,1,0,0,0,1,Sharks,1,1,1,0,3,20220227,0,1,2,2,4,2,2021,0,6,709,0
Jets,2,0,3,0,5,Coyotes,2,1,0,0,3,20220227,0,-1,2,2,8,-2,2021,0,6,1365,0
Sabres,0,1,1,0,2,Stars,1,2,1,0,4,20220227,1,2,2,2,6,2,2021,0,6,1197,0
Oilers,0,1,0,0,1,Hurricanes,2,0,0,0,2,20220227,2,1,1,1,3,1,2021,0,6,2076,0
Blues,0,3,1,0,4,Blackhawks,0,0,0,0,0,20220227,0,3,4,4,4,-4,2021,0,6,260,0
Canucks,0,2,0,0,2,Devils,3,3,1,0,7,20220228,3,4,5,5,9,5,2021,0,0,2421,0
Maple Leafs,3,0,2,0,5,Capitals,1,1,1,0,3,20220228,2,1,2,2,8,-2,2021,0,0,349,0
Bruins,2,3,2,0,7,Kings,0,0,0,0,0,20220228,2,5,7,7,7,-7,2021,0,0,2590,0
Bruins,1,1,1,0,3,Ducks,3,0,1,0,4,20220301,2,1,1,1,7,1,2021,0,1,2590,0
Sharks,0,1,0,0,1,Golden Knights,1,1,1,0,3,20220301,1,1,2,2,4,2,2021,0,1,382,0
Islanders,1,2,0,0,3,Avalanche,1,1,3,0,5,20220301,0,-1,2,2,8,2,2021,0,1,1627,0
Flames,2,1,2,0,5,Wild,0,1,0,0,1,20220301,2,2,4,4,6,-4,2021,0,1,1043,0
Canadiens,3,1,0,0,4,Jets,4,1,3,0,8,20220301,1,1,4,4,12,4,2021,0,1,1115,0
Devils,1,1,1,0,3,Blue Jackets,2,1,1,0,4,20220301,1,1,1,1,7,1,2021,0,1,467,0
Oilers,1,1,1,0,3,Flyers,0,0,0,0,0,20220301,1,2,3,3,3,-3,2021,0,1,2011,0
Senators,2,0,0,0,2,Lightning,2,2,1,0,5,20220301,0,2,3,3,7,3,2021,0,1,1251,0
Hurricanes,1,0,2,0,3,Red Wings,0,1,2,1,4,20220301,-1,0,0,1,7,1,2021,1,1,511,0
Sabres,1,2,2,0,5,Maple Leafs,1,0,0,0,1,20220302,0,2,4,4,6,-4,2021,0,2,57,0
Blues,0,3,0,0,3,Rangers,1,1,3,0,5,20220302,1,-1,2,2,8,2,2021,0,2,871,0
Kings,1,2,0,0,3,Stars,0,4,0,0,4,20220302,-1,1,1,1,7,1,2021,0,2,1237,0
Predators,1,2,0,0,3,Kraken,0,3,1,0,4,20220302,-1,0,1,1,7,1,2021,0,2,1970,0
Canadiens,1,1,2,1,5,Flames,1,2,1,0,4,20220303,0,-1,0,1,9,-1,2021,1,3,1852,0
Bruins,1,1,3,0,5,Golden Knights,0,1,1,0,2,20220303,1,1,3,3,7,-3,2021,0,3,2369,0
Avalanche,0,1,0,0,1,Coyotes,0,1,1,0,2,20220303,0,0,1,1,3,1,2021,0,3,585,0
Oilers,2,0,1,0,3,Blackhawks,2,0,1,1,4,20220303,0,0,0,1,7,1,2021,1,3,1437,0
Wild,2,1,2,0,5,Flyers,2,2,0,0,4,20220303,0,-1,1,1,9,-1,2021,0,3,983,0
Hurricanes,0,0,0,0,0,Capitals,1,2,1,0,4,20220303,1,3,4,4,4,4,2021,0,3,233,0
Canucks,0,2,2,0,4,Islanders,0,2,1,0,3,20220303,0,0,1,1,7,-1,2021,0,3,2429,0
Senators,0,0,0,0,0,Panthers,1,0,2,0,3,20220303,1,1,3,3,3,3,2021,0,3,1370,0
Penguins,2,1,2,0,5,Lightning,0,1,0,0,1,20220303,2,2,4,4,6,-4,2021,0,3,874,0
Wild,1,0,3,0,4,Sabres,1,1,3,0,5,20220304,0,1,1,1,9,1,2021,0,4,729,0
Red Wings,0,1,0,0,1,Lightning,0,1,2,0,3,20220304,0,0,2,2,4,2,2021,0,4,994,0
Devils,1,0,0,0,1,Rangers,1,1,1,0,3,20220304,0,1,2,2,4,2,2021,0,4,8,0
Penguins,2,0,0,0,2,Hurricanes,0,1,1,1,3,20220304,-2,-1,0,1,5,1,2021,1,4,330,0
Kings,0,1,2,1,4,Blue Jackets,0,3,0,0,3,20220304,0,-2,0,1,7,-1,2021,1,4,1973,0
Stars,1,1,1,1,4,Jets,0,1,2,0,3,20220304,1,1,0,1,7,-1,2021,1,4,1183,0
Golden Knights,1,4,0,0,5,Ducks,1,2,1,0,4,20220304,0,2,1,1,9,-1,2021,0,4,228,0
Flames,2,1,0,1,4,Avalanche,2,1,0,0,3,20220305,0,0,0,1,7,-1,2021,1,5,898,0
Canadiens,2,1,2,0,5,Oilers,1,1,0,0,2,20220305,1,1,3,3,7,-3,2021,0,5,1826,0
Bruins,1,1,2,1,5,Blue Jackets,2,1,1,0,4,20220305,-1,-1,0,1,9,-1,2021,1,5,642,0
Kraken,1,1,0,0,2,Capitals,2,1,2,0,5,20220305,1,1,3,3,7,3,2021,0,5,2322,0
Predators,2,2,4,0,8,Sharks,0,0,0,0,0,20220305,2,4,8,8,8,-8,2021,0,5,1934,0
Red Wings,1,0,1,0,2,Panthers,3,3,0,0,6,20220305,2,5,4,4,8,4,2021,0,5,1155,0
Senators,0,3,2,0,5,Coyotes,2,2,4,0,8,20220305,2,1,3,3,13,3,2021,0,5,2071,0
Blackhawks,0,3,0,0,3,Flyers,1,1,2,0,4,20220305,1,-1,1,1,7,1,2021,0,5,664,0
Blues,0,0,1,0,1,Islanders,1,1,0,0,2,20220305,1,2,1,1,3,1,2021,0,5,871,0
Canucks,2,1,3,0,6,Maple Leafs,1,3,0,0,4,20220305,1,-1,2,2,10,-2,2021,0,5,2090,0
Sharks,1,1,0,0,2,Ducks,0,2,0,1,3,20220306,-1,0,0,1,5,1,2021,1,6,305,0
Rangers,2,0,2,0,4,Jets,0,1,0,0,1,20220306,2,1,3,3,5,-3,2021,0,6,1287,0
Lightning,0,3,3,0,6,Blackhawks,1,1,1,0,3,20220306,-1,1,3,3,9,-3,2021,0,6,1004,0
Senators,0,1,0,0,1,Golden Knights,0,1,1,0,2,20220306,0,0,1,1,3,1,2021,0,6,2119,0
Stars,1,3,2,0,6,Wild,1,0,2,0,3,20220306,0,3,3,3,9,-3,2021,0,6,863,0
Blues,0,0,2,0,2,Devils,1,1,0,1,3,20220306,1,2,0,1,5,1,2021,1,6,863,0
Kings,0,1,2,0,3,Sabres,0,0,0,0,0,20220306,0,1,3,3,3,-3,2021,0,6,2193,0
Kraken,0,2,0,0,2,Hurricanes,0,2,1,0,3,20220306,0,0,1,1,5,1,2021,0,6,2361,0
Kings,1,0,1,1,3,Bruins,1,1,0,0,2,20220307,0,-1,0,1,5,-1,2021,1,0,2590,0
Panthers,1,4,1,0,6,Sabres,0,0,1,0,1,20220307,1,5,5,5,7,-5,2021,0,0,1184,0
Maple Leafs,3,0,2,0,5,Blue Jackets,0,2,2,0,4,20220307,3,1,1,1,9,-1,2021,0,0,313,0
Avalanche,1,0,4,0,5,Islanders,1,0,3,0,4,20220307,0,0,1,1,9,-1,2021,0,0,1627,0
Oilers,0,0,1,0,1,Flames,0,2,1,0,3,20220307,0,2,2,2,4,2,2021,0,0,171,0
Stars,0,0,1,0,1,Predators,0,0,2,0,2,20220308,0,0,1,1,3,1,2021,0,1,616,0
Ducks,0,3,0,0,3,Blackhawks,5,2,1,0,8,20220308,5,4,5,5,11,5,2021,0,1,1741,0
Lightning,3,0,1,0,4,Jets,3,0,4,0,7,20220308,0,0,3,3,11,3,2021,0,1,1705,0
Rangers,0,2,0,0,2,Wild,2,3,0,0,5,20220308,2,3,3,3,7,3,2021,0,1,1016,0
Senators,1,1,2,0,4,Blues,1,0,0,0,1,20220308,0,1,3,3,5,-3,2021,0,1,860,0
Capitals,0,2,3,0,5,Flames,1,1,2,0,4,20220308,-1,0,1,1,9,-1,2021,0,1,1967,0
Kraken,1,2,1,0,4,Maple Leafs,2,1,3,0,6,20220308,1,0,2,2,10,2,2021,0,1,2066,0
Panthers,2,1,1,0,4,Penguins,0,2,1,0,3,20220308,2,1,1,1,7,-1,2021,0,1,1013,0
Golden Knights,0,1,0,0,1,Flyers,2,0,0,0,2,20220308,2,1,1,1,3,1,2021,0,1,2171,0
Avalanche,2,1,0,0,3,Devils,0,3,2,0,5,20220308,-2,0,2,2,8,2,2021,0,1,1618,0
Coyotes,3,4,2,0,9,Red Wings,1,1,0,0,2,20220308,2,5,7,7,11,-7,2021,0,1,1687,0
Capitals,0,1,2,0,3,Oilers,0,2,1,1,4,20220309,0,1,0,1,7,1,2021,1,2,1985,0
Canadiens,1,1,1,0,3,Canucks,1,1,3,0,5,20220309,0,0,2,2,8,2,2021,0,2,2273,0
Sharks,1,1,1,1,4,Kings,2,1,0,0,3,20220310,-1,-1,0,1,7,-1,2021,1,3,305,0
Lightning,0,1,0,0,1,Flames,1,2,1,0,4,20220310,1,2,3,3,5,3,2021,0,3,2289,0
Ducks,0,0,1,0,1,Predators,1,1,2,0,4,20220310,1,2,3,3,5,3,2021,0,3,1776,0
Rangers,1,1,0,0,2,Blues,3,3,0,0,6,20220310,2,4,4,4,8,4,2021,0,3,871,0
Blue Jackets,0,0,0,0,0,Islanders,1,3,2,0,6,20220310,1,4,6,6,6,6,2021,0,3,476,0
Jets,1,1,0,0,2,Devils,1,0,0,0,1,20220310,0,1,1,1,3,-1,2021,0,3,1280,0
Avalanche,0,0,0,0,0,Hurricanes,0,0,2,0,2,20220310,0,0,2,2,2,2,2021,0,3,1459,0
Wild,2,1,2,1,6,Red Wings,3,1,1,0,5,20220310,-1,-1,0,1,11,-1,2021,1,3,542,0
Kraken,0,0,3,0,3,Senators,1,2,0,1,4,20220310,1,3,0,1,7,1,2021,1,3,2176,0
Coyotes,2,2,0,1,5,Maple Leafs,0,1,3,0,4,20220310,2,3,0,1,9,-1,2021,1,3,1885,0
Golden Knights,0,0,1,0,1,Sabres,1,0,2,0,3,20220310,1,1,2,2,4,2,2021,0,3,1970,0
Blackhawks,1,1,1,0,3,Bruins,1,2,1,0,4,20220310,0,1,1,1,7,1,2021,0,3,849,0
Flyers,0,3,0,0,3,Panthers,4,0,2,0,6,20220310,4,1,3,3,9,3,2021,0,3,1021,0
Golden Knights,0,2,0,0,2,Penguins,1,1,3,0,5,20220311,1,0,3,3,7,3,2021,0,4,1915,0
Wild,1,1,0,0,2,Blue Jackets,1,0,1,1,3,20220311,0,-1,0,1,5,1,2021,1,4,626,0
Jets,1,0,1,0,2,Islanders,1,2,2,0,5,20220311,0,2,3,3,7,3,2021,0,4,1287,0
Capitals,2,0,1,1,4,Canucks,0,0,3,0,3,20220311,2,2,0,1,7,-1,2021,1,4,2359,0
Red Wings,0,0,0,0,0,Flames,1,0,2,0,3,20220312,1,1,3,3,3,3,2021,0,5,1573,0
Lightning,0,0,1,0,1,Oilers,1,1,2,0,4,20220312,1,2,3,3,5,3,2021,0,5,2367,0
Kings,0,0,0,0,0,Sharks,3,1,1,0,5,20220312,3,4,5,5,5,5,2021,0,5,305,0
Rangers,4,1,2,0,7,Stars,2,1,1,0,4,20220312,2,2,3,3,11,-3,2021,0,5,1370,0
Ducks,1,0,0,0,1,Devils,0,1,0,1,2,20220312,-1,0,0,1,3,1,2021,1,5,2436,0
Blues,3,1,3,0,7,Predators,1,3,0,0,4,20220312,2,0,3,3,11,-3,2021,0,5,253,0
Kraken,2,1,0,1,4,Canadiens,1,0,2,0,3,20220312,1,2,0,1,7,-1,2021,1,5,2262,0
Coyotes,0,1,1,0,2,Bruins,2,0,1,0,3,20220312,2,1,1,1,5,1,2021,0,5,2295,0
Flyers,0,1,0,0,1,Hurricanes,0,1,2,0,3,20220312,0,0,2,2,4,2,2021,0,5,345,0
Blackhawks,0,4,2,0,6,Senators,2,1,0,0,3,20220312,-2,1,3,3,9,-3,2021,0,5,628,0
Panthers,0,2,0,0,2,Kings,1,0,1,1,3,20220313,1,-1,0,1,5,1,2021,1,6,2335,0
Lightning,2,0,0,0,2,Canucks,0,0,1,0,1,20220313,2,2,1,1,3,-1,2021,0,6,2598,0
Flames,0,0,0,0,0,Avalanche,1,0,2,0,3,20220313,1,1,3,3,3,3,2021,0,6,898,0
Ducks,1,1,1,0,3,Islanders,3,1,0,0,4,20220313,2,2,1,1,7,1,2021,0,6,2445,0
Predators,1,2,3,0,6,Wild,1,1,0,0,2,20220313,0,1,4,4,8,-4,2021,0,6,696,0
Golden Knights,2,1,1,0,4,Blue Jackets,3,2,1,0,6,20220313,1,2,2,2,10,2,2021,0,6,1757,0
Canadiens,0,2,1,1,4,Flyers,1,1,1,0,3,20220313,-1,0,0,1,7,-1,2021,1,6,400,0
Maple Leafs,0,2,0,0,2,Sabres,0,2,3,0,5,20220313,0,0,3,3,7,3,2021,0,6,57,0
Hurricanes,0,0,2,0,2,Penguins,1,1,2,0,4,20220313,1,2,2,2,6,2,2021,0,6,330,0
Jets,0,1,2,1,4,Blues,1,1,1,0,3,20220313,-1,-1,0,1,7,-1,2021,1,6,853,0
Coyotes,2,1,2,0,5,Senators,2,0,1,0,3,20220314,0,1,2,2,8,-2,2021,0,0,2071,0
Red Wings,1,1,3,0,5,Oilers,4,0,3,0,7,20220315,3,2,2,2,12,2,2021,0,1,1592,0
Panthers,1,0,1,1,3,Sharks,2,0,0,0,2,20220315,-1,-1,0,1,5,-1,2021,1,1,2558,0
Avalanche,1,1,1,0,3,Kings,0,0,0,0,0,20220315,1,2,3,3,3,-3,2021,0,1,830,0
Devils,1,2,0,0,3,Canucks,2,2,2,0,6,20220315,1,1,3,3,9,3,2021,0,1,2421,0
Bruins,0,0,1,1,2,Blackhawks,0,0,1,0,1,20220315,0,0,0,1,3,-1,2021,1,1,849,0
Stars,0,0,0,0,0,Maple Leafs,2,0,2,0,4,20220315,2,2,4,4,4,4,2021,0,1,1201,0
Penguins,0,1,0,0,1,Predators,1,2,1,0,4,20220315,1,2,3,3,5,3,2021,0,1,471,0
Islanders,0,2,1,0,3,Capitals,1,0,2,1,4,20220315,1,-1,0,1,7,1,2021,1,1,204,0
Ducks,1,1,1,0,3,Rangers,1,1,1,1,4,20220315,0,0,0,1,7,1,2021,1,1,2445,0
Coyotes,4,1,1,0,6,Canadiens,1,2,0,0,3,20220315,3,2,3,3,9,-3,2021,0,1,2175,0
Golden Knights,0,1,2,0,3,Jets,2,3,2,0,7,20220315,2,4,4,4,10,4,2021,0,1,1303,0
Blue Jackets,1,2,1,0,4,Senators,1,0,0,0,1,20220316,0,2,3,3,5,-3,2021,0,2,512,0
Bruins,1,1,0,0,2,Wild,2,0,2,0,4,20220316,1,0,2,2,6,2,2021,0,2,1120,0
Devils,1,1,1,0,3,Flames,2,3,1,0,6,20220316,1,3,3,3,9,3,2021,0,2,2015,0
Lightning,1,1,2,0,4,Kraken,1,0,0,0,1,20220316,0,1,3,3,5,-3,2021,0,2,2526,0
Sharks,0,0,0,0,0,Kings,0,2,1,0,3,20220317,0,2,3,3,3,3,2021,0,3,305,0
Red Wings,0,1,0,0,1,Canucks,0,0,0,0,0,20220317,0,1,1,1,1,-1,2021,0,3,1967,0
Sabres,0,0,1,0,1,Oilers,2,2,2,0,6,20220317,2,4,5,5,7,5,2021,0,3,1734,0
Penguins,1,1,0,1,3,Blues,0,1,1,0,2,20220317,1,1,0,1,5,-1,2021,1,3,557,0
Panthers,1,1,1,0,3,Golden Knights,1,2,2,0,5,20220317,0,1,2,2,8,2,2021,0,3,2177,0
Predators,0,3,1,0,4,Flyers,1,2,2,0,5,20220317,1,0,1,1,9,1,2021,0,3,683,0
Stars,1,1,1,1,4,Canadiens,0,1,2,0,3,20220317,1,1,0,1,7,-1,2021,1,3,1505,0
Hurricanes,0,0,2,0,2,Maple Leafs,1,1,1,0,3,20220317,1,2,1,1,5,1,2021,0,3,544,0
Islanders,0,1,1,0,2,Rangers,0,1,0,0,1,20220317,0,0,1,1,3,-1,2021,0,3,0,0
Capitals,2,2,3,0,7,Blue Jackets,0,1,1,0,2,20220317,2,3,5,5,9,-5,2021,0,3,326,0
Flyers,0,1,0,0,1,Senators,1,0,2,0,3,20220318,1,0,2,2,4,2,2021,0,4,373,0
Capitals,2,0,1,1,4,Hurricanes,1,2,0,0,3,20220318,1,-1,0,1,7,-1,2021,1,4,233,0
Bruins,0,2,2,0,4,Jets,0,0,2,0,2,20220318,0,2,2,2,6,-2,2021,0,4,1349,0
Sabres,0,0,0,1,1,Flames,0,0,0,0,0,20220318,0,0,0,1,1,-1,2021,1,4,1731,0
Panthers,2,1,0,0,3,Ducks,0,0,0,0,0,20220318,2,3,3,3,3,-3,2021,0,4,2335,0
Avalanche,2,2,1,0,5,Sharks,0,1,2,0,3,20220318,2,3,2,2,8,-2,2021,0,4,927,0
Red Wings,0,2,0,0,2,Kraken,0,0,4,0,4,20220319,0,-2,2,2,6,2,2021,0,5,1933,0
Flames,3,1,1,0,5,Canucks,0,0,2,0,2,20220319,3,4,3,3,7,-3,2021,0,5,426,0
Rangers,0,1,1,0,2,Lightning,1,0,0,0,1,20220319,-1,0,1,1,3,-1,2021,0,5,1004,0
Maple Leafs,0,1,2,0,3,Predators,1,2,3,0,6,20220319,1,2,3,3,9,3,2021,0,5,646,0
Senators,1,0,0,0,1,Canadiens,1,3,1,0,5,20220319,0,3,4,4,6,4,2021,0,5,104,0
Stars,0,1,1,0,2,Islanders,0,1,3,0,4,20220319,0,0,2,2,6,2,2021,0,5,1370,0
Blues,1,1,2,0,4,Blue Jackets,2,1,2,0,5,20220319,1,1,1,1,9,1,2021,0,5,395,0
Kings,0,1,0,0,1,Golden Knights,1,2,2,0,5,20220319,1,2,4,4,6,4,2021,0,5,228,0
Devils,1,0,2,0,3,Oilers,1,1,4,0,6,20220319,0,1,3,3,9,3,2021,0,5,2016,0
Blackhawks,0,0,1,0,1,Wild,1,0,2,0,3,20220319,1,1,2,2,4,2,2021,0,5,355,0
Penguins,0,1,3,0,4,Coyotes,0,1,0,0,1,20220319,0,0,3,3,5,-3,2021,0,5,1824,0
Sabres,1,1,0,1,3,Canucks,0,2,0,0,2,20220320,1,0,0,1,5,-1,2021,1,6,2137,0
Jets,1,4,1,0,6,Blackhawks,0,2,2,0,4,20220320,1,3,2,2,10,-2,2021,0,6,722,0
Coyotes,0,1,1,0,2,Sharks,1,0,3,0,4,20220320,1,0,2,2,6,2,2021,0,6,614,0
Stars,2,1,0,0,3,Capitals,0,1,1,0,2,20220320,2,2,1,1,5,-1,2021,0,6,1181,0
Rangers,0,1,1,0,2,Hurricanes,0,0,0,0,0,20220320,0,1,2,2,2,-2,2021,0,6,423,0
Islanders,1,0,0,0,1,Flyers,0,2,0,0,2,20220320,-1,1,1,1,3,1,2021,0,6,80,0
Bruins,1,0,1,1,3,Canadiens,0,1,1,0,2,20220321,1,0,0,1,5,-1,2021,1,0,270,0
Golden Knights,0,0,0,0,0,Wild,1,0,2,0,3,20220321,1,1,3,3,3,3,2021,0,0,1293,0
Oilers,0,2,0,0,2,Avalanche,1,1,0,1,3,20220321,1,0,0,1,5,1,2021,1,0,1036,0
Predators,1,1,4,0,6,Ducks,1,1,1,0,3,20220321,0,0,3,3,9,-3,2021,0,0,1776,0
Lightning,0,1,1,0,2,Hurricanes,0,2,1,0,3,20220322,0,1,1,1,5,1,2021,0,1,585,0
Kraken,0,3,1,0,4,Coyotes,0,2,0,0,2,20220322,0,1,2,2,6,-2,2021,0,1,1114,0
Sharks,1,1,2,0,4,Flames,2,1,0,0,3,20220322,-1,-1,1,1,7,-1,2021,0,1,1027,0
Oilers,1,0,2,0,3,Stars,0,2,3,0,5,20220322,-1,1,2,2,8,2,2021,0,1,1655,0
Golden Knights,0,0,0,0,0,Jets,0,2,2,0,4,20220322,0,2,4,4,4,4,2021,0,1,1303,0
Blues,2,2,1,0,5,Capitals,2,0,0,0,2,20220322,0,2,3,3,7,-3,2021,0,1,708,0
Flyers,0,2,1,0,3,Red Wings,2,2,2,0,6,20220322,2,2,3,3,9,3,2021,0,1,441,0
Predators,0,1,0,0,1,Kings,3,0,3,0,6,20220322,3,2,5,5,7,5,2021,0,1,1776,0
Blue Jackets,1,0,0,0,1,Penguins,0,4,1,0,5,20220322,-1,3,4,4,6,4,2021,0,1,161,0
Rangers,2,0,2,0,4,Devils,0,5,2,0,7,20220322,-2,3,3,3,11,3,2021,0,1,8,0
Senators,0,0,0,0,0,Islanders,0,0,3,0,3,20220322,0,0,3,3,3,3,2021,0,1,334,0
Blackhawks,1,1,2,0,4,Ducks,1,0,1,0,2,20220323,0,1,2,2,6,-2,2021,0,2,1741,0
Canucks,0,0,3,0,3,Avalanche,0,0,1,0,1,20220323,0,0,2,2,4,-2,2021,0,2,1105,0
Devils,0,2,0,0,2,Maple Leafs,0,2,1,0,3,20220323,0,0,1,1,5,1,2021,0,2,333,0
Penguins,0,2,1,0,3,Sabres,1,1,1,1,4,20220323,1,0,0,1,7,1,2021,1,2,178,0
Blackhawks,1,2,0,1,4,Kings,0,2,1,0,3,20220324,1,1,0,1,7,-1,2021,1,3,1741,0
Sharks,0,1,1,0,2,Oilers,0,2,3,0,5,20220324,0,1,3,3,7,3,2021,0,3,1190,0
Senators,1,0,4,0,5,Jets,1,0,1,0,2,20220324,0,0,3,3,7,-3,2021,0,3,1033,0
Canucks,1,0,1,0,2,Wild,1,1,0,1,3,20220324,0,1,0,1,5,1,2021,1,3,1427,0
Predators,0,1,0,0,1,Golden Knights,2,2,2,0,6,20220324,2,3,5,5,7,5,2021,0,3,1575,0
Red Wings,0,0,2,0,2,Islanders,2,1,2,0,5,20220324,2,3,3,3,7,3,2021,0,3,480,0
Stars,0,1,2,1,4,Hurricanes,0,1,2,0,3,20220324,0,0,0,1,7,-1,2021,1,3,1055,0
Panthers,1,2,1,0,4,Canadiens,1,1,1,0,3,20220324,0,1,1,1,7,-1,2021,0,3,1418,0
Lightning,0,1,1,0,2,Bruins,0,1,2,0,3,20220324,0,0,1,1,5,1,2021,0,3,1183,0
Flyers,2,1,2,0,5,Blues,0,2,0,0,2,20220324,2,1,3,3,7,-3,2021,0,3,808,0
Capitals,1,2,0,1,4,Sabres,1,2,0,0,3,20220325,0,0,0,1,7,-1,2021,1,4,292,0
Penguins,0,0,1,0,1,Rangers,3,1,1,0,5,20220325,3,4,4,4,6,4,2021,0,4,314,0
Blue Jackets,1,1,1,0,3,Jets,2,1,0,1,4,20220325,1,1,0,1,7,1,2021,1,4,975,0
Flyers,1,1,1,0,3,Avalanche,4,1,1,0,6,20220325,3,3,3,3,9,3,2021,0,4,1574,0
Coyotes,0,1,1,0,2,Flames,0,3,1,0,4,20220325,0,2,2,2,6,2,2021,0,4,1224,0
Hurricanes,1,3,3,0,7,Blues,0,1,1,0,2,20220326,1,3,5,5,9,-5,2021,0,5,665,0
Kraken,0,1,1,0,2,Kings,1,2,1,0,4,20220326,1,2,2,2,6,2,2021,0,5,960,0
Oilers,2,3,0,0,5,Flames,3,3,3,0,9,20220326,1,1,4,4,14,4,2021,0,5,171,0
Blue Jackets,0,2,0,0,2,Wild,1,0,1,1,3,20220326,1,-1,0,1,5,1,2021,1,5,626,0
Canucks,0,1,3,0,4,Stars,0,1,0,0,1,20220326,0,0,3,3,5,-3,2021,0,5,1766,0
Ducks,0,0,1,0,1,Sharks,1,1,2,0,4,20220326,1,2,3,3,5,3,2021,0,5,305,0
Panthers,0,2,1,1,4,Senators,2,1,0,0,3,20220326,-2,-1,0,1,7,-1,2021,1,5,1370,0
Maple Leafs,1,0,1,0,2,Canadiens,0,2,2,0,4,20220326,-1,1,2,2,6,2,2021,0,5,303,0
Blackhawks,1,2,1,0,4,Golden Knights,0,0,4,1,5,20220326,-1,-3,0,1,9,1,2021,1,5,1519,0
Lightning,0,0,1,1,2,Red Wings,0,0,1,0,1,20220326,0,0,0,1,3,-1,2021,1,5,994,0
Islanders,1,1,1,0,3,Bruins,2,4,0,0,6,20220326,1,4,3,3,9,3,2021,0,5,190,0
Devils,0,2,1,0,3,Capitals,0,1,3,0,4,20220326,0,-1,1,1,7,1,2021,0,5,198,0
Coyotes,0,0,1,0,1,Jets,1,0,0,1,2,20220327,1,1,0,1,3,1,2021,1,6,1365,0
Canadiens,0,1,1,0,2,Devils,1,1,0,1,3,20220327,1,1,0,1,5,1,2021,1,6,342,0
Avalanche,0,0,2,0,2,Wild,0,1,1,1,3,20220327,0,1,0,1,5,1,2021,1,6,698,0
Panthers,1,1,0,0,2,Maple Leafs,1,2,2,0,5,20220327,0,1,3,3,7,3,2021,0,6,1234,0
Red Wings,0,2,0,0,2,Penguins,2,5,4,0,11,20220327,2,5,9,9,13,9,2021,0,6,205,0
Sabres,1,2,1,0,4,Rangers,2,1,1,1,5,20220327,1,0,0,1,9,1,2021,1,6,292,0
Lightning,0,2,2,0,4,Islanders,1,0,0,0,1,20220327,-1,1,3,3,5,-3,2021,0,6,1004,0
Flyers,2,2,0,0,4,Predators,0,4,1,0,5,20220327,-2,0,1,1,9,1,2021,0,6,683,0
Hurricanes,2,3,1,0,6,Capitals,0,1,0,0,1,20220328,2,4,5,5,7,-5,2021,0,0,233,0
Canucks,0,0,1,0,1,Blues,2,0,2,0,4,20220328,2,2,3,3,5,3,2021,0,0,1778,0
Sabres,0,3,3,0,6,Blackhawks,3,1,1,0,5,20220328,-3,-1,1,1,11,-1,2021,0,0,453,0
Coyotes,1,0,0,0,1,Oilers,2,3,1,0,6,20220328,1,4,5,5,7,5,2021,0,0,1392,0
Kraken,2,1,3,0,6,Kings,1,0,0,0,1,20220328,1,2,5,5,7,-5,2021,0,0,960,0
Flyers,0,0,1,0,1,Wild,2,2,0,0,4,20220329,2,4,3,3,5,3,2021,0,1,983,0
Stars,1,0,2,0,3,Ducks,0,2,0,0,2,20220329,1,-1,1,1,5,-1,2021,0,1,1237,0
Avalanche,0,1,1,0,2,Flames,0,1,0,0,1,20220329,0,0,1,1,3,-1,2021,0,1,898,0
Senators,1,0,0,0,1,Predators,1,1,2,0,4,20220329,0,1,3,3,5,3,2021,0,1,845,0
Rangers,0,2,1,0,3,Penguins,1,0,1,0,2,20220329,-1,1,1,1,5,-1,2021,0,1,314,0
Canadiens,1,3,0,0,4,Panthers,2,2,3,0,7,20220329,1,0,3,3,11,3,2021,0,1,1418,0
Hurricanes,1,2,0,0,3,Lightning,0,2,1,1,4,20220329,-1,-1,0,1,7,1,2021,1,1,585,0
Maple Leafs,3,3,0,0,6,Bruins,1,1,2,0,4,20220329,2,4,2,2,10,-2,2021,0,1,430,0
Islanders,2,2,0,0,4,Blue Jackets,1,1,1,0,3,20220329,1,2,1,1,7,-1,2021,0,1,476,0
Golden Knights,0,1,2,0,3,Kraken,0,0,0,0,0,20220330,0,1,3,3,3,-3,2021,0,2,871,0
Jets,0,2,0,1,3,Sabres,1,1,0,0,2,20220330,-1,0,0,1,5,-1,2021,1,2,996,0
Rangers,2,1,1,1,5,Red Wings,2,1,1,0,4,20220330,0,0,0,1,9,-1,2021,1,2,480,0
Kings,1,2,0,0,3,Oilers,2,1,0,1,4,20220330,1,0,0,1,7,1,2021,1,2,1368,0
Blues,0,3,1,0,4,Canucks,0,2,1,0,3,20220330,0,1,1,1,7,-1,2021,0,2,1778,0
Sharks,1,1,0,0,2,Coyotes,1,1,3,0,5,20220330,0,0,3,3,7,3,2021,0,2,614,0
Sharks,0,1,1,0,2,Avalanche,0,1,3,0,4,20220331,0,0,2,2,6,2,2021,0,3,927,0
Penguins,1,2,0,1,4,Wild,1,1,1,0,3,20220331,0,1,0,1,7,-1,2021,1,3,741,0
Canadiens,0,0,0,0,0,Hurricanes,2,1,1,0,4,20220331,2,3,4,4,4,4,2021,0,3,727,0
Devils,1,0,0,0,1,Bruins,2,6,0,0,8,20220331,1,7,7,7,9,7,2021,0,3,196,0
Blackhawks,0,0,0,0,0,Panthers,1,2,1,0,4,20220331,1,3,4,4,4,4,2021,0,3,1189,0
Jets,2,1,0,0,3,Maple Leafs,1,4,2,0,7,20220331,-1,2,4,4,10,4,2021,0,3,946,0
Kings,0,1,1,1,3,Flames,0,0,2,0,2,20220331,0,1,0,1,5,-1,2021,1,3,1197,0
Blue Jackets,0,2,0,0,2,Islanders,2,0,3,0,5,20220331,2,0,3,3,7,3,2021,0,3,476,0
Stars,1,0,1,1,3,Ducks,0,1,1,0,2,20220331,1,0,0,1,5,-1,2021,1,3,1237,0
Golden Knights,1,2,2,0,5,Kraken,0,0,2,0,2,20220401,1,3,3,3,7,-3,2021,0,4,871,0
Ducks,3,1,1,0,5,Coyotes,0,0,0,0,0,20220401,3,4,5,5,5,-5,2021,0,4,356,0
Blues,1,2,2,0,5,Oilers,4,1,0,1,6,20220401,3,2,0,1,11,1,2021,1,4,1508,0
Islanders,1,1,1,0,3,Rangers,0,0,0,0,0,20220401,1,2,3,3,3,-3,2021,0,4,0,0
Senators,1,0,4,0,5,Red Wings,0,1,1,0,2,20220401,1,0,3,3,7,-3,2021,0,4,406,0
Blackhawks,2,0,0,0,2,Lightning,2,2,1,0,5,20220401,0,2,3,3,7,3,2021,0,4,1004,0
Predators,3,0,0,0,3,Sabres,3,1,0,0,4,20220401,0,1,1,1,7,1,2021,0,4,626,0
Blues,2,1,3,0,6,Flames,2,0,2,0,4,20220402,0,1,2,2,10,-2,2021,0,5,1440,0
Kings,2,1,0,0,3,Jets,1,1,0,0,2,20220402,1,1,1,1,5,-1,2021,0,5,1527,0
Wild,1,1,1,0,3,Hurricanes,0,0,1,0,1,20220402,1,2,2,2,4,-2,2021,0,5,995,0
Maple Leafs,0,2,4,0,6,Flyers,0,2,1,0,3,20220402,0,0,3,3,9,-3,2021,0,5,334,0
Stars,4,0,1,0,5,Sharks,1,1,2,0,4,20220402,3,2,1,1,9,-1,2021,0,5,1449,0
Blue Jackets,1,1,0,0,2,Bruins,1,1,3,0,5,20220402,0,0,3,3,7,3,2021,0,5,642,0
Penguins,0,1,1,0,2,Avalanche,0,2,1,0,3,20220402,0,1,1,1,5,1,2021,0,5,1317,0
Panthers,1,1,4,1,7,Devils,2,4,0,0,6,20220402,-1,-4,0,1,13,-1,2021,1,5,1090,0
Canadiens,0,3,1,1,5,Lightning,2,2,0,0,4,20220402,-2,-1,0,1,9,-1,2021,1,5,1311,0
Panthers,0,3,2,0,5,Sabres,1,0,2,0,3,20220403,-1,2,2,2,8,-2,2021,0,6,1184,0
Red Wings,1,0,1,0,2,Senators,1,2,2,0,5,20220403,0,2,3,3,7,3,2021,0,6,406,0
Islanders,2,1,1,0,4,Devils,0,1,2,0,3,20220403,2,2,1,1,7,-1,2021,0,6,8,0
Flyers,2,0,1,1,4,Rangers,0,0,3,0,3,20220403,2,2,0,1,7,-1,2021,1,6,80,0
Wild,2,1,2,0,5,Capitals,0,0,1,0,1,20220403,2,3,4,4,6,-4,2021,0,6,931,0
Coyotes,0,2,0,1,3,Blackhawks,1,0,1,0,2,20220403,-1,1,0,1,5,-1,2021,1,6,1450,0
Golden Knights,2,0,0,1,3,Canucks,0,0,2,0,2,20220403,2,2,0,1,5,-1,2021,1,6,986,0
Oilers,3,1,2,0,6,Ducks,0,0,1,0,1,20220403,3,4,5,5,7,-5,2021,0,6,1368,0
Stars,0,0,1,0,1,Kraken,1,0,3,0,4,20220403,1,1,3,3,5,3,2021,0,6,1679,0
Coyotes,0,0,1,0,1,Blues,0,4,1,0,5,20220404,0,4,4,4,6,4,2021,0,0,1270,0
Flames,1,2,0,0,3,Kings,2,0,0,0,2,20220404,-1,1,1,1,5,-1,2021,0,0,1197,0
Maple Leafs,1,3,2,0,6,Lightning,1,1,0,0,2,20220404,0,2,4,4,8,-4,2021,0,0,1096,0
Bruins,1,1,0,1,3,Blue Jackets,1,1,0,0,2,20220404,0,0,0,1,5,-1,2021,1,0,642,0
Wild,1,1,0,0,2,Predators,3,1,2,0,6,20220405,2,2,4,4,8,4,2021,0,1,696,0
Hurricanes,1,0,1,0,2,Sabres,0,2,2,0,4,20220405,-1,1,2,2,6,2,2021,0,1,491,0
Senators,1,2,3,0,6,Canadiens,1,2,0,0,3,20220405,0,0,3,3,9,-3,2021,0,1,104,0
Maple Leafs,1,4,1,0,6,Panthers,1,3,2,1,7,20220405,0,-1,0,1,13,1,2021,1,1,1234,0
Rangers,2,0,1,0,3,Devils,1,0,0,0,1,20220405,1,1,2,2,4,-2,2021,0,1,8,0
Blue Jackets,2,0,2,0,4,Flyers,1,1,0,0,2,20220405,1,0,2,2,6,-2,2021,0,1,414,0
Avalanche,1,2,3,0,6,Penguins,1,1,2,0,4,20220405,0,1,2,2,10,-2,2021,0,1,1317,0
Bruins,2,0,1,0,3,Red Wings,1,2,2,0,5,20220405,-1,1,2,2,8,2,2021,0,1,611,0
Islanders,1,1,0,0,2,Stars,2,1,0,0,3,20220405,1,1,1,1,5,1,2021,0,1,1370,0
Oilers,0,0,1,1,2,Sharks,1,0,0,0,1,20220405,-1,-1,0,1,3,-1,2021,1,1,1190,0
Canucks,2,2,1,0,5,Golden Knights,1,0,0,0,1,20220406,1,3,4,4,6,-4,2021,0,2,986,0
Kraken,0,1,0,0,1,Blues,1,1,2,0,4,20220406,1,1,3,3,5,3,2021,0,2,1720,0
Flames,1,1,2,0,4,Ducks,0,1,1,0,2,20220406,1,1,2,2,6,-2,2021,0,2,1197,0
Lightning,2,0,1,0,3,Capitals,3,1,0,0,4,20220406,1,2,1,1,7,1,2021,0,2,818,0
Red Wings,1,0,2,0,3,Jets,0,1,0,0,1,20220406,1,0,2,2,4,-2,2021,0,2,855,0
Canucks,1,3,1,0,5,Coyotes,0,1,0,0,1,20220407,1,3,4,4,6,-4,2021,0,3,1228,0
Maple Leafs,1,1,1,1,4,Stars,1,0,2,0,3,20220407,0,1,0,1,7,-1,2021,1,3,1201,0
Flames,2,1,1,0,4,Sharks,1,0,1,0,2,20220407,1,2,2,2,6,-2,2021,0,3,1027,0
Oilers,1,1,1,0,3,Kings,0,1,1,0,2,20220407,1,1,1,1,5,-1,2021,0,3,1368,0
Kraken,0,1,1,0,2,Blackhawks,0,0,0,0,0,20220407,0,1,2,2,2,-2,2021,0,3,1732,0
Sabres,2,1,0,0,3,Hurricanes,0,2,3,0,5,20220407,-2,-1,2,2,8,2,2021,0,3,491,0
Canadiens,3,1,3,0,7,Devils,1,1,2,0,4,20220407,2,2,3,3,11,-3,2021,0,3,342,0
Predators,1,0,2,0,3,Senators,0,1,1,0,2,20220407,1,0,1,1,5,-1,2021,0,3,845,0
Flyers,0,3,1,0,4,Blue Jackets,1,0,0,0,1,20220407,-1,2,3,3,5,-3,2021,0,3,414,0
Penguins,0,0,0,0,0,Rangers,0,2,1,0,3,20220407,0,2,3,3,3,3,2021,0,3,314,0
Bruins,0,1,0,1,2,Lightning,0,1,0,0,1,20220408,0,0,0,1,3,-1,2021,1,4,1183,0
Sabres,3,0,0,0,3,Panthers,1,2,1,0,4,20220408,-2,0,1,1,7,1,2021,0,4,1184,0
Islanders,0,1,1,0,2,Hurricanes,0,0,1,0,1,20220408,0,1,1,1,3,-1,2021,0,4,423,0
Wild,1,1,1,0,3,Blues,1,0,2,1,4,20220408,0,-1,0,1,7,1,2021,1,4,466,0
Avalanche,1,2,1,1,5,Jets,2,0,2,0,4,20220408,-1,1,0,1,9,-1,2021,1,4,797,0
Coyotes,1,0,0,0,1,Golden Knights,2,1,3,0,6,20220409,1,2,5,5,7,5,2021,0,5,256,0
Sharks,1,1,0,0,2,Canucks,1,1,2,0,4,20220409,0,0,2,2,6,2,2021,0,5,821,0
Avalanche,0,0,1,1,2,Oilers,0,0,1,0,1,20220409,0,0,0,1,3,-1,2021,1,5,1036,0
Islanders,0,1,0,0,1,Blues,2,4,0,0,6,20220409,2,5,5,5,7,5,2021,0,5,871,0
Ducks,0,3,2,0,5,Flyers,2,0,1,0,3,20220409,-2,1,2,2,8,-2,2021,0,5,2388,0
Flames,2,1,1,0,4,Kraken,1,0,0,0,1,20220409,1,2,3,3,5,-3,2021,0,5,445,0
Panthers,1,1,2,0,4,Predators,1,0,0,0,1,20220409,0,1,3,3,5,-3,2021,0,5,816,0
Blue Jackets,1,1,2,1,5,Red Wings,0,2,2,0,4,20220409,1,0,0,1,9,-1,2021,1,5,163,0
Canadiens,0,2,0,0,2,Maple Leafs,2,1,0,0,3,20220409,2,1,1,1,5,1,2021,0,5,303,0
Capitals,2,1,3,0,6,Penguins,3,0,0,0,3,20220409,-1,0,3,3,9,-3,2021,0,5,190,0
Devils,0,0,3,0,3,Stars,0,1,0,0,1,20220409,0,-1,2,2,4,-2,2021,0,5,1362,0
Senators,1,0,0,0,1,Rangers,1,3,1,0,5,20220409,0,3,4,4,6,4,2021,0,5,334,0
Stars,2,3,1,0,6,Blackhawks,2,1,1,0,4,20220410,0,2,2,2,10,-2,2021,0,6,802,0
Jets,1,2,1,0,4,Senators,1,0,2,0,3,20220410,0,2,1,1,7,-1,2021,0,6,1033,0
Ducks,2,0,0,0,2,Hurricanes,3,0,2,0,5,20220410,1,1,3,3,7,3,2021,0,6,2231,0
Bruins,0,2,0,0,2,Capitals,0,2,2,0,4,20220410,0,0,2,2,6,2,2021,0,6,394,0
Sabres,0,0,0,0,0,Lightning,2,2,1,0,5,20220410,2,4,5,5,5,5,2021,0,6,1051,0
Predators,1,0,1,0,2,Penguins,1,0,1,1,3,20220410,0,0,0,1,5,1,2021,1,6,471,0
Kings,3,0,0,0,3,Wild,2,3,1,0,6,20220410,-1,2,3,3,9,3,2021,0,6,1521,0
Jets,0,2,2,0,4,Canadiens,0,1,1,0,2,20220411,0,1,2,2,6,-2,2021,0,0,1115,0
Golden Knights,1,1,2,0,4,Canucks,1,3,0,1,5,20220412,0,2,0,1,9,1,2021,1,1,986,0
Lightning,0,0,0,0,0,Stars,0,0,1,0,1,20220412,0,0,1,1,1,1,2021,0,1,916,0
Kraken,1,2,0,0,3,Flames,1,0,4,0,5,20220412,0,-2,2,2,8,2,2021,0,1,445,0
Kings,2,1,2,0,5,Blackhawks,0,1,1,0,2,20220412,2,2,3,3,7,-3,2021,0,1,1741,0
Sharks,0,0,0,0,0,Predators,0,0,0,1,1,20220412,0,0,0,1,1,1,2021,1,1,1934,0
Oilers,0,0,1,0,1,Wild,1,3,1,0,5,20220412,1,4,4,4,6,4,2021,0,1,1083,0
Senators,1,1,2,0,4,Red Wings,0,1,0,0,1,20220412,1,1,3,3,5,-3,2021,0,1,406,0
Flyers,1,0,1,0,2,Capitals,3,2,4,0,9,20220412,2,4,7,7,11,7,2021,0,1,123,0
Hurricanes,0,1,3,0,4,Rangers,0,1,1,0,2,20220412,0,0,2,2,6,-2,2021,0,1,423,0
Ducks,1,1,0,0,2,Panthers,0,1,1,1,3,20220412,-1,-1,0,1,5,1,2021,1,1,2335,0
Sabres,1,1,3,0,5,Maple Leafs,0,1,1,0,2,20220412,1,1,3,3,7,-3,2021,0,1,57,0
Blues,1,2,1,0,4,Bruins,2,0,0,0,2,20220412,-1,1,2,2,6,-2,2021,0,1,1035,0
Devils,1,3,2,0,6,Coyotes,1,1,0,0,2,20220412,0,2,4,4,8,-4,2021,0,1,2131,0
Penguins,1,2,1,0,4,Islanders,3,0,1,1,5,20220412,2,0,0,1,9,1,2021,1,1,314,0
Canadiens,0,1,0,0,1,Blue Jackets,1,2,2,0,5,20220413,1,2,4,4,6,4,2021,0,2,605,0
Kings,0,2,1,0,3,Avalanche,4,2,3,0,9,20220413,4,4,6,6,12,6,2021,0,2,830,0
Rangers,1,2,1,0,4,Flyers,0,0,0,0,0,20220413,1,3,4,4,4,-4,2021,0,2,80,0
Coyotes,0,1,0,0,1,Canucks,2,4,1,0,7,20220414,2,5,6,6,8,6,2021,0,3,1228,0
Golden Knights,1,4,1,0,6,Flames,1,0,0,0,1,20220414,0,4,5,5,7,-5,2021,0,3,1033,0
Sharks,1,1,2,0,4,Blackhawks,1,2,1,1,5,20220414,0,1,0,1,9,1,2021,1,3,1837,0
Wild,1,1,0,1,3,Stars,0,1,1,0,2,20220414,1,1,0,1,5,-1,2021,1,3,863,0
Oilers,1,2,1,0,4,Predators,0,0,0,0,0,20220414,1,3,4,4,4,-4,2021,0,3,1758,0
Devils,0,0,1,0,1,Avalanche,0,3,0,0,3,20220414,0,3,2,2,4,2,2021,0,3,1618,0
Islanders,0,1,2,0,3,Penguins,2,1,3,0,6,20220414,2,2,3,3,9,3,2021,0,3,314,0
Ducks,0,3,0,0,3,Lightning,2,0,1,1,4,20220414,2,-1,0,1,7,1,2021,1,3,2149,0
Capitals,0,2,1,0,3,Maple Leafs,2,4,1,0,7,20220414,2,4,4,4,10,4,2021,0,3,349,0
Blues,1,3,2,0,6,Sabres,1,1,0,0,2,20220414,0,2,4,4,8,-4,2021,0,3,660,0
Senators,0,3,0,0,3,Bruins,2,0,0,0,2,20220414,-2,1,1,1,5,-1,2021,0,3,320,0
Red Wings,0,1,2,0,3,Hurricanes,0,0,0,0,0,20220414,0,1,3,3,3,-3,2021,0,3,511,0
Islanders,0,0,3,0,3,Canadiens,0,0,0,0,0,20220415,0,0,3,3,3,-3,2021,0,4,343,0
Jets,0,0,1,0,1,Panthers,2,2,2,0,6,20220415,2,4,5,5,7,5,2021,0,4,1899,0
Jets,2,2,0,0,4,Lightning,2,2,3,0,7,20220416,0,0,3,3,11,3,2021,0,5,1705,0
Blue Jackets,0,1,0,0,1,Kings,2,0,0,0,2,20220416,2,1,1,1,3,1,2021,0,5,1973,0
Devils,2,0,1,0,3,Kraken,1,2,0,1,4,20220416,-1,1,0,1,7,1,2021,1,5,2393,0
Coyotes,1,0,0,0,1,Flames,0,6,3,0,9,20220416,-1,5,8,8,10,8,2021,0,5,1224,0
Hurricanes,0,3,1,0,4,Avalanche,2,3,2,0,7,20220416,2,2,3,3,11,3,2021,0,5,1459,0
Sharks,0,1,0,0,1,Stars,1,1,0,0,2,20220416,1,1,1,1,3,1,2021,0,5,1449,0
Maple Leafs,0,3,1,1,5,Senators,2,1,1,0,4,20220416,-2,0,0,1,9,-1,2021,1,5,203,0
Flyers,2,1,0,0,3,Sabres,0,4,0,0,4,20220416,-2,1,1,1,7,1,2021,0,5,279,0
Golden Knights,0,0,0,0,0,Oilers,1,0,3,0,4,20220416,1,1,4,4,4,4,2021,0,5,1204,0
Wild,0,1,4,0,5,Blues,1,3,1,1,6,20220416,1,3,0,1,11,1,2021,1,5,466,0
Blackhawks,1,1,1,0,3,Predators,1,2,1,0,4,20220416,0,1,1,1,7,1,2021,0,5,395,0
Red Wings,0,0,0,0,0,Rangers,1,1,2,0,4,20220416,1,2,4,4,4,4,2021,0,5,480,0
Penguins,0,1,0,0,1,Bruins,2,0,0,0,2,20220416,2,1,1,1,3,1,2021,0,5,481,0
Capitals,1,3,4,0,8,Canadiens,0,2,2,0,4,20220416,1,2,4,4,12,-4,2021,0,5,495,0
Sharks,1,2,1,0,4,Wild,2,1,1,1,5,20220417,1,0,0,1,9,1,2021,1,6,1570,0
Panthers,0,4,2,0,6,Red Wings,0,0,1,0,1,20220417,0,4,5,5,7,-5,2021,0,6,1155,0
Sabres,2,2,1,0,5,Flyers,1,1,1,0,3,20220417,1,2,2,2,8,-2,2021,0,6,279,0
Blues,1,7,0,0,8,Predators,1,1,1,0,3,20220417,0,6,5,5,11,-5,2021,0,6,253,0
Islanders,1,1,0,0,2,Maple Leafs,1,2,1,0,4,20220417,0,1,2,2,6,2,2021,0,6,341,0
Blue Jackets,1,2,1,0,4,Ducks,3,0,3,0,6,20220417,2,0,2,2,10,2,2021,0,6,1973,0
Senators,0,2,0,0,2,Kraken,1,2,1,0,4,20220418,1,1,2,2,6,2,2021,0,0,2176,0
Devils,1,0,2,0,3,Golden Knights,0,1,1,0,2,20220418,1,0,1,1,5,-1,2021,0,0,2218,0
Stars,1,1,0,0,2,Canucks,2,2,2,0,6,20220418,1,2,4,4,8,4,2021,0,0,1766,0
Capitals,1,1,1,0,3,Avalanche,1,0,1,0,2,20220418,0,1,1,1,5,-1,2021,0,0,1489,0
Flames,3,0,2,0,5,Blackhawks,1,1,0,0,2,20220418,2,1,3,3,7,-3,2021,0,0,1397,0
Hurricanes,1,3,1,0,5,Coyotes,0,3,0,0,3,20220418,1,1,2,2,8,-2,2021,0,0,1898,0
Kings,0,1,1,0,2,Ducks,0,1,0,0,1,20220419,0,0,1,1,3,-1,2021,0,1,0,0
Flames,0,1,1,0,2,Predators,0,2,0,1,3,20220419,0,1,0,1,5,1,2021,1,1,1692,0
Senators,0,1,2,1,4,Canucks,2,0,1,0,3,20220419,-2,-1,0,1,7,-1,2021,1,1,2191,0
Blue Jackets,0,0,2,0,2,Sharks,3,0,0,0,3,20220419,3,3,1,1,5,1,2021,0,1,2090,0
Bruins,0,2,0,1,3,Blues,1,1,0,0,2,20220419,-1,0,0,1,5,-1,2021,1,1,1035,0
Wild,1,0,1,0,2,Canadiens,0,0,0,0,0,20220419,1,1,2,2,2,-2,2021,0,1,938,0
Jets,0,0,0,0,0,Rangers,0,1,2,0,3,20220419,0,1,3,3,3,3,2021,0,1,1287,0
Red Wings,0,3,1,0,4,Lightning,0,2,1,0,3,20220419,0,1,1,1,7,-1,2021,0,1,994,0
Flyers,0,1,1,0,2,Maple Leafs,0,3,2,0,5,20220419,0,2,3,3,7,3,2021,0,1,334,0
Panthers,0,1,1,1,3,Islanders,0,1,1,0,2,20220419,0,0,0,1,5,-1,2021,1,1,1091,0
Stars,1,1,0,0,2,Oilers,2,2,1,0,5,20220420,1,2,3,3,7,3,2021,0,2,1655,0
Blackhawks,2,1,0,1,4,Coyotes,0,1,2,0,3,20220420,2,2,0,1,7,-1,2021,1,2,1450,0
Capitals,1,1,1,0,3,Golden Knights,1,0,2,1,4,20220420,0,-1,0,1,7,1,2021,1,2,2080,0
Avalanche,1,0,1,0,2,Kraken,3,0,0,0,3,20220420,2,2,1,1,5,1,2021,0,2,1019,0
Blues,1,1,1,0,3,Sharks,1,0,0,0,1,20220421,0,1,2,2,4,-2,2021,0,3,1719,0
Blackhawks,0,1,0,0,1,Kings,1,1,2,0,4,20220421,1,1,3,3,5,3,2021,0,3,1741,0
Stars,0,1,1,0,2,Flames,0,1,3,0,4,20220421,0,0,2,2,6,2,2021,0,3,1536,0
Canucks,0,3,0,0,3,Wild,0,3,3,0,6,20220421,0,0,3,3,9,3,2021,0,3,1427,0
Maple Leafs,0,0,1,0,1,Lightning,0,4,4,0,8,20220421,0,4,7,7,9,7,2021,0,3,1096,0
Sabres,0,3,2,0,5,Devils,0,1,1,0,2,20220421,0,2,3,3,7,-3,2021,0,3,284,0
Jets,2,0,0,0,2,Hurricanes,0,1,3,0,4,20220421,-2,-1,2,2,6,2,2021,0,3,1350,0
Bruins,0,0,0,0,0,Penguins,1,2,1,0,4,20220421,1,3,4,4,4,4,2021,0,3,481,0
Red Wings,1,1,0,0,2,Panthers,3,1,1,0,5,20220421,2,2,3,3,7,3,2021,0,3,1155,0
Flyers,2,2,2,0,6,Canadiens,1,1,1,0,3,20220421,1,2,3,3,9,-3,2021,0,3,400,0
Rangers,3,2,1,0,6,Islanders,0,1,2,0,3,20220421,3,4,3,3,9,-3,2021,0,3,0,0
Capitals,1,0,1,0,2,Coyotes,0,0,0,0,0,20220422,1,1,2,2,2,-2,2021,0,4,1977,0
Avalanche,1,1,1,0,3,Oilers,0,4,2,0,6,20220422,-1,2,3,3,9,3,2021,0,4,1036,0
Senators,0,0,1,1,2,Blue Jackets,1,0,0,0,1,20220422,-1,-1,0,1,3,-1,2021,1,4,512,0
Kraken,2,0,1,0,3,Wild,1,5,0,0,6,20220422,-1,4,3,3,9,3,2021,0,4,1391,0
Kraken,2,0,0,0,2,Stars,0,3,0,0,3,20220423,-2,1,1,1,5,1,2021,0,5,1679,0
Islanders,1,0,2,0,3,Sabres,1,3,1,0,5,20220423,0,3,2,2,8,2,2021,0,5,292,0
Penguins,2,3,2,0,7,Red Wings,1,1,0,0,2,20220423,1,3,5,5,9,-5,2021,0,5,205,0
Hurricanes,0,0,2,1,3,Devils,0,1,1,0,2,20220423,0,-1,0,1,5,-1,2021,1,5,419,0
Rangers,0,0,1,0,1,Bruins,1,1,1,0,3,20220423,1,2,2,2,4,2,2021,0,5,190,0
Canadiens,1,2,1,0,4,Senators,1,5,0,0,6,20220423,0,3,2,2,10,2,2021,0,5,104,0
Predators,1,1,0,0,2,Lightning,3,1,2,0,6,20220423,2,2,4,4,8,4,2021,0,5,621,0
Maple Leafs,2,0,0,0,2,Panthers,0,2,0,1,3,20220423,-2,0,0,1,5,1,2021,1,5,1234,0
Blackhawks,0,1,0,0,1,Sharks,1,2,1,0,4,20220423,1,2,3,3,5,3,2021,0,5,1837,0
Canucks,0,1,2,0,3,Flames,0,2,4,0,6,20220423,0,1,3,3,9,3,2021,0,5,426,0
Blues,3,1,0,1,5,Coyotes,1,0,3,0,4,20220423,2,3,0,1,9,-1,2021,1,5,1270,0
Ducks,0,2,0,0,2,Kings,1,1,2,0,4,20220423,1,0,2,2,6,2,2021,0,5,0,0
Wild,1,3,0,1,5,Predators,1,2,1,0,4,20220424,0,1,0,1,9,-1,2021,1,6,696,0
Bruins,2,2,1,0,5,Canadiens,0,1,2,0,3,20220424,2,3,2,2,8,-2,2021,0,6,270,0
Sharks,1,1,2,1,5,Golden Knights,1,2,1,0,4,20220424,0,-1,0,1,9,-1,2021,1,6,382,0
Blues,0,4,2,0,6,Ducks,2,0,1,0,3,20220424,-2,2,3,3,9,-3,2021,0,6,1586,0
Avalanche,0,0,1,0,1,Jets,0,0,4,0,4,20220424,0,0,3,3,5,3,2021,0,6,797,0
Maple Leafs,1,0,2,1,4,Capitals,1,0,2,0,3,20220424,0,0,0,1,7,-1,2021,1,6,349,0
Lightning,3,2,3,0,8,Panthers,2,1,1,0,4,20220424,1,2,4,4,12,-4,2021,0,6,205,0
Penguins,0,0,1,0,1,Flyers,1,1,2,0,4,20220424,1,2,3,3,5,3,2021,0,6,257,0
Oilers,1,1,0,0,2,Blue Jackets,1,0,4,0,5,20220424,0,-1,3,3,7,3,2021,0,6,1703,0
Hurricanes,2,0,3,0,5,Islanders,1,1,0,0,2,20220424,1,0,3,3,7,-3,2021,0,6,423,0
Red Wings,1,0,2,0,3,Devils,0,0,0,0,0,20220424,1,1,3,3,3,-3,2021,0,6,471,0
Flyers,1,0,0,0,1,Blackhawks,2,0,1,0,3,20220425,1,1,2,2,4,2,2021,0,0,664,0
Ducks,1,2,2,0,5,Sharks,0,2,0,0,2,20220426,1,1,3,3,7,-3,2021,0,1,305,0
Kraken,0,2,0,0,2,Canucks,3,0,2,0,5,20220426,3,1,3,3,7,3,2021,0,1,116,0
Blues,0,1,2,0,3,Avalanche,0,3,2,0,5,20220426,0,2,2,2,8,2,2021,0,1,794,0
Golden Knights,1,1,0,0,2,Stars,0,1,1,1,3,20220426,-1,-1,0,1,5,1,2021,1,1,1068,0
Coyotes,0,1,4,0,5,Wild,1,0,2,0,3,20220426,-1,0,2,2,8,-2,2021,0,1,1278,0
Flames,1,1,2,1,5,Predators,0,2,2,0,4,20220426,1,0,0,1,9,-1,2021,1,1,1692,0
Oilers,1,1,3,0,5,Penguins,0,1,0,0,1,20220426,1,1,4,4,6,-4,2021,0,1,1797,0
Islanders,1,0,3,0,4,Capitals,1,0,0,0,1,20220426,0,0,3,3,5,-3,2021,0,1,204,0
Hurricanes,0,3,1,0,4,Rangers,0,1,2,0,3,20220426,0,2,1,1,7,-1,2021,0,1,423,0
Blue Jackets,1,0,0,0,1,Lightning,2,1,1,0,4,20220426,1,2,3,3,5,3,2021,0,1,830,0
Devils,0,2,2,0,4,Senators,1,2,1,1,5,20220426,1,1,0,1,9,1,2021,1,1,330,0
Panthers,2,0,0,0,2,Bruins,2,1,1,0,4,20220426,0,1,2,2,6,2,2021,0,1,1257,0
Red Wings,0,0,0,0,0,Maple Leafs,0,1,2,0,3,20220426,0,1,3,3,3,3,2021,0,1,205,0
Kings,0,3,2,0,5,Kraken,1,2,0,0,3,20220427,-1,0,2,2,8,-2,2021,0,2,960,0
Coyotes,0,0,3,1,4,Stars,2,1,0,0,3,20220427,-2,-3,0,1,7,-1,2021,1,2,884,0
Flyers,0,0,0,0,0,Jets,1,2,1,0,4,20220427,1,3,4,4,4,4,2021,0,2,1273,0
Canadiens,1,1,2,0,4,Rangers,0,1,2,0,3,20220427,1,1,1,1,7,-1,2021,0,2,343,0
Golden Knights,1,2,0,0,3,Blackhawks,2,1,0,1,4,20220427,1,0,0,1,7,1,2021,1,2,1519,0
Kings,0,2,0,0,2,Canucks,0,0,2,1,3,20220428,0,-2,0,1,5,1,2021,1,3,1076,0
Sharks,2,1,1,0,4,Oilers,0,2,2,1,5,20220428,-2,-1,0,1,9,1,2021,1,3,1190,0
Flames,0,1,1,0,2,Wild,0,1,1,1,3,20220428,0,0,0,1,5,1,2021,1,3,1043,0
Lightning,0,1,1,0,2,Blue Jackets,1,1,3,0,5,20220428,1,1,3,3,7,3,2021,0,3,830,0
Predators,1,2,1,1,5,Avalanche,3,1,0,0,4,20220428,-2,-1,0,1,9,-1,2021,1,3,1019,0
Devils,1,0,2,0,3,Hurricanes,3,1,2,0,6,20220428,2,3,3,3,9,3,2021,0,3,419,0
Panthers,1,0,3,0,4,Senators,0,0,0,0,0,20220428,1,1,4,4,4,-4,2021,0,3,1370,0
Sabres,0,0,0,0,0,Bruins,0,2,3,0,5,20220428,0,2,5,5,5,5,2021,0,3,399,0
Capitals,0,0,1,0,1,Islanders,2,0,3,0,5,20220428,2,2,4,4,6,4,2021,0,3,204,0
Golden Knights,1,2,4,0,7,Blues,1,2,1,0,4,20220429,0,0,3,3,11,-3,2021,0,4,1375,0
Sharks,0,0,0,0,0,Kraken,2,0,1,0,3,20220429,2,2,3,3,3,3,2021,0,4,709,0
Canucks,1,0,1,0,2,Oilers,0,0,2,1,3,20220429,-1,-1,0,1,5,1,2021,1,4,514,0
Ducks,1,1,0,0,2,Stars,0,2,2,0,4,20220429,-1,0,2,2,6,2,2021,0,4,1237,0
Flames,1,0,0,0,1,Jets,1,1,1,0,3,20220429,0,1,2,2,4,2,2021,0,4,740,0
Avalanche,0,1,0,0,1,Wild,2,1,1,0,4,20220429,2,2,3,3,5,3,2021,0,4,698,0
Lightning,1,0,5,0,6,Islanders,1,2,1,0,4,20220429,0,-2,2,2,10,-2,2021,0,4,1004,0
Predators,4,0,0,0,4,Coyotes,1,2,2,0,5,20220429,-3,-1,1,1,9,1,2021,0,4,1442,0
Senators,0,1,3,0,4,Flyers,1,0,1,0,2,20220429,-1,0,2,2,6,-2,2021,0,4,373,0
Capitals,0,2,0,0,2,Rangers,0,2,1,0,3,20220429,0,0,1,1,5,1,2021,0,4,204,0
Red Wings,1,1,3,0,5,Devils,1,1,1,0,3,20220429,0,0,2,2,8,-2,2021,0,4,471,0
Panthers,1,0,1,0,2,Canadiens,4,4,2,0,10,20220429,3,7,8,8,12,8,2021,0,4,1418,0
Bruins,1,0,1,0,2,Maple Leafs,3,0,2,0,5,20220429,2,2,3,3,7,3,2021,0,4,430,0
Blackhawks,0,1,1,0,2,Sabres,0,0,2,1,3,20220429,0,-1,0,1,5,1,2021,1,4,453,0
Blue Jackets,0,1,2,0,3,Penguins,3,2,0,0,5,20220429,3,4,2,2,8,2,2021,0,4,161,0
Kraken,0,3,0,0,3,Jets,1,0,3,0,4,20220501,1,-2,1,1,7,1,2021,0,6,1148,0
Bruins,0,0,1,0,1,Hurricanes,0,2,3,0,5,20220502,0,2,4,4,6,4,2021,0,0,609,1
Lightning,0,0,0,0,0,Maple Leafs,1,3,1,0,5,20220502,1,4,5,5,5,5,2021,0,0,1096,1
Blues,2,1,1,0,4,Wild,0,0,0,0,0,20220502,2,3,4,4,4,-4,2021,0,0,466,1
Kings,2,1,1,0,4,Oilers,1,2,0,0,3,20220502,1,0,1,1,7,-1,2021,0,0,1368,1
Stars,0,0,0,0,0,Flames,1,0,0,0,1,20220503,1,1,1,1,1,1,2021,0,1,1536,1
Predators,0,1,1,0,2,Avalanche,5,1,1,0,7,20220503,5,5,5,5,9,5,2021,0,1,1019,1
Penguins,0,3,0,1,4,Rangers,1,2,0,0,3,20220503,-1,0,0,1,7,-1,2021,1,1,314,1
Capitals,1,0,3,0,4,Panthers,1,1,0,0,2,20220503,0,-1,2,2,6,-2,2021,0,1,924,1
Bruins,0,1,1,0,2,Hurricanes,2,2,1,0,5,20220504,2,3,3,3,7,3,2021,0,2,609,1
Lightning,1,2,2,0,5,Maple Leafs,0,1,2,0,3,20220504,1,2,2,2,8,-2,2021,0,2,1096,1
Blues,0,1,1,0,2,Wild,3,1,2,0,6,20220504,3,3,4,4,8,4,2021,0,2,466,1
Kings,0,0,0,0,0,Oilers,0,3,3,0,6,20220504,0,3,6,6,6,6,2021,0,2,1368,1
Penguins,1,1,0,0,2,Rangers,1,2,2,0,5,20220505,0,1,3,3,7,3,2021,0,3,314,1
Capitals,0,1,0,0,1,Panthers,2,3,0,0,5,20220505,2,4,4,4,6,4,2021,0,3,924,1
Predators,1,0,0,0,1,Avalanche,1,0,0,1,2,20220505,0,0,0,1,3,1,2021,1,3,1019,1
Stars,1,0,1,0,2,Flames,0,0,0,0,0,20220505,1,1,2,2,2,-2,2021,0,3,1536,1
Oilers,2,3,3,0,8,Kings,0,2,0,0,2,20220506,2,3,6,6,10,-6,2021,0,4,1368,1
Wild,2,1,2,0,5,Blues,0,0,1,0,1,20220506,2,3,4,4,6,-4,2021,0,4,466,1
Hurricanes,1,0,1,0,2,Bruins,1,2,1,0,4,20220506,0,2,2,2,6,2,2021,0,4,609,1
Maple Leafs,2,1,2,0,5,Lightning,0,1,1,0,2,20220506,2,2,3,3,7,-3,2021,0,4,1096,1
Panthers,1,0,0,0,1,Capitals,1,2,3,0,6,20220507,0,2,5,5,7,5,2021,0,5,924,1
Avalanche,2,3,2,0,7,Predators,1,2,0,0,3,20220507,1,2,4,4,10,-4,2021,0,5,1019,1
Rangers,1,3,0,0,4,Penguins,4,0,3,0,7,20220507,3,0,3,3,11,3,2021,0,5,314,1
Flames,1,1,0,0,2,Stars,1,1,2,0,4,20220507,0,0,2,2,6,2,2021,0,5,1536,1
Hurricanes,1,1,0,0,2,Bruins,1,1,3,0,5,20220508,0,0,3,3,7,3,2021,0,6,609,1
Wild,1,0,1,0,2,Blues,1,2,2,0,5,20220508,0,2,3,3,7,3,2021,0,6,466,1
Maple Leafs,0,0,3,0,3,Lightning,3,2,2,0,7,20220508,3,5,4,4,10,4,2021,0,6,1096,1
Oilers,0,0,0,0,0,Kings,2,0,2,0,4,20220508,2,2,4,4,4,4,2021,0,6,1368,1
Rangers,1,1,0,0,2,Penguins,1,5,1,0,7,20220509,0,4,5,5,9,5,2021,0,0,314,1
Avalanche,1,1,3,0,5,Predators,1,1,1,0,3,20220509,0,0,2,2,8,-2,2021,0,0,1019,1
Panthers,1,0,1,1,3,Capitals,1,0,1,0,2,20220509,0,0,0,1,5,-1,2021,1,0,924,1
Flames,0,1,3,0,4,Stars,0,0,1,0,1,20220509,0,1,3,3,5,-3,2021,0,0,1536,1
Bruins,0,0,1,0,1,Hurricanes,2,1,2,0,5,20220510,2,3,4,4,6,4,2021,0,1,609,1
Lightning,2,0,1,0,3,Maple Leafs,0,1,3,0,4,20220510,-2,-1,1,1,7,1,2021,0,1,1096,1
Blues,1,1,3,0,5,Wild,2,0,0,0,2,20220510,-1,0,3,3,7,-3,2021,0,1,466,1
Kings,1,2,1,1,5,Oilers,0,1,3,0,4,20220510,1,2,0,1,9,-1,2021,1,1,1368,1
Capitals,1,2,0,0,3,Panthers,0,3,2,0,5,20220511,-1,0,2,2,8,2,2021,0,2,924,1
Penguins,1,2,0,0,3,Rangers,0,3,2,0,5,20220511,-1,0,2,2,8,2,2021,0,2,314,1
Stars,0,1,0,0,1,Flames,0,0,3,0,3,20220511,0,-1,2,2,4,2,2021,0,2,1536,1
Oilers,1,1,2,0,4,Kings,0,1,1,0,2,20220512,1,1,2,2,6,-2,2021,0,3,1368,1
Wild,0,0,1,0,1,Blues,1,3,1,0,5,20220512,1,4,4,4,6,4,2021,0,3,466,1
Hurricanes,0,0,2,0,2,Bruins,0,2,3,0,5,20220512,0,2,3,3,7,3,2021,0,3,609,1
Maple Leafs,0,3,0,0,3,Lightning,1,1,1,1,4,20220512,1,-1,0,1,7,1,2021,1,3,1096,1
Rangers,0,3,2,0,5,Penguins,2,1,0,0,3,20220513,-2,0,2,2,8,-2,2021,0,4,314,1
Panthers,0,1,2,1,4,Capitals,0,1,2,0,3,20220513,0,0,0,1,7,-1,2021,1,4,924,1
Flames,0,2,0,0,2,Stars,1,2,1,0,4,20220513,1,1,2,2,6,2,2021,0,4,1536,1
Bruins,0,1,1,0,2,Hurricanes,1,2,0,0,3,20220514,1,2,1,1,5,1,2021,0,5,609,1
Lightning,1,1,0,0,2,Maple Leafs,0,1,0,0,1,20220514,1,1,1,1,3,-1,2021,0,5,1096,1
Kings,0,0,0,0,0,Oilers,0,1,1,0,2,20220514,0,1,2,2,2,2,2021,0,5,1368,1
Penguins,1,2,0,0,3,Rangers,1,1,1,1,4,20220515,0,-1,0,1,7,1,2021,1,6,314,1
Stars,1,1,0,0,2,Flames,0,2,0,1,3,20220515,-1,0,0,1,5,1,2021,1,6,1536,1
Blues,1,0,1,0,2,Avalanche,0,2,0,1,3,20220517,-1,1,0,1,5,1,2021,1,1,794,1
Lightning,0,1,3,0,4,Panthers,1,0,0,0,1,20220517,-1,0,3,3,5,-3,2021,0,1,205,1
Rangers,1,0,0,0,1,Hurricanes,0,0,1,1,2,20220518,-1,-1,0,1,3,1,2021,1,2,423,1
Oilers,1,4,1,0,6,Flames,3,3,3,0,9,20220518,2,1,3,3,15,3,2021,0,2,171,1
Lightning,1,0,1,0,2,Panthers,0,1,0,0,1,20220519,1,0,1,1,3,-1,2021,0,3,205,1
Blues,0,2,2,0,4,Avalanche,0,0,1,0,1,20220519,0,2,3,3,5,-3,2021,0,3,794,1
Rangers,0,0,0,0,0,Hurricanes,0,1,1,0,2,20220520,0,1,2,2,2,2,2021,0,4,423,1
Oilers,1,2,2,0,5,Flames,2,1,0,0,3,20220520,-1,0,2,2,8,-2,2021,0,4,171,1
Avalanche,1,2,2,0,5,Blues,1,1,0,0,2,20220521,0,1,3,3,7,-3,2021,0,5,794,1
Flames,0,0,1,0,1,Oilers,0,4,0,0,4,20220522,0,4,3,3,5,3,2021,0,6,171,1
Panthers,1,0,0,0,1,Lightning,1,2,2,0,5,20220522,0,2,4,4,6,4,2021,0,6,205,1
Hurricanes,0,1,0,0,1,Rangers,1,1,1,0,3,20220522,1,1,2,2,4,2,2021,0,6,423,1
Avalanche,0,4,2,0,6,Blues,1,2,0,0,3,20220523,-1,1,3,3,9,-3,2021,0,0,794,1
Panthers,0,0,0,0,0,Lightning,0,0,2,0,2,20220523,0,0,2,2,2,2,2021,0,0,205,1
Hurricanes,0,0,1,0,1,Rangers,2,1,1,0,4,20220524,2,3,3,3,5,3,2021,0,1,423,1
Flames,0,2,1,0,3,Oilers,3,0,2,0,5,20220524,3,1,2,2,8,2,2021,0,1,171,1
Blues,0,1,3,1,5,Avalanche,2,1,1,0,4,20220525,-2,-2,0,1,9,-1,2021,1,2,794,1
Rangers,1,0,0,0,1,Hurricanes,1,1,1,0,3,20220526,0,1,2,2,4,2,2021,0,3,423,1
Oilers,0,4,0,1,5,Flames,1,3,0,0,4,20220526,-1,0,0,1,9,-1,2021,1,3,171,1
Avalanche,0,1,2,0,3,Blues,1,1,0,0,2,20220527,-1,-1,1,1,5,-1,2021,0,4,794,1
Hurricanes,0,2,0,0,2,Rangers,2,2,1,0,5,20220528,2,2,3,3,7,3,2021,0,5,423,1
Rangers,2,1,3,0,6,Hurricanes,0,0,2,0,2,20220530,2,3,4,4,8,-4,2021,0,0,423,1
Oilers,2,2,2,0,6,Avalanche,3,4,1,0,8,20220531,1,3,2,2,14,2,2021,0,1,1036,1
Lightning,1,1,0,0,2,Rangers,1,3,2,0,6,20220601,0,2,4,4,8,4,2021,0,2,1004,1
Oilers,0,0,0,0,0,Avalanche,0,3,1,0,4,20220602,0,3,4,4,4,4,2021,0,3,1036,1
Lightning,1,0,1,0,2,Rangers,2,0,1,0,3,20220603,1,1,1,1,5,1,2021,0,4,1004,1
Avalanche,1,1,2,0,4,Oilers,1,0,1,0,2,20220604,0,1,2,2,6,-2,2021,0,5,1036,1
Rangers,0,2,0,0,2,Lightning,0,1,2,0,3,20220605,0,-1,1,1,5,1,2021,0,6,1004,1
Avalanche,1,0,4,1,6,Oilers,0,3,2,0,5,20220606,1,-2,0,1,11,-1,2021,1,0,1036,1
Rangers,0,0,1,0,1,Lightning,1,1,2,0,4,20220607,1,2,3,3,5,3,2021,0,1,1004,1
Lightning,0,1,2,0,3,Rangers,0,1,0,0,1,20220609,0,0,2,2,4,-2,2021,0,3,1004,1
Rangers,0,0,1,0,1,Lightning,0,1,1,0,2,20220611,0,1,1,1,3,1,2021,0,5,1004,1
Lightning,1,2,0,0,3,Avalanche,3,0,0,1,4,20220615,2,0,0,1,7,1,2021,1,2,1521,1
Lightning,0,0,0,0,0,Avalanche,3,2,2,0,7,20220618,3,5,7,7,7,7,2021,0,5,1521,1
Avalanche,1,1,0,0,2,Lightning,2,4,0,0,6,20220620,1,4,4,4,8,4,2021,0,0,1521,1
Avalanche,0,1,1,1,3,Lightning,1,1,0,0,2,20220622,-1,-1,0,1,5,-1,2021,1,2,1521,1
Lightning,1,1,1,0,3,Avalanche,0,1,1,0,2,20220624,1,1,1,1,5,-1,2021,0,4,1521,1
Avalanche,0,2,0,0,2,Lightning,1,0,0,0,1,20220626,-1,1,1,1,3,-1,2021,0,6,1521,1
